Timestamp,NAnimals,NResources,NFemales,NMales,MeanLifeSuccess,MeanAge,%MatingAccept
2024-12-08 16:51:05,100,0,50,50,0.00,0.00,0.00
2024-12-08 16:51:06,100,0,50,50,0.00,0.00,0.00
2024-12-08 16:51:06,100,1,50,50,0.74,1.00,0.00
2024-12-08 16:51:06,99,1,49,50,0.78,1.04,0.00
2024-12-08 16:51:06,98,1,48,50,0.79,1.04,0.00
2024-12-08 16:51:06,97,1,48,49,0.79,1.04,0.00
2024-12-08 16:51:06,96,1,47,49,0.79,1.04,0.00
2024-12-08 16:51:06,95,1,47,48,0.84,1.11,0.00
2024-12-08 16:51:06,94,1,47,47,0.86,1.12,0.00
2024-12-08 16:51:06,93,1,47,46,0.86,1.12,0.00
2024-12-08 16:51:06,92,1,47,45,0.89,1.15,0.00
2024-12-08 16:51:06,91,1,46,45,0.89,1.15,0.00
2024-12-08 16:51:06,90,1,45,45,0.90,1.17,0.00
2024-12-08 16:51:06,89,1,45,44,0.91,1.17,0.00
2024-12-08 16:51:06,88,1,45,43,0.91,1.17,0.00
2024-12-08 16:51:06,87,1,45,42,0.92,1.17,0.00
2024-12-08 16:51:06,86,1,45,41,0.95,1.22,0.00
2024-12-08 16:51:06,85,1,45,40,1.01,1.32,0.00
2024-12-08 16:51:06,84,1,44,40,1.03,1.33,0.00
2024-12-08 16:51:06,83,1,44,39,1.12,1.51,0.00
2024-12-08 16:51:06,82,1,44,38,1.12,1.56,0.00
2024-12-08 16:51:06,81,1,44,37,1.16,1.60,0.00
2024-12-08 16:51:06,80,1,43,37,1.28,1.81,0.00
2024-12-08 16:51:06,79,1,42,37,1.31,1.86,0.00
2024-12-08 16:51:06,78,1,41,37,1.33,1.90,0.00
2024-12-08 16:51:06,77,1,41,36,1.35,1.91,0.00
2024-12-08 16:51:06,76,1,40,36,1.39,1.97,0.00
2024-12-08 16:51:07,76,2,40,36,1.41,2.00,0.00
2024-12-08 16:51:07,75,2,40,35,1.53,2.19,0.00
2024-12-08 16:51:07,74,2,40,34,1.62,2.31,0.00
2024-12-08 16:51:07,73,2,40,33,1.65,2.36,0.00
2024-12-08 16:51:07,72,2,39,33,1.70,2.43,0.00
2024-12-08 16:51:07,71,2,38,33,1.75,2.49,0.00
2024-12-08 16:51:07,70,2,37,33,1.79,2.54,0.00
2024-12-08 16:51:07,69,2,37,32,1.81,2.55,0.00
2024-12-08 16:51:07,68,2,36,32,1.84,2.56,0.00
2024-12-08 16:51:07,67,2,35,32,1.89,2.61,0.00
2024-12-08 16:51:07,66,2,34,32,1.99,2.77,0.00
2024-12-08 16:51:07,65,2,34,31,2.03,2.80,0.00
2024-12-08 16:51:07,64,2,33,31,2.07,2.89,0.00
2024-12-08 16:51:07,63,2,32,31,2.13,2.94,0.00
2024-12-08 16:51:07,62,2,31,31,2.18,2.98,0.00
2024-12-08 16:51:07,62,3,31,31,2.19,3.00,0.00
2024-12-08 16:51:07,61,3,31,30,2.30,3.08,0.00
2024-12-08 16:51:07,60,3,30,30,2.38,3.17,0.00
2024-12-08 16:51:07,59,3,29,30,2.46,3.25,0.00
2024-12-08 16:51:07,58,3,29,29,2.56,3.33,0.00
2024-12-08 16:51:07,57,3,28,29,2.67,3.58,0.00
2024-12-08 16:51:07,56,3,28,28,2.75,3.66,0.00
2024-12-08 16:51:07,55,3,28,27,2.81,3.69,0.00
2024-12-08 16:51:07,54,3,28,26,2.99,3.85,0.00
2024-12-08 16:51:07,53,3,27,26,3.04,3.87,0.00
2024-12-08 16:51:07,53,4,27,26,3.15,4.00,0.00
2024-12-08 16:51:07,52,4,27,25,3.46,4.37,0.00
2024-12-08 16:51:07,51,4,27,24,3.54,4.47,0.00
2024-12-08 16:51:07,51,5,27,24,3.86,5.00,0.00
2024-12-08 16:51:07,50,5,27,23,4.16,5.40,0.00
2024-12-08 16:51:07,50,6,27,23,4.47,6.00,0.00
2024-12-08 16:51:07,49,6,27,22,4.64,6.29,0.00
2024-12-08 16:51:07,48,6,27,21,4.85,6.46,0.00
2024-12-08 16:51:07,47,6,26,21,4.92,6.57,0.00
2024-12-08 16:51:07,47,7,26,21,5.22,7.00,0.00
2024-12-08 16:51:07,46,7,25,21,5.40,7.17,0.00
2024-12-08 16:51:07,45,7,25,20,5.48,7.18,0.00
2024-12-08 16:51:07,44,7,24,20,5.73,7.45,0.00
2024-12-08 16:51:07,43,7,23,20,5.87,7.49,0.00
2024-12-08 16:51:07,43,8,23,20,6.18,8.00,0.00
2024-12-08 16:51:07,42,8,23,19,6.43,8.14,0.00
2024-12-08 16:51:07,42,9,23,19,6.86,9.00,0.00
2024-12-08 16:51:07,41,9,22,19,7.18,9.20,0.00
2024-12-08 16:51:07,41,10,22,19,7.44,10.00,0.00
2024-12-08 16:51:07,42,10,23,19,7.26,10.02,0.00
2024-12-08 16:51:07,41,10,23,18,7.66,10.39,0.00
2024-12-08 16:51:07,40,10,22,18,7.87,10.48,0.00
2024-12-08 16:51:07,39,10,22,17,7.96,10.56,0.00
2024-12-08 16:51:08,39,11,22,17,8.17,11.00,0.00
2024-12-08 16:51:08,40,11,23,17,7.97,11.03,0.00
2024-12-08 16:51:08,39,11,23,16,8.33,11.51,0.00
2024-12-08 16:51:08,38,11,23,15,8.53,11.53,0.00
2024-12-08 16:51:08,38,12,23,15,9.01,12.00,0.00
2024-12-08 16:51:08,39,12,24,15,8.78,12.03,0.00
2024-12-08 16:51:08,39,13,24,15,9.36,13.00,0.00
2024-12-08 16:51:08,40,13,24,16,9.12,13.03,0.00
2024-12-08 16:51:08,39,13,24,15,9.52,13.49,0.00
2024-12-08 16:51:08,39,14,24,15,9.93,14.00,0.00
2024-12-08 16:51:08,40,14,24,16,9.68,14.03,0.00
2024-12-08 16:51:08,39,14,24,15,9.94,14.08,0.00
2024-12-08 16:51:08,38,14,23,15,10.54,14.74,0.00
2024-12-08 16:51:08,37,14,22,15,10.76,14.95,0.00
2024-12-08 16:51:08,37,15,22,15,11.18,15.00,0.00
2024-12-08 16:51:08,38,15,23,15,10.89,15.03,0.00
2024-12-08 16:51:08,38,16,23,15,11.43,16.00,0.00
2024-12-08 16:51:08,39,16,23,16,11.14,16.03,0.00
2024-12-08 16:51:08,38,16,23,15,11.54,16.87,0.00
2024-12-08 16:51:08,38,17,23,15,12.05,17.00,0.00
2024-12-08 16:51:08,39,17,24,15,11.74,17.03,0.00
2024-12-08 16:51:08,38,17,24,14,12.13,17.45,0.00
2024-12-08 16:51:08,38,18,24,14,12.59,18.00,0.00
2024-12-08 16:51:08,39,18,24,15,12.27,18.03,0.00
2024-12-08 16:51:08,39,19,24,15,12.73,19.00,0.00
2024-12-08 16:51:08,40,19,24,16,12.42,19.03,0.00
2024-12-08 16:51:08,39,19,24,15,12.69,19.13,0.00
2024-12-08 16:51:08,38,19,24,14,13.21,19.63,0.00
2024-12-08 16:51:08,38,20,24,14,13.66,20.00,0.00
2024-12-08 16:51:08,39,20,25,14,13.31,20.03,0.00
2024-12-08 16:51:08,39,21,25,14,14.07,21.00,0.00
2024-12-08 16:51:08,40,21,26,14,13.72,21.03,0.00
2024-12-08 16:51:08,40,22,26,14,14.39,22.00,0.00
2024-12-08 16:51:08,41,22,26,15,14.04,22.02,0.00
2024-12-08 16:51:08,41,23,26,15,14.63,23.00,0.00
2024-12-08 16:51:08,42,23,26,16,14.28,23.02,0.00
2024-12-08 16:51:08,41,23,26,15,14.83,23.78,0.00
2024-12-08 16:51:08,41,24,26,15,15.27,24.00,0.00
2024-12-08 16:51:08,42,24,27,15,14.91,24.02,0.00
2024-12-08 16:51:08,41,24,26,15,15.50,24.66,0.00
2024-12-08 16:51:08,41,25,26,15,16.07,25.00,0.00
2024-12-08 16:51:08,42,25,26,16,15.68,25.02,0.00
2024-12-08 16:51:08,42,26,26,16,16.46,26.00,0.00
2024-12-08 16:51:08,43,26,27,16,16.07,26.02,0.00
2024-12-08 16:51:08,43,27,27,16,16.74,27.00,0.00
2024-12-08 16:51:08,44,27,28,16,16.36,27.02,0.00
2024-12-08 16:51:08,43,27,27,16,16.91,27.51,0.00
2024-12-08 16:51:08,43,28,27,16,17.33,28.00,0.00
2024-12-08 16:51:08,44,28,28,16,16.94,28.02,0.00
2024-12-08 16:51:08,43,28,28,15,17.45,28.70,0.00
2024-12-08 16:51:08,43,29,28,15,17.95,29.00,0.00
2024-12-08 16:51:08,44,29,28,16,17.55,29.02,0.00
2024-12-08 16:51:08,43,29,27,16,17.90,29.74,0.00
2024-12-08 16:51:09,43,30,27,16,18.69,30.00,0.00
2024-12-08 16:51:09,44,30,27,17,18.26,30.02,0.00
2024-12-08 16:51:09,44,31,27,17,18.97,31.00,0.00
2024-12-08 16:51:09,45,31,27,18,18.54,31.02,0.00
2024-12-08 16:51:09,44,31,26,18,18.91,31.55,0.00
2024-12-08 16:51:09,44,32,26,18,19.64,32.00,0.00
2024-12-08 16:51:09,45,32,27,18,19.21,32.02,0.00
2024-12-08 16:51:09,45,33,27,18,19.89,33.00,0.00
2024-12-08 16:51:09,46,33,27,19,19.46,33.02,0.00
2024-12-08 16:51:09,46,34,27,19,19.99,34.00,0.00
2024-12-08 16:51:09,47,34,27,20,19.56,34.02,0.00
2024-12-08 16:51:09,46,34,26,20,19.72,34.20,0.00
2024-12-08 16:51:09,45,34,25,20,20.09,34.27,0.00
2024-12-08 16:51:09,45,35,25,20,21.00,35.00,0.00
2024-12-08 16:51:09,46,35,25,21,20.55,35.02,0.00
2024-12-08 16:51:09,45,35,25,20,20.98,35.07,0.00
2024-12-08 16:51:09,45,36,25,20,21.63,36.00,0.00
2024-12-08 16:51:09,46,36,26,20,21.16,36.02,0.00
2024-12-08 16:51:09,46,37,26,20,21.68,37.00,0.00
2024-12-08 16:51:09,47,37,26,21,21.22,37.02,0.00
2024-12-08 16:51:09,46,37,25,21,21.64,37.37,0.00
2024-12-08 16:51:09,46,38,25,21,22.13,38.00,0.00
2024-12-08 16:51:09,47,38,26,21,21.66,38.02,0.00
2024-12-08 16:51:09,46,38,26,20,22.15,38.59,0.00
2024-12-08 16:51:09,46,39,26,20,22.79,39.00,0.00
2024-12-08 16:51:09,47,39,27,20,22.30,39.02,0.00
2024-12-08 16:51:09,47,40,27,20,22.95,40.00,0.00
2024-12-08 16:51:09,48,40,27,21,22.47,40.02,0.00
2024-12-08 16:51:09,48,41,27,21,22.98,41.00,0.00
2024-12-08 16:51:09,49,41,28,21,22.51,41.02,0.00
2024-12-08 16:51:09,48,41,28,20,22.84,41.54,0.00
2024-12-08 16:51:09,47,41,27,20,23.32,41.60,0.00
2024-12-08 16:51:09,47,42,27,20,23.97,42.00,0.00
2024-12-08 16:51:09,48,42,27,21,23.47,42.02,0.00
2024-12-08 16:51:09,48,43,27,21,24.13,43.00,0.00
2024-12-08 16:51:09,49,43,28,21,23.64,43.02,0.00
2024-12-08 16:51:09,48,43,27,21,24.12,43.25,0.00
2024-12-08 16:51:09,48,44,27,21,24.66,44.00,0.00
2024-12-08 16:51:09,49,44,28,21,24.16,44.02,0.00
2024-12-08 16:51:09,48,44,28,20,24.53,44.31,0.00
2024-12-08 16:51:09,47,44,27,20,25.00,44.36,0.00
2024-12-08 16:51:09,47,45,27,20,26.08,45.00,0.00
2024-12-08 16:51:09,48,45,27,21,25.54,45.02,0.00
2024-12-08 16:51:09,48,46,27,21,26.31,46.00,0.00
2024-12-08 16:51:09,49,46,28,21,25.77,46.02,0.00
2024-12-08 16:51:09,48,46,27,21,26.30,46.31,0.00
2024-12-08 16:51:10,48,47,27,21,26.99,47.00,0.00
2024-12-08 16:51:10,49,47,28,21,26.44,47.02,0.00
2024-12-08 16:51:10,49,48,28,21,26.95,48.00,0.00
2024-12-08 16:51:10,50,48,28,22,26.41,48.02,0.00
2024-12-08 16:51:10,49,48,28,21,26.82,48.45,0.00
2024-12-08 16:51:10,49,49,28,21,27.51,49.00,0.00
2024-12-08 16:51:10,50,49,29,21,26.96,49.02,0.00
2024-12-08 16:51:10,50,50,29,21,27.71,50.00,0.00
2024-12-08 16:51:10,51,50,29,22,27.16,50.02,0.00
2024-12-08 16:51:10,51,51,29,22,27.80,51.00,0.00
2024-12-08 16:51:10,52,51,29,23,27.26,51.02,0.00
2024-12-08 16:51:10,51,51,28,23,27.56,51.43,0.00
2024-12-08 16:51:10,51,52,28,23,28.45,52.00,0.00
2024-12-08 16:51:10,52,52,28,24,27.91,52.02,0.00
2024-12-08 16:51:10,51,52,27,24,28.44,52.20,0.00
2024-12-08 16:51:10,50,52,27,23,28.86,52.42,0.00
2024-12-08 16:51:10,50,53,27,23,29.58,53.00,0.00
2024-12-08 16:51:10,51,53,28,23,29.00,53.02,0.00
2024-12-08 16:51:10,51,54,28,23,29.73,54.00,0.00
2024-12-08 16:51:10,52,54,28,24,29.15,54.02,0.00
2024-12-08 16:51:10,52,55,28,24,29.75,55.00,0.00
2024-12-08 16:51:10,53,55,29,24,29.19,55.02,0.00
2024-12-08 16:51:10,52,55,28,24,29.56,55.38,0.00
2024-12-08 16:51:10,52,56,28,24,30.47,56.00,0.00
2024-12-08 16:51:10,53,56,29,24,29.90,56.02,0.00
2024-12-08 16:51:10,52,56,29,23,30.30,56.38,0.00
2024-12-08 16:51:10,51,56,28,23,30.89,56.63,0.00
2024-12-08 16:51:10,51,57,28,23,31.62,57.00,0.00
2024-12-08 16:51:10,52,57,29,23,31.01,57.02,0.00
2024-12-08 16:51:10,52,58,29,23,31.71,58.00,0.00
2024-12-08 16:51:10,53,58,30,23,31.11,58.02,0.00
2024-12-08 16:51:10,52,58,29,23,31.51,58.38,0.00
2024-12-08 16:51:10,52,59,29,23,32.47,59.00,0.00
2024-12-08 16:51:10,53,59,30,23,31.85,59.02,0.00
2024-12-08 16:51:10,53,60,30,23,32.25,60.00,0.00
2024-12-08 16:51:10,54,60,31,23,31.66,60.02,0.00
2024-12-08 16:51:10,53,60,31,22,32.05,60.38,0.00
2024-12-08 16:51:10,53,61,31,22,32.77,61.00,0.00
2024-12-08 16:51:10,54,61,31,23,32.16,61.02,0.00
2024-12-08 16:51:10,53,61,30,23,32.32,61.60,0.00
2024-12-08 16:51:10,53,62,30,23,33.53,62.00,0.00
2024-12-08 16:51:10,54,62,31,23,32.91,62.02,0.00
2024-12-08 16:51:10,53,62,30,23,33.45,62.30,0.00
2024-12-08 16:51:10,53,63,30,23,34.10,63.00,0.00
2024-12-08 16:51:10,54,63,31,23,33.47,63.02,0.00
2024-12-08 16:51:10,54,64,31,23,33.87,64.00,0.00
2024-12-08 16:51:11,55,64,32,23,33.25,64.02,0.00
2024-12-08 16:51:11,54,64,32,22,33.67,64.41,0.00
2024-12-08 16:51:11,53,64,31,22,34.10,64.58,0.00
2024-12-08 16:51:11,53,65,31,22,35.36,65.00,0.00
2024-12-08 16:51:11,54,65,32,22,34.71,65.02,0.00
2024-12-08 16:51:11,54,66,32,22,35.40,66.00,0.00
2024-12-08 16:51:11,55,66,32,23,34.76,66.02,0.00
2024-12-08 16:51:11,55,67,32,23,35.29,67.00,0.00
2024-12-08 16:51:11,56,67,32,24,34.66,67.02,0.00
2024-12-08 16:51:11,56,68,32,24,34.96,68.00,0.00
2024-12-08 16:51:11,57,68,32,25,34.35,68.02,0.00
2024-12-08 16:51:11,56,68,32,24,34.63,68.39,0.00
2024-12-08 16:51:11,55,68,31,24,34.84,68.96,0.00
2024-12-08 16:51:11,55,69,31,24,36.09,69.00,0.00
2024-12-08 16:51:11,56,69,31,25,35.45,69.02,0.00
2024-12-08 16:51:11,56,70,31,25,35.87,70.00,0.00
2024-12-08 16:51:11,57,70,32,25,35.24,70.02,0.00
2024-12-08 16:51:11,56,70,32,24,35.82,70.14,0.00
2024-12-08 16:51:11,56,71,32,24,36.37,71.00,0.00
2024-12-08 16:51:11,57,71,33,24,35.73,71.02,0.00
2024-12-08 16:51:11,56,71,33,23,36.29,71.20,0.00
2024-12-08 16:51:11,55,71,33,22,36.60,71.36,0.00
2024-12-08 16:51:11,55,72,33,22,37.37,72.00,0.00
2024-12-08 16:51:11,56,72,33,23,36.71,72.02,0.00
2024-12-08 16:51:11,56,73,33,23,37.35,73.00,0.00
2024-12-08 16:51:11,57,73,33,24,36.70,73.02,0.00
2024-12-08 16:51:11,56,73,32,24,37.10,73.36,0.00
2024-12-08 16:51:11,56,74,32,24,38.11,74.00,0.00
2024-12-08 16:51:11,57,74,32,25,37.44,74.02,0.00
2024-12-08 16:51:11,56,74,31,25,37.47,74.43,0.00
2024-12-08 16:51:11,56,75,31,25,38.78,75.00,0.00
2024-12-08 16:51:11,57,75,31,26,38.10,75.02,0.00
2024-12-08 16:51:11,56,75,30,26,38.10,75.82,0.00
2024-12-08 16:51:11,56,76,30,26,39.47,76.00,0.00
2024-12-08 16:51:11,57,76,31,26,38.78,76.02,0.00
2024-12-08 16:51:11,57,77,31,26,39.10,77.00,0.00
2024-12-08 16:51:11,58,77,31,27,38.42,77.02,0.00
2024-12-08 16:51:11,57,77,31,26,38.86,77.40,0.00
2024-12-08 16:51:11,57,78,31,26,39.64,78.00,0.00
2024-12-08 16:51:11,58,78,31,27,38.95,78.02,0.00
2024-12-08 16:51:11,58,79,31,27,39.57,79.00,0.00
2024-12-08 16:51:11,59,79,31,28,38.90,79.02,0.00
2024-12-08 16:51:11,58,79,30,28,39.00,79.86,0.00
2024-12-08 16:51:11,58,80,30,28,40.39,80.00,0.00
2024-12-08 16:51:11,59,80,30,29,39.70,80.02,0.00
2024-12-08 16:51:11,58,80,30,28,39.87,80.40,0.00
2024-12-08 16:51:11,57,80,29,28,40.50,80.68,0.00
2024-12-08 16:51:11,57,81,29,28,41.42,81.00,0.00
2024-12-08 16:51:11,58,81,29,29,40.70,81.02,0.00
2024-12-08 16:51:11,58,82,29,29,41.32,82.00,0.00
2024-12-08 16:51:11,59,82,29,30,40.62,82.02,0.00
2024-12-08 16:51:11,59,83,29,30,41.07,83.00,0.00
2024-12-08 16:51:11,60,83,30,30,40.39,83.02,0.00
2024-12-08 16:51:11,59,83,29,30,40.99,83.12,0.00
2024-12-08 16:51:11,58,83,29,29,41.24,83.38,0.00
2024-12-08 16:51:11,57,83,28,29,41.66,83.39,0.00
2024-12-08 16:51:11,57,84,28,29,43.05,84.00,0.00
2024-12-08 16:51:11,58,84,29,29,42.31,84.02,0.00
2024-12-08 16:51:12,58,85,29,29,42.93,85.00,0.00
2024-12-08 16:51:12,59,85,30,29,42.21,85.02,0.00
2024-12-08 16:51:12,59,86,30,29,42.66,86.00,0.00
2024-12-08 16:51:12,60,86,30,30,41.95,86.02,0.00
2024-12-08 16:51:12,59,86,30,29,42.11,86.39,0.00
2024-12-08 16:51:12,59,87,30,29,42.94,87.00,0.00
2024-12-08 16:51:12,60,87,30,30,42.23,87.02,0.00
2024-12-08 16:51:12,59,87,30,29,42.90,87.07,0.00
2024-12-08 16:51:12,58,87,29,29,43.56,87.17,0.00
2024-12-08 16:51:12,57,87,28,29,44.26,87.25,0.00
2024-12-08 16:51:12,56,87,27,29,44.88,87.38,0.00
2024-12-08 16:51:12,56,88,27,29,46.04,88.00,0.00
2024-12-08 16:51:12,57,88,27,30,45.23,88.02,0.00
2024-12-08 16:51:12,56,88,26,30,45.88,88.21,0.00
2024-12-08 16:51:12,55,88,25,30,46.70,88.24,0.00
2024-12-08 16:51:12,54,88,24,30,47.16,88.33,0.00
2024-12-08 16:51:12,54,89,24,30,48.36,89.00,0.00
2024-12-08 16:51:12,55,89,24,31,47.48,89.02,0.00
2024-12-08 16:51:12,54,89,24,30,47.80,89.33,0.00
2024-12-08 16:51:12,53,89,23,30,48.70,89.34,0.00
2024-12-08 16:51:12,53,90,23,30,49.62,90.00,0.00
2024-12-08 16:51:12,54,90,23,31,48.70,90.02,0.00
2024-12-08 16:51:12,53,90,22,31,49.45,90.21,0.00
2024-12-08 16:51:12,53,91,22,31,50.36,91.00,0.00
2024-12-08 16:51:12,54,91,23,31,49.42,91.02,0.00
2024-12-08 16:51:12,53,91,22,31,50.25,91.13,0.00
2024-12-08 16:51:12,52,91,21,31,50.95,91.19,0.00
2024-12-08 16:51:12,52,92,21,31,52.16,92.00,0.00
2024-12-08 16:51:12,53,92,21,32,51.18,92.02,0.00
2024-12-08 16:51:12,52,92,21,31,51.63,92.29,0.00
2024-12-08 16:51:12,52,93,21,31,52.55,93.00,0.00
2024-12-08 16:51:12,53,93,22,31,51.56,93.02,0.00
2024-12-08 16:51:12,53,94,22,31,52.29,94.00,0.00
2024-12-08 16:51:12,54,94,22,32,51.32,94.02,0.00
2024-12-08 16:51:12,53,94,22,31,52.10,94.23,0.00
2024-12-08 16:51:12,52,94,21,31,52.61,94.35,0.00
2024-12-08 16:51:12,52,95,21,31,54.30,95.00,0.00
2024-12-08 16:51:12,53,95,21,32,53.28,95.02,0.00
2024-12-08 16:51:12,52,95,21,31,53.79,95.27,0.00
2024-12-08 16:51:12,52,96,21,31,54.73,96.00,0.00
2024-12-08 16:51:12,53,96,22,31,53.70,96.02,0.00
2024-12-08 16:51:12,53,97,22,31,54.41,97.00,0.00
2024-12-08 16:51:12,54,97,23,31,53.40,97.02,0.00
2024-12-08 16:51:12,54,98,23,31,53.87,98.00,0.00
2024-12-08 16:51:12,55,98,24,31,52.89,98.02,0.00
2024-12-08 16:51:12,54,98,24,30,53.39,98.26,0.00
2024-12-08 16:51:12,54,99,24,30,54.28,99.00,0.00
2024-12-08 16:51:12,55,99,24,31,53.29,99.02,0.00
2024-12-08 16:51:12,54,99,23,31,54.26,99.02,0.00
2024-12-08 16:51:12,53,99,23,30,55.26,99.02,0.00
2024-12-08 16:51:12,52,99,22,30,56.31,99.02,0.00
2024-12-08 16:51:12,51,99,21,30,57.39,99.02,0.00
2024-12-08 16:51:12,50,99,21,29,58.52,99.02,0.00
2024-12-08 16:51:12,49,99,21,28,59.69,99.02,0.00
2024-12-08 16:51:12,48,99,20,28,60.92,99.02,0.00
2024-12-08 16:51:12,47,99,19,28,62.19,99.02,0.00
2024-12-08 16:51:12,46,99,19,27,63.52,99.02,0.00
2024-12-08 16:51:12,46,100,19,27,64.52,100.00,0.00
2024-12-08 16:51:12,47,100,20,27,63.14,100.02,0.00
2024-12-08 16:51:12,47,101,20,27,63.65,101.00,0.00
2024-12-08 16:51:12,48,101,20,28,62.32,101.02,0.00
2024-12-08 16:51:12,47,101,20,27,63.27,101.13,0.00
2024-12-08 16:51:12,47,102,20,27,64.28,102.00,0.00
2024-12-08 16:51:12,48,102,21,27,62.94,102.02,0.00
2024-12-08 16:51:12,48,103,21,27,63.81,103.00,0.00
2024-12-08 16:51:12,49,103,21,28,62.50,103.02,0.00
2024-12-08 16:51:12,49,104,21,28,63.02,104.00,0.00
2024-12-08 16:51:12,50,104,21,29,61.76,104.02,0.00
2024-12-08 16:51:12,49,104,21,28,62.51,104.20,0.00
2024-12-08 16:51:12,49,105,21,28,63.50,105.00,0.00
2024-12-08 16:51:12,50,105,21,29,62.23,105.02,0.00
2024-12-08 16:51:12,49,105,20,29,62.98,105.20,0.00
2024-12-08 16:51:12,49,106,20,29,64.40,106.00,0.00
2024-12-08 16:51:12,50,106,21,29,63.11,106.02,0.00
2024-12-08 16:51:13,50,107,21,29,63.65,107.00,0.00
2024-12-08 16:51:13,51,107,22,29,62.40,107.02,0.00
2024-12-08 16:51:13,50,107,22,28,63.08,107.22,0.00
2024-12-08 16:51:13,50,108,22,28,64.05,108.00,0.00
2024-12-08 16:51:13,51,108,22,29,62.80,108.02,0.00
2024-12-08 16:51:13,51,109,22,29,63.62,109.00,0.00
2024-12-08 16:51:13,52,109,23,29,62.40,109.02,0.00
2024-12-08 16:51:13,52,110,23,29,62.88,110.00,0.00
2024-12-08 16:51:13,53,110,24,29,61.69,110.02,0.00
2024-12-08 16:51:13,52,110,24,28,62.35,110.21,0.00
2024-12-08 16:51:13,52,111,24,28,63.26,111.00,0.00
2024-12-08 16:51:13,53,111,24,29,62.07,111.02,0.00
2024-12-08 16:51:13,53,112,24,29,62.82,112.00,0.00
2024-12-08 16:51:13,54,112,24,30,61.66,112.02,0.00
2024-12-08 16:51:13,54,113,24,30,62.09,113.00,0.00
2024-12-08 16:51:13,55,113,24,31,60.96,113.02,0.00
2024-12-08 16:51:13,54,113,24,30,61.60,113.20,0.00
2024-12-08 16:51:13,54,114,24,30,62.44,114.00,0.00
2024-12-08 16:51:13,55,114,25,30,61.31,114.02,0.00
2024-12-08 16:51:13,54,114,24,30,61.79,114.22,0.00
2024-12-08 16:51:13,54,115,24,30,63.50,115.00,0.00
2024-12-08 16:51:13,55,115,25,30,62.35,115.02,0.00
2024-12-08 16:51:13,55,116,25,30,62.74,116.00,0.00
2024-12-08 16:51:13,56,116,26,30,61.62,116.02,0.00
2024-12-08 16:51:13,55,116,25,30,62.63,116.11,0.00
2024-12-08 16:51:13,54,116,25,29,63.43,116.19,0.00
2024-12-08 16:51:13,54,117,25,29,64.28,117.00,0.00
2024-12-08 16:51:13,55,117,26,29,63.11,117.02,0.00
2024-12-08 16:51:13,54,117,25,29,63.23,117.89,0.00
2024-12-08 16:51:13,54,118,25,29,65.36,118.00,0.00
2024-12-08 16:51:13,55,118,25,30,64.18,118.02,0.00
2024-12-08 16:51:13,55,119,25,30,64.58,119.00,0.00
2024-12-08 16:51:13,56,119,25,31,63.42,119.02,0.00
2024-12-08 16:51:13,55,119,25,30,64.06,119.22,0.00
2024-12-08 16:51:13,55,120,25,30,64.90,120.00,0.00
2024-12-08 16:51:13,56,120,25,31,63.74,120.02,0.00
2024-12-08 16:51:13,56,121,25,31,64.42,121.00,0.00
2024-12-08 16:51:13,57,121,26,31,63.29,121.02,0.00
2024-12-08 16:51:13,57,122,26,31,63.64,122.00,0.00
2024-12-08 16:51:13,58,122,27,31,62.54,122.02,0.00
2024-12-08 16:51:13,57,122,27,30,63.16,122.21,0.00
2024-12-08 16:51:13,57,123,27,30,63.95,123.00,0.00
2024-12-08 16:51:13,58,123,28,30,62.85,123.02,0.00
2024-12-08 16:51:13,58,124,28,30,63.47,124.00,0.00
2024-12-08 16:51:13,59,124,28,31,62.39,124.02,0.00
2024-12-08 16:51:13,59,125,28,31,62.71,125.00,0.00
2024-12-08 16:51:13,60,125,29,31,61.66,125.02,0.00
2024-12-08 16:51:13,59,125,28,31,62.52,125.20,0.00
2024-12-08 16:51:13,58,125,28,30,63.31,125.21,0.00
2024-12-08 16:51:13,57,125,27,30,64.18,125.53,0.00
2024-12-08 16:51:13,56,125,26,30,65.12,125.84,0.00
2024-12-08 16:51:13,56,126,26,30,66.38,126.00,0.00
2024-12-08 16:51:13,57,126,27,30,65.21,126.02,0.00
2024-12-08 16:51:13,56,126,26,30,65.41,126.63,0.00
2024-12-08 16:51:13,56,127,26,30,67.02,127.00,0.00
2024-12-08 16:51:13,57,127,26,31,65.85,127.02,0.00
2024-12-08 16:51:13,57,128,26,31,66.13,128.00,0.00
2024-12-08 16:51:13,58,128,26,32,64.99,128.02,0.00
2024-12-08 16:51:13,57,128,25,32,66.11,128.02,0.00
2024-12-08 16:51:13,56,128,25,31,66.86,128.20,0.00
2024-12-08 16:51:13,56,129,25,31,67.68,129.00,0.00
2024-12-08 16:51:13,57,129,26,31,66.49,129.02,0.00
2024-12-08 16:51:13,57,130,26,31,67.09,130.00,0.00
2024-12-08 16:51:13,58,130,27,31,65.93,130.02,0.00
2024-12-08 16:51:13,58,131,27,31,66.18,131.00,0.00
2024-12-08 16:51:13,59,131,28,31,65.05,131.02,0.00
2024-12-08 16:51:13,58,131,28,30,65.79,131.19,0.00
2024-12-08 16:51:13,58,132,28,30,66.54,132.00,0.00
2024-12-08 16:51:13,59,132,28,31,65.42,132.02,0.00
2024-12-08 16:51:13,58,132,27,31,65.25,132.38,0.00
2024-12-08 16:51:14,58,133,27,31,67.09,133.00,0.00
2024-12-08 16:51:14,59,133,27,32,65.96,133.02,0.00
2024-12-08 16:51:14,58,133,27,31,67.07,133.02,0.00
2024-12-08 16:51:14,57,133,26,31,67.39,133.25,0.00
2024-12-08 16:51:14,57,134,26,31,69.17,134.00,0.00
2024-12-08 16:51:14,58,134,26,32,67.98,134.02,0.00
2024-12-08 16:51:14,57,134,26,31,68.83,134.18,0.00
2024-12-08 16:51:14,57,135,26,31,69.61,135.00,0.00
2024-12-08 16:51:14,58,135,26,32,68.41,135.02,0.00
2024-12-08 16:51:14,57,135,26,31,69.59,135.02,0.00
2024-12-08 16:51:14,56,135,25,31,69.48,135.34,0.00
2024-12-08 16:51:14,56,136,25,31,71.41,136.00,0.00
2024-12-08 16:51:14,57,136,26,31,70.16,136.02,0.00
2024-12-08 16:51:14,56,136,25,31,70.11,136.20,0.00
2024-12-08 16:51:14,56,137,25,31,71.93,137.00,0.00
2024-12-08 16:51:14,57,137,26,31,70.66,137.02,0.00
2024-12-08 16:51:14,56,137,25,31,71.89,137.04,0.00
2024-12-08 16:51:14,55,137,25,30,72.95,137.15,0.00
2024-12-08 16:51:14,55,138,25,30,73.78,138.00,0.00
2024-12-08 16:51:14,56,138,25,31,72.46,138.02,0.00
2024-12-08 16:51:14,56,139,25,31,72.98,139.00,0.00
2024-12-08 16:51:14,57,139,25,32,71.70,139.02,0.00
2024-12-08 16:51:14,56,139,24,32,70.85,139.96,0.00
2024-12-08 16:51:14,56,140,24,32,73.31,140.00,0.00
2024-12-08 16:51:14,57,140,25,32,72.03,140.02,0.00
2024-12-08 16:51:14,56,140,25,31,73.09,140.14,0.00
2024-12-08 16:51:14,56,141,25,31,73.89,141.00,0.00
2024-12-08 16:51:14,57,141,25,32,72.59,141.02,0.00
2024-12-08 16:51:14,56,141,24,32,73.52,141.14,0.00
2024-12-08 16:51:14,56,142,24,32,74.83,142.00,0.00
2024-12-08 16:51:14,57,142,24,33,73.52,142.02,0.00
2024-12-08 16:51:14,57,143,24,33,73.66,143.00,0.00
2024-12-08 16:51:14,58,143,25,33,72.39,143.02,0.00
2024-12-08 16:51:14,57,143,25,32,73.41,143.14,0.00
2024-12-08 16:51:14,56,143,24,32,73.78,143.79,0.00
2024-12-08 16:51:14,56,144,24,32,76.21,144.00,0.00
2024-12-08 16:51:14,57,144,25,32,74.87,144.02,0.00
2024-12-08 16:51:14,56,144,24,32,76.19,144.02,0.00
2024-12-08 16:51:14,56,145,24,32,76.70,145.00,0.00
2024-12-08 16:51:14,57,145,24,33,75.36,145.02,0.00
2024-12-08 16:51:14,56,145,23,33,75.61,145.55,0.00
2024-12-08 16:51:14,55,145,22,33,76.26,145.76,0.00
2024-12-08 16:51:14,55,146,22,33,78.77,146.00,0.00
2024-12-08 16:51:14,56,146,23,33,77.36,146.02,0.00
2024-12-08 16:51:14,55,146,23,32,78.58,146.13,0.00
2024-12-08 16:51:14,55,147,23,32,79.42,147.00,0.00
2024-12-08 16:51:14,56,147,24,32,78.00,147.02,0.00
2024-12-08 16:51:14,56,148,24,32,78.46,148.00,0.00
2024-12-08 16:51:14,57,148,25,32,77.08,148.02,0.00
2024-12-08 16:51:14,56,148,25,31,77.76,148.13,0.00
2024-12-08 16:51:14,56,149,25,31,78.56,149.00,0.00
2024-12-08 16:51:14,57,149,25,32,77.19,149.02,0.00
2024-12-08 16:51:14,57,150,25,32,77.62,150.00,0.00
2024-12-08 16:51:14,58,150,26,32,76.28,150.02,0.00
2024-12-08 16:51:14,57,150,26,31,76.95,150.12,0.00
2024-12-08 16:51:14,57,151,26,31,77.71,151.00,0.00
2024-12-08 16:51:14,58,151,26,32,76.37,151.02,0.00
2024-12-08 16:51:14,57,151,25,32,76.64,151.25,0.00
2024-12-08 16:51:14,57,152,25,32,78.60,152.00,0.00
2024-12-08 16:51:14,58,152,25,33,77.24,152.02,0.00
2024-12-08 16:51:14,57,152,25,32,77.94,152.12,0.00
2024-12-08 16:51:14,56,152,24,32,77.75,152.55,0.00
2024-12-08 16:51:14,56,153,24,32,80.12,153.00,0.00
2024-12-08 16:51:14,57,153,24,33,78.71,153.02,0.00
2024-12-08 16:51:14,56,153,23,33,79.22,153.18,0.00
2024-12-08 16:51:14,57,152,24,33,77.26,153.77,0.00
2024-12-08 16:51:14,57,153,24,33,80.15,154.00,0.00
2024-12-08 16:51:14,58,153,24,34,78.77,154.02,0.00
2024-12-08 16:51:14,57,153,24,33,79.48,154.12,0.00
2024-12-08 16:51:14,56,153,23,33,79.49,154.39,0.00
2024-12-08 16:51:14,56,154,23,33,84.49,155.00,0.00
2024-12-08 16:51:15,57,154,23,34,83.00,155.02,0.00
2024-12-08 16:51:15,56,154,22,34,83.62,155.16,0.00
2024-12-08 16:51:15,56,155,22,34,85.62,156.00,0.00
2024-12-08 16:51:15,57,155,22,35,84.11,156.02,0.00
2024-12-08 16:51:15,56,155,21,35,85.48,156.04,0.00
2024-12-08 16:51:15,55,155,21,34,86.39,156.11,0.00
2024-12-08 16:51:15,54,155,20,34,87.83,156.24,0.00
2024-12-08 16:51:15,54,156,20,34,90.05,157.00,0.00
2024-12-08 16:51:15,55,156,20,35,88.41,157.02,0.00
2024-12-08 16:51:15,54,156,19,35,90.02,157.02,0.00
2024-12-08 16:51:15,54,157,19,35,91.38,158.00,0.00
2024-12-08 16:51:15,55,157,19,36,89.72,158.02,0.00
2024-12-08 16:51:15,54,157,18,36,91.30,158.02,0.00
2024-12-08 16:51:15,53,157,18,35,92.40,158.08,0.00
2024-12-08 16:51:15,53,158,18,35,94.51,159.00,0.00
2024-12-08 16:51:15,54,158,19,35,92.76,159.02,0.00
2024-12-08 16:51:15,53,158,18,35,94.33,159.02,0.00
2024-12-08 16:51:15,53,159,18,35,95.77,160.00,0.00
2024-12-08 16:51:15,54,159,18,36,93.99,160.02,0.00
2024-12-08 16:51:15,54,160,18,36,94.19,161.00,0.00
2024-12-08 16:51:15,55,160,18,37,92.48,161.02,0.00
2024-12-08 16:51:15,54,160,18,36,94.00,161.09,0.00
2024-12-08 16:51:15,53,160,17,36,95.49,161.32,0.00
2024-12-08 16:51:15,53,161,17,36,96.70,162.00,0.00
2024-12-08 16:51:15,54,161,17,37,94.91,162.02,0.00
2024-12-08 16:51:15,54,162,17,37,95.39,163.00,0.00
2024-12-08 16:51:15,55,162,18,37,93.66,163.02,0.00
2024-12-08 16:51:15,55,163,18,37,93.82,164.00,0.00
2024-12-08 16:51:15,56,163,19,37,92.14,164.02,0.00
2024-12-08 16:51:15,55,163,19,36,93.68,164.09,0.00
2024-12-08 16:51:15,55,164,19,36,94.54,165.00,0.00
2024-12-08 16:51:15,56,164,19,37,92.85,165.02,0.00
2024-12-08 16:51:15,55,164,18,37,93.48,165.33,0.00
2024-12-08 16:51:15,55,165,18,37,95.84,166.00,0.00
2024-12-08 16:51:15,56,165,19,37,94.13,166.02,0.00
2024-12-08 16:51:15,55,165,19,36,95.13,166.09,0.00
2024-12-08 16:51:15,54,165,18,36,95.78,166.31,0.00
2024-12-08 16:51:15,54,166,18,36,98.21,167.00,0.00
2024-12-08 16:51:15,55,166,18,37,96.43,167.02,0.00
2024-12-08 16:51:15,54,166,17,37,98.10,167.09,0.00
2024-12-08 16:51:15,53,166,16,37,98.49,167.55,0.00
2024-12-08 16:51:15,53,167,16,37,101.24,168.00,0.00
2024-12-08 16:51:15,54,167,17,37,99.37,168.02,0.00
2024-12-08 16:51:15,53,167,17,36,100.46,168.09,0.00
2024-12-08 16:51:15,52,167,16,36,101.28,168.17,0.00
2024-12-08 16:51:15,52,168,16,36,103.69,169.00,0.00
2024-12-08 16:51:15,53,168,17,36,101.74,169.02,0.00
2024-12-08 16:51:15,52,168,16,36,101.60,169.31,0.00
2024-12-08 16:51:15,52,169,16,36,104.19,170.00,0.00
2024-12-08 16:51:15,53,169,17,36,102.22,170.02,0.00
2024-12-08 16:51:15,52,169,16,36,104.07,170.10,0.00
2024-12-08 16:51:15,52,170,16,36,104.44,171.00,0.00
2024-12-08 16:51:15,53,170,16,37,102.47,171.02,0.00
2024-12-08 16:51:15,52,170,16,36,104.29,171.10,0.00
2024-12-08 16:51:15,52,171,16,36,105.32,172.00,0.00
2024-12-08 16:51:15,53,171,16,37,103.33,172.02,0.00
2024-12-08 16:51:15,52,171,16,36,105.28,172.02,0.00
2024-12-08 16:51:15,52,172,16,36,105.76,173.00,0.00
2024-12-08 16:51:15,53,172,16,37,103.76,173.02,0.00
2024-12-08 16:51:15,52,172,16,36,105.72,173.02,0.00
2024-12-08 16:51:15,51,172,16,35,107.06,173.06,0.00
2024-12-08 16:51:15,51,173,16,35,108.08,174.00,0.00
2024-12-08 16:51:15,52,173,17,35,106.00,174.02,0.00
2024-12-08 16:51:15,52,174,17,35,106.40,175.00,0.00
2024-12-08 16:51:15,53,174,18,35,104.39,175.02,0.00
2024-12-08 16:51:15,52,174,18,34,105.70,175.06,0.00
2024-12-08 16:51:15,52,175,18,34,106.67,176.00,0.00
2024-12-08 16:51:15,53,175,18,35,104.66,176.02,0.00
2024-12-08 16:51:15,53,176,18,35,105.13,177.00,0.00
2024-12-08 16:51:15,54,176,19,35,103.18,177.02,0.00
2024-12-08 16:51:16,54,177,19,35,103.34,178.00,0.00
2024-12-08 16:51:16,55,177,20,35,101.46,178.02,0.00
2024-12-08 16:51:16,54,177,20,34,103.25,178.06,0.00
2024-12-08 16:51:16,54,178,20,34,104.12,179.00,0.00
2024-12-08 16:51:16,55,178,21,34,102.23,179.02,0.00
2024-12-08 16:51:16,54,178,20,34,102.64,179.65,0.00
2024-12-08 16:51:16,53,178,19,34,103.41,179.94,0.00
2024-12-08 16:51:16,53,179,19,34,106.73,180.00,0.00
2024-12-08 16:51:16,54,179,20,34,104.75,180.02,0.00
2024-12-08 16:51:16,53,179,20,33,105.99,180.06,0.00
2024-12-08 16:51:16,53,180,20,33,106.91,181.00,0.00
2024-12-08 16:51:16,54,180,20,34,104.93,181.02,0.00
2024-12-08 16:51:16,53,180,19,34,104.75,181.79,0.00
2024-12-08 16:51:16,53,181,19,34,107.96,182.00,0.00
2024-12-08 16:51:16,54,181,20,34,105.96,182.02,0.00
2024-12-08 16:51:16,53,181,20,33,107.24,182.06,0.00
2024-12-08 16:51:16,52,181,19,33,109.27,182.06,0.00
2024-12-08 16:51:16,52,182,19,33,110.25,183.00,0.00
2024-12-08 16:51:16,53,182,19,34,108.17,183.02,0.00
2024-12-08 16:51:16,53,183,19,34,108.59,184.00,0.00
2024-12-08 16:51:16,54,183,19,35,106.58,184.02,0.00
2024-12-08 16:51:16,53,183,19,34,107.80,184.06,0.00
2024-12-08 16:51:16,53,184,19,34,108.73,185.00,0.00
2024-12-08 16:51:16,54,184,19,35,106.71,185.02,0.00
2024-12-08 16:51:16,54,185,19,35,107.16,186.00,0.00
2024-12-08 16:51:16,55,185,20,35,105.21,186.02,0.00
2024-12-08 16:51:16,54,185,19,35,105.01,186.74,0.00
2024-12-08 16:51:16,54,186,19,35,108.18,187.00,0.00
2024-12-08 16:51:16,55,186,20,35,106.21,187.02,0.00
2024-12-08 16:51:16,54,186,20,34,108.08,187.06,0.00
2024-12-08 16:51:16,54,187,20,34,108.97,188.00,0.00
2024-12-08 16:51:16,55,187,21,34,106.98,188.02,0.00
2024-12-08 16:51:16,55,188,21,34,107.36,189.00,0.00
2024-12-08 16:51:16,56,188,21,35,105.44,189.02,0.00
2024-12-08 16:51:16,55,188,21,34,106.61,189.05,0.00
2024-12-08 16:51:16,54,188,20,34,107.69,189.69,0.00
2024-12-08 16:51:16,53,188,19,34,108.89,189.83,0.00
2024-12-08 16:51:16,53,189,19,34,112.27,190.00,0.00
2024-12-08 16:51:16,54,189,20,34,110.20,190.02,0.00
2024-12-08 16:51:16,53,189,19,34,109.70,190.87,0.00
2024-12-08 16:51:16,53,190,19,34,113.15,191.00,0.00
2024-12-08 16:51:16,54,190,19,35,111.06,191.02,0.00
2024-12-08 16:51:16,53,190,18,35,111.49,191.66,0.00
2024-12-08 16:51:16,53,191,18,35,113.28,192.00,0.00
2024-12-08 16:51:16,54,191,18,36,111.18,192.02,0.00
2024-12-08 16:51:16,53,191,18,35,113.17,192.06,0.00
2024-12-08 16:51:16,53,192,18,35,114.12,193.00,0.00
2024-12-08 16:51:16,54,192,18,36,112.01,193.02,0.00
2024-12-08 16:51:16,54,193,18,36,112.39,194.00,0.00
2024-12-08 16:51:16,55,193,18,37,110.35,194.02,0.00
2024-12-08 16:51:16,54,193,18,36,111.61,194.06,0.00
2024-12-08 16:51:16,54,194,18,36,112.50,195.00,0.00
2024-12-08 16:51:16,55,194,18,37,110.46,195.02,0.00
2024-12-08 16:51:16,54,194,17,37,110.92,195.26,0.00
2024-12-08 16:51:16,54,195,17,37,113.59,196.00,0.00
2024-12-08 16:51:16,55,195,18,37,111.52,196.02,0.00
2024-12-08 16:51:16,54,195,18,36,112.83,196.06,0.00
2024-12-08 16:51:16,53,195,17,36,114.18,196.25,0.00
2024-12-08 16:51:16,53,196,17,36,116.92,197.00,0.00
2024-12-08 16:51:16,54,196,18,36,114.75,197.02,0.00
2024-12-08 16:51:16,54,197,18,36,115.08,198.00,0.00
2024-12-08 16:51:16,55,197,19,36,112.99,198.02,0.00
2024-12-08 16:51:16,54,197,19,35,114.35,198.06,0.00
2024-12-08 16:51:16,53,197,18,35,116.51,198.06,0.00
2024-12-08 16:51:16,53,198,18,35,117.47,199.00,0.00
2024-12-08 16:51:16,54,198,19,35,115.30,199.02,0.00
2024-12-08 16:51:16,53,198,19,34,117.43,199.02,0.00
2024-12-08 16:51:16,52,198,18,34,118.52,199.08,0.00
2024-12-08 16:51:16,52,199,18,34,121.10,200.00,0.00
2024-12-08 16:51:16,53,199,19,34,118.81,200.02,0.00
2024-12-08 16:51:16,52,199,19,33,120.33,200.04,0.00
2024-12-08 16:51:16,52,200,19,33,121.32,201.00,0.00
2024-12-08 16:51:16,53,200,20,33,119.03,201.02,0.00
2024-12-08 16:51:16,52,200,20,32,121.28,201.02,0.00
2024-12-08 16:51:16,52,201,20,32,122.04,202.00,0.00
2024-12-08 16:51:16,53,201,20,33,119.74,202.02,0.00
2024-12-08 16:51:16,52,201,19,33,119.86,202.23,0.00
2024-12-08 16:51:16,52,202,19,33,122.72,203.00,0.00
2024-12-08 16:51:16,53,202,19,34,120.40,203.02,0.00
2024-12-08 16:51:16,52,202,19,33,122.29,203.02,0.00
2024-12-08 16:51:16,52,203,19,33,123.24,204.00,0.00
2024-12-08 16:51:16,53,203,19,34,120.92,204.02,0.00
2024-12-08 16:51:16,53,204,19,34,121.18,205.00,0.00
2024-12-08 16:51:16,54,204,19,35,118.93,205.02,0.00
2024-12-08 16:51:16,53,204,19,34,120.52,205.02,0.00
2024-12-08 16:51:16,52,204,18,34,122.80,205.04,0.00
2024-12-08 16:51:16,52,205,18,34,123.79,206.00,0.00
2024-12-08 16:51:16,53,205,18,35,121.46,206.02,0.00
2024-12-08 16:51:17,53,206,18,35,121.69,207.00,0.00
2024-12-08 16:51:17,54,206,19,35,119.43,207.02,0.00
2024-12-08 16:51:17,53,206,19,34,121.06,207.02,0.00
2024-12-08 16:51:17,52,206,18,34,122.37,207.62,0.00
2024-12-08 16:51:17,52,207,18,34,125.83,208.00,0.00
2024-12-08 16:51:17,53,207,19,34,123.46,208.02,0.00
2024-12-08 16:51:17,53,208,19,34,123.73,209.00,0.00
2024-12-08 16:51:17,54,208,20,34,121.43,209.02,0.00
2024-12-08 16:51:17,53,208,20,33,123.05,209.02,0.00
2024-12-08 16:51:17,53,209,20,33,123.96,210.00,0.00
2024-12-08 16:51:17,54,209,21,33,121.67,210.02,0.00
2024-12-08 16:51:17,53,209,20,33,123.93,210.02,0.00
2024-12-08 16:51:17,52,209,19,33,123.15,210.63,0.00
2024-12-08 16:51:17,52,210,19,33,126.71,211.00,0.00
2024-12-08 16:51:17,53,210,19,34,124.32,211.02,0.00
2024-12-08 16:51:17,52,210,19,33,125.94,211.02,0.00
2024-12-08 16:51:17,52,211,19,33,126.90,212.00,0.00
2024-12-08 16:51:17,53,211,19,34,124.51,212.02,0.00
2024-12-08 16:51:17,52,211,18,34,124.65,212.71,0.00
2024-12-08 16:51:17,52,212,18,34,128.34,213.00,0.00
2024-12-08 16:51:17,53,212,18,35,125.92,213.02,0.00
2024-12-08 16:51:17,52,212,17,35,126.53,213.56,0.00
2024-12-08 16:51:17,53,211,17,36,123.91,213.75,0.00
2024-12-08 16:51:17,53,212,17,36,129.76,214.00,0.00
2024-12-08 16:51:17,54,212,17,37,127.36,214.02,0.00
2024-12-08 16:51:17,53,212,17,36,129.18,214.19,0.00
2024-12-08 16:51:17,53,213,17,36,134.47,215.00,0.00
2024-12-08 16:51:17,54,213,17,37,131.98,215.02,0.00
2024-12-08 16:51:17,54,214,17,37,132.42,216.00,0.00
2024-12-08 16:51:17,55,214,17,38,130.01,216.02,0.00
2024-12-08 16:51:17,54,214,16,38,129.50,216.83,0.00
2024-12-08 16:51:17,54,215,16,38,133.29,217.00,0.00
2024-12-08 16:51:17,55,215,17,38,130.86,217.02,0.00
2024-12-08 16:51:17,54,215,16,38,133.25,217.02,0.00
2024-12-08 16:51:17,53,215,16,37,135.29,217.17,0.00
2024-12-08 16:51:17,53,216,16,37,136.52,218.00,0.00
2024-12-08 16:51:17,54,216,16,38,133.99,218.02,0.00
2024-12-08 16:51:17,54,217,16,38,134.38,219.00,0.00
2024-12-08 16:51:17,55,217,16,39,131.93,219.02,0.00
2024-12-08 16:51:17,55,218,16,39,131.98,220.00,0.00
2024-12-08 16:51:17,56,218,16,40,129.62,220.02,0.00
2024-12-08 16:51:17,55,218,16,39,131.59,220.16,0.00
2024-12-08 16:51:17,54,218,15,39,131.76,220.96,0.00
2024-12-08 16:51:17,54,219,15,39,135.79,221.00,0.00
2024-12-08 16:51:17,55,219,15,40,133.32,221.02,0.00
2024-12-08 16:51:17,54,219,14,40,133.89,221.30,0.00
2024-12-08 16:51:17,54,220,14,40,136.94,222.00,0.00
2024-12-08 16:51:17,55,220,15,40,134.45,222.02,0.00
2024-12-08 16:51:17,54,220,14,40,134.91,222.31,0.00
2024-12-08 16:51:17,54,221,14,40,138.01,223.00,0.00
2024-12-08 16:51:17,55,221,15,40,135.50,223.02,0.00
2024-12-08 16:51:17,54,221,15,39,137.53,223.20,0.00
2024-12-08 16:51:17,54,222,15,39,138.80,224.00,0.00
2024-12-08 16:51:17,55,222,15,40,136.27,224.02,0.00
2024-12-08 16:51:17,54,222,14,40,138.51,224.17,0.00
2024-12-08 16:51:17,54,223,14,40,140.54,225.00,0.00
2024-12-08 16:51:17,55,223,15,40,137.99,225.02,0.00
2024-12-08 16:51:17,54,223,14,40,138.59,225.17,0.00
2024-12-08 16:51:17,54,224,14,40,140.62,226.00,0.00
2024-12-08 16:51:17,55,224,15,40,138.07,226.02,0.00
2024-12-08 16:51:17,54,224,15,39,140.25,226.17,0.00
2024-12-08 16:51:17,54,225,15,39,141.45,227.00,0.00
2024-12-08 16:51:17,55,225,15,40,138.88,227.02,0.00
2024-12-08 16:51:17,55,226,15,40,139.20,228.00,0.00
2024-12-08 16:51:17,56,226,15,41,136.72,228.02,0.00
2024-12-08 16:51:17,56,227,15,41,136.70,229.00,0.00
2024-12-08 16:51:17,57,227,15,42,134.31,229.02,0.00
2024-12-08 16:51:17,56,227,15,41,136.29,229.16,0.00
2024-12-08 16:51:17,55,227,14,41,136.43,229.96,0.00
2024-12-08 16:51:17,55,228,14,41,140.55,230.00,0.00
2024-12-08 16:51:17,56,228,14,42,138.04,230.02,0.00
2024-12-08 16:51:17,56,229,14,42,138.30,231.00,0.00
2024-12-08 16:51:17,57,229,15,42,135.87,231.02,0.00
2024-12-08 16:51:17,56,229,14,42,136.35,231.23,0.00
2024-12-08 16:51:17,56,230,14,42,139.24,232.00,0.00
2024-12-08 16:51:17,57,230,15,42,136.80,232.02,0.00
2024-12-08 16:51:17,56,230,15,41,138.90,232.16,0.00
2024-12-08 16:51:17,56,231,15,41,140.01,233.00,0.00
2024-12-08 16:51:17,57,231,15,42,137.55,233.02,0.00
2024-12-08 16:51:17,57,232,15,42,137.73,234.00,0.00
2024-12-08 16:51:17,58,232,15,43,135.36,234.02,0.00
2024-12-08 16:51:17,57,232,15,42,136.61,234.16,0.00
2024-12-08 16:51:17,56,232,14,42,137.30,234.82,0.00
2024-12-08 16:51:17,56,233,14,42,141.21,235.00,0.00
2024-12-08 16:51:17,57,233,15,42,138.73,235.02,0.00
2024-12-08 16:51:17,57,234,15,42,138.96,236.00,0.00
2024-12-08 16:51:17,58,234,15,43,136.56,236.02,0.00
2024-12-08 16:51:17,57,234,15,42,137.78,236.16,0.00
2024-12-08 16:51:18,57,235,15,42,138.84,237.00,0.00
2024-12-08 16:51:18,58,235,16,42,136.45,237.02,0.00
2024-12-08 16:51:18,58,236,16,42,136.77,238.00,0.00
2024-12-08 16:51:18,59,236,16,43,134.45,238.02,0.00
2024-12-08 16:51:18,59,237,16,43,134.28,239.00,0.00
2024-12-08 16:51:18,60,237,17,43,132.05,239.02,0.00
2024-12-08 16:51:18,59,237,17,42,133.83,239.17,0.00
2024-12-08 16:51:18,58,237,16,42,133.84,239.90,0.00
2024-12-08 16:51:18,58,238,16,42,137.80,240.00,0.00
2024-12-08 16:51:18,59,238,16,43,135.47,240.02,0.00
2024-12-08 16:51:18,59,239,16,43,135.75,241.00,0.00
2024-12-08 16:51:18,60,239,17,43,133.49,241.02,0.00
2024-12-08 16:51:18,60,240,17,43,133.27,242.00,0.00
2024-12-08 16:51:18,61,240,17,44,131.09,242.02,0.00
2024-12-08 16:51:18,60,240,17,43,132.85,242.17,0.00
2024-12-08 16:51:18,60,241,17,43,133.78,243.00,0.00
2024-12-08 16:51:18,61,241,18,43,131.59,243.02,0.00
2024-12-08 16:51:18,61,242,18,43,131.78,244.00,0.00
2024-12-08 16:51:18,62,242,18,44,129.66,244.02,0.00
2024-12-08 16:51:18,61,242,18,43,130.60,244.16,0.00
2024-12-08 16:51:18,61,243,18,43,131.48,245.00,0.00
2024-12-08 16:51:18,62,243,18,44,129.36,245.02,0.00
2024-12-08 16:51:18,62,244,18,44,129.52,246.00,0.00
2024-12-08 16:51:18,63,244,18,45,127.46,246.02,0.00
2024-12-08 16:51:18,62,244,18,44,128.38,246.16,0.00
2024-12-08 16:51:18,61,244,17,44,127.80,246.97,0.00
2024-12-08 16:51:18,61,245,17,44,131.79,247.00,0.00
2024-12-08 16:51:18,62,245,18,44,129.66,247.02,0.00
2024-12-08 16:51:18,62,246,18,44,129.89,248.00,0.00
2024-12-08 16:51:18,63,246,18,45,127.82,248.02,0.00
2024-12-08 16:51:18,63,247,18,45,127.49,249.00,0.00
2024-12-08 16:51:18,64,247,19,45,125.50,249.02,0.00
2024-12-08 16:51:18,63,247,19,44,127.07,249.17,0.00
2024-12-08 16:51:18,63,248,19,44,127.89,250.00,0.00
2024-12-08 16:51:18,64,248,20,44,125.89,250.02,0.00
2024-12-08 16:51:18,63,248,19,44,124.40,250.89,0.00
2024-12-08 16:51:18,63,249,19,44,128.19,251.00,0.00
2024-12-08 16:51:18,64,249,20,44,126.18,251.02,0.00
2024-12-08 16:51:18,63,249,20,43,128.15,251.02,0.00
2024-12-08 16:51:18,62,249,20,42,129.00,251.16,0.00
2024-12-08 16:51:18,62,250,20,42,129.89,252.00,0.00
2024-12-08 16:51:18,63,250,20,43,127.83,252.02,0.00
2024-12-08 16:51:18,62,250,20,42,129.85,252.02,0.00
2024-12-08 16:51:18,61,250,19,42,131.71,252.11,0.00
2024-12-08 16:51:18,61,251,19,42,132.21,253.00,0.00
2024-12-08 16:51:18,62,251,20,42,130.08,253.02,0.00
2024-12-08 16:51:18,61,251,20,41,132.17,253.02,0.00
2024-12-08 16:51:18,60,251,20,40,133.28,253.12,0.00
2024-12-08 16:51:18,60,252,20,40,134.10,254.00,0.00
2024-12-08 16:51:18,61,252,21,40,131.90,254.02,0.00
2024-12-08 16:51:18,60,252,21,39,134.06,254.02,0.00
2024-12-08 16:51:18,60,253,21,39,134.29,255.00,0.00
2024-12-08 16:51:18,61,253,21,40,132.09,255.02,0.00
2024-12-08 16:51:18,60,253,21,39,134.25,255.02,0.00
2024-12-08 16:51:18,59,253,21,38,135.53,255.08,0.00
2024-12-08 16:51:18,58,253,20,38,135.13,255.53,0.00
2024-12-08 16:51:18,58,254,20,38,138.67,256.00,0.00
2024-12-08 16:51:18,59,254,21,38,136.32,256.02,0.00
2024-12-08 16:51:18,58,254,21,37,138.63,256.02,0.00
2024-12-08 16:51:18,57,254,20,37,140.96,256.05,0.00
2024-12-08 16:51:18,56,254,19,37,139.48,256.91,0.00
2024-12-08 16:51:18,56,255,19,37,143.90,257.00,0.00
2024-12-08 16:51:18,57,255,20,37,141.38,257.02,0.00
2024-12-08 16:51:18,56,255,20,36,143.86,257.02,0.00
2024-12-08 16:51:18,55,255,20,35,145.59,257.04,0.00
2024-12-08 16:51:18,55,256,20,35,146.48,258.00,0.00
2024-12-08 16:51:18,56,256,21,35,143.86,258.02,0.00
2024-12-08 16:51:18,55,256,21,34,146.43,258.02,0.00
2024-12-08 16:51:18,54,256,20,34,148.15,258.04,0.00
2024-12-08 16:51:18,54,257,20,34,149.45,259.00,0.00
2024-12-08 16:51:18,55,257,20,35,146.73,259.02,0.00
2024-12-08 16:51:18,54,257,20,34,148.63,259.02,0.00
2024-12-08 16:51:18,54,258,20,34,149.54,260.00,0.00
2024-12-08 16:51:18,55,258,20,35,146.82,260.02,0.00
2024-12-08 16:51:18,54,258,19,35,149.33,260.07,0.00
2024-12-08 16:51:18,54,259,19,35,151.33,261.00,0.00
2024-12-08 16:51:18,55,259,19,36,148.57,261.02,0.00
2024-12-08 16:51:18,54,259,18,36,149.49,261.02,0.00
2024-12-08 16:51:18,54,260,18,36,151.37,262.00,0.00
2024-12-08 16:51:18,55,260,18,37,148.62,262.02,0.00
2024-12-08 16:51:18,54,260,18,36,149.29,262.06,0.00
2024-12-08 16:51:18,54,261,18,36,152.24,263.00,0.00
2024-12-08 16:51:18,55,261,19,36,149.47,263.02,0.00
2024-12-08 16:51:18,54,261,18,36,151.71,263.02,0.00
2024-12-08 16:51:18,54,262,18,36,153.60,264.00,0.00
2024-12-08 16:51:18,55,262,19,36,150.81,264.02,0.00
2024-12-08 16:51:18,54,262,19,35,152.58,264.04,0.00
2024-12-08 16:51:18,54,263,19,35,153.55,265.00,0.00
2024-12-08 16:51:18,55,263,20,35,150.75,265.02,0.00
2024-12-08 16:51:18,54,263,19,35,151.02,265.59,0.00
2024-12-08 16:51:18,54,264,19,35,155.16,266.00,0.00
2024-12-08 16:51:18,55,264,20,35,152.34,266.02,0.00
2024-12-08 16:51:18,54,264,20,34,154.18,266.04,0.00
2024-12-08 16:51:18,53,264,19,34,154.87,266.45,0.00
2024-12-08 16:51:19,53,265,19,34,158.83,267.00,0.00
2024-12-08 16:51:19,54,265,20,34,155.89,267.02,0.00
2024-12-08 16:51:19,54,266,20,34,156.08,268.00,0.00
2024-12-08 16:51:19,55,266,21,34,153.25,268.02,0.00
2024-12-08 16:51:19,54,266,21,33,155.15,268.04,0.00
2024-12-08 16:51:19,53,266,20,33,156.74,268.64,0.00
2024-12-08 16:51:19,52,266,19,33,159.21,268.69,0.00
2024-12-08 16:51:19,52,267,19,33,163.79,269.00,0.00
2024-12-08 16:51:19,53,267,20,33,160.70,269.02,0.00
2024-12-08 16:51:19,52,267,19,33,162.66,269.06,0.00
2024-12-08 16:51:19,51,267,18,33,163.51,269.47,0.00
2024-12-08 16:51:19,51,268,18,33,167.78,270.00,0.00
2024-12-08 16:51:19,52,268,19,33,164.56,270.02,0.00
2024-12-08 16:51:19,51,268,19,32,166.83,270.04,0.00
2024-12-08 16:51:19,51,269,19,32,168.03,271.00,0.00
2024-12-08 16:51:19,52,269,20,32,164.80,271.02,0.00
2024-12-08 16:51:19,51,269,19,32,167.94,271.06,0.00
2024-12-08 16:51:19,51,270,19,32,170.25,272.00,0.00
2024-12-08 16:51:19,52,270,20,32,166.98,272.02,0.00
2024-12-08 16:51:19,51,270,20,31,169.09,272.06,0.00
2024-12-08 16:51:19,51,271,20,31,170.34,273.00,0.00
2024-12-08 16:51:19,52,271,21,31,167.07,273.02,0.00
2024-12-08 16:51:19,52,272,21,31,167.19,274.00,0.00
2024-12-08 16:51:19,53,272,21,32,164.03,274.02,0.00
2024-12-08 16:51:19,52,272,21,31,166.09,274.06,0.00
2024-12-08 16:51:19,52,273,21,31,167.27,275.00,0.00
2024-12-08 16:51:19,53,273,22,31,164.11,275.02,0.00
2024-12-08 16:51:19,53,274,22,31,164.23,276.00,0.00
2024-12-08 16:51:19,54,274,22,32,161.19,276.02,0.00
2024-12-08 16:51:19,53,274,22,31,163.20,276.06,0.00
2024-12-08 16:51:19,53,275,22,31,164.30,277.00,0.00
2024-12-08 16:51:19,54,275,22,32,161.26,277.02,0.00
2024-12-08 16:51:19,53,275,21,32,163.05,277.02,0.00
2024-12-08 16:51:19,53,276,21,32,165.11,278.00,0.00
2024-12-08 16:51:19,54,276,22,32,162.05,278.02,0.00
2024-12-08 16:51:19,53,276,22,31,164.22,278.04,0.00
2024-12-08 16:51:19,53,277,22,31,165.28,279.00,0.00
2024-12-08 16:51:19,54,277,23,31,162.22,279.02,0.00
2024-12-08 16:51:19,54,278,23,31,162.29,280.00,0.00
2024-12-08 16:51:19,55,278,24,31,159.34,280.02,0.00
2024-12-08 16:51:19,54,278,24,30,161.47,280.04,0.00
2024-12-08 16:51:19,53,278,23,30,162.08,280.81,0.00
2024-12-08 16:51:19,53,279,23,30,166.99,281.00,0.00
2024-12-08 16:51:19,54,279,24,30,163.90,281.02,0.00
2024-12-08 16:51:19,54,280,24,30,163.96,282.00,0.00
2024-12-08 16:51:19,55,280,25,30,160.97,282.02,0.00
2024-12-08 16:51:19,54,280,25,29,163.18,282.04,0.00
2024-12-08 16:51:19,54,281,25,29,164.17,283.00,0.00
2024-12-08 16:51:19,55,281,25,30,161.19,283.02,0.00
2024-12-08 16:51:19,55,282,25,30,161.20,284.00,0.00
2024-12-08 16:51:19,56,282,25,31,158.32,284.02,0.00
2024-12-08 16:51:19,55,282,25,30,160.48,284.04,0.00
2024-12-08 16:51:19,54,282,24,30,162.03,284.65,0.00
2024-12-08 16:51:19,54,283,24,30,164.45,285.00,0.00
2024-12-08 16:51:19,55,283,24,31,161.46,285.02,0.00
2024-12-08 16:51:19,55,284,24,31,161.47,286.00,0.00
2024-12-08 16:51:19,56,284,24,32,158.59,286.02,0.00
2024-12-08 16:51:19,55,284,24,31,160.75,286.04,0.00
2024-12-08 16:51:19,54,284,23,31,163.54,286.11,0.00
2024-12-08 16:51:19,53,284,22,31,164.18,286.43,0.00
2024-12-08 16:51:19,52,284,21,31,167.15,286.50,0.00
2024-12-08 16:51:19,52,285,21,31,171.59,287.00,0.00
2024-12-08 16:51:19,53,285,21,32,168.35,287.02,0.00
2024-12-08 16:51:19,52,285,20,32,168.88,287.63,0.00
2024-12-08 16:51:19,52,286,20,32,173.64,288.00,0.00
2024-12-08 16:51:19,53,286,21,32,170.36,288.02,0.00
2024-12-08 16:51:19,52,286,20,32,172.42,288.02,0.00
2024-12-08 16:51:19,51,286,20,31,175.12,288.02,0.00
2024-12-08 16:51:19,51,287,20,31,178.57,289.00,0.00
2024-12-08 16:51:19,52,287,20,32,175.13,289.02,0.00
2024-12-08 16:51:19,51,287,19,32,174.63,289.47,0.00
2024-12-08 16:51:19,51,288,19,32,179.18,290.00,0.00
2024-12-08 16:51:19,52,288,19,33,175.74,290.02,0.00
2024-12-08 16:51:19,51,288,19,32,178.56,290.02,0.00
2024-12-08 16:51:19,51,289,19,32,179.74,291.00,0.00
2024-12-08 16:51:19,52,289,20,32,176.29,291.02,0.00
2024-12-08 16:51:19,51,289,19,32,176.10,291.78,0.00
2024-12-08 16:51:19,51,290,19,32,181.38,292.00,0.00
2024-12-08 16:51:19,52,290,19,33,177.89,292.02,0.00
2024-12-08 16:51:19,51,290,19,32,180.80,292.02,0.00
2024-12-08 16:51:19,51,291,19,32,182.00,293.00,0.00
2024-12-08 16:51:19,52,291,19,33,178.50,293.02,0.00
2024-12-08 16:51:19,52,292,19,33,178.49,294.00,0.00
2024-12-08 16:51:19,53,292,19,34,175.12,294.02,0.00
2024-12-08 16:51:19,52,292,19,33,177.86,294.02,0.00
2024-12-08 16:51:19,51,292,18,33,178.30,294.51,0.00
2024-12-08 16:51:19,51,293,18,33,183.01,295.00,0.00
2024-12-08 16:51:19,52,293,18,34,179.49,295.02,0.00
2024-12-08 16:51:19,52,294,18,34,179.47,296.00,0.00
2024-12-08 16:51:19,53,294,18,35,176.09,296.02,0.00
2024-12-08 16:51:19,52,294,18,34,178.79,296.02,0.00
2024-12-08 16:51:19,52,295,18,34,179.91,297.00,0.00
2024-12-08 16:51:19,53,295,18,35,176.51,297.02,0.00
2024-12-08 16:51:20,52,295,17,35,176.12,297.13,0.00
2024-12-08 16:51:20,52,296,17,35,179.82,298.00,0.00
2024-12-08 16:51:20,53,296,18,35,176.43,298.02,0.00
2024-12-08 16:51:20,52,296,18,34,179.19,298.02,0.00
2024-12-08 16:51:20,52,297,18,34,180.31,299.00,0.00
2024-12-08 16:51:20,53,297,18,35,176.91,299.02,0.00
2024-12-08 16:51:20,53,298,18,35,176.82,300.00,0.00
2024-12-08 16:51:20,54,298,19,35,173.55,300.02,0.00
2024-12-08 16:51:20,53,298,19,34,176.26,300.02,0.00
2024-12-08 16:51:20,53,299,19,34,177.30,301.00,0.00
2024-12-08 16:51:20,54,299,20,34,174.02,301.02,0.00
2024-12-08 16:51:20,54,300,20,34,173.87,302.00,0.00
2024-12-08 16:51:20,55,300,20,35,170.71,302.02,0.00
2024-12-08 16:51:20,54,300,20,34,173.36,302.02,0.00
2024-12-08 16:51:20,53,300,19,34,174.99,302.64,0.00
2024-12-08 16:51:20,53,301,19,34,177.62,303.00,0.00
2024-12-08 16:51:20,54,301,19,35,174.33,303.02,0.00
2024-12-08 16:51:20,53,301,18,35,174.97,303.28,0.00
2024-12-08 16:51:20,53,302,18,35,179.01,304.00,0.00
2024-12-08 16:51:20,54,302,19,35,175.69,304.02,0.00
2024-12-08 16:51:20,53,302,19,34,178.44,304.02,0.00
2024-12-08 16:51:20,53,303,19,34,179.48,305.00,0.00
2024-12-08 16:51:20,54,303,19,35,176.16,305.02,0.00
2024-12-08 16:51:20,54,304,19,35,176.00,306.00,0.00
2024-12-08 16:51:20,55,304,20,35,172.80,306.02,0.00
2024-12-08 16:51:20,54,304,20,34,175.49,306.02,0.00
2024-12-08 16:51:20,54,305,20,34,176.46,307.00,0.00
2024-12-08 16:51:20,55,305,21,34,173.25,307.02,0.00
2024-12-08 16:51:20,55,306,21,34,173.08,308.00,0.00
2024-12-08 16:51:20,56,306,22,34,169.99,308.02,0.00
2024-12-08 16:51:20,55,306,22,33,172.58,308.02,0.00
2024-12-08 16:51:20,55,307,22,33,173.48,309.00,0.00
2024-12-08 16:51:20,56,307,22,34,170.38,309.02,0.00
2024-12-08 16:51:20,55,307,21,34,169.91,309.40,0.00
2024-12-08 16:51:20,55,308,21,34,174.09,310.00,0.00
2024-12-08 16:51:20,56,308,22,34,170.99,310.02,0.00
2024-12-08 16:51:20,55,308,22,33,173.59,310.02,0.00
2024-12-08 16:51:20,55,309,22,33,174.49,311.00,0.00
2024-12-08 16:51:20,56,309,23,33,171.37,311.02,0.00
2024-12-08 16:51:20,56,310,23,33,171.25,312.00,0.00
2024-12-08 16:51:20,57,310,24,33,168.24,312.02,0.00
2024-12-08 16:51:20,56,310,24,32,170.75,312.02,0.00
2024-12-08 16:51:20,55,310,23,32,173.55,312.11,0.00
2024-12-08 16:51:20,54,310,22,32,175.36,312.63,0.00
2024-12-08 16:51:20,54,311,22,32,177.94,313.00,0.00
2024-12-08 16:51:20,55,311,23,32,174.71,313.02,0.00
2024-12-08 16:51:20,55,312,23,32,174.58,314.00,0.00
2024-12-08 16:51:20,56,312,23,33,171.46,314.02,0.00
2024-12-08 16:51:20,55,312,23,32,174.07,314.02,0.00
2024-12-08 16:51:20,55,313,23,32,174.97,315.00,0.00
2024-12-08 16:51:20,56,313,23,33,171.84,315.02,0.00
2024-12-08 16:51:20,55,313,22,33,171.77,315.71,0.00
2024-12-08 16:51:20,55,314,22,33,176.79,316.00,0.00
2024-12-08 16:51:20,56,314,23,33,173.63,316.02,0.00
2024-12-08 16:51:20,55,314,23,32,176.27,316.02,0.00
2024-12-08 16:51:20,54,314,22,32,177.48,316.33,0.00
2024-12-08 16:51:20,54,315,22,32,181.69,317.00,0.00
2024-12-08 16:51:20,55,315,23,32,178.38,317.02,0.00
2024-12-08 16:51:20,54,315,22,32,179.29,317.22,0.00
2024-12-08 16:51:20,54,316,22,32,183.20,318.00,0.00
2024-12-08 16:51:20,55,316,22,33,179.87,318.02,0.00
2024-12-08 16:51:20,54,316,22,32,182.73,318.02,0.00
2024-12-08 16:51:20,54,317,22,32,183.72,319.00,0.00
2024-12-08 16:51:20,55,317,23,32,180.38,319.02,0.00
2024-12-08 16:51:20,56,316,24,32,174.34,319.68,0.00
2024-12-08 16:51:20,56,317,24,32,182.57,320.00,0.00
2024-12-08 16:51:20,57,317,24,33,179.37,320.02,0.00
2024-12-08 16:51:20,56,317,24,32,182.17,320.02,0.00
2024-12-08 16:51:20,56,318,24,32,188.76,321.00,0.00
2024-12-08 16:51:20,57,318,25,32,185.45,321.02,0.00
2024-12-08 16:51:20,57,319,25,32,185.12,322.00,0.00
2024-12-08 16:51:20,58,319,25,33,181.93,322.02,0.00
2024-12-08 16:51:20,57,319,25,32,184.72,322.02,0.00
2024-12-08 16:51:20,57,320,25,32,185.52,323.00,0.00
2024-12-08 16:51:20,58,320,25,33,182.33,323.02,0.00
2024-12-08 16:51:20,58,321,25,33,181.99,324.00,0.00
2024-12-08 16:51:20,59,321,26,33,178.91,324.02,0.00
2024-12-08 16:51:20,58,321,26,32,181.49,324.02,0.00
2024-12-08 16:51:20,58,322,26,32,182.22,325.00,0.00
2024-12-08 16:51:20,59,322,26,33,179.13,325.02,0.00
2024-12-08 16:51:20,58,322,25,33,179.45,325.28,0.00
2024-12-08 16:51:20,58,323,25,33,183.17,326.00,0.00
2024-12-08 16:51:20,59,323,25,34,180.07,326.02,0.00
2024-12-08 16:51:20,58,323,25,33,182.56,326.03,0.00
2024-12-08 16:51:20,58,324,25,33,183.34,327.00,0.00
2024-12-08 16:51:20,59,324,25,34,180.23,327.02,0.00
2024-12-08 16:51:20,58,324,24,34,178.53,327.60,0.00
2024-12-08 16:51:20,58,325,24,34,183.14,328.00,0.00
2024-12-08 16:51:20,59,325,25,34,180.04,328.02,0.00
2024-12-08 16:51:20,58,325,25,33,182.41,328.03,0.00
2024-12-08 16:51:21,57,325,24,33,185.35,328.11,0.00
2024-12-08 16:51:21,56,325,23,33,184.78,328.64,0.00
2024-12-08 16:51:21,56,326,23,33,189.73,329.00,0.00
2024-12-08 16:51:21,57,326,23,34,186.41,329.02,0.00
2024-12-08 16:51:21,57,327,23,34,186.15,330.00,0.00
2024-12-08 16:51:21,58,327,23,35,182.94,330.02,0.00
2024-12-08 16:51:21,57,327,23,34,185.46,330.04,0.00
2024-12-08 16:51:21,56,327,22,34,188.56,330.09,0.00
2024-12-08 16:51:21,55,327,21,34,191.07,330.18,0.00
2024-12-08 16:51:21,55,328,21,34,194.90,331.00,0.00
2024-12-08 16:51:21,56,328,21,35,191.42,331.02,0.00
2024-12-08 16:51:21,55,328,20,35,191.48,331.07,0.00
2024-12-08 16:51:21,54,328,19,35,193.47,331.61,0.00
2024-12-08 16:51:21,54,329,19,35,198.62,332.00,0.00
2024-12-08 16:51:21,55,329,19,36,195.01,332.02,0.00
2024-12-08 16:51:21,54,329,18,36,198.45,332.07,0.00
2024-12-08 16:51:21,54,330,18,36,198.93,333.00,0.00
2024-12-08 16:51:21,55,330,19,36,195.32,333.02,0.00
2024-12-08 16:51:21,55,331,19,36,195.05,334.00,0.00
2024-12-08 16:51:21,56,331,19,37,191.57,334.02,0.00
2024-12-08 16:51:21,55,331,19,36,194.77,334.09,0.00
2024-12-08 16:51:21,54,331,18,36,194.43,334.61,0.00
2024-12-08 16:51:21,54,332,18,36,199.63,335.00,0.00
2024-12-08 16:51:21,55,332,19,36,196.00,335.02,0.00
2024-12-08 16:51:21,55,333,19,36,196.21,336.00,0.00
2024-12-08 16:51:21,56,333,19,37,192.71,336.02,0.00
2024-12-08 16:51:21,55,333,19,36,194.70,336.09,0.00
2024-12-08 16:51:21,55,334,19,36,195.88,337.00,0.00
2024-12-08 16:51:21,56,334,20,36,192.38,337.02,0.00
2024-12-08 16:51:21,55,334,19,36,191.94,337.42,0.00
2024-12-08 16:51:21,55,335,19,36,196.52,338.00,0.00
2024-12-08 16:51:21,56,335,19,37,193.01,338.02,0.00
2024-12-08 16:51:21,56,336,19,37,192.67,339.00,0.00
2024-12-08 16:51:21,57,336,19,38,189.29,339.02,0.00
2024-12-08 16:51:21,56,336,19,37,192.03,339.13,0.00
2024-12-08 16:51:21,56,337,19,37,193.24,340.00,0.00
2024-12-08 16:51:21,57,337,20,37,189.85,340.02,0.00
2024-12-08 16:51:21,56,337,19,37,188.25,340.96,0.00
2024-12-08 16:51:21,56,338,19,37,194.23,341.00,0.00
2024-12-08 16:51:21,57,338,20,37,190.83,341.02,0.00
2024-12-08 16:51:21,56,338,20,36,194.12,341.04,0.00
2024-12-08 16:51:21,56,339,20,36,193.83,342.00,0.00
2024-12-08 16:51:21,57,339,20,37,190.43,342.02,0.00
2024-12-08 16:51:21,56,339,19,37,193.60,342.09,0.00
2024-12-08 16:51:21,55,339,19,36,196.93,342.09,0.00
2024-12-08 16:51:21,55,340,19,36,198.12,343.00,0.00
2024-12-08 16:51:21,56,340,20,36,194.58,343.02,0.00
2024-12-08 16:51:21,56,341,20,36,194.79,344.00,0.00
2024-12-08 16:51:21,57,341,21,36,191.37,344.02,0.00
2024-12-08 16:51:21,56,341,20,36,192.60,344.32,0.00
2024-12-08 16:51:21,56,342,20,36,194.40,345.00,0.00
2024-12-08 16:51:21,57,342,21,36,190.99,345.02,0.00
2024-12-08 16:51:21,56,342,21,35,194.11,345.09,0.00
2024-12-08 16:51:21,56,343,21,35,195.21,346.00,0.00
2024-12-08 16:51:21,57,343,22,35,191.79,346.02,0.00
2024-12-08 16:51:21,56,343,21,35,190.65,346.48,0.00
2024-12-08 16:51:21,56,344,21,35,195.40,347.00,0.00
2024-12-08 16:51:21,57,344,22,35,191.98,347.02,0.00
2024-12-08 16:51:21,56,344,22,34,193.93,347.09,0.00
2024-12-08 16:51:21,56,345,22,34,195.03,348.00,0.00
2024-12-08 16:51:21,57,345,22,35,191.61,348.02,0.00
2024-12-08 16:51:21,57,346,22,35,191.70,349.00,0.00
2024-12-08 16:51:21,58,346,22,36,188.40,349.02,0.00
2024-12-08 16:51:21,57,346,22,35,190.31,349.09,0.00
2024-12-08 16:51:21,56,346,21,35,192.44,349.50,0.00
2024-12-08 16:51:21,55,346,20,35,194.50,349.65,0.00
2024-12-08 16:51:21,55,347,20,35,199.91,350.00,0.00
2024-12-08 16:51:21,56,347,20,36,196.34,350.02,0.00
2024-12-08 16:51:21,56,348,20,36,196.45,351.00,0.00
2024-12-08 16:51:21,57,348,21,36,193.00,351.02,0.00
2024-12-08 16:51:21,56,348,21,35,194.96,351.11,0.00
2024-12-08 16:51:21,56,349,21,35,196.13,352.00,0.00
2024-12-08 16:51:21,57,349,22,35,192.69,352.02,0.00
2024-12-08 16:51:21,56,349,21,35,191.94,352.43,0.00
2024-12-08 16:51:21,56,350,21,35,196.62,353.00,0.00
2024-12-08 16:51:21,57,350,21,36,193.17,353.02,0.00
2024-12-08 16:51:21,56,350,21,35,195.19,353.11,0.00
2024-12-08 16:51:21,56,351,21,35,196.36,354.00,0.00
2024-12-08 16:51:21,57,351,21,36,192.91,354.02,0.00
2024-12-08 16:51:21,56,351,20,36,196.29,354.02,0.00
2024-12-08 16:51:21,55,351,19,36,196.80,354.29,0.00
2024-12-08 16:51:21,55,352,19,36,201.20,355.00,0.00
2024-12-08 16:51:21,56,352,20,36,197.61,355.02,0.00
2024-12-08 16:51:21,55,352,20,35,199.80,355.09,0.00
2024-12-08 16:51:21,55,353,20,35,200.99,356.00,0.00
2024-12-08 16:51:21,56,353,21,35,197.40,356.02,0.00
2024-12-08 16:51:21,55,353,20,35,197.73,356.65,0.00
2024-12-08 16:51:21,55,354,20,35,201.15,357.00,0.00
2024-12-08 16:51:21,56,354,20,36,197.56,357.02,0.00
2024-12-08 16:51:21,55,354,20,35,199.80,357.09,0.00
2024-12-08 16:51:21,55,355,20,35,201.00,358.00,0.00
2024-12-08 16:51:21,56,355,21,35,197.41,358.02,0.00
2024-12-08 16:51:21,55,355,20,35,198.79,358.07,0.00
2024-12-08 16:51:22,55,356,20,35,201.23,359.00,0.00
2024-12-08 16:51:22,56,356,20,36,197.64,359.02,0.00
2024-12-08 16:51:22,55,356,20,35,200.00,359.07,0.00
2024-12-08 16:51:22,55,357,20,35,201.14,360.00,0.00
2024-12-08 16:51:22,56,357,20,36,197.55,360.02,0.00
2024-12-08 16:51:22,56,358,20,36,197.56,361.00,0.00
2024-12-08 16:51:22,57,358,20,37,194.10,361.02,0.00
2024-12-08 16:51:22,56,358,20,36,196.41,361.07,0.00
2024-12-08 16:51:22,55,358,19,36,198.44,361.55,0.00
2024-12-08 16:51:22,54,358,18,36,201.32,361.65,0.00
2024-12-08 16:51:22,54,359,18,36,207.02,362.00,0.00
2024-12-08 16:51:22,55,359,19,36,203.25,362.02,0.00
2024-12-08 16:51:22,54,359,19,35,206.95,362.02,0.00
2024-12-08 16:51:22,53,359,18,35,207.33,362.30,0.00
2024-12-08 16:51:22,53,360,18,35,212.12,363.00,0.00
2024-12-08 16:51:22,54,360,18,36,208.19,363.02,0.00
2024-12-08 16:51:22,53,360,18,35,211.03,363.06,0.00
2024-12-08 16:51:22,53,361,18,35,212.30,364.00,0.00
2024-12-08 16:51:22,54,361,18,36,208.36,364.02,0.00
2024-12-08 16:51:22,54,362,18,36,208.27,365.00,0.00
2024-12-08 16:51:22,55,362,18,37,204.49,365.02,0.00
2024-12-08 16:51:22,54,362,18,36,207.26,365.06,0.00
2024-12-08 16:51:22,53,362,17,36,209.17,365.62,0.00
2024-12-08 16:51:22,53,363,17,36,214.98,366.00,0.00
2024-12-08 16:51:22,54,363,17,37,211.00,366.02,0.00
2024-12-08 16:51:22,54,364,17,37,210.92,367.00,0.00
2024-12-08 16:51:22,55,364,17,38,207.08,367.02,0.00
2024-12-08 16:51:22,54,364,17,37,209.90,367.06,0.00
2024-12-08 16:51:22,54,365,17,37,211.08,368.00,0.00
2024-12-08 16:51:22,55,365,18,37,207.25,368.02,0.00
2024-12-08 16:51:22,54,365,17,37,207.99,368.54,0.00
2024-12-08 16:51:22,54,366,17,37,213.45,369.00,0.00
2024-12-08 16:51:22,55,366,17,38,209.57,369.02,0.00
2024-12-08 16:51:22,54,366,17,37,212.36,369.06,0.00
2024-12-08 16:51:22,54,367,17,37,213.55,370.00,0.00
2024-12-08 16:51:22,55,367,17,38,209.67,370.02,0.00
2024-12-08 16:51:22,55,368,17,38,209.57,371.00,0.00
2024-12-08 16:51:22,56,368,18,38,205.83,371.02,0.00
2024-12-08 16:51:22,55,368,18,37,208.56,371.05,0.00
2024-12-08 16:51:22,54,368,17,37,210.80,371.56,0.00
2024-12-08 16:51:22,54,369,17,37,216.36,372.00,0.00
2024-12-08 16:51:22,55,369,18,37,212.43,372.02,0.00
2024-12-08 16:51:22,54,369,17,37,216.29,372.02,0.00
2024-12-08 16:51:22,53,369,16,37,218.56,372.11,0.00
2024-12-08 16:51:22,52,369,15,37,221.80,372.19,0.00
2024-12-08 16:51:22,52,370,15,37,226.51,373.00,0.00
2024-12-08 16:51:22,53,370,15,38,222.23,373.02,0.00
2024-12-08 16:51:22,52,370,15,37,225.50,373.04,0.00
2024-12-08 16:51:22,52,371,15,37,226.83,374.00,0.00
2024-12-08 16:51:22,53,371,16,37,222.55,374.02,0.00
2024-12-08 16:51:22,52,371,15,37,225.17,374.08,0.00
2024-12-08 16:51:22,52,372,15,37,226.82,375.00,0.00
2024-12-08 16:51:22,53,372,16,37,222.54,375.02,0.00
2024-12-08 16:51:22,52,372,15,37,226.72,375.04,0.00
2024-12-08 16:51:22,51,372,15,36,230.07,375.04,0.00
2024-12-08 16:51:22,51,373,15,36,231.49,376.00,0.00
2024-12-08 16:51:22,52,373,15,37,227.04,376.02,0.00
2024-12-08 16:51:22,52,374,15,37,227.05,377.00,0.00
2024-12-08 16:51:22,53,374,16,37,222.76,377.02,0.00
2024-12-08 16:51:22,52,374,16,36,226.97,377.02,0.00
2024-12-08 16:51:22,51,374,16,35,230.09,377.02,0.00
2024-12-08 16:51:22,51,375,16,35,231.45,378.00,0.00
2024-12-08 16:51:22,52,375,16,36,227.00,378.02,0.00
2024-12-08 16:51:22,52,376,16,36,226.93,379.00,0.00
2024-12-08 16:51:22,53,376,16,37,222.65,379.02,0.00
2024-12-08 16:51:22,52,376,16,36,225.69,379.02,0.00
2024-12-08 16:51:22,51,376,15,36,225.92,379.92,0.00
2024-12-08 16:51:22,51,377,15,36,233.12,380.00,0.00
2024-12-08 16:51:22,52,377,16,36,228.63,380.02,0.00
2024-12-08 16:51:22,51,377,15,36,227.62,380.49,0.00
2024-12-08 16:51:22,51,378,15,36,233.51,381.00,0.00
2024-12-08 16:51:22,52,378,16,36,229.02,381.02,0.00
2024-12-08 16:51:22,51,378,16,35,232.16,381.02,0.00
2024-12-08 16:51:22,51,379,16,35,233.52,382.00,0.00
2024-12-08 16:51:22,52,379,16,36,229.03,382.02,0.00
2024-12-08 16:51:22,52,380,16,36,229.06,383.00,0.00
2024-12-08 16:51:22,53,380,17,36,224.74,383.02,0.00
2024-12-08 16:51:22,52,380,17,35,227.73,383.02,0.00
2024-12-08 16:51:22,51,380,16,35,228.40,383.43,0.00
2024-12-08 16:51:22,50,380,15,35,232.40,383.62,0.00
2024-12-08 16:51:22,50,381,15,35,238.90,384.00,0.00
2024-12-08 16:51:22,51,381,15,36,234.22,384.02,0.00
2024-12-08 16:51:22,50,381,14,36,234.34,384.34,0.00
2024-12-08 16:51:22,50,382,14,36,239.96,385.00,0.00
2024-12-08 16:51:22,51,382,14,37,235.26,385.02,0.00
2024-12-08 16:51:22,50,382,14,36,238.57,385.02,0.00
2024-12-08 16:51:22,50,383,14,36,240.04,386.00,0.00
2024-12-08 16:51:22,51,383,15,36,235.34,386.02,0.00
2024-12-08 16:51:22,51,384,15,36,235.34,387.00,0.00
2024-12-08 16:51:22,52,384,15,37,230.81,387.02,0.00
2024-12-08 16:51:22,51,384,15,36,234.05,387.02,0.00
2024-12-08 16:51:22,51,385,15,36,235.42,388.00,0.00
2024-12-08 16:51:22,52,385,16,36,230.89,388.02,0.00
2024-12-08 16:51:22,51,385,15,36,231.80,388.27,0.00
2024-12-08 16:51:22,51,386,15,36,237.09,389.00,0.00
2024-12-08 16:51:23,52,386,16,36,232.53,389.02,0.00
2024-12-08 16:51:23,51,386,16,35,235.72,389.04,0.00
2024-12-08 16:51:23,51,387,16,35,237.16,390.00,0.00
2024-12-08 16:51:23,52,387,16,36,232.60,390.02,0.00
2024-12-08 16:51:23,52,388,16,36,232.55,391.00,0.00
2024-12-08 16:51:23,53,388,17,36,228.16,391.02,0.00
2024-12-08 16:51:23,52,388,17,35,231.28,391.04,0.00
2024-12-08 16:51:23,52,389,17,35,232.62,392.00,0.00
2024-12-08 16:51:23,53,389,18,35,228.23,392.02,0.00
2024-12-08 16:51:23,53,390,18,35,228.15,393.00,0.00
2024-12-08 16:51:23,54,390,18,36,223.92,393.02,0.00
2024-12-08 16:51:23,53,390,18,35,226.97,393.04,0.00
2024-12-08 16:51:23,53,391,18,35,228.21,394.00,0.00
2024-12-08 16:51:23,54,391,19,35,223.98,394.02,0.00
2024-12-08 16:51:23,54,392,19,35,224.07,395.00,0.00
2024-12-08 16:51:23,55,392,19,36,219.99,395.02,0.00
2024-12-08 16:51:23,54,392,19,35,222.48,395.09,0.00
2024-12-08 16:51:23,53,392,18,35,222.02,395.58,0.00
2024-12-08 16:51:23,53,393,18,35,228.12,396.00,0.00
2024-12-08 16:51:23,54,393,19,35,223.90,396.02,0.00
2024-12-08 16:51:23,53,393,18,35,224.92,396.19,0.00
2024-12-08 16:51:23,53,394,18,35,229.70,397.00,0.00
2024-12-08 16:51:23,54,394,19,35,225.45,397.02,0.00
2024-12-08 16:51:23,53,394,19,34,228.08,397.09,0.00
2024-12-08 16:51:23,53,395,19,34,229.53,398.00,0.00
2024-12-08 16:51:23,54,395,19,35,225.28,398.02,0.00
2024-12-08 16:51:23,53,395,18,35,225.99,398.58,0.00
2024-12-08 16:51:23,53,396,18,35,229.69,399.00,0.00
2024-12-08 16:51:23,54,396,19,35,225.44,399.02,0.00
2024-12-08 16:51:23,53,396,19,34,228.06,399.09,0.00
2024-12-08 16:51:23,52,396,18,34,230.88,399.54,0.00
2024-12-08 16:51:23,51,396,17,34,232.09,399.96,0.00
2024-12-08 16:51:23,51,397,17,34,239.79,400.00,0.00
2024-12-08 16:51:23,52,397,17,35,235.18,400.02,0.00
2024-12-08 16:51:23,51,397,16,35,234.29,400.49,0.00
2024-12-08 16:51:23,51,398,16,35,240.47,401.00,0.00
2024-12-08 16:51:23,52,398,16,36,235.85,401.02,0.00
2024-12-08 16:51:23,51,398,16,35,238.76,401.10,0.00
2024-12-08 16:51:23,50,398,15,35,241.69,401.26,0.00
2024-12-08 16:51:23,50,399,15,35,247.26,402.00,0.00
2024-12-08 16:51:23,51,399,16,35,242.41,402.02,0.00
2024-12-08 16:51:23,51,400,16,35,242.49,403.00,0.00
2024-12-08 16:51:23,52,400,17,35,237.83,403.02,0.00
2024-12-08 16:51:23,51,400,17,34,240.85,403.10,0.00
2024-12-08 16:51:23,50,400,16,34,244.01,403.58,0.00
2024-12-08 16:51:23,49,400,15,34,247.39,403.76,0.00
2024-12-08 16:51:23,49,401,15,34,254.85,404.00,0.00
2024-12-08 16:51:23,50,401,15,35,249.75,404.02,0.00
2024-12-08 16:51:23,50,402,15,35,249.86,405.00,0.00
2024-12-08 16:51:23,51,402,16,35,244.96,405.02,0.00
2024-12-08 16:51:23,50,402,16,34,248.10,405.10,0.00
2024-12-08 16:51:23,50,403,16,34,249.91,406.00,0.00
2024-12-08 16:51:23,51,403,16,35,245.01,406.02,0.00
2024-12-08 16:51:23,51,404,16,35,245.38,407.00,0.00
2024-12-08 16:51:23,52,404,17,35,240.66,407.02,0.00
2024-12-08 16:51:23,51,404,16,35,240.17,407.75,0.00
2024-12-08 16:51:23,51,405,16,35,247.33,408.00,0.00
2024-12-08 16:51:23,52,405,16,36,242.58,408.02,0.00
2024-12-08 16:51:23,51,405,16,35,246.95,408.10,0.00
2024-12-08 16:51:23,50,405,15,35,249.78,408.68,0.00
2024-12-08 16:51:23,50,406,15,35,253.63,409.00,0.00
2024-12-08 16:51:23,51,406,16,35,248.66,409.02,0.00
2024-12-08 16:51:23,51,407,16,35,248.86,410.00,0.00
2024-12-08 16:51:23,52,407,17,35,244.07,410.02,0.00
2024-12-08 16:51:23,51,407,17,34,246.94,410.10,0.00
2024-12-08 16:51:23,51,408,17,34,248.66,411.00,0.00
2024-12-08 16:51:23,52,408,18,34,243.88,411.02,0.00
2024-12-08 16:51:23,52,409,18,34,244.03,412.00,0.00
2024-12-08 16:51:23,53,409,18,35,239.42,412.02,0.00
2024-12-08 16:51:23,52,409,18,34,242.22,412.10,0.00
2024-12-08 16:51:23,52,410,18,34,243.82,413.00,0.00
2024-12-08 16:51:23,53,410,18,35,239.22,413.02,0.00
2024-12-08 16:51:23,52,410,17,35,238.36,413.42,0.00
2024-12-08 16:51:23,52,411,17,35,244.34,414.00,0.00
2024-12-08 16:51:23,53,411,18,35,239.73,414.02,0.00
2024-12-08 16:51:23,52,411,18,34,242.44,414.10,0.00
2024-12-08 16:51:23,52,412,18,34,244.05,415.00,0.00
2024-12-08 16:51:23,53,412,18,35,239.45,415.02,0.00
2024-12-08 16:51:23,53,413,18,35,239.64,416.00,0.00
2024-12-08 16:51:23,54,413,18,36,235.20,416.02,0.00
2024-12-08 16:51:23,53,413,18,35,237.85,416.09,0.00
2024-12-08 16:51:23,53,414,18,35,239.35,417.00,0.00
2024-12-08 16:51:23,54,414,18,36,234.92,417.02,0.00
2024-12-08 16:51:23,53,414,17,36,237.17,417.13,0.00
2024-12-08 16:51:23,53,415,17,36,241.98,418.00,0.00
2024-12-08 16:51:23,54,415,17,37,237.50,418.02,0.00
2024-12-08 16:51:23,53,415,17,36,240.02,418.11,0.00
2024-12-08 16:51:23,54,414,18,36,233.37,418.76,0.00
2024-12-08 16:51:23,54,415,18,36,238.22,419.00,0.00
2024-12-08 16:51:23,55,415,18,37,233.89,419.02,0.00
2024-12-08 16:51:23,55,416,18,37,241.76,420.00,0.00
2024-12-08 16:51:23,56,416,18,38,237.44,420.02,0.00
2024-12-08 16:51:23,55,416,18,37,239.86,420.11,0.00
2024-12-08 16:51:24,54,416,17,37,240.65,420.39,0.00
2024-12-08 16:51:24,54,417,17,37,246.30,421.00,0.00
2024-12-08 16:51:24,55,417,18,37,241.82,421.02,0.00
2024-12-08 16:51:24,55,418,18,37,241.94,422.00,0.00
2024-12-08 16:51:24,56,418,18,38,237.62,422.02,0.00
2024-12-08 16:51:24,55,418,18,37,240.11,422.11,0.00
2024-12-08 16:51:24,55,419,18,37,241.52,423.00,0.00
2024-12-08 16:51:24,56,419,18,38,237.20,423.02,0.00
2024-12-08 16:51:24,55,419,17,38,237.53,423.62,0.00
2024-12-08 16:51:24,55,420,17,38,243.89,424.00,0.00
2024-12-08 16:51:24,56,420,18,38,239.53,424.02,0.00
2024-12-08 16:51:24,55,420,17,38,243.81,424.02,0.00
2024-12-08 16:51:24,54,420,17,37,246.61,424.09,0.00
2024-12-08 16:51:24,54,421,17,37,248.04,425.00,0.00
2024-12-08 16:51:24,55,421,17,38,243.53,425.02,0.00
2024-12-08 16:51:24,55,422,17,38,243.56,426.00,0.00
2024-12-08 16:51:24,56,422,17,39,239.21,426.02,0.00
2024-12-08 16:51:24,55,422,17,38,241.87,426.09,0.00
2024-12-08 16:51:24,55,423,17,38,243.20,427.00,0.00
2024-12-08 16:51:24,56,423,18,38,238.86,427.02,0.00
2024-12-08 16:51:24,56,424,18,38,238.85,428.00,0.00
2024-12-08 16:51:24,57,424,19,38,234.66,428.02,0.00
2024-12-08 16:51:24,56,424,19,37,237.26,428.09,0.00
2024-12-08 16:51:24,55,424,18,37,237.27,428.45,0.00
2024-12-08 16:51:24,55,425,18,37,243.09,429.00,0.00
2024-12-08 16:51:24,56,425,18,38,238.75,429.02,0.00
2024-12-08 16:51:24,55,425,18,37,243.02,429.02,0.00
2024-12-08 16:51:24,55,426,18,37,243.07,430.00,0.00
2024-12-08 16:51:24,56,426,19,37,238.73,430.02,0.00
2024-12-08 16:51:24,55,426,19,36,242.99,430.02,0.00
2024-12-08 16:51:24,54,426,19,35,246.07,430.06,0.00
2024-12-08 16:51:24,53,426,18,35,248.64,430.53,0.00
2024-12-08 16:51:24,52,426,17,35,253.21,430.60,0.00
2024-12-08 16:51:24,52,427,17,35,260.06,431.00,0.00
2024-12-08 16:51:24,53,427,17,36,255.15,431.02,0.00
2024-12-08 16:51:24,52,427,17,35,259.98,431.02,0.00
2024-12-08 16:51:24,51,427,16,35,258.49,431.49,0.00
2024-12-08 16:51:24,51,428,16,35,265.13,432.00,0.00
2024-12-08 16:51:24,52,428,17,35,260.03,432.02,0.00
2024-12-08 16:51:24,51,428,17,34,263.78,432.04,0.00
2024-12-08 16:51:24,50,428,16,34,265.94,432.32,0.00
2024-12-08 16:51:24,50,429,16,34,272.14,433.00,0.00
2024-12-08 16:51:24,51,429,16,35,266.80,433.02,0.00
2024-12-08 16:51:24,51,430,16,35,266.58,434.00,0.00
2024-12-08 16:51:24,52,430,16,36,261.46,434.02,0.00
2024-12-08 16:51:24,51,430,16,35,265.31,434.04,0.00
2024-12-08 16:51:24,51,431,16,35,266.85,435.00,0.00
2024-12-08 16:51:24,52,431,16,36,261.72,435.02,0.00
2024-12-08 16:51:24,52,432,16,36,261.56,436.00,0.00
2024-12-08 16:51:24,53,432,17,36,256.62,436.02,0.00
2024-12-08 16:51:24,52,432,17,35,260.30,436.04,0.00
2024-12-08 16:51:24,52,433,17,35,261.74,437.00,0.00
2024-12-08 16:51:24,53,433,18,35,256.80,437.02,0.00
2024-12-08 16:51:24,52,433,17,35,256.50,437.77,0.00
2024-12-08 16:51:24,52,434,17,35,264.09,438.00,0.00
2024-12-08 16:51:24,53,434,17,36,259.11,438.02,0.00
2024-12-08 16:51:24,52,434,17,35,262.92,438.04,0.00
2024-12-08 16:51:24,52,435,17,35,264.36,439.00,0.00
2024-12-08 16:51:24,53,435,17,36,259.37,439.02,0.00
2024-12-08 16:51:24,52,435,16,36,262.92,439.02,0.00
2024-12-08 16:51:24,52,436,16,36,265.98,440.00,0.00
2024-12-08 16:51:24,53,436,17,36,260.96,440.02,0.00
2024-12-08 16:51:24,52,436,17,35,264.79,440.02,0.00
2024-12-08 16:51:24,52,437,17,35,266.16,441.00,0.00
2024-12-08 16:51:24,53,437,18,35,261.13,441.02,0.00
2024-12-08 16:51:24,52,437,17,35,264.14,441.08,0.00
2024-12-08 16:51:24,51,437,16,35,267.62,441.49,0.00
2024-12-08 16:51:24,51,438,16,35,271.28,442.00,0.00
2024-12-08 16:51:24,52,438,16,36,266.07,442.02,0.00
2024-12-08 16:51:24,51,438,16,35,269.98,442.02,0.00
2024-12-08 16:51:24,51,439,16,35,271.46,443.00,0.00
2024-12-08 16:51:24,52,439,16,36,266.24,443.02,0.00
2024-12-08 16:51:24,51,439,15,36,266.83,443.25,0.00
2024-12-08 16:51:24,51,440,15,36,272.74,444.00,0.00
2024-12-08 16:51:24,52,440,15,37,267.50,444.02,0.00
2024-12-08 16:51:24,51,440,15,36,271.44,444.02,0.00
2024-12-08 16:51:24,51,441,15,36,272.92,445.00,0.00
2024-12-08 16:51:24,52,441,15,37,267.67,445.02,0.00
2024-12-08 16:51:24,52,442,15,37,267.42,446.00,0.00
2024-12-08 16:51:24,53,442,15,38,262.37,446.02,0.00
2024-12-08 16:51:24,52,442,15,37,266.22,446.02,0.00
2024-12-08 16:51:24,51,442,14,37,266.46,446.92,0.00
2024-12-08 16:51:25,51,443,14,37,274.93,447.00,0.00
2024-12-08 16:51:25,52,443,15,37,269.65,447.02,0.00
2024-12-08 16:51:25,51,443,14,37,272.94,447.08,0.00
2024-12-08 16:51:25,51,444,14,37,274.86,448.00,0.00
2024-12-08 16:51:25,52,444,14,38,269.57,448.02,0.00
2024-12-08 16:51:25,51,444,14,37,273.54,448.02,0.00
2024-12-08 16:51:25,51,445,14,37,275.03,449.00,0.00
2024-12-08 16:51:25,52,445,14,38,269.74,449.02,0.00
2024-12-08 16:51:25,52,446,14,38,269.56,450.00,0.00
2024-12-08 16:51:25,53,446,14,39,264.48,450.02,0.00
2024-12-08 16:51:25,52,446,14,38,268.27,450.02,0.00
2024-12-08 16:51:25,52,447,14,38,269.64,451.00,0.00
2024-12-08 16:51:25,53,447,15,38,264.56,451.02,0.00
2024-12-08 16:51:25,53,448,15,38,264.39,452.00,0.00
2024-12-08 16:51:25,54,448,15,39,259.49,452.02,0.00
2024-12-08 16:51:25,53,448,15,38,263.19,452.02,0.00
2024-12-08 16:51:25,52,448,14,38,265.78,452.62,0.00
2024-12-08 16:51:25,52,449,14,38,269.56,453.00,0.00
2024-12-08 16:51:25,53,449,15,38,264.47,453.02,0.00
2024-12-08 16:51:25,52,449,14,38,265.12,453.27,0.00
2024-12-08 16:51:25,52,450,14,38,271.03,454.00,0.00
2024-12-08 16:51:25,53,450,14,39,265.91,454.02,0.00
2024-12-08 16:51:25,52,450,14,38,269.80,454.02,0.00
2024-12-08 16:51:25,52,451,14,38,271.19,455.00,0.00
2024-12-08 16:51:25,53,451,14,39,266.07,455.02,0.00
2024-12-08 16:51:25,52,451,13,39,267.09,455.60,0.00
2024-12-08 16:51:25,52,452,13,39,271.14,456.00,0.00
2024-12-08 16:51:25,53,452,13,40,266.03,456.02,0.00
2024-12-08 16:51:25,52,452,13,39,269.83,456.02,0.00
2024-12-08 16:51:25,51,452,12,39,269.78,456.92,0.00
2024-12-08 16:51:25,51,453,12,39,278.43,457.00,0.00
2024-12-08 16:51:25,52,453,12,40,273.08,457.02,0.00
2024-12-08 16:51:25,51,453,11,40,274.56,457.22,0.00
2024-12-08 16:51:25,51,454,11,40,280.48,458.00,0.00
2024-12-08 16:51:25,52,454,12,40,275.09,458.02,0.00
2024-12-08 16:51:25,51,454,12,39,279.04,458.02,0.00
2024-12-08 16:51:25,50,454,11,39,284.61,458.02,0.00
2024-12-08 16:51:25,49,454,10,39,285.78,458.47,0.00
2024-12-08 16:51:25,49,455,10,39,293.11,459.00,0.00
2024-12-08 16:51:25,50,455,10,40,287.25,459.02,0.00
2024-12-08 16:51:25,50,456,10,40,287.08,460.00,0.00
2024-12-08 16:51:25,51,456,10,41,281.45,460.02,0.00
2024-12-08 16:51:25,50,456,10,40,285.61,460.02,0.00
2024-12-08 16:51:25,49,456,9,40,289.11,460.59,0.00
2024-12-08 16:51:25,49,457,9,40,293.19,461.00,0.00
2024-12-08 16:51:25,50,457,9,41,287.33,461.02,0.00
2024-12-08 16:51:25,49,457,8,41,288.78,461.63,0.00
2024-12-08 16:51:25,49,458,8,41,293.19,462.00,0.00
2024-12-08 16:51:25,50,458,9,41,287.33,462.02,0.00
2024-12-08 16:51:25,49,458,9,40,291.59,462.02,0.00
2024-12-08 16:51:25,49,459,9,40,293.35,463.00,0.00
2024-12-08 16:51:25,50,459,10,40,287.48,463.02,0.00
2024-12-08 16:51:25,50,460,10,40,287.40,464.00,0.00
2024-12-08 16:51:25,51,460,11,40,281.76,464.02,0.00
2024-12-08 16:51:25,50,460,11,39,285.82,464.02,0.00
2024-12-08 16:51:25,50,461,11,39,287.46,465.00,0.00
2024-12-08 16:51:25,51,461,11,40,281.82,465.02,0.00
2024-12-08 16:51:25,50,461,10,40,280.41,465.52,0.00
2024-12-08 16:51:25,50,462,10,40,287.86,466.00,0.00
2024-12-08 16:51:25,51,462,11,40,282.21,466.02,0.00
2024-12-08 16:51:25,50,462,11,39,286.37,466.02,0.00
2024-12-08 16:51:25,50,463,11,39,288.01,467.00,0.00
2024-12-08 16:51:25,51,463,11,40,282.36,467.02,0.00
2024-12-08 16:51:25,50,463,10,40,283.40,467.22,0.00
2024-12-08 16:51:25,50,464,10,40,289.64,468.00,0.00
2024-12-08 16:51:25,51,464,10,41,283.96,468.02,0.00
2024-12-08 16:51:25,50,464,9,41,287.59,468.06,0.00
2024-12-08 16:51:25,49,464,8,41,291.35,468.24,0.00
2024-12-08 16:51:25,49,465,8,41,297.90,469.00,0.00
2024-12-08 16:51:25,50,465,8,42,291.95,469.02,0.00
2024-12-08 16:51:25,49,465,8,41,296.95,469.02,0.00
2024-12-08 16:51:25,49,466,8,41,298.73,470.00,0.00
2024-12-08 16:51:25,50,466,9,41,292.76,470.02,0.00
2024-12-08 16:51:25,49,466,8,41,292.70,470.78,0.00
2024-12-08 16:51:25,49,467,8,41,301.42,471.00,0.00
2024-12-08 16:51:25,50,467,9,41,295.40,471.02,0.00
2024-12-08 16:51:25,49,467,9,40,299.89,471.02,0.00
2024-12-08 16:51:25,49,468,9,40,301.68,472.00,0.00
2024-12-08 16:51:25,50,468,10,40,295.64,472.02,0.00
2024-12-08 16:51:25,50,469,10,40,295.42,473.00,0.00
2024-12-08 16:51:25,51,469,10,41,289.63,473.02,0.00
2024-12-08 16:51:25,50,469,10,40,293.91,473.02,0.00
2024-12-08 16:51:26,49,469,9,40,294.33,473.96,0.00
2024-12-08 16:51:26,49,470,9,40,303.83,474.00,0.00
2024-12-08 16:51:26,50,470,10,40,297.75,474.02,0.00
2024-12-08 16:51:26,50,471,10,40,297.59,475.00,0.00
2024-12-08 16:51:26,51,471,11,40,291.75,475.02,0.00
2024-12-08 16:51:26,50,471,11,39,295.88,475.02,0.00
2024-12-08 16:51:26,50,472,11,39,297.55,476.00,0.00
2024-12-08 16:51:26,51,472,11,40,291.72,476.02,0.00
2024-12-08 16:51:26,50,472,10,40,293.09,476.24,0.00
2024-12-08 16:51:26,50,473,10,40,299.53,477.00,0.00
2024-12-08 16:51:26,51,473,11,40,293.65,477.02,0.00
2024-12-08 16:51:26,50,473,11,39,297.90,477.02,0.00
2024-12-08 16:51:26,50,474,11,39,299.58,478.00,0.00
2024-12-08 16:51:26,51,474,11,40,293.71,478.02,0.00
2024-12-08 16:51:26,50,474,10,40,294.08,478.74,0.00
2024-12-08 16:51:26,50,475,10,40,302.60,479.00,0.00
2024-12-08 16:51:26,51,475,11,40,296.67,479.02,0.00
2024-12-08 16:51:26,50,475,11,39,300.97,479.02,0.00
2024-12-08 16:51:26,50,476,11,39,302.66,480.00,0.00
2024-12-08 16:51:26,51,476,12,39,296.72,480.02,0.00
2024-12-08 16:51:26,51,477,12,39,296.40,481.00,0.00
2024-12-08 16:51:26,52,477,13,39,290.70,481.02,0.00
2024-12-08 16:51:26,51,477,13,38,294.71,481.04,0.00
2024-12-08 16:51:26,51,478,13,38,296.35,482.00,0.00
2024-12-08 16:51:26,52,478,13,39,290.65,482.02,0.00
2024-12-08 16:51:26,51,478,12,39,290.31,482.41,0.00
2024-12-08 16:51:26,51,479,12,39,297.35,483.00,0.00
2024-12-08 16:51:26,52,479,12,40,291.63,483.02,0.00
2024-12-08 16:51:26,51,479,12,39,295.74,483.04,0.00
2024-12-08 16:51:26,50,479,11,39,295.24,483.64,0.00
2024-12-08 16:51:26,50,480,11,39,303.44,484.00,0.00
2024-12-08 16:51:26,51,480,11,40,297.49,484.02,0.00
2024-12-08 16:51:26,51,481,11,40,297.15,485.00,0.00
2024-12-08 16:51:26,52,481,11,41,291.44,485.02,0.00
2024-12-08 16:51:26,51,481,11,40,295.64,485.04,0.00
2024-12-08 16:51:26,51,482,11,40,297.29,486.00,0.00
2024-12-08 16:51:26,52,482,11,41,291.57,486.02,0.00
2024-12-08 16:51:26,52,483,11,41,291.14,487.00,0.00
2024-12-08 16:51:26,53,483,11,42,285.65,487.02,0.00
2024-12-08 16:51:26,52,483,11,41,289.74,487.04,0.00
2024-12-08 16:51:26,52,484,11,41,291.27,488.00,0.00
2024-12-08 16:51:26,53,484,11,42,285.77,488.02,0.00
2024-12-08 16:51:26,53,485,11,42,285.40,489.00,0.00
2024-12-08 16:51:26,54,485,12,42,280.12,489.02,0.00
2024-12-08 16:51:26,53,485,12,41,284.02,489.04,0.00
2024-12-08 16:51:26,52,485,11,41,283.33,489.60,0.00
2024-12-08 16:51:26,52,486,11,41,291.05,490.00,0.00
2024-12-08 16:51:26,53,486,11,42,285.56,490.02,0.00
2024-12-08 16:51:26,53,487,11,42,285.03,491.00,0.00
2024-12-08 16:51:26,54,487,12,42,279.75,491.02,0.00
2024-12-08 16:51:26,53,487,12,41,284.47,491.02,0.00
2024-12-08 16:51:26,53,488,12,41,285.80,492.00,0.00
2024-12-08 16:51:26,54,488,13,41,280.50,492.02,0.00
2024-12-08 16:51:26,54,489,13,41,280.00,493.00,0.00
2024-12-08 16:51:26,55,489,13,42,274.91,493.02,0.00
2024-12-08 16:51:26,54,489,13,41,279.00,493.02,0.00
2024-12-08 16:51:26,54,490,13,41,280.21,494.00,0.00
2024-12-08 16:51:26,55,490,13,42,275.11,494.02,0.00
2024-12-08 16:51:26,54,490,12,42,275.33,494.67,0.00
2024-12-08 16:51:26,54,491,12,42,283.06,495.00,0.00
2024-12-08 16:51:26,55,491,13,42,277.92,495.02,0.00
2024-12-08 16:51:26,54,491,13,41,282.06,495.02,0.00
2024-12-08 16:51:26,53,491,12,41,284.18,495.68,0.00
2024-12-08 16:51:26,53,492,12,41,292.17,496.00,0.00
2024-12-08 16:51:26,54,492,13,41,286.76,496.02,0.00
2024-12-08 16:51:26,53,492,12,41,286.43,496.74,0.00
2024-12-08 16:51:26,53,493,12,41,294.70,497.00,0.00
2024-12-08 16:51:26,54,493,13,41,289.24,497.02,0.00
2024-12-08 16:51:26,53,493,13,40,293.76,497.02,0.00
2024-12-08 16:51:26,53,494,13,40,295.11,498.00,0.00
2024-12-08 16:51:26,54,494,13,41,289.64,498.02,0.00
2024-12-08 16:51:26,54,495,13,41,289.02,499.00,0.00
2024-12-08 16:51:26,55,495,13,42,283.77,499.02,0.00
2024-12-08 16:51:26,54,495,13,41,288.01,499.02,0.00
2024-12-08 16:51:26,53,495,12,41,287.59,499.96,0.00
2024-12-08 16:51:26,53,496,12,41,296.86,500.00,0.00
2024-12-08 16:51:26,54,496,12,42,291.36,500.02,0.00
2024-12-08 16:51:26,53,496,11,42,290.42,500.83,0.00
2024-12-08 16:51:26,53,497,11,42,299.15,501.00,0.00
2024-12-08 16:51:26,54,497,11,43,293.61,501.02,0.00
2024-12-08 16:51:26,53,497,11,42,298.11,501.02,0.00
2024-12-08 16:51:26,52,497,10,42,297.04,501.67,0.00
2024-12-08 16:51:27,52,498,10,42,305.32,502.00,0.00
2024-12-08 16:51:27,53,498,11,42,299.56,502.02,0.00
2024-12-08 16:51:27,52,498,10,42,296.84,502.65,0.00
2024-12-08 16:51:27,52,499,10,42,305.06,503.00,0.00
2024-12-08 16:51:27,53,499,10,43,299.30,503.02,0.00
2024-12-08 16:51:27,52,499,10,42,304.00,503.02,0.00
2024-12-08 16:51:27,52,500,10,42,305.47,504.00,0.00
2024-12-08 16:51:27,53,500,10,43,299.71,504.02,0.00
2024-12-08 16:51:27,53,501,10,43,299.16,505.00,0.00
2024-12-08 16:51:27,54,501,10,44,293.62,505.02,0.00
2024-12-08 16:51:27,53,501,10,43,298.21,505.02,0.00
2024-12-08 16:51:27,53,502,10,43,299.56,506.00,0.00
2024-12-08 16:51:27,54,502,11,43,294.01,506.02,0.00
2024-12-08 16:51:27,54,503,11,43,293.37,507.00,0.00
2024-12-08 16:51:27,55,503,11,44,288.04,507.02,0.00
2024-12-08 16:51:27,54,503,11,43,292.53,507.02,0.00
2024-12-08 16:51:27,54,504,11,43,293.76,508.00,0.00
2024-12-08 16:51:27,55,504,12,43,288.42,508.02,0.00
2024-12-08 16:51:27,54,504,11,43,287.32,508.81,0.00
2024-12-08 16:51:27,54,505,11,43,295.95,509.00,0.00
2024-12-08 16:51:27,55,505,11,44,290.56,509.02,0.00
2024-12-08 16:51:27,54,505,11,43,295.00,509.02,0.00
2024-12-08 16:51:27,54,506,11,43,296.24,510.00,0.00
2024-12-08 16:51:27,55,506,12,43,290.86,510.02,0.00
2024-12-08 16:51:27,55,507,12,43,290.13,511.00,0.00
2024-12-08 16:51:27,56,507,13,43,284.95,511.02,0.00
2024-12-08 16:51:27,55,507,13,42,289.29,511.02,0.00
2024-12-08 16:51:27,55,508,13,42,290.42,512.00,0.00
2024-12-08 16:51:27,56,508,14,42,285.23,512.02,0.00
2024-12-08 16:51:27,56,509,14,42,284.56,513.00,0.00
2024-12-08 16:51:27,57,509,15,42,279.57,513.02,0.00
2024-12-08 16:51:27,56,509,15,41,283.65,513.02,0.00
2024-12-08 16:51:27,55,509,14,41,285.76,513.67,0.00
2024-12-08 16:51:27,55,510,14,41,289.93,514.00,0.00
2024-12-08 16:51:27,56,510,15,41,284.75,514.02,0.00
2024-12-08 16:51:27,55,510,14,41,287.35,514.16,0.00
2024-12-08 16:51:27,55,511,14,41,289.26,515.00,0.00
2024-12-08 16:51:27,56,511,14,42,284.10,515.02,0.00
2024-12-08 16:51:27,55,511,14,41,288.42,515.02,0.00
2024-12-08 16:51:27,55,512,14,41,289.54,516.00,0.00
2024-12-08 16:51:27,56,512,14,42,284.37,516.02,0.00
2024-12-08 16:51:27,56,513,14,42,283.55,517.00,0.00
2024-12-08 16:51:27,57,513,14,43,278.58,517.02,0.00
2024-12-08 16:51:27,56,513,14,42,282.81,517.02,0.00
2024-12-08 16:51:27,55,513,13,42,284.78,517.36,0.00
2024-12-08 16:51:27,55,514,13,42,291.32,518.00,0.00
2024-12-08 16:51:27,56,514,13,43,286.12,518.02,0.00
2024-12-08 16:51:27,55,514,12,43,286.48,518.35,0.00
2024-12-08 16:51:27,55,515,12,43,292.95,519.00,0.00
2024-12-08 16:51:27,56,515,12,44,287.72,519.02,0.00
2024-12-08 16:51:27,55,515,12,43,292.29,519.02,0.00
2024-12-08 16:51:27,55,516,12,43,293.42,520.00,0.00
2024-12-08 16:51:27,56,516,13,43,288.18,520.02,0.00
2024-12-08 16:51:27,55,516,12,43,288.53,520.35,0.00
2024-12-08 16:51:27,55,517,12,43,295.03,521.00,0.00
2024-12-08 16:51:27,56,517,13,43,289.76,521.02,0.00
2024-12-08 16:51:27,55,517,13,42,294.46,521.02,0.00
2024-12-08 16:51:27,55,518,13,42,295.60,522.00,0.00
2024-12-08 16:51:27,56,518,14,42,290.32,522.02,0.00
2024-12-08 16:51:27,56,519,14,42,289.47,523.00,0.00
2024-12-08 16:51:27,57,519,14,43,284.39,523.02,0.00
2024-12-08 16:51:27,56,519,14,42,288.91,523.02,0.00
2024-12-08 16:51:27,55,519,13,42,291.25,523.64,0.00
2024-12-08 16:51:27,55,520,13,42,295.30,524.00,0.00
2024-12-08 16:51:27,56,520,13,43,290.03,524.02,0.00
2024-12-08 16:51:27,56,521,13,43,289.17,525.00,0.00
2024-12-08 16:51:27,57,521,13,44,284.10,525.02,0.00
2024-12-08 16:51:27,56,521,13,43,288.70,525.02,0.00
2024-12-08 16:51:27,55,521,12,43,293.15,525.18,0.00
2024-12-08 16:51:27,54,521,11,43,295.03,525.78,0.00
2024-12-08 16:51:27,54,522,11,43,303.77,526.00,0.00
2024-12-08 16:51:27,55,522,11,44,298.24,526.02,0.00
2024-12-08 16:51:27,54,522,10,44,297.63,526.76,0.00
2024-12-08 16:51:27,54,523,10,44,306.31,527.00,0.00
2024-12-08 16:51:27,55,523,11,44,300.74,527.02,0.00
2024-12-08 16:51:27,54,523,11,43,305.92,527.02,0.00
2024-12-08 16:51:27,54,524,11,43,307.18,528.00,0.00
2024-12-08 16:51:27,55,524,12,43,301.60,528.02,0.00
2024-12-08 16:51:27,54,524,11,43,301.42,528.72,0.00
2024-12-08 16:51:27,54,525,11,43,309.95,529.00,0.00
2024-12-08 16:51:27,55,525,12,43,304.32,529.02,0.00
2024-12-08 16:51:27,54,525,12,42,309.56,529.02,0.00
2024-12-08 16:51:27,53,525,11,42,312.25,529.68,0.00
2024-12-08 16:51:27,53,526,11,42,316.80,530.00,0.00
2024-12-08 16:51:27,54,526,11,43,310.93,530.02,0.00
2024-12-08 16:51:28,54,527,11,43,310.24,531.00,0.00
2024-12-08 16:51:28,55,527,12,43,304.60,531.02,0.00
2024-12-08 16:51:28,54,527,12,42,309.85,531.02,0.00
2024-12-08 16:51:28,53,527,11,42,310.92,531.81,0.00
2024-12-08 16:51:28,53,528,11,42,320.10,532.00,0.00
2024-12-08 16:51:28,54,528,12,42,314.18,532.02,0.00
2024-12-08 16:51:28,54,529,12,42,313.48,533.00,0.00
2024-12-08 16:51:28,55,529,12,43,307.78,533.02,0.00
2024-12-08 16:51:28,54,529,12,42,313.19,533.02,0.00
2024-12-08 16:51:28,54,530,12,42,314.47,534.00,0.00
2024-12-08 16:51:28,55,530,12,43,308.75,534.02,0.00
2024-12-08 16:51:28,54,530,11,43,305.48,534.65,0.00
2024-12-08 16:51:28,54,531,11,43,313.77,535.00,0.00
2024-12-08 16:51:28,55,531,12,43,308.06,535.02,0.00
2024-12-08 16:51:28,54,531,12,42,313.57,535.02,0.00
2024-12-08 16:51:28,54,532,12,42,314.85,536.00,0.00
2024-12-08 16:51:28,55,532,12,43,309.13,536.02,0.00
2024-12-08 16:51:28,55,533,12,43,308.34,537.00,0.00
2024-12-08 16:51:28,56,533,13,43,302.83,537.02,0.00
2024-12-08 16:51:28,55,533,13,42,308.24,537.02,0.00
2024-12-08 16:51:28,55,534,13,42,309.40,538.00,0.00
2024-12-08 16:51:28,56,534,14,42,303.87,538.02,0.00
2024-12-08 16:51:28,56,535,14,42,302.99,539.00,0.00
2024-12-08 16:51:28,57,535,14,43,297.68,539.02,0.00
2024-12-08 16:51:28,56,535,14,42,302.90,539.02,0.00
2024-12-08 16:51:28,55,535,13,42,302.80,539.89,0.00
2024-12-08 16:51:28,55,536,13,42,312.12,540.00,0.00
2024-12-08 16:51:28,56,536,14,42,306.55,540.02,0.00
2024-12-08 16:51:28,55,536,14,41,310.06,540.02,0.00
2024-12-08 16:51:28,55,537,14,41,311.22,541.00,0.00
2024-12-08 16:51:28,56,537,15,41,305.66,541.02,0.00
2024-12-08 16:51:28,55,537,15,40,309.16,541.02,0.00
2024-12-08 16:51:28,54,537,14,40,308.82,541.56,0.00
2024-12-08 16:51:28,54,538,14,40,316.77,542.00,0.00
2024-12-08 16:51:28,55,538,15,40,311.01,542.02,0.00
2024-12-08 16:51:28,54,538,14,40,309.86,542.50,0.00
2024-12-08 16:51:28,54,539,14,40,317.55,543.00,0.00
2024-12-08 16:51:28,55,539,15,40,311.78,543.02,0.00
2024-12-08 16:51:28,54,539,15,39,317.25,543.02,0.00
2024-12-08 16:51:28,54,540,15,39,318.54,544.00,0.00
2024-12-08 16:51:28,55,540,15,40,312.75,544.02,0.00
2024-12-08 16:51:28,55,541,15,40,311.94,545.00,0.00
2024-12-08 16:51:28,56,541,15,41,306.37,545.02,0.00
2024-12-08 16:51:28,55,541,15,40,311.64,545.02,0.00
2024-12-08 16:51:28,54,541,14,40,315.48,545.26,0.00
2024-12-08 16:51:28,54,542,14,40,322.04,546.00,0.00
2024-12-08 16:51:28,55,542,15,40,316.18,546.02,0.00
2024-12-08 16:51:28,55,543,15,40,315.37,547.00,0.00
2024-12-08 16:51:28,56,543,16,40,309.74,547.02,0.00
2024-12-08 16:51:28,55,543,16,39,314.98,547.04,0.00
2024-12-08 16:51:28,54,543,15,39,317.60,547.67,0.00
2024-12-08 16:51:28,55,542,16,39,306.55,547.96,0.00
2024-12-08 16:51:28,55,543,16,39,316.54,548.00,0.00
2024-12-08 16:51:28,56,543,16,40,310.89,548.02,0.00
2024-12-08 16:51:28,56,544,16,40,319.79,549.00,0.00
2024-12-08 16:51:28,57,544,17,40,314.18,549.02,0.00
2024-12-08 16:51:28,56,544,17,39,319.21,549.04,0.00
2024-12-08 16:51:28,55,544,16,39,319.26,549.53,0.00
2024-12-08 16:51:28,54,544,15,39,324.73,549.63,0.00
2024-12-08 16:51:28,53,544,14,39,330.75,549.64,0.00
2024-12-08 16:51:28,53,545,14,39,339.44,550.00,0.00
2024-12-08 16:51:28,54,545,14,40,333.16,550.02,0.00
2024-12-08 16:51:28,54,546,14,40,332.44,551.00,0.00
2024-12-08 16:51:28,55,546,14,41,326.39,551.02,0.00
2024-12-08 16:51:28,54,546,14,40,331.73,551.04,0.00
2024-12-08 16:51:28,53,546,13,40,334.86,551.64,0.00
2024-12-08 16:51:28,53,547,13,40,339.43,552.00,0.00
2024-12-08 16:51:28,54,547,13,41,333.14,552.02,0.00
2024-12-08 16:51:28,54,548,13,41,332.41,553.00,0.00
2024-12-08 16:51:28,55,548,13,42,326.37,553.02,0.00
2024-12-08 16:51:28,54,548,13,41,331.70,553.04,0.00
2024-12-08 16:51:28,53,548,12,41,334.52,553.66,0.00
2024-12-08 16:51:28,53,549,12,41,343.38,554.00,0.00
2024-12-08 16:51:28,54,549,13,41,337.02,554.02,0.00
2024-12-08 16:51:28,54,550,13,41,336.29,555.00,0.00
2024-12-08 16:51:28,55,550,14,41,330.17,555.02,0.00
2024-12-08 16:51:28,54,550,14,40,335.37,555.04,0.00
2024-12-08 16:51:28,54,551,14,40,336.79,556.00,0.00
2024-12-08 16:51:28,55,551,14,41,330.67,556.02,0.00
2024-12-08 16:51:28,54,551,13,41,329.57,556.48,0.00
2024-12-08 16:51:28,54,552,13,41,337.40,557.00,0.00
2024-12-08 16:51:28,55,552,14,41,331.26,557.02,0.00
2024-12-08 16:51:28,54,552,14,40,336.57,557.04,0.00
2024-12-08 16:51:29,54,553,14,40,338.00,558.00,0.00
2024-12-08 16:51:29,55,553,14,41,331.86,558.02,0.00
2024-12-08 16:51:29,54,553,13,41,331.96,558.70,0.00
2024-12-08 16:51:29,54,554,13,41,340.89,559.00,0.00
2024-12-08 16:51:29,55,554,14,41,334.69,559.02,0.00
2024-12-08 16:51:29,54,554,14,40,340.16,559.04,0.00
2024-12-08 16:51:29,54,555,14,40,341.60,560.00,0.00
2024-12-08 16:51:29,55,555,14,41,335.39,560.02,0.00
2024-12-08 16:51:29,55,556,14,41,334.56,561.00,0.00
2024-12-08 16:51:29,56,556,14,42,328.59,561.02,0.00
2024-12-08 16:51:29,55,556,14,41,333.95,561.04,0.00
2024-12-08 16:51:29,55,557,14,41,335.26,562.00,0.00
2024-12-08 16:51:29,56,557,14,42,329.27,562.02,0.00
2024-12-08 16:51:29,56,558,14,42,328.35,563.00,0.00
2024-12-08 16:51:29,57,558,15,42,322.59,563.02,0.00
2024-12-08 16:51:29,56,558,15,41,327.85,563.04,0.00
2024-12-08 16:51:29,56,559,15,41,329.03,564.00,0.00
2024-12-08 16:51:29,57,559,16,41,323.26,564.02,0.00
2024-12-08 16:51:29,57,560,16,41,322.25,565.00,0.00
2024-12-08 16:51:29,58,560,17,41,316.69,565.02,0.00
2024-12-08 16:51:29,57,560,17,40,321.85,565.04,0.00
2024-12-08 16:51:29,57,561,17,40,322.92,566.00,0.00
2024-12-08 16:51:29,58,561,17,41,317.35,566.02,0.00
2024-12-08 16:51:29,57,561,16,41,315.81,566.82,0.00
2024-12-08 16:51:29,57,562,16,41,324.88,567.00,0.00
2024-12-08 16:51:29,58,562,17,41,319.28,567.02,0.00
2024-12-08 16:51:29,57,562,17,40,324.58,567.04,0.00
2024-12-08 16:51:29,57,563,17,40,325.65,568.00,0.00
2024-12-08 16:51:29,58,563,17,41,320.04,568.02,0.00
2024-12-08 16:51:29,57,563,17,40,325.55,568.02,0.00
2024-12-08 16:51:29,57,564,17,40,324.53,569.00,0.00
2024-12-08 16:51:29,58,564,18,40,318.93,569.02,0.00
2024-12-08 16:51:29,57,564,18,39,324.33,569.02,0.00
2024-12-08 16:51:29,56,564,17,39,324.02,569.91,0.00
2024-12-08 16:51:29,56,565,17,39,333.76,570.00,0.00
2024-12-08 16:51:29,57,565,17,40,327.90,570.02,0.00
2024-12-08 16:51:29,56,565,16,40,324.22,570.68,0.00
2024-12-08 16:51:29,56,566,16,40,332.81,571.00,0.00
2024-12-08 16:51:29,57,566,16,41,326.97,571.02,0.00
2024-12-08 16:51:29,56,566,16,40,332.51,571.02,0.00
2024-12-08 16:51:29,55,566,15,40,332.66,571.53,0.00
2024-12-08 16:51:29,55,567,15,40,340.70,572.00,0.00
2024-12-08 16:51:29,56,567,16,40,334.62,572.02,0.00
2024-12-08 16:51:29,56,568,16,40,333.67,573.00,0.00
2024-12-08 16:51:29,57,568,17,40,327.82,573.02,0.00
2024-12-08 16:51:29,56,568,17,39,333.47,573.02,0.00
2024-12-08 16:51:29,55,568,16,39,333.95,573.85,0.00
2024-12-08 16:51:29,55,569,16,39,343.67,574.00,0.00
2024-12-08 16:51:29,56,569,16,40,337.53,574.02,0.00
2024-12-08 16:51:29,56,570,16,40,336.58,575.00,0.00
2024-12-08 16:51:29,57,570,16,41,330.68,575.02,0.00
2024-12-08 16:51:29,56,570,16,40,336.07,575.04,0.00
2024-12-08 16:51:29,55,570,15,40,338.77,575.69,0.00
2024-12-08 16:51:29,54,570,14,40,344.22,575.76,0.00
2024-12-08 16:51:29,54,571,14,40,353.71,576.00,0.00
2024-12-08 16:51:29,55,571,15,40,347.28,576.02,0.00
2024-12-08 16:51:29,55,572,15,40,346.41,577.00,0.00
2024-12-08 16:51:29,56,572,15,41,340.22,577.02,0.00
2024-12-08 16:51:29,55,572,15,40,345.99,577.04,0.00
2024-12-08 16:51:29,54,572,14,40,348.80,577.70,0.00
2024-12-08 16:51:29,54,573,14,40,353.76,578.00,0.00
2024-12-08 16:51:29,55,573,15,40,347.33,578.02,0.00
2024-12-08 16:51:29,55,574,15,40,346.45,579.00,0.00
2024-12-08 16:51:29,56,574,15,41,340.27,579.02,0.00
2024-12-08 16:51:29,55,574,15,40,346.14,579.04,0.00
2024-12-08 16:51:29,55,575,15,40,347.47,580.00,0.00
2024-12-08 16:51:29,56,575,15,41,341.27,580.02,0.00
2024-12-08 16:51:29,55,575,14,41,339.68,580.53,0.00
2024-12-08 16:51:29,55,576,14,41,347.86,581.00,0.00
2024-12-08 16:51:29,56,576,15,41,341.65,581.02,0.00
2024-12-08 16:51:29,55,576,15,40,347.65,581.04,0.00
2024-12-08 16:51:29,55,577,15,40,348.99,582.00,0.00
2024-12-08 16:51:29,56,577,15,41,342.76,582.02,0.00
2024-12-08 16:51:29,56,578,15,41,341.78,583.00,0.00
2024-12-08 16:51:29,57,578,15,42,335.79,583.02,0.00
2024-12-08 16:51:29,56,578,15,41,341.58,583.04,0.00
2024-12-08 16:51:29,56,579,15,41,342.79,584.00,0.00
2024-12-08 16:51:29,57,579,16,41,336.77,584.02,0.00
2024-12-08 16:51:29,56,579,16,40,340.49,584.04,0.00
2024-12-08 16:51:29,56,580,16,40,341.70,585.00,0.00
2024-12-08 16:51:29,57,580,17,40,335.71,585.02,0.00
2024-12-08 16:51:29,56,580,17,39,339.41,585.04,0.00
2024-12-08 16:51:30,56,581,17,39,340.61,586.00,0.00
2024-12-08 16:51:30,57,581,17,40,334.64,586.02,0.00
2024-12-08 16:51:30,57,582,17,40,333.56,587.00,0.00
2024-12-08 16:51:30,58,582,17,41,327.81,587.02,0.00
2024-12-08 16:51:30,57,582,17,40,333.36,587.04,0.00
2024-12-08 16:51:30,56,582,16,40,332.52,587.96,0.00
2024-12-08 16:51:30,56,583,16,40,342.82,588.00,0.00
2024-12-08 16:51:30,57,583,17,40,336.81,588.02,0.00
2024-12-08 16:51:30,56,583,16,40,333.46,588.63,0.00
2024-12-08 16:51:30,56,584,16,40,342.04,589.00,0.00
2024-12-08 16:51:30,57,584,17,40,336.04,589.02,0.00
2024-12-08 16:51:30,56,584,17,39,341.83,589.04,0.00
2024-12-08 16:51:30,56,585,17,39,343.04,590.00,0.00
2024-12-08 16:51:30,57,585,17,40,337.02,590.02,0.00
2024-12-08 16:51:30,56,585,16,40,335.67,590.82,0.00
2024-12-08 16:51:30,56,586,16,40,345.31,591.00,0.00
2024-12-08 16:51:30,57,586,16,41,339.25,591.02,0.00
2024-12-08 16:51:30,56,586,16,40,344.68,591.04,0.00
2024-12-08 16:51:30,56,587,16,40,345.90,592.00,0.00
2024-12-08 16:51:30,57,587,16,41,339.83,592.02,0.00
2024-12-08 16:51:30,56,587,15,41,340.00,592.70,0.00
2024-12-08 16:51:30,56,588,15,41,349.02,593.00,0.00
2024-12-08 16:51:30,57,588,16,41,342.90,593.02,0.00
2024-12-08 16:51:30,56,588,16,40,348.49,593.04,0.00
2024-12-08 16:51:30,55,588,15,40,350.58,593.75,0.00
2024-12-08 16:51:30,55,589,15,40,360.07,594.00,0.00
2024-12-08 16:51:30,56,589,16,40,353.64,594.02,0.00
2024-12-08 16:51:30,56,590,16,40,352.64,595.00,0.00
2024-12-08 16:51:30,57,590,16,41,346.46,595.02,0.00
2024-12-08 16:51:30,56,590,15,41,352.54,595.02,0.00
2024-12-08 16:51:30,55,590,15,40,358.62,595.02,0.00
2024-12-08 16:51:30,54,590,14,40,357.44,595.67,0.00
2024-12-08 16:51:30,54,591,14,40,366.76,596.00,0.00
2024-12-08 16:51:30,55,591,14,41,360.09,596.02,0.00
2024-12-08 16:51:30,55,592,14,41,359.18,597.00,0.00
2024-12-08 16:51:30,56,592,14,42,352.76,597.02,0.00
2024-12-08 16:51:30,55,592,14,41,358.96,597.02,0.00
2024-12-08 16:51:30,54,592,13,41,359.78,597.85,0.00
2024-12-08 16:51:30,54,593,13,41,370.10,598.00,0.00
2024-12-08 16:51:30,55,593,13,42,363.37,598.02,0.00
2024-12-08 16:51:30,55,594,13,42,362.45,599.00,0.00
2024-12-08 16:51:30,56,594,14,42,355.98,599.02,0.00
2024-12-08 16:51:30,55,594,14,41,362.34,599.02,0.00
2024-12-08 16:51:30,54,594,13,41,362.96,599.54,0.00
2024-12-08 16:51:30,54,595,13,41,371.67,600.00,0.00
2024-12-08 16:51:30,55,595,14,41,364.91,600.02,0.00
2024-12-08 16:51:30,55,596,14,41,363.99,601.00,0.00
2024-12-08 16:51:30,56,596,14,42,357.49,601.02,0.00
2024-12-08 16:51:30,55,596,14,41,363.66,601.02,0.00
2024-12-08 16:51:30,55,597,14,41,364.92,602.00,0.00
2024-12-08 16:51:30,56,597,15,41,358.40,602.02,0.00
2024-12-08 16:51:30,55,597,14,41,354.74,602.67,0.00
2024-12-08 16:51:30,55,598,14,41,363.99,603.00,0.00
2024-12-08 16:51:30,56,598,15,41,357.49,603.02,0.00
2024-12-08 16:51:30,55,598,15,40,363.77,603.02,0.00
2024-12-08 16:51:30,55,599,15,40,365.04,604.00,0.00
2024-12-08 16:51:30,56,599,15,41,358.52,604.02,0.00
2024-12-08 16:51:30,56,600,15,41,357.49,605.00,0.00
2024-12-08 16:51:30,57,600,15,42,351.22,605.02,0.00
2024-12-08 16:51:30,56,600,15,41,357.38,605.02,0.00
2024-12-08 16:51:30,55,600,14,41,356.75,605.96,0.00
2024-12-08 16:51:30,55,601,14,41,367.57,606.00,0.00
2024-12-08 16:51:30,56,601,15,41,361.00,606.02,0.00
2024-12-08 16:51:30,55,601,15,40,365.25,606.02,0.00
2024-12-08 16:51:30,55,602,15,40,366.52,607.00,0.00
2024-12-08 16:51:30,56,602,15,41,359.97,607.02,0.00
2024-12-08 16:51:30,55,602,14,41,359.82,607.15,0.00
2024-12-08 16:51:30,55,603,14,41,366.24,608.00,0.00
2024-12-08 16:51:30,56,603,14,42,359.70,608.02,0.00
2024-12-08 16:51:30,55,603,14,41,365.91,608.02,0.00
2024-12-08 16:51:30,55,604,14,41,367.17,609.00,0.00
2024-12-08 16:51:30,56,604,15,41,360.61,609.02,0.00
2024-12-08 16:51:30,55,604,14,41,361.21,609.09,0.00
2024-12-08 16:51:30,55,605,14,41,367.33,610.00,0.00
2024-12-08 16:51:30,56,605,15,41,360.77,610.02,0.00
2024-12-08 16:51:30,55,605,15,40,366.89,610.02,0.00
2024-12-08 16:51:30,55,606,15,40,368.16,611.00,0.00
2024-12-08 16:51:30,56,606,15,41,361.58,611.02,0.00
2024-12-08 16:51:30,56,607,15,41,360.53,612.00,0.00
2024-12-08 16:51:30,57,607,15,42,354.21,612.02,0.00
2024-12-08 16:51:30,56,607,15,41,360.21,612.02,0.00
2024-12-08 16:51:30,56,608,15,41,361.34,613.00,0.00
2024-12-08 16:51:30,57,608,15,42,355.00,613.02,0.00
2024-12-08 16:51:30,56,608,14,42,356.31,613.04,0.00
2024-12-08 16:51:30,55,608,13,42,359.11,613.67,0.00
2024-12-08 16:51:30,55,609,13,42,368.51,614.00,0.00
2024-12-08 16:51:30,56,609,13,43,361.93,614.02,0.00
2024-12-08 16:51:30,55,609,13,42,368.18,614.02,0.00
2024-12-08 16:51:30,55,610,13,42,369.45,615.00,0.00
2024-12-08 16:51:30,56,610,14,42,362.85,615.02,0.00
2024-12-08 16:51:30,55,610,13,42,363.20,615.09,0.00
2024-12-08 16:51:31,55,611,13,42,369.38,616.00,0.00
2024-12-08 16:51:31,56,611,14,42,362.78,616.02,0.00
2024-12-08 16:51:31,55,611,14,41,368.93,616.02,0.00
2024-12-08 16:51:31,55,612,14,41,370.20,617.00,0.00
2024-12-08 16:51:31,56,612,14,42,363.59,617.02,0.00
2024-12-08 16:51:31,56,613,14,42,362.52,618.00,0.00
2024-12-08 16:51:31,57,613,14,43,356.16,618.02,0.00
2024-12-08 16:51:31,56,613,14,42,361.31,618.04,0.00
2024-12-08 16:51:31,55,613,13,42,365.06,618.29,0.00
2024-12-08 16:51:31,55,614,13,42,372.41,619.00,0.00
2024-12-08 16:51:31,56,614,14,42,365.76,619.02,0.00
2024-12-08 16:51:31,55,614,13,42,366.68,619.05,0.00
2024-12-08 16:51:31,54,614,12,42,369.91,619.67,0.00
2024-12-08 16:51:31,54,615,12,42,379.58,620.00,0.00
2024-12-08 16:51:31,55,615,13,42,372.68,620.02,0.00
2024-12-08 16:51:31,54,615,13,41,378.78,620.04,0.00
2024-12-08 16:51:31,54,616,13,41,380.30,621.00,0.00
2024-12-08 16:51:31,55,616,14,41,373.39,621.02,0.00
2024-12-08 16:51:31,55,617,14,41,372.41,622.00,0.00
2024-12-08 16:51:31,56,617,14,42,365.76,622.02,0.00
2024-12-08 16:51:31,55,617,14,41,371.51,622.04,0.00
2024-12-08 16:51:31,55,618,14,41,372.89,623.00,0.00
2024-12-08 16:51:31,56,618,14,42,366.23,623.02,0.00
2024-12-08 16:51:31,55,618,13,42,364.11,623.89,0.00
2024-12-08 16:51:31,55,619,13,42,374.85,624.00,0.00
2024-12-08 16:51:31,56,619,14,42,368.16,624.02,0.00
2024-12-08 16:51:31,55,619,14,41,373.95,624.04,0.00
2024-12-08 16:51:31,55,620,14,41,375.34,625.00,0.00
2024-12-08 16:51:31,56,620,15,41,368.64,625.02,0.00
2024-12-08 16:51:31,56,621,15,41,367.55,626.00,0.00
2024-12-08 16:51:31,57,621,15,42,361.10,626.02,0.00
2024-12-08 16:51:31,56,621,15,41,366.77,626.04,0.00
2024-12-08 16:51:31,55,621,14,41,369.69,626.67,0.00
2024-12-08 16:51:31,55,622,14,41,374.72,627.00,0.00
2024-12-08 16:51:31,56,622,15,41,368.03,627.02,0.00
2024-12-08 16:51:31,56,623,15,41,366.93,628.00,0.00
2024-12-08 16:51:31,57,623,16,41,360.49,628.02,0.00
2024-12-08 16:51:31,56,623,16,40,366.26,628.04,0.00
2024-12-08 16:51:31,56,624,16,40,367.52,629.00,0.00
2024-12-08 16:51:31,57,624,16,41,361.07,629.02,0.00
2024-12-08 16:51:31,56,624,15,41,358.27,629.93,0.00
2024-12-08 16:51:31,56,625,15,41,369.11,630.00,0.00
2024-12-08 16:51:31,57,625,15,42,362.64,630.02,0.00
2024-12-08 16:51:31,56,625,15,41,368.55,630.04,0.00
2024-12-08 16:51:31,56,626,15,41,369.81,631.00,0.00
2024-12-08 16:51:31,57,626,16,41,363.32,631.02,0.00
2024-12-08 16:51:31,57,627,16,41,362.12,632.00,0.00
2024-12-08 16:51:31,58,627,16,42,355.88,632.02,0.00
2024-12-08 16:51:31,57,627,16,41,361.46,632.04,0.00
2024-12-08 16:51:31,57,628,16,41,362.59,633.00,0.00
2024-12-08 16:51:31,58,628,17,41,356.34,633.02,0.00
2024-12-08 16:51:31,58,629,17,41,355.04,634.00,0.00
2024-12-08 16:51:31,59,629,17,42,349.02,634.02,0.00
2024-12-08 16:51:31,58,629,17,41,354.39,634.03,0.00
2024-12-08 16:51:31,58,630,17,41,355.38,635.00,0.00
2024-12-08 16:51:31,59,630,17,42,349.36,635.02,0.00
2024-12-08 16:51:31,58,630,16,42,354.40,635.02,0.00
2024-12-08 16:51:31,58,631,16,42,357.48,636.00,0.00
2024-12-08 16:51:31,59,631,16,43,351.42,636.02,0.00
2024-12-08 16:51:31,58,631,16,42,356.93,636.02,0.00
2024-12-08 16:51:31,57,631,15,42,359.95,636.30,0.00
2024-12-08 16:51:31,56,631,14,42,364.22,636.68,0.00
2024-12-08 16:51:31,56,632,14,42,373.78,637.00,0.00
2024-12-08 16:51:31,57,632,14,43,367.22,637.02,0.00
2024-12-08 16:51:31,57,633,14,43,366.01,638.00,0.00
2024-12-08 16:51:31,58,633,15,43,359.70,638.02,0.00
2024-12-08 16:51:31,57,633,15,42,365.56,638.02,0.00
2024-12-08 16:51:31,56,633,14,42,364.98,638.93,0.00
2024-12-08 16:51:31,56,634,14,42,375.98,639.00,0.00
2024-12-08 16:51:31,57,634,14,43,369.39,639.02,0.00
2024-12-08 16:51:31,57,635,14,43,368.17,640.00,0.00
2024-12-08 16:51:31,58,635,15,43,361.82,640.02,0.00
2024-12-08 16:51:31,57,635,15,42,367.83,640.02,0.00
2024-12-08 16:51:31,56,635,14,42,369.09,640.45,0.00
2024-12-08 16:51:31,56,636,14,42,377.39,641.00,0.00
2024-12-08 16:51:31,57,636,14,43,370.77,641.02,0.00
2024-12-08 16:51:31,57,637,14,43,369.54,642.00,0.00
2024-12-08 16:51:31,58,637,15,43,363.17,642.02,0.00
2024-12-08 16:51:31,57,637,15,42,368.98,642.02,0.00
2024-12-08 16:51:31,56,637,14,42,370.46,642.77,0.00
2024-12-08 16:51:31,56,638,14,42,380.63,643.00,0.00
2024-12-08 16:51:31,57,638,14,43,373.96,643.02,0.00
2024-12-08 16:51:31,57,639,14,43,372.73,644.00,0.00
2024-12-08 16:51:31,58,639,14,44,366.30,644.02,0.00
2024-12-08 16:51:31,57,639,14,43,372.16,644.02,0.00
2024-12-08 16:51:31,57,640,14,43,373.19,645.00,0.00
2024-12-08 16:51:31,58,640,15,43,366.76,645.02,0.00
2024-12-08 16:51:31,57,640,14,43,369.85,645.18,0.00
2024-12-08 16:51:32,57,641,14,43,371.85,646.00,0.00
2024-12-08 16:51:32,58,641,14,44,365.44,646.02,0.00
2024-12-08 16:51:32,57,641,14,43,371.28,646.02,0.00
2024-12-08 16:51:32,56,641,13,43,374.23,646.34,0.00
2024-12-08 16:51:32,56,642,13,43,381.96,647.00,0.00
2024-12-08 16:51:32,57,642,13,44,375.26,647.02,0.00
2024-12-08 16:51:32,56,642,12,44,371.30,647.66,0.00
2024-12-08 16:51:32,56,643,12,44,380.93,648.00,0.00
2024-12-08 16:51:32,57,643,13,44,374.25,648.02,0.00
2024-12-08 16:51:32,56,643,13,43,380.47,648.02,0.00
2024-12-08 16:51:32,55,643,12,43,383.35,648.67,0.00
2024-12-08 16:51:32,55,644,12,43,388.57,649.00,0.00
2024-12-08 16:51:32,56,644,12,44,381.64,649.02,0.00
2024-12-08 16:51:32,56,645,12,44,380.48,650.00,0.00
2024-12-08 16:51:32,57,645,12,45,373.81,650.02,0.00
2024-12-08 16:51:32,56,645,12,44,379.90,650.02,0.00
2024-12-08 16:51:32,56,646,12,44,381.07,651.00,0.00
2024-12-08 16:51:32,57,646,12,45,374.38,651.02,0.00
2024-12-08 16:51:32,56,646,11,45,374.65,651.68,0.00
2024-12-08 16:51:32,56,647,11,45,379.79,652.00,0.00
2024-12-08 16:51:32,57,647,12,45,373.13,652.02,0.00
2024-12-08 16:51:32,56,647,12,44,379.32,652.02,0.00
2024-12-08 16:51:32,55,647,11,44,380.92,652.76,0.00
2024-12-08 16:51:32,55,648,11,44,391.44,653.00,0.00
2024-12-08 16:51:32,56,648,12,44,384.45,653.02,0.00
2024-12-08 16:51:32,56,649,12,44,383.29,654.00,0.00
2024-12-08 16:51:32,57,649,12,45,376.57,654.02,0.00
2024-12-08 16:51:32,56,649,12,44,382.82,654.02,0.00
2024-12-08 16:51:32,55,649,11,44,382.69,654.91,0.00
2024-12-08 16:51:32,55,650,11,44,394.07,655.00,0.00
2024-12-08 16:51:32,56,650,11,45,387.03,655.02,0.00
2024-12-08 16:51:32,56,651,11,45,385.87,656.00,0.00
2024-12-08 16:51:32,57,651,12,45,379.10,656.02,0.00
2024-12-08 16:51:32,56,651,12,44,385.40,656.02,0.00
2024-12-08 16:51:32,56,652,12,44,386.57,657.00,0.00
2024-12-08 16:51:32,57,652,13,44,379.79,657.02,0.00
2024-12-08 16:51:32,56,652,12,44,378.98,657.77,0.00
2024-12-08 16:51:32,56,653,12,44,389.39,658.00,0.00
2024-12-08 16:51:32,57,653,12,45,382.56,658.02,0.00
2024-12-08 16:51:32,56,653,12,44,389.04,658.02,0.00
2024-12-08 16:51:32,56,654,12,44,390.22,659.00,0.00
2024-12-08 16:51:32,57,654,13,44,383.38,659.02,0.00
2024-12-08 16:51:32,57,655,13,44,382.11,660.00,0.00
2024-12-08 16:51:32,58,655,13,45,375.52,660.02,0.00
2024-12-08 16:51:32,57,655,13,44,381.76,660.02,0.00
2024-12-08 16:51:32,57,656,13,44,382.80,661.00,0.00
2024-12-08 16:51:32,58,656,13,45,376.20,661.02,0.00
2024-12-08 16:51:32,57,656,12,45,375.87,661.12,0.00
2024-12-08 16:51:32,57,657,12,45,382.22,662.00,0.00
2024-12-08 16:51:32,58,657,12,46,375.63,662.02,0.00
2024-12-08 16:51:32,57,657,12,45,381.99,662.02,0.00
2024-12-08 16:51:32,56,657,11,45,383.97,662.73,0.00
2024-12-08 16:51:32,56,658,11,45,394.25,663.00,0.00
2024-12-08 16:51:32,57,658,12,45,387.33,663.02,0.00
2024-12-08 16:51:32,57,659,12,45,386.05,664.00,0.00
2024-12-08 16:51:32,58,659,12,46,379.40,664.02,0.00
2024-12-08 16:51:32,57,659,12,45,385.47,664.04,0.00
2024-12-08 16:51:32,57,660,12,45,386.63,665.00,0.00
2024-12-08 16:51:32,58,660,12,46,379.97,665.02,0.00
2024-12-08 16:51:32,58,661,12,46,378.59,666.00,0.00
2024-12-08 16:51:32,59,661,13,46,372.17,666.02,0.00
2024-12-08 16:51:32,58,661,13,45,377.90,666.03,0.00
2024-12-08 16:51:32,58,662,13,45,378.92,667.00,0.00
2024-12-08 16:51:32,59,662,14,45,372.50,667.02,0.00
2024-12-08 16:51:32,59,663,14,45,371.02,668.00,0.00
2024-12-08 16:51:32,60,663,14,46,364.84,668.02,0.00
2024-12-08 16:51:32,59,663,14,45,370.46,668.03,0.00
2024-12-08 16:51:32,59,664,14,45,371.35,669.00,0.00
2024-12-08 16:51:32,60,664,14,46,365.16,669.02,0.00
2024-12-08 16:51:32,59,664,13,46,365.34,669.37,0.00
2024-12-08 16:51:32,59,665,13,46,372.93,670.00,0.00
2024-12-08 16:51:32,60,665,13,47,366.71,670.02,0.00
2024-12-08 16:51:32,59,665,13,46,372.48,670.03,0.00
2024-12-08 16:51:32,58,665,12,46,377.91,670.19,0.00
2024-12-08 16:51:32,57,665,11,46,384.42,670.19,0.00
2024-12-08 16:51:32,57,666,11,46,386.59,671.00,0.00
2024-12-08 16:51:32,58,666,11,47,379.92,671.02,0.00
2024-12-08 16:51:32,57,666,10,47,378.74,671.77,0.00
2024-12-08 16:51:32,57,667,10,47,389.17,672.00,0.00
2024-12-08 16:51:32,58,667,10,48,382.46,672.02,0.00
2024-12-08 16:51:32,57,667,10,47,388.58,672.04,0.00
2024-12-08 16:51:32,57,668,10,47,389.75,673.00,0.00
2024-12-08 16:51:32,58,668,10,48,383.03,673.02,0.00
2024-12-08 16:51:32,57,668,9,48,381.87,673.77,0.00
2024-12-08 16:51:33,57,669,9,48,392.34,674.00,0.00
2024-12-08 16:51:33,58,669,9,49,385.57,674.02,0.00
2024-12-08 16:51:33,57,669,9,48,391.87,674.04,0.00
2024-12-08 16:51:33,57,670,9,48,393.04,675.00,0.00
2024-12-08 16:51:33,58,670,9,49,386.26,675.02,0.00
2024-12-08 16:51:33,57,670,8,49,384.69,675.81,0.00
2024-12-08 16:51:33,57,671,8,49,395.40,676.00,0.00
2024-12-08 16:51:33,58,671,8,50,388.58,676.02,0.00
2024-12-08 16:51:33,57,671,8,49,395.05,676.04,0.00
2024-12-08 16:51:33,56,671,7,49,393.83,676.64,0.00
2024-12-08 16:51:33,55,671,6,49,400.54,676.71,0.00
2024-12-08 16:51:33,55,672,6,49,411.12,677.00,0.00
2024-12-08 16:51:33,56,672,7,49,403.78,677.02,0.00
2024-12-08 16:51:33,56,673,7,49,402.56,678.00,0.00
2024-12-08 16:51:33,57,673,8,49,395.50,678.02,0.00
2024-12-08 16:51:33,56,673,8,48,402.32,678.04,0.00
2024-12-08 16:51:33,56,674,8,48,403.64,679.00,0.00
2024-12-08 16:51:33,57,674,8,49,396.56,679.02,0.00
2024-12-08 16:51:33,57,675,8,49,395.23,680.00,0.00
2024-12-08 16:51:33,58,675,9,49,388.42,680.02,0.00
2024-12-08 16:51:33,57,675,9,48,394.88,680.04,0.00
2024-12-08 16:51:33,56,675,8,48,400.77,680.21,0.00
2024-12-08 16:51:33,56,676,8,48,403.25,681.00,0.00
2024-12-08 16:51:33,57,676,9,48,396.17,681.02,0.00
2024-12-08 16:51:33,57,677,9,48,394.84,682.00,0.00
2024-12-08 16:51:33,58,677,9,49,388.03,682.02,0.00
2024-12-08 16:51:33,57,677,9,48,394.36,682.04,0.00
2024-12-08 16:51:33,57,678,9,48,395.54,683.00,0.00
2024-12-08 16:51:33,58,678,10,48,388.72,683.02,0.00
2024-12-08 16:51:33,57,678,9,48,385.96,683.56,0.00
2024-12-08 16:51:33,57,679,9,48,395.28,684.00,0.00
2024-12-08 16:51:33,58,679,9,49,388.46,684.02,0.00
2024-12-08 16:51:33,57,679,9,48,394.92,684.04,0.00
2024-12-08 16:51:33,57,680,9,48,396.10,685.00,0.00
2024-12-08 16:51:33,58,680,10,48,389.27,685.02,0.00
2024-12-08 16:51:33,58,681,10,48,387.83,686.00,0.00
2024-12-08 16:51:33,59,681,11,48,381.25,686.02,0.00
2024-12-08 16:51:33,58,681,11,47,387.71,686.02,0.00
2024-12-08 16:51:33,57,681,11,46,394.27,686.02,0.00
2024-12-08 16:51:33,56,681,10,46,397.11,686.66,0.00
2024-12-08 16:51:33,56,682,10,46,402.39,687.00,0.00
2024-12-08 16:51:33,57,682,11,46,395.33,687.02,0.00
2024-12-08 16:51:33,56,682,10,46,393.40,687.84,0.00
2024-12-08 16:51:33,56,683,10,46,404.69,688.00,0.00
2024-12-08 16:51:33,57,683,11,46,397.59,688.02,0.00
2024-12-08 16:51:33,56,683,11,45,404.57,688.02,0.00
2024-12-08 16:51:33,56,684,11,45,405.77,689.00,0.00
2024-12-08 16:51:33,57,684,12,45,398.65,689.02,0.00
2024-12-08 16:51:33,57,685,12,45,397.29,690.00,0.00
2024-12-08 16:51:33,58,685,13,45,390.44,690.02,0.00
2024-12-08 16:51:33,57,685,13,44,397.05,690.02,0.00
2024-12-08 16:51:33,57,686,13,44,398.11,691.00,0.00
2024-12-08 16:51:33,58,686,13,45,391.25,691.02,0.00
2024-12-08 16:51:33,58,687,13,45,389.79,692.00,0.00
2024-12-08 16:51:33,59,687,13,46,383.18,692.02,0.00
2024-12-08 16:51:33,58,687,13,45,389.67,692.02,0.00
2024-12-08 16:51:33,58,688,13,45,390.59,693.00,0.00
2024-12-08 16:51:33,59,688,13,46,383.97,693.02,0.00
2024-12-08 16:51:33,58,688,13,45,388.08,693.02,0.00
2024-12-08 16:51:33,58,689,13,45,389.00,694.00,0.00
2024-12-08 16:51:33,59,689,14,45,382.41,694.02,0.00
2024-12-08 16:51:33,58,689,14,44,386.49,694.02,0.00
2024-12-08 16:51:33,58,690,14,44,387.40,695.00,0.00
2024-12-08 16:51:33,59,690,15,44,380.84,695.02,0.00
2024-12-08 16:51:33,58,690,14,44,381.66,695.05,0.00
2024-12-08 16:51:33,58,691,14,44,387.60,696.00,0.00
2024-12-08 16:51:33,59,691,15,44,381.03,696.02,0.00
2024-12-08 16:51:33,58,691,15,43,387.36,696.02,0.00
2024-12-08 16:51:33,58,692,15,43,388.28,697.00,0.00
2024-12-08 16:51:33,59,692,16,43,381.70,697.02,0.00
2024-12-08 16:51:33,59,693,16,43,380.11,698.00,0.00
2024-12-08 16:51:33,60,693,17,43,373.78,698.02,0.00
2024-12-08 16:51:33,59,693,17,42,380.00,698.02,0.00
2024-12-08 16:51:33,58,693,16,42,382.19,698.67,0.00
2024-12-08 16:51:33,57,693,15,42,386.30,698.86,0.00
2024-12-08 16:51:33,57,694,15,42,397.69,699.00,0.00
2024-12-08 16:51:33,58,694,15,43,390.84,699.02,0.00
2024-12-08 16:51:33,57,694,14,43,393.71,699.21,0.00
2024-12-08 16:51:33,57,695,14,43,400.96,700.00,0.00
2024-12-08 16:51:33,58,695,15,43,394.05,700.02,0.00
2024-12-08 16:51:33,57,695,15,42,400.60,700.02,0.00
2024-12-08 16:51:33,56,695,14,42,402.15,700.77,0.00
2024-12-08 16:51:33,56,696,14,42,413.21,701.00,0.00
2024-12-08 16:51:33,57,696,15,42,405.96,701.02,0.00
2024-12-08 16:51:33,57,697,15,42,404.57,702.00,0.00
2024-12-08 16:51:33,58,697,15,43,397.60,702.02,0.00
2024-12-08 16:51:33,57,697,15,42,404.33,702.02,0.00
2024-12-08 16:51:33,56,697,14,42,405.91,702.77,0.00
2024-12-08 16:51:33,56,698,14,42,417.03,703.00,0.00
2024-12-08 16:51:33,57,698,15,42,409.71,703.02,0.00
2024-12-08 16:51:34,56,698,14,42,405.55,703.66,0.00
2024-12-08 16:51:34,56,699,14,42,415.99,704.00,0.00
2024-12-08 16:51:34,57,699,15,42,408.69,704.02,0.00
2024-12-08 16:51:34,56,699,15,41,415.61,704.02,0.00
2024-12-08 16:51:34,56,700,15,41,416.83,705.00,0.00
2024-12-08 16:51:34,57,700,15,42,409.52,705.02,0.00
2024-12-08 16:51:34,57,701,15,42,408.12,706.00,0.00
2024-12-08 16:51:34,58,701,15,43,401.08,706.02,0.00
2024-12-08 16:51:34,57,701,15,42,407.62,706.02,0.00
2024-12-08 16:51:34,56,701,14,42,410.32,706.70,0.00
2024-12-08 16:51:34,55,701,13,42,413.90,706.96,0.00
2024-12-08 16:51:34,55,702,13,42,426.51,707.00,0.00
2024-12-08 16:51:34,56,702,13,43,418.90,707.02,0.00
2024-12-08 16:51:34,56,703,13,43,417.59,708.00,0.00
2024-12-08 16:51:34,57,703,13,44,410.27,708.02,0.00
2024-12-08 16:51:34,56,703,13,43,417.21,708.02,0.00
2024-12-08 16:51:34,56,704,13,43,418.44,709.00,0.00
2024-12-08 16:51:34,57,704,14,43,411.10,709.02,0.00
2024-12-08 16:51:34,56,704,13,43,410.21,709.77,0.00
2024-12-08 16:51:34,56,705,13,43,421.44,710.00,0.00
2024-12-08 16:51:34,57,705,14,43,414.04,710.02,0.00
2024-12-08 16:51:34,56,705,14,42,421.06,710.02,0.00
2024-12-08 16:51:34,56,706,14,42,422.28,711.00,0.00
2024-12-08 16:51:34,57,706,15,42,414.87,711.02,0.00
2024-12-08 16:51:34,57,707,15,42,413.46,712.00,0.00
2024-12-08 16:51:34,58,707,16,42,406.33,712.02,0.00
2024-12-08 16:51:34,57,707,16,41,413.08,712.02,0.00
2024-12-08 16:51:34,57,708,16,41,414.17,713.00,0.00
2024-12-08 16:51:34,58,708,16,42,407.02,713.02,0.00
2024-12-08 16:51:34,58,709,16,42,405.50,714.00,0.00
2024-12-08 16:51:34,59,709,16,43,398.63,714.02,0.00
2024-12-08 16:51:34,58,709,16,42,405.26,714.02,0.00
2024-12-08 16:51:34,58,710,16,42,406.19,715.00,0.00
2024-12-08 16:51:34,59,710,16,43,399.31,715.02,0.00
2024-12-08 16:51:34,59,711,16,43,397.68,716.00,0.00
2024-12-08 16:51:34,60,711,16,44,391.06,716.02,0.00
2024-12-08 16:51:34,59,711,16,43,397.56,716.02,0.00
2024-12-08 16:51:34,58,711,15,43,396.40,716.93,0.00
2024-12-08 16:51:34,58,712,15,43,408.32,717.00,0.00
2024-12-08 16:51:34,59,712,15,44,401.40,717.02,0.00
2024-12-08 16:51:34,58,712,15,43,405.72,717.02,0.00
2024-12-08 16:51:34,58,713,15,43,406.66,718.00,0.00
2024-12-08 16:51:34,59,713,15,44,399.77,718.02,0.00
2024-12-08 16:51:34,59,714,15,44,398.13,719.00,0.00
2024-12-08 16:51:34,60,714,15,45,391.50,719.02,0.00
2024-12-08 16:51:34,59,714,15,44,398.01,719.02,0.00
2024-12-08 16:51:34,58,714,14,44,398.86,719.48,0.00
2024-12-08 16:51:34,58,715,14,44,407.92,720.00,0.00
2024-12-08 16:51:34,59,715,14,45,401.00,720.02,0.00
2024-12-08 16:51:34,59,716,14,45,399.36,721.00,0.00
2024-12-08 16:51:34,60,716,15,45,392.70,721.02,0.00
2024-12-08 16:51:34,59,716,15,44,399.24,721.02,0.00
2024-12-08 16:51:34,58,716,14,44,397.09,721.66,0.00
2024-12-08 16:51:34,58,717,14,44,407.31,722.00,0.00
2024-12-08 16:51:34,59,717,14,45,400.40,722.02,0.00
2024-12-08 16:51:34,59,718,14,45,398.75,723.00,0.00
2024-12-08 16:51:34,60,718,14,46,392.11,723.02,0.00
2024-12-08 16:51:34,59,718,14,45,398.63,723.02,0.00
2024-12-08 16:51:34,59,719,14,45,399.43,724.00,0.00
2024-12-08 16:51:34,60,719,14,46,392.77,724.02,0.00
2024-12-08 16:51:34,59,719,14,45,396.85,724.02,0.00
2024-12-08 16:51:34,58,719,13,45,399.02,724.69,0.00
2024-12-08 16:51:34,57,719,12,45,402.04,724.96,0.00
2024-12-08 16:51:34,57,720,12,45,414.52,725.00,0.00
2024-12-08 16:51:34,58,720,12,46,407.37,725.02,0.00
2024-12-08 16:51:34,58,721,12,46,405.81,726.00,0.00
2024-12-08 16:51:34,59,721,13,46,398.93,726.02,0.00
2024-12-08 16:51:34,58,721,13,45,405.68,726.02,0.00
2024-12-08 16:51:34,58,722,13,45,406.62,727.00,0.00
2024-12-08 16:51:34,59,722,14,45,399.73,727.02,0.00
2024-12-08 16:51:34,58,722,14,44,403.99,727.02,0.00
2024-12-08 16:51:34,58,723,14,44,404.92,728.00,0.00
2024-12-08 16:51:34,59,723,14,45,398.06,728.02,0.00
2024-12-08 16:51:34,58,723,13,45,401.08,728.21,0.00
2024-12-08 16:51:34,57,723,12,45,404.19,728.74,0.00
2024-12-08 16:51:34,57,724,12,45,415.27,729.00,0.00
2024-12-08 16:51:34,58,724,12,46,408.11,729.02,0.00
2024-12-08 16:51:34,57,724,12,45,415.15,729.02,0.00
2024-12-08 16:51:34,56,724,11,45,417.69,729.71,0.00
2024-12-08 16:51:34,56,725,11,45,428.87,730.00,0.00
2024-12-08 16:51:34,57,725,11,46,421.35,730.02,0.00
2024-12-08 16:51:34,56,725,11,45,426.14,730.02,0.00
2024-12-08 16:51:35,56,726,11,45,427.37,731.00,0.00
2024-12-08 16:51:35,57,726,12,45,419.88,731.02,0.00
2024-12-08 16:51:35,56,726,12,44,424.63,731.02,0.00
2024-12-08 16:51:35,56,727,12,44,425.87,732.00,0.00
2024-12-08 16:51:35,57,727,13,44,418.40,732.02,0.00
2024-12-08 16:51:35,56,727,12,44,413.36,732.68,0.00
2024-12-08 16:51:35,56,728,12,44,424.35,733.00,0.00
2024-12-08 16:51:35,57,728,13,44,416.91,733.02,0.00
2024-12-08 16:51:35,56,728,13,43,424.09,733.02,0.00
2024-12-08 16:51:35,56,729,13,43,425.33,734.00,0.00
2024-12-08 16:51:35,57,729,14,43,417.86,734.02,0.00
2024-12-08 16:51:35,56,729,13,43,419.14,734.34,0.00
2024-12-08 16:51:35,56,730,13,43,427.87,735.00,0.00
2024-12-08 16:51:35,57,730,13,44,420.37,735.02,0.00
2024-12-08 16:51:35,56,730,13,43,427.74,735.02,0.00
2024-12-08 16:51:35,56,731,13,43,428.98,736.00,0.00
2024-12-08 16:51:35,57,731,13,44,421.46,736.02,0.00
2024-12-08 16:51:35,56,731,12,44,422.39,736.34,0.00
2024-12-08 16:51:35,56,732,12,44,431.14,737.00,0.00
2024-12-08 16:51:35,57,732,13,44,423.58,737.02,0.00
2024-12-08 16:51:35,56,732,13,43,430.88,737.02,0.00
2024-12-08 16:51:35,56,733,13,43,432.13,738.00,0.00
2024-12-08 16:51:35,57,733,14,43,424.54,738.02,0.00
2024-12-08 16:51:35,57,734,14,43,423.04,739.00,0.00
2024-12-08 16:51:35,58,734,15,43,415.75,739.02,0.00
2024-12-08 16:51:35,57,734,15,42,422.79,739.02,0.00
2024-12-08 16:51:35,57,735,15,42,423.88,740.00,0.00
2024-12-08 16:51:35,58,735,15,43,416.57,740.02,0.00
2024-12-08 16:51:35,58,736,15,43,414.96,741.00,0.00
2024-12-08 16:51:35,59,736,15,44,407.93,741.02,0.00
2024-12-08 16:51:35,58,736,15,43,414.83,741.02,0.00
2024-12-08 16:51:35,58,737,15,43,415.78,742.00,0.00
2024-12-08 16:51:35,59,737,16,43,408.73,742.02,0.00
2024-12-08 16:51:35,58,737,16,42,413.09,742.02,0.00
2024-12-08 16:51:35,58,738,16,42,414.03,743.00,0.00
2024-12-08 16:51:35,59,738,16,43,407.01,743.02,0.00
2024-12-08 16:51:35,58,738,15,43,404.60,743.83,0.00
2024-12-08 16:51:35,58,739,15,43,416.25,744.00,0.00
2024-12-08 16:51:35,59,739,16,43,409.20,744.02,0.00
2024-12-08 16:51:35,58,739,16,42,416.13,744.02,0.00
2024-12-08 16:51:35,58,740,16,42,417.07,745.00,0.00
2024-12-08 16:51:35,59,740,16,43,410.00,745.02,0.00
2024-12-08 16:51:35,58,740,16,42,414.37,745.02,0.00
2024-12-08 16:51:35,58,741,16,42,415.32,746.00,0.00
2024-12-08 16:51:35,59,741,17,42,408.28,746.02,0.00
2024-12-08 16:51:35,59,742,17,42,406.55,747.00,0.00
2024-12-08 16:51:35,60,742,17,43,399.77,747.02,0.00
2024-12-08 16:51:35,59,742,17,42,406.29,747.02,0.00
2024-12-08 16:51:35,59,743,17,42,407.09,748.00,0.00
2024-12-08 16:51:35,60,743,17,43,400.30,748.02,0.00
2024-12-08 16:51:35,60,744,17,43,398.47,749.00,0.00
2024-12-08 16:51:35,61,744,18,43,391.94,749.02,0.00
2024-12-08 16:51:35,60,744,18,42,398.34,749.02,0.00
2024-12-08 16:51:35,60,745,18,42,399.00,750.00,0.00
2024-12-08 16:51:35,61,745,19,42,392.46,750.02,0.00
2024-12-08 16:51:35,60,745,19,41,396.37,750.02,0.00
2024-12-08 16:51:35,59,745,18,41,401.86,750.17,0.00
2024-12-08 16:51:35,58,745,17,41,403.19,750.81,0.00
2024-12-08 16:51:35,58,746,17,41,414.86,751.00,0.00
2024-12-08 16:51:35,59,746,18,41,407.83,751.02,0.00
2024-12-08 16:51:35,58,746,17,41,406.91,751.72,0.00
2024-12-08 16:51:35,58,747,17,41,418.01,752.00,0.00
2024-12-08 16:51:35,59,747,18,41,410.92,752.02,0.00
2024-12-08 16:51:35,58,747,18,40,417.75,752.03,0.00
2024-12-08 16:51:35,58,748,18,40,418.82,753.00,0.00
2024-12-08 16:51:35,59,748,19,40,411.72,753.02,0.00
2024-12-08 16:51:35,58,748,19,39,415.97,753.03,0.00
2024-12-08 16:51:35,58,749,19,39,417.04,754.00,0.00
2024-12-08 16:51:35,59,749,19,40,409.97,754.02,0.00
2024-12-08 16:51:35,58,749,19,39,414.18,754.03,0.00
2024-12-08 16:51:35,57,749,18,39,414.83,754.81,0.00
2024-12-08 16:51:35,57,750,18,39,426.77,755.00,0.00
2024-12-08 16:51:35,58,750,19,39,419.42,755.02,0.00
2024-12-08 16:51:35,57,750,19,38,423.86,755.04,0.00
2024-12-08 16:51:35,57,751,19,38,425.08,756.00,0.00
2024-12-08 16:51:35,58,751,20,38,417.75,756.02,0.00
2024-12-08 16:51:35,57,751,20,37,422.17,756.04,0.00
2024-12-08 16:51:35,56,751,19,37,428.93,756.14,0.00
2024-12-08 16:51:35,56,752,19,37,431.08,757.00,0.00
2024-12-08 16:51:35,57,752,19,38,423.52,757.02,0.00
2024-12-08 16:51:35,56,752,18,38,427.20,757.16,0.00
2024-12-08 16:51:35,55,752,17,38,434.29,757.18,0.00
2024-12-08 16:51:35,55,753,17,38,442.40,758.00,0.00
2024-12-08 16:51:35,56,753,18,38,434.50,758.02,0.00
2024-12-08 16:51:35,55,753,18,37,441.99,758.04,0.00
2024-12-08 16:51:35,55,754,18,37,443.53,759.00,0.00
2024-12-08 16:51:35,56,754,19,37,435.61,759.02,0.00
2024-12-08 16:51:36,55,754,18,37,431.66,759.60,0.00
2024-12-08 16:51:36,55,755,18,37,442.73,760.00,0.00
2024-12-08 16:51:36,56,755,18,38,434.83,760.02,0.00
2024-12-08 16:51:36,55,755,18,37,442.18,760.04,0.00
2024-12-08 16:51:36,55,756,18,37,443.73,761.00,0.00
2024-12-08 16:51:36,56,756,19,37,435.81,761.02,0.00
2024-12-08 16:51:36,55,756,18,37,439.89,761.15,0.00
2024-12-08 16:51:36,55,757,18,37,442.24,762.00,0.00
2024-12-08 16:51:36,56,757,18,38,434.34,762.02,0.00
2024-12-08 16:51:36,55,757,18,37,441.68,762.04,0.00
2024-12-08 16:51:36,55,758,18,37,443.23,763.00,0.00
2024-12-08 16:51:36,56,758,19,37,435.32,763.02,0.00
2024-12-08 16:51:36,56,759,19,37,433.84,764.00,0.00
2024-12-08 16:51:36,57,759,19,38,426.23,764.02,0.00
2024-12-08 16:51:36,56,759,19,37,432.62,764.04,0.00
2024-12-08 16:51:36,56,760,19,37,434.00,765.00,0.00
2024-12-08 16:51:36,57,760,20,37,426.39,765.02,0.00
2024-12-08 16:51:36,57,761,20,37,424.79,766.00,0.00
2024-12-08 16:51:36,58,761,20,38,417.47,766.02,0.00
2024-12-08 16:51:36,57,761,20,37,423.72,766.04,0.00
2024-12-08 16:51:36,56,761,19,37,425.64,766.73,0.00
2024-12-08 16:51:36,56,762,19,37,437.46,767.00,0.00
2024-12-08 16:51:36,57,762,19,38,429.79,767.02,0.00
2024-12-08 16:51:36,57,763,19,38,428.04,768.00,0.00
2024-12-08 16:51:36,58,763,20,38,420.66,768.02,0.00
2024-12-08 16:51:36,57,763,20,37,427.10,768.04,0.00
2024-12-08 16:51:36,57,764,20,37,427.89,769.00,0.00
2024-12-08 16:51:36,58,764,21,37,420.51,769.02,0.00
2024-12-08 16:51:36,58,765,21,37,418.65,770.00,0.00
2024-12-08 16:51:36,59,765,22,37,411.55,770.02,0.00
2024-12-08 16:51:36,58,765,22,36,417.06,770.05,0.00
2024-12-08 16:51:36,58,766,22,36,418.08,771.00,0.00
2024-12-08 16:51:36,59,766,23,36,411.00,771.02,0.00
2024-12-08 16:51:36,58,766,23,35,417.95,771.02,0.00
2024-12-08 16:51:36,58,767,23,35,416.86,772.00,0.00
2024-12-08 16:51:36,59,767,24,35,409.79,772.02,0.00
2024-12-08 16:51:36,58,767,24,34,415.26,772.03,0.00
2024-12-08 16:51:36,57,767,23,34,417.85,772.67,0.00
2024-12-08 16:51:36,57,768,23,34,423.63,773.00,0.00
2024-12-08 16:51:36,58,768,23,35,416.33,773.02,0.00
2024-12-08 16:51:36,57,768,22,35,416.02,773.67,0.00
2024-12-08 16:51:36,56,768,21,35,421.34,773.80,0.00
2024-12-08 16:51:36,56,769,21,35,433.77,774.00,0.00
2024-12-08 16:51:36,57,769,22,35,426.16,774.02,0.00
2024-12-08 16:51:36,56,769,22,34,431.98,774.04,0.00
2024-12-08 16:51:36,56,770,22,34,433.30,775.00,0.00
2024-12-08 16:51:36,57,770,22,35,425.70,775.02,0.00
2024-12-08 16:51:36,57,771,22,35,424.34,776.00,0.00
2024-12-08 16:51:36,58,771,23,35,417.03,776.02,0.00
2024-12-08 16:51:36,57,771,23,34,422.71,776.04,0.00
2024-12-08 16:51:36,57,772,23,34,423.82,777.00,0.00
2024-12-08 16:51:36,58,772,23,35,416.51,777.02,0.00
2024-12-08 16:51:36,58,773,23,35,414.41,778.00,0.00
2024-12-08 16:51:36,59,773,23,36,407.39,778.02,0.00
2024-12-08 16:51:36,58,773,23,35,412.94,778.03,0.00
2024-12-08 16:51:36,57,773,22,35,417.27,778.26,0.00
2024-12-08 16:51:36,57,774,22,35,425.40,779.00,0.00
2024-12-08 16:51:36,58,774,22,36,418.06,779.02,0.00
2024-12-08 16:51:36,58,775,22,36,416.66,780.00,0.00
2024-12-08 16:51:36,59,775,23,36,409.60,780.02,0.00
2024-12-08 16:51:36,58,775,23,35,415.32,780.03,0.00
2024-12-08 16:51:36,57,775,22,35,418.09,780.49,0.00
2024-12-08 16:51:36,56,775,21,35,419.53,780.59,0.00
2024-12-08 16:51:36,56,776,21,35,430.56,781.00,0.00
2024-12-08 16:51:36,57,776,22,35,423.00,781.02,0.00
2024-12-08 16:51:36,57,777,22,35,421.99,782.00,0.00
2024-12-08 16:51:36,58,777,23,35,414.72,782.02,0.00
2024-12-08 16:51:36,57,777,23,34,420.21,782.04,0.00
2024-12-08 16:51:36,57,778,23,34,421.43,783.00,0.00
2024-12-08 16:51:36,58,778,23,35,414.17,783.02,0.00
2024-12-08 16:51:36,57,778,22,35,414.97,783.30,0.00
2024-12-08 16:51:36,57,779,22,35,423.66,784.00,0.00
2024-12-08 16:51:36,58,779,23,35,416.35,784.02,0.00
2024-12-08 16:51:36,57,779,23,34,422.01,784.04,0.00
2024-12-08 16:51:36,56,779,22,34,427.65,784.21,0.00
2024-12-08 16:51:36,56,780,22,34,435.98,785.00,0.00
2024-12-08 16:51:36,57,780,23,34,428.33,785.02,0.00
2024-12-08 16:51:36,57,781,23,34,427.02,786.00,0.00
2024-12-08 16:51:36,58,781,24,34,419.66,786.02,0.00
2024-12-08 16:51:36,57,781,24,33,425.51,786.04,0.00
2024-12-08 16:51:36,56,781,23,33,428.79,786.61,0.00
2024-12-08 16:51:36,56,782,23,33,434.41,787.00,0.00
2024-12-08 16:51:36,57,782,23,34,426.79,787.02,0.00
2024-12-08 16:51:36,57,783,23,34,425.38,788.00,0.00
2024-12-08 16:51:36,58,783,24,34,418.04,788.02,0.00
2024-12-08 16:51:36,57,783,24,33,424.00,788.04,0.00
2024-12-08 16:51:36,56,783,23,33,423.04,788.89,0.00
2024-12-08 16:51:36,56,784,23,33,436.36,789.00,0.00
2024-12-08 16:51:36,57,784,24,33,428.70,789.02,0.00
2024-12-08 16:51:36,56,784,23,33,424.22,789.93,0.00
2024-12-08 16:51:37,56,785,23,33,437.82,790.00,0.00
2024-12-08 16:51:37,57,785,24,33,430.14,790.02,0.00
2024-12-08 16:51:37,56,785,24,32,436.55,790.04,0.00
2024-12-08 16:51:37,56,786,24,32,437.95,791.00,0.00
2024-12-08 16:51:37,57,786,25,32,430.26,791.02,0.00
2024-12-08 16:51:37,56,786,24,32,427.27,791.52,0.00
2024-12-08 16:51:37,56,787,24,32,437.94,792.00,0.00
2024-12-08 16:51:37,57,787,24,33,430.25,792.02,0.00
2024-12-08 16:51:37,56,787,24,32,436.80,792.04,0.00
2024-12-08 16:51:37,56,788,24,32,438.21,793.00,0.00
2024-12-08 16:51:37,57,788,24,33,430.52,793.02,0.00
2024-12-08 16:51:37,57,789,24,33,428.87,794.00,0.00
2024-12-08 16:51:37,58,789,24,34,421.47,794.02,0.00
2024-12-08 16:51:37,57,789,24,33,427.89,794.04,0.00
2024-12-08 16:51:37,56,789,23,33,427.20,794.54,0.00
2024-12-08 16:51:37,56,790,23,33,438.03,795.00,0.00
2024-12-08 16:51:37,57,790,23,34,430.35,795.02,0.00
2024-12-08 16:51:37,56,790,22,34,432.83,795.23,0.00
2024-12-08 16:51:37,56,791,22,34,441.43,796.00,0.00
2024-12-08 16:51:37,57,791,22,35,433.68,796.02,0.00
2024-12-08 16:51:37,56,791,21,35,441.28,796.02,0.00
2024-12-08 16:51:37,55,791,21,34,448.58,796.02,0.00
2024-12-08 16:51:37,54,791,20,34,452.01,796.65,0.00
2024-12-08 16:51:37,54,792,20,34,464.24,797.00,0.00
2024-12-08 16:51:37,55,792,20,35,455.80,797.02,0.00
2024-12-08 16:51:37,55,793,20,35,454.34,798.00,0.00
2024-12-08 16:51:37,56,793,21,35,446.22,798.02,0.00
2024-12-08 16:51:37,55,793,21,34,453.61,798.02,0.00
2024-12-08 16:51:37,54,793,20,34,460.88,798.17,0.00
2024-12-08 16:51:37,53,793,19,34,462.18,798.89,0.00
2024-12-08 16:51:37,53,794,19,34,476.45,799.00,0.00
2024-12-08 16:51:37,54,794,20,34,467.62,799.02,0.00
2024-12-08 16:51:37,54,795,20,34,466.28,800.00,0.00
2024-12-08 16:51:37,55,795,21,34,457.80,800.02,0.00
2024-12-08 16:51:37,54,795,21,33,465.69,800.02,0.00
2024-12-08 16:51:37,54,796,21,33,467.31,801.00,0.00
2024-12-08 16:51:37,55,796,21,34,458.81,801.02,0.00
2024-12-08 16:51:37,55,797,21,34,457.34,802.00,0.00
2024-12-08 16:51:37,56,797,22,34,449.18,802.02,0.00
2024-12-08 16:51:37,55,797,22,33,456.91,802.02,0.00
2024-12-08 16:51:37,54,797,21,33,455.96,802.94,0.00
2024-12-08 16:51:37,54,798,21,33,470.41,803.00,0.00
2024-12-08 16:51:37,55,798,22,33,461.86,803.02,0.00
2024-12-08 16:51:37,55,799,22,33,460.39,804.00,0.00
2024-12-08 16:51:37,56,799,23,33,452.16,804.02,0.00
2024-12-08 16:51:37,55,799,23,32,460.09,804.02,0.00
2024-12-08 16:51:37,55,800,23,32,461.54,805.00,0.00
2024-12-08 16:51:37,56,800,23,33,453.30,805.02,0.00
2024-12-08 16:51:37,56,801,23,33,451.70,806.00,0.00
2024-12-08 16:51:37,57,801,24,33,443.77,806.02,0.00
2024-12-08 16:51:37,56,801,24,32,451.26,806.02,0.00
2024-12-08 16:51:37,56,802,24,32,452.53,807.00,0.00
2024-12-08 16:51:37,57,802,25,32,444.59,807.02,0.00
2024-12-08 16:51:37,57,803,25,32,442.84,808.00,0.00
2024-12-08 16:51:37,58,803,26,32,435.21,808.02,0.00
2024-12-08 16:51:37,57,803,26,31,442.56,808.02,0.00
2024-12-08 16:51:37,57,804,26,31,443.57,809.00,0.00
2024-12-08 16:51:37,58,804,27,31,435.92,809.02,0.00
2024-12-08 16:51:37,57,804,26,31,439.03,809.19,0.00
2024-12-08 16:51:37,57,805,26,31,441.51,810.00,0.00
2024-12-08 16:51:37,58,805,26,32,433.89,810.02,0.00
2024-12-08 16:51:37,57,805,26,31,441.36,810.02,0.00
2024-12-08 16:51:37,56,805,25,31,443.64,810.70,0.00
2024-12-08 16:51:37,56,806,25,31,450.10,811.00,0.00
2024-12-08 16:51:37,57,806,26,31,442.20,811.02,0.00
2024-12-08 16:51:37,57,807,26,31,440.12,812.00,0.00
2024-12-08 16:51:37,58,807,27,31,432.53,812.02,0.00
2024-12-08 16:51:37,57,807,27,30,439.55,812.02,0.00
2024-12-08 16:51:37,56,807,26,30,445.86,812.16,0.00
2024-12-08 16:51:37,55,807,25,30,448.12,812.78,0.00
2024-12-08 16:51:37,55,808,25,30,461.28,813.00,0.00
2024-12-08 16:51:37,56,808,25,31,453.04,813.02,0.00
2024-12-08 16:51:37,56,809,25,31,450.94,814.00,0.00
2024-12-08 16:51:37,57,809,26,31,443.03,814.02,0.00
2024-12-08 16:51:37,56,809,26,30,450.51,814.02,0.00
2024-12-08 16:51:37,55,809,25,30,456.02,814.20,0.00
2024-12-08 16:51:37,55,810,25,30,464.82,815.00,0.00
2024-12-08 16:51:37,56,810,25,31,456.52,815.02,0.00
2024-12-08 16:51:37,56,811,25,31,454.37,816.00,0.00
2024-12-08 16:51:37,57,811,26,31,446.40,816.02,0.00
2024-12-08 16:51:37,56,811,26,30,453.64,816.02,0.00
2024-12-08 16:51:37,55,811,25,30,460.18,816.15,0.00
2024-12-08 16:51:37,55,812,25,30,462.64,817.00,0.00
2024-12-08 16:51:37,56,812,26,30,454.38,817.02,0.00
2024-12-08 16:51:37,55,812,25,30,449.24,817.96,0.00
2024-12-08 16:51:37,55,813,25,30,463.83,818.00,0.00
2024-12-08 16:51:37,56,813,25,31,455.55,818.02,0.00
2024-12-08 16:51:37,55,813,25,30,463.24,818.02,0.00
2024-12-08 16:51:37,54,813,25,29,471.03,818.07,0.00
2024-12-08 16:51:37,54,814,25,29,473.11,819.00,0.00
2024-12-08 16:51:37,55,814,25,30,464.51,819.02,0.00
2024-12-08 16:51:38,55,815,25,30,462.99,820.00,0.00
2024-12-08 16:51:38,56,815,26,30,454.72,820.02,0.00
2024-12-08 16:51:38,55,815,26,29,462.39,820.02,0.00
2024-12-08 16:51:38,54,815,25,29,464.28,820.43,0.00
2024-12-08 16:51:38,54,816,25,29,475.18,821.00,0.00
2024-12-08 16:51:38,55,816,25,30,466.54,821.02,0.00
2024-12-08 16:51:38,55,817,25,30,465.01,822.00,0.00
2024-12-08 16:51:38,56,817,26,30,456.71,822.02,0.00
2024-12-08 16:51:38,55,817,26,29,464.27,822.04,0.00
2024-12-08 16:51:38,55,818,26,29,465.88,823.00,0.00
2024-12-08 16:51:38,56,818,26,30,457.56,823.02,0.00
2024-12-08 16:51:38,56,819,26,30,455.91,824.00,0.00
2024-12-08 16:51:38,57,819,26,31,447.91,824.02,0.00
2024-12-08 16:51:38,56,819,26,30,455.03,824.04,0.00
2024-12-08 16:51:38,55,819,25,30,458.52,824.65,0.00
2024-12-08 16:51:38,54,819,24,30,463.19,824.89,0.00
2024-12-08 16:51:38,54,820,24,30,477.64,825.00,0.00
2024-12-08 16:51:38,55,820,25,30,468.96,825.02,0.00
2024-12-08 16:51:38,54,820,24,30,467.13,825.48,0.00
2024-12-08 16:51:38,54,821,24,30,478.53,826.00,0.00
2024-12-08 16:51:38,55,821,24,31,469.83,826.02,0.00
2024-12-08 16:51:38,54,821,24,30,477.00,826.04,0.00
2024-12-08 16:51:38,54,822,24,30,478.80,827.00,0.00
2024-12-08 16:51:38,55,822,24,31,470.10,827.02,0.00
2024-12-08 16:51:38,54,822,23,31,464.65,827.69,0.00
2024-12-08 16:51:38,54,823,23,31,477.63,828.00,0.00
2024-12-08 16:51:38,55,823,23,32,468.94,828.02,0.00
2024-12-08 16:51:38,54,823,23,31,475.94,828.04,0.00
2024-12-08 16:51:38,53,823,22,31,474.17,828.62,0.00
2024-12-08 16:51:38,53,824,22,31,486.98,829.00,0.00
2024-12-08 16:51:38,54,824,22,32,477.96,829.02,0.00
2024-12-08 16:51:38,54,825,22,32,476.94,830.00,0.00
2024-12-08 16:51:38,55,825,23,32,468.27,830.02,0.00
2024-12-08 16:51:38,54,825,23,31,475.10,830.04,0.00
2024-12-08 16:51:38,53,825,22,31,483.32,830.13,0.00
2024-12-08 16:51:38,52,825,21,31,484.08,830.54,0.00
2024-12-08 16:51:38,52,826,21,31,496.59,831.00,0.00
2024-12-08 16:51:38,53,826,22,31,487.22,831.02,0.00
2024-12-08 16:51:38,52,826,21,31,482.00,831.67,0.00
2024-12-08 16:51:38,52,827,21,31,495.56,832.00,0.00
2024-12-08 16:51:38,53,827,21,32,486.21,832.02,0.00
2024-12-08 16:51:38,52,827,21,31,493.64,832.04,0.00
2024-12-08 16:51:38,51,827,20,31,502.53,832.14,0.00
2024-12-08 16:51:38,51,828,20,31,505.72,833.00,0.00
2024-12-08 16:51:38,52,828,20,32,496.00,833.02,0.00
2024-12-08 16:51:38,52,829,20,32,494.92,834.00,0.00
2024-12-08 16:51:38,53,829,20,33,485.58,834.02,0.00
2024-12-08 16:51:38,52,829,20,32,493.00,834.04,0.00
2024-12-08 16:51:38,51,829,19,32,501.89,834.12,0.00
2024-12-08 16:51:38,50,829,18,32,504.01,834.50,0.00
2024-12-08 16:51:38,50,830,18,32,516.93,835.00,0.00
2024-12-08 16:51:38,51,830,19,32,506.80,835.02,0.00
2024-12-08 16:51:38,50,830,18,32,512.82,835.10,0.00
2024-12-08 16:51:38,50,831,18,32,515.92,836.00,0.00
2024-12-08 16:51:38,51,831,18,33,505.81,836.02,0.00
2024-12-08 16:51:38,50,831,18,32,513.92,836.04,0.00
2024-12-08 16:51:38,50,832,18,32,516.54,837.00,0.00
2024-12-08 16:51:38,51,832,19,32,506.41,837.02,0.00
2024-12-08 16:51:38,50,832,18,32,515.20,837.02,0.00
2024-12-08 16:51:38,50,833,18,32,521.01,838.00,0.00
2024-12-08 16:51:38,51,833,19,32,510.80,838.02,0.00
2024-12-08 16:51:38,50,833,19,31,519.34,838.02,0.00
2024-12-08 16:51:38,50,834,19,31,521.80,839.00,0.00
2024-12-08 16:51:38,51,834,19,32,511.57,839.02,0.00
2024-12-08 16:51:38,50,834,18,32,511.58,839.08,0.00
2024-12-08 16:51:38,50,835,18,32,521.25,840.00,0.00
2024-12-08 16:51:38,51,835,19,32,511.03,840.02,0.00
2024-12-08 16:51:38,50,835,19,31,518.73,840.04,0.00
2024-12-08 16:51:38,49,835,18,31,527.69,840.12,0.00
2024-12-08 16:51:38,49,836,18,31,538.07,841.00,0.00
2024-12-08 16:51:38,50,836,18,32,527.31,841.02,0.00
2024-12-08 16:51:38,50,837,18,32,526.42,842.00,0.00
2024-12-08 16:51:38,51,837,19,32,516.10,842.02,0.00
2024-12-08 16:51:38,50,837,19,31,523.90,842.04,0.00
2024-12-08 16:51:38,49,837,18,31,526.97,842.80,0.00
2024-12-08 16:51:38,49,838,18,31,542.62,843.00,0.00
2024-12-08 16:51:38,50,838,18,32,531.76,843.02,0.00
2024-12-08 16:51:38,50,839,18,32,530.88,844.00,0.00
2024-12-08 16:51:38,51,839,19,32,520.47,844.02,0.00
2024-12-08 16:51:38,50,839,19,31,528.35,844.04,0.00
2024-12-08 16:51:38,49,839,18,31,538.29,844.10,0.00
2024-12-08 16:51:38,49,840,18,31,548.56,845.00,0.00
2024-12-08 16:51:38,50,840,18,32,537.59,845.02,0.00
2024-12-08 16:51:38,50,841,18,32,536.70,846.00,0.00
2024-12-08 16:51:38,51,841,19,32,526.18,846.02,0.00
2024-12-08 16:51:38,50,841,19,31,534.34,846.04,0.00
2024-12-08 16:51:38,49,841,18,31,544.74,846.08,0.00
2024-12-08 16:51:38,49,842,18,31,554.87,847.00,0.00
2024-12-08 16:51:38,50,842,19,31,543.77,847.02,0.00
2024-12-08 16:51:38,50,843,19,31,542.89,848.00,0.00
2024-12-08 16:51:38,51,843,20,31,532.24,848.02,0.00
2024-12-08 16:51:38,50,843,20,30,540.69,848.04,0.00
2024-12-08 16:51:38,49,843,19,30,551.22,848.08,0.00
2024-12-08 16:51:39,49,844,19,30,554.45,849.00,0.00
2024-12-08 16:51:39,50,844,19,31,543.36,849.02,0.00
2024-12-08 16:51:39,50,845,19,31,542.47,850.00,0.00
2024-12-08 16:51:39,51,845,20,31,531.83,850.02,0.00
2024-12-08 16:51:39,50,845,20,30,539.92,850.04,0.00
2024-12-08 16:51:39,49,845,19,30,546.52,850.22,0.00
2024-12-08 16:51:39,49,846,19,30,557.84,851.00,0.00
2024-12-08 16:51:39,50,846,20,30,546.68,851.02,0.00
2024-12-08 16:51:39,49,846,19,30,546.03,851.41,0.00
2024-12-08 16:51:39,49,847,19,30,558.84,852.00,0.00
2024-12-08 16:51:39,50,847,20,30,547.67,852.02,0.00
2024-12-08 16:51:39,49,847,20,29,555.89,852.04,0.00
2024-12-08 16:51:39,49,848,20,29,558.80,853.00,0.00
2024-12-08 16:51:39,50,848,20,30,547.63,853.02,0.00
2024-12-08 16:51:39,50,849,20,30,546.80,854.00,0.00
2024-12-08 16:51:39,51,849,20,31,536.08,854.02,0.00
2024-12-08 16:51:39,50,849,20,30,543.38,854.04,0.00
2024-12-08 16:51:39,49,849,19,30,546.56,854.39,0.00
2024-12-08 16:51:39,49,850,19,30,559.24,855.00,0.00
2024-12-08 16:51:39,50,850,20,30,548.05,855.02,0.00
2024-12-08 16:51:39,50,851,20,30,547.17,856.00,0.00
2024-12-08 16:51:39,51,851,20,31,536.44,856.02,0.00
2024-12-08 16:51:39,50,851,20,30,543.92,856.04,0.00
2024-12-08 16:51:39,50,852,20,30,546.61,857.00,0.00
2024-12-08 16:51:39,51,852,20,31,535.89,857.02,0.00
2024-12-08 16:51:39,51,853,20,31,534.90,858.00,0.00
2024-12-08 16:51:39,52,853,20,32,524.61,858.02,0.00
2024-12-08 16:51:39,51,853,20,31,531.87,858.04,0.00
2024-12-08 16:51:39,50,853,19,31,533.24,858.48,0.00
2024-12-08 16:51:39,50,854,19,31,546.34,859.00,0.00
2024-12-08 16:51:39,51,854,20,31,535.63,859.02,0.00
2024-12-08 16:51:39,50,854,19,31,532.35,859.54,0.00
2024-12-08 16:51:39,50,855,19,31,545.94,860.00,0.00
2024-12-08 16:51:39,51,855,20,31,535.24,860.02,0.00
2024-12-08 16:51:39,50,855,20,30,543.02,860.04,0.00
2024-12-08 16:51:39,50,856,20,30,545.72,861.00,0.00
2024-12-08 16:51:39,51,856,21,30,535.02,861.02,0.00
2024-12-08 16:51:39,51,857,21,30,533.95,862.00,0.00
2024-12-08 16:51:39,52,857,22,30,523.68,862.02,0.00
2024-12-08 16:51:39,51,857,22,29,531.25,862.04,0.00
2024-12-08 16:51:39,51,858,22,29,533.72,863.00,0.00
2024-12-08 16:51:39,52,858,22,30,523.46,863.02,0.00
2024-12-08 16:51:39,52,859,22,30,522.28,864.00,0.00
2024-12-08 16:51:39,53,859,22,31,512.43,864.02,0.00
2024-12-08 16:51:39,52,859,22,30,519.79,864.04,0.00
2024-12-08 16:51:39,51,859,21,30,520.15,864.92,0.00
2024-12-08 16:51:39,51,860,21,30,536.49,865.00,0.00
2024-12-08 16:51:39,52,860,22,30,526.17,865.02,0.00
2024-12-08 16:51:39,51,860,21,30,524.59,865.84,0.00
2024-12-08 16:51:39,51,861,21,30,540.33,866.00,0.00
2024-12-08 16:51:39,52,861,21,31,529.94,866.02,0.00
2024-12-08 16:51:39,51,861,21,30,537.45,866.04,0.00
2024-12-08 16:51:39,51,862,21,30,539.94,867.00,0.00
2024-12-08 16:51:39,52,862,21,31,529.55,867.02,0.00
2024-12-08 16:51:39,52,863,21,31,528.83,868.00,0.00
2024-12-08 16:51:39,53,863,21,32,518.85,868.02,0.00
2024-12-08 16:51:39,52,863,20,32,528.66,868.02,0.00
2024-12-08 16:51:39,51,863,20,31,535.96,868.02,0.00
2024-12-08 16:51:39,51,864,20,31,538.29,869.00,0.00
2024-12-08 16:51:39,52,864,20,32,527.93,869.02,0.00
2024-12-08 16:51:39,52,865,20,32,527.66,870.00,0.00
2024-12-08 16:51:39,53,865,21,32,517.71,870.02,0.00
2024-12-08 16:51:39,52,865,20,32,527.50,870.04,0.00
2024-12-08 16:51:39,51,865,20,31,534.26,870.04,0.00
2024-12-08 16:51:39,50,865,19,31,539.68,870.22,0.00
2024-12-08 16:51:39,50,866,19,31,550.84,871.00,0.00
2024-12-08 16:51:39,51,866,20,31,540.04,871.02,0.00
2024-12-08 16:51:39,51,867,20,31,539.86,872.00,0.00
2024-12-08 16:51:39,52,867,21,31,529.48,872.02,0.00
2024-12-08 16:51:39,51,867,20,31,539.52,872.04,0.00
2024-12-08 16:51:39,51,868,20,31,538.59,873.00,0.00
2024-12-08 16:51:39,52,868,21,31,528.24,873.02,0.00
2024-12-08 16:51:39,51,868,21,30,538.26,873.04,0.00
2024-12-08 16:51:39,50,868,20,30,539.57,873.44,0.00
2024-12-08 16:51:39,50,869,20,30,552.56,874.00,0.00
2024-12-08 16:51:39,51,869,21,30,541.73,874.02,0.00
2024-12-08 16:51:39,50,869,20,30,538.18,874.58,0.00
2024-12-08 16:51:39,50,870,20,30,552.33,875.00,0.00
2024-12-08 16:51:39,51,870,21,30,541.50,875.02,0.00
2024-12-08 16:51:39,50,870,21,29,548.48,875.04,0.00
2024-12-08 16:51:39,50,871,21,29,551.20,876.00,0.00
2024-12-08 16:51:39,51,871,21,30,540.40,876.02,0.00
2024-12-08 16:51:39,50,871,20,30,550.15,876.04,0.00
2024-12-08 16:51:39,50,872,20,30,556.39,877.00,0.00
2024-12-08 16:51:39,51,872,21,30,545.48,877.02,0.00
2024-12-08 16:51:39,51,873,21,30,544.38,878.00,0.00
2024-12-08 16:51:40,52,873,21,31,533.91,878.02,0.00
2024-12-08 16:51:40,51,873,21,30,544.04,878.04,0.00
2024-12-08 16:51:40,51,874,21,30,546.55,879.00,0.00
2024-12-08 16:51:40,52,874,21,31,536.04,879.02,0.00
2024-12-08 16:51:40,51,874,20,31,533.35,879.51,0.00
2024-12-08 16:51:40,51,875,20,31,546.65,880.00,0.00
2024-12-08 16:51:40,52,875,21,31,536.14,880.02,0.00
2024-12-08 16:51:40,51,875,21,30,543.03,880.04,0.00
2024-12-08 16:51:40,51,876,21,30,545.55,881.00,0.00
2024-12-08 16:51:40,52,876,22,30,535.05,881.02,0.00
2024-12-08 16:51:40,52,877,22,30,534.60,882.00,0.00
2024-12-08 16:51:40,53,877,22,31,524.52,882.02,0.00
2024-12-08 16:51:40,52,877,22,30,531.05,882.04,0.00
2024-12-08 16:51:40,52,878,22,30,533.34,883.00,0.00
2024-12-08 16:51:40,53,878,23,30,523.28,883.02,0.00
2024-12-08 16:51:40,53,879,23,30,522.84,884.00,0.00
2024-12-08 16:51:40,54,879,23,31,513.16,884.02,0.00
2024-12-08 16:51:40,53,879,23,30,519.34,884.04,0.00
2024-12-08 16:51:40,52,879,22,30,519.95,884.83,0.00
2024-12-08 16:51:40,52,880,22,30,535.57,885.00,0.00
2024-12-08 16:51:40,53,880,22,31,525.47,885.02,0.00
2024-12-08 16:51:40,53,881,22,31,524.96,886.00,0.00
2024-12-08 16:51:40,54,881,22,32,515.24,886.02,0.00
2024-12-08 16:51:40,53,881,22,31,521.62,886.04,0.00
2024-12-08 16:51:40,52,881,21,31,523.80,886.75,0.00
2024-12-08 16:51:40,52,882,21,31,538.83,887.00,0.00
2024-12-08 16:51:40,53,882,21,32,528.66,887.02,0.00
2024-12-08 16:51:40,53,883,21,32,528.19,888.00,0.00
2024-12-08 16:51:40,54,883,21,33,518.41,888.02,0.00
2024-12-08 16:51:40,53,883,21,32,524.85,888.04,0.00
2024-12-08 16:51:40,52,883,20,32,526.62,888.40,0.00
2024-12-08 16:51:40,52,884,20,32,538.85,889.00,0.00
2024-12-08 16:51:40,53,884,20,33,528.68,889.02,0.00
2024-12-08 16:51:40,52,884,19,33,531.55,889.23,0.00
2024-12-08 16:51:40,52,885,19,33,542.35,890.00,0.00
2024-12-08 16:51:40,53,885,20,33,532.11,890.02,0.00
2024-12-08 16:51:40,52,885,20,32,539.10,890.04,0.00
2024-12-08 16:51:40,52,886,20,32,541.41,891.00,0.00
2024-12-08 16:51:40,53,886,20,33,531.20,891.02,0.00
2024-12-08 16:51:40,52,886,19,33,532.61,891.31,0.00
2024-12-08 16:51:40,52,887,19,33,544.08,892.00,0.00
2024-12-08 16:51:40,53,887,19,34,533.81,892.02,0.00
2024-12-08 16:51:40,52,887,19,33,541.00,892.04,0.00
2024-12-08 16:51:40,52,888,19,33,543.32,893.00,0.00
2024-12-08 16:51:40,53,888,19,34,533.06,893.02,0.00
2024-12-08 16:51:40,52,888,18,34,534.35,893.65,0.00
2024-12-08 16:51:40,52,889,18,34,542.60,894.00,0.00
2024-12-08 16:51:40,53,889,18,35,532.36,894.02,0.00
2024-12-08 16:51:40,52,889,18,34,539.68,894.04,0.00
2024-12-08 16:51:40,51,889,17,34,542.02,894.76,0.00
2024-12-08 16:51:40,51,890,17,34,557.67,895.00,0.00
2024-12-08 16:51:40,52,890,17,35,546.94,895.02,0.00
2024-12-08 16:51:40,52,891,17,35,546.32,896.00,0.00
2024-12-08 16:51:40,53,891,18,35,536.01,896.02,0.00
2024-12-08 16:51:40,52,891,18,34,543.22,896.04,0.00
2024-12-08 16:51:40,52,892,18,34,545.55,897.00,0.00
2024-12-08 16:51:40,53,892,19,34,535.26,897.02,0.00
2024-12-08 16:51:40,52,892,18,34,534.14,897.42,0.00
2024-12-08 16:51:40,52,893,18,34,546.67,898.00,0.00
2024-12-08 16:51:40,53,893,19,34,536.36,898.02,0.00
2024-12-08 16:51:40,52,893,19,33,543.74,898.04,0.00
2024-12-08 16:51:40,51,893,18,33,554.06,898.08,0.00
2024-12-08 16:51:40,50,893,17,33,564.97,898.08,0.00
2024-12-08 16:51:40,50,894,17,33,568.10,899.00,0.00
2024-12-08 16:51:40,51,894,18,33,556.96,899.02,0.00
2024-12-08 16:51:40,51,895,18,33,555.93,900.00,0.00
2024-12-08 16:51:40,52,895,19,33,545.24,900.02,0.00
2024-12-08 16:51:40,51,895,19,32,553.11,900.04,0.00
2024-12-08 16:51:40,51,896,19,32,555.67,901.00,0.00
2024-12-08 16:51:40,52,896,20,32,544.98,901.02,0.00
2024-12-08 16:51:40,52,897,20,32,543.99,902.00,0.00
2024-12-08 16:51:40,53,897,20,33,533.72,902.02,0.00
2024-12-08 16:51:40,52,897,20,32,541.21,902.04,0.00
2024-12-08 16:51:40,51,897,19,32,541.27,902.92,0.00
2024-12-08 16:51:40,51,898,19,32,558.32,903.00,0.00
2024-12-08 16:51:40,52,898,20,32,547.58,903.02,0.00
2024-12-08 16:51:40,51,898,19,32,546.81,903.37,0.00
2024-12-08 16:51:40,51,899,19,32,559.33,904.00,0.00
2024-12-08 16:51:40,52,899,20,32,548.58,904.02,0.00
2024-12-08 16:51:40,51,899,20,31,556.32,904.04,0.00
2024-12-08 16:51:40,51,900,20,31,558.89,905.00,0.00
2024-12-08 16:51:40,52,900,20,32,548.14,905.02,0.00
2024-12-08 16:51:40,52,901,20,32,547.30,906.00,0.00
2024-12-08 16:51:40,53,901,21,32,536.97,906.02,0.00
2024-12-08 16:51:40,52,901,21,31,544.34,906.04,0.00
2024-12-08 16:51:40,51,901,20,31,544.92,906.88,0.00
2024-12-08 16:51:40,51,902,20,31,561.72,907.00,0.00
2024-12-08 16:51:40,52,902,20,32,550.92,907.02,0.00
2024-12-08 16:51:40,51,902,19,32,551.06,907.06,0.00
2024-12-08 16:51:40,51,903,19,32,560.92,908.00,0.00
2024-12-08 16:51:40,52,903,20,32,550.13,908.02,0.00
2024-12-08 16:51:40,51,903,19,32,560.74,908.02,0.00
2024-12-08 16:51:40,50,903,19,31,569.05,908.02,0.00
2024-12-08 16:51:40,49,903,18,31,573.26,908.04,0.00
2024-12-08 16:51:40,48,903,17,31,585.01,908.04,0.00
2024-12-08 16:51:41,48,904,17,31,595.87,909.00,0.00
2024-12-08 16:51:41,49,904,17,32,583.71,909.02,0.00
2024-12-08 16:51:41,49,905,17,32,582.87,910.00,0.00
2024-12-08 16:51:41,50,905,18,32,571.21,910.02,0.00
2024-12-08 16:51:41,49,905,18,31,579.90,910.02,0.00
2024-12-08 16:51:41,49,906,18,31,582.77,911.00,0.00
2024-12-08 16:51:41,50,906,18,32,571.11,911.02,0.00
2024-12-08 16:51:41,49,906,17,32,567.75,911.96,0.00
2024-12-08 16:51:41,49,907,17,32,586.01,912.00,0.00
2024-12-08 16:51:41,50,907,18,32,574.29,912.02,0.00
2024-12-08 16:51:41,49,907,18,31,582.66,912.02,0.00
2024-12-08 16:51:41,49,908,18,31,585.54,913.00,0.00
2024-12-08 16:51:41,50,908,18,32,573.83,913.02,0.00
2024-12-08 16:51:41,50,909,18,32,573.38,914.00,0.00
2024-12-08 16:51:41,51,909,19,32,562.14,914.02,0.00
2024-12-08 16:51:41,50,909,19,31,569.72,914.02,0.00
2024-12-08 16:51:41,49,909,18,31,576.28,914.59,0.00
2024-12-08 16:51:41,49,910,18,31,584.07,915.00,0.00
2024-12-08 16:51:41,50,910,19,31,572.39,915.02,0.00
2024-12-08 16:51:41,49,910,18,31,572.16,915.76,0.00
2024-12-08 16:51:41,49,911,18,31,588.80,916.00,0.00
2024-12-08 16:51:41,50,911,18,32,577.02,916.02,0.00
2024-12-08 16:51:41,49,911,18,31,585.25,916.02,0.00
2024-12-08 16:51:41,49,912,18,31,588.13,917.00,0.00
2024-12-08 16:51:41,50,912,18,32,576.37,917.02,0.00
2024-12-08 16:51:41,49,912,17,32,582.73,917.10,0.00
2024-12-08 16:51:41,49,913,17,32,593.83,918.00,0.00
2024-12-08 16:51:41,50,913,17,33,581.96,918.02,0.00
2024-12-08 16:51:41,49,913,17,32,590.27,918.02,0.00
2024-12-08 16:51:41,49,914,17,32,593.17,919.00,0.00
2024-12-08 16:51:41,50,914,18,32,581.30,919.02,0.00
2024-12-08 16:51:41,50,915,18,32,580.39,920.00,0.00
2024-12-08 16:51:41,51,915,18,33,569.01,920.02,0.00
2024-12-08 16:51:41,50,915,18,32,577.08,920.02,0.00
2024-12-08 16:51:41,49,915,17,32,576.12,920.63,0.00
2024-12-08 16:51:41,49,916,17,32,591.83,921.00,0.00
2024-12-08 16:51:41,50,916,18,32,579.99,921.02,0.00
2024-12-08 16:51:41,49,916,17,32,587.88,921.04,0.00
2024-12-08 16:51:41,49,917,17,32,591.04,922.00,0.00
2024-12-08 16:51:41,50,917,17,33,579.22,922.02,0.00
2024-12-08 16:51:41,49,917,17,32,587.85,922.02,0.00
2024-12-08 16:51:41,48,917,16,32,594.22,922.65,0.00
2024-12-08 16:51:41,48,918,16,32,610.47,923.00,0.00
2024-12-08 16:51:41,49,918,16,33,598.01,923.02,0.00
2024-12-08 16:51:41,49,919,16,33,597.24,924.00,0.00
2024-12-08 16:51:41,50,919,16,34,585.30,924.02,0.00
2024-12-08 16:51:41,49,919,16,33,593.47,924.02,0.00
2024-12-08 16:51:41,49,920,16,33,596.38,925.00,0.00
2024-12-08 16:51:41,50,920,16,34,584.45,925.02,0.00
2024-12-08 16:51:41,50,921,16,34,583.72,926.00,0.00
2024-12-08 16:51:41,51,921,17,34,572.27,926.02,0.00
2024-12-08 16:51:41,50,921,17,33,580.20,926.02,0.00
2024-12-08 16:51:41,49,921,16,33,579.38,926.59,0.00
2024-12-08 16:51:41,49,922,16,33,594.83,927.00,0.00
2024-12-08 16:51:41,50,922,17,33,582.93,927.02,0.00
2024-12-08 16:51:41,50,923,17,33,582.31,928.00,0.00
2024-12-08 16:51:41,51,923,17,34,570.89,928.02,0.00
2024-12-08 16:51:41,50,923,17,33,578.78,928.02,0.00
2024-12-08 16:51:41,49,923,16,33,582.27,928.76,0.00
2024-12-08 16:51:41,49,924,16,33,599.15,929.00,0.00
2024-12-08 16:51:41,50,924,16,34,587.17,929.02,0.00
2024-12-08 16:51:41,50,925,16,34,586.42,930.00,0.00
2024-12-08 16:51:41,51,925,16,35,574.92,930.02,0.00
2024-12-08 16:51:41,50,925,16,34,583.07,930.02,0.00
2024-12-08 16:51:41,49,925,15,34,594.42,930.06,0.00
2024-12-08 16:51:41,49,926,15,34,597.70,931.00,0.00
2024-12-08 16:51:41,50,926,16,34,585.74,931.02,0.00
2024-12-08 16:51:41,50,927,16,34,584.92,932.00,0.00
2024-12-08 16:51:41,51,927,16,35,573.46,932.02,0.00
2024-12-08 16:51:41,50,927,16,34,581.76,932.02,0.00
2024-12-08 16:51:41,49,927,15,34,588.57,932.59,0.00
2024-12-08 16:51:41,49,928,15,34,596.51,933.00,0.00
2024-12-08 16:51:41,50,928,15,35,584.58,933.02,0.00
2024-12-08 16:51:41,50,929,15,35,583.63,934.00,0.00
2024-12-08 16:51:41,51,929,15,36,572.18,934.02,0.00
2024-12-08 16:51:41,50,929,15,35,580.64,934.02,0.00
2024-12-08 16:51:41,49,929,14,35,585.05,934.02,0.00
2024-12-08 16:51:41,48,929,13,35,592.18,934.58,0.00
2024-12-08 16:51:41,48,930,13,35,608.09,935.00,0.00
2024-12-08 16:51:41,49,930,14,35,595.68,935.02,0.00
2024-12-08 16:51:41,49,931,14,35,595.43,936.00,0.00
2024-12-08 16:51:41,50,931,14,36,583.52,936.02,0.00
2024-12-08 16:51:41,49,931,13,36,595.30,936.02,0.00
2024-12-08 16:51:41,48,931,13,35,603.60,936.02,0.00
2024-12-08 16:51:41,48,932,13,35,606.79,937.00,0.00
2024-12-08 16:51:41,49,932,14,35,594.40,937.02,0.00
2024-12-08 16:51:41,49,933,14,35,594.12,938.00,0.00
2024-12-08 16:51:41,50,933,14,36,582.24,938.02,0.00
2024-12-08 16:51:41,49,933,14,35,589.92,938.04,0.00
2024-12-08 16:51:41,49,934,14,35,593.03,939.00,0.00
2024-12-08 16:51:41,50,934,14,36,581.17,939.02,0.00
2024-12-08 16:51:42,50,935,14,36,580.75,940.00,0.00
2024-12-08 16:51:42,51,935,15,36,569.36,940.02,0.00
2024-12-08 16:51:42,50,935,15,35,576.81,940.04,0.00
2024-12-08 16:51:42,49,935,14,35,583.60,940.59,0.00
2024-12-08 16:51:42,48,935,13,35,588.52,940.96,0.00
2024-12-08 16:51:42,48,936,13,35,607.75,941.00,0.00
2024-12-08 16:51:42,49,936,14,35,595.35,941.02,0.00
2024-12-08 16:51:42,49,937,14,35,594.97,942.00,0.00
2024-12-08 16:51:42,50,937,15,35,583.07,942.02,0.00
2024-12-08 16:51:42,49,937,15,34,590.56,942.06,0.00
2024-12-08 16:51:42,49,938,15,34,593.87,943.00,0.00
2024-12-08 16:51:42,50,938,15,35,581.99,943.02,0.00
2024-12-08 16:51:42,50,939,15,35,581.63,944.00,0.00
2024-12-08 16:51:42,51,939,15,36,570.22,944.02,0.00
2024-12-08 16:51:42,50,939,15,35,577.11,944.08,0.00
2024-12-08 16:51:42,49,939,14,35,582.86,944.31,0.00
2024-12-08 16:51:42,49,940,14,35,596.09,945.00,0.00
2024-12-08 16:51:42,50,940,14,36,584.17,945.02,0.00
2024-12-08 16:51:42,50,941,14,36,583.73,946.00,0.00
2024-12-08 16:51:42,51,941,15,36,572.29,946.02,0.00
2024-12-08 16:51:42,50,941,15,35,579.40,946.08,0.00
2024-12-08 16:51:42,49,941,14,35,584.29,946.33,0.00
2024-12-08 16:51:42,49,942,14,35,597.74,947.00,0.00
2024-12-08 16:51:42,50,942,14,36,585.78,947.02,0.00
2024-12-08 16:51:42,49,942,13,36,597.30,947.06,0.00
2024-12-08 16:51:42,49,943,13,36,597.36,948.00,0.00
2024-12-08 16:51:42,50,943,14,36,585.41,948.02,0.00
2024-12-08 16:51:42,49,943,14,35,593.31,948.06,0.00
2024-12-08 16:51:42,49,944,14,35,596.63,949.00,0.00
2024-12-08 16:51:42,50,944,14,36,584.70,949.02,0.00
2024-12-08 16:51:42,50,945,14,36,583.99,950.00,0.00
2024-12-08 16:51:42,51,945,15,36,572.54,950.02,0.00
2024-12-08 16:51:42,50,945,15,35,580.20,950.06,0.00
2024-12-08 16:51:42,50,946,15,35,583.27,951.00,0.00
2024-12-08 16:51:42,51,946,16,35,571.83,951.02,0.00
2024-12-08 16:51:42,51,947,16,35,571.14,952.00,0.00
2024-12-08 16:51:42,52,947,17,35,560.16,952.02,0.00
2024-12-08 16:51:42,51,947,17,34,567.61,952.06,0.00
2024-12-08 16:51:42,51,948,17,34,570.44,953.00,0.00
2024-12-08 16:51:42,52,948,17,35,559.47,953.02,0.00
2024-12-08 16:51:42,51,948,16,35,562.22,953.51,0.00
2024-12-08 16:51:42,51,949,16,35,569.86,954.00,0.00
2024-12-08 16:51:42,52,949,17,35,558.90,954.02,0.00
2024-12-08 16:51:42,51,949,17,34,566.50,954.06,0.00
2024-12-08 16:51:42,50,949,16,34,573.73,954.50,0.00
2024-12-08 16:51:42,50,950,16,34,588.41,955.00,0.00
2024-12-08 16:51:42,51,950,17,34,576.87,955.02,0.00
2024-12-08 16:51:42,50,950,16,34,576.76,955.72,0.00
2024-12-08 16:51:42,50,951,16,34,593.42,956.00,0.00
2024-12-08 16:51:42,51,951,16,35,581.78,956.02,0.00
2024-12-08 16:51:42,50,951,16,34,589.99,956.06,0.00
2024-12-08 16:51:42,50,952,16,34,593.08,957.00,0.00
2024-12-08 16:51:42,51,952,16,35,581.45,957.02,0.00
2024-12-08 16:51:42,50,952,15,35,588.03,957.14,0.00
2024-12-08 16:51:42,50,953,15,35,592.03,958.00,0.00
2024-12-08 16:51:42,51,953,16,35,580.42,958.02,0.00
2024-12-08 16:51:42,50,953,16,34,588.78,958.06,0.00
2024-12-08 16:51:42,50,954,16,34,591.88,959.00,0.00
2024-12-08 16:51:42,51,954,16,35,580.27,959.02,0.00
2024-12-08 16:51:42,51,955,16,35,579.00,960.00,0.00
2024-12-08 16:51:42,52,955,17,35,567.86,960.02,0.00
2024-12-08 16:51:42,51,955,17,34,575.99,960.06,0.00
2024-12-08 16:51:42,50,955,16,34,580.92,960.32,0.00
2024-12-08 16:51:42,50,956,16,34,594.07,961.00,0.00
2024-12-08 16:51:42,51,956,17,34,582.43,961.02,0.00
2024-12-08 16:51:42,51,957,17,34,581.15,962.00,0.00
2024-12-08 16:51:42,52,957,17,35,569.97,962.02,0.00
2024-12-08 16:51:42,51,957,17,34,578.32,962.06,0.00
2024-12-08 16:51:42,51,958,17,34,581.18,963.00,0.00
2024-12-08 16:51:42,52,958,18,34,570.01,963.02,0.00
2024-12-08 16:51:42,52,959,18,34,568.56,964.00,0.00
2024-12-08 16:51:42,53,959,18,35,557.83,964.02,0.00
2024-12-08 16:51:42,52,959,18,34,565.97,964.06,0.00
2024-12-08 16:51:42,52,960,18,34,568.59,965.00,0.00
2024-12-08 16:51:42,53,960,18,35,557.86,965.02,0.00
2024-12-08 16:51:42,53,961,18,35,557.15,966.00,0.00
2024-12-08 16:51:42,54,961,19,35,546.83,966.02,0.00
2024-12-08 16:51:42,53,961,19,34,553.69,966.06,0.00
2024-12-08 16:51:42,52,961,18,34,559.79,966.54,0.00
2024-12-08 16:51:42,52,962,18,34,574.23,967.00,0.00
2024-12-08 16:51:42,53,962,19,34,563.40,967.02,0.00
2024-12-08 16:51:42,53,963,19,34,562.83,968.00,0.00
2024-12-08 16:51:42,54,963,19,35,552.41,968.02,0.00
2024-12-08 16:51:42,53,963,19,34,559.19,968.06,0.00
2024-12-08 16:51:42,53,964,19,34,561.59,969.00,0.00
2024-12-08 16:51:42,54,964,19,35,551.19,969.02,0.00
2024-12-08 16:51:43,53,964,18,35,550.59,969.36,0.00
2024-12-08 16:51:43,53,965,18,35,563.08,970.00,0.00
2024-12-08 16:51:43,54,965,19,35,552.65,970.02,0.00
2024-12-08 16:51:43,53,965,19,34,559.43,970.06,0.00
2024-12-08 16:51:43,52,965,18,34,565.60,970.56,0.00
2024-12-08 16:51:43,52,966,18,34,572.80,971.00,0.00
2024-12-08 16:51:43,53,966,18,35,562.00,971.02,0.00
2024-12-08 16:51:43,53,967,18,35,561.48,972.00,0.00
2024-12-08 16:51:43,54,967,18,36,551.08,972.02,0.00
2024-12-08 16:51:43,53,967,18,35,557.81,972.06,0.00
2024-12-08 16:51:43,52,967,17,35,563.43,972.62,0.00
2024-12-08 16:51:43,52,968,17,35,571.18,973.00,0.00
2024-12-08 16:51:43,53,968,17,36,560.40,973.02,0.00
2024-12-08 16:51:43,52,968,16,36,561.79,973.62,0.00
2024-12-08 16:51:43,52,969,16,36,570.67,974.00,0.00
2024-12-08 16:51:43,53,969,16,37,559.90,974.02,0.00
2024-12-08 16:51:43,52,969,16,36,566.93,974.06,0.00
2024-12-08 16:51:43,51,969,15,36,568.91,974.76,0.00
2024-12-08 16:51:43,51,970,15,36,585.90,975.00,0.00
2024-12-08 16:51:43,52,970,16,36,574.64,975.02,0.00
2024-12-08 16:51:43,52,971,16,36,574.08,976.00,0.00
2024-12-08 16:51:43,53,971,16,37,563.25,976.02,0.00
2024-12-08 16:51:43,52,971,16,36,570.33,976.06,0.00
2024-12-08 16:51:43,51,971,15,36,569.91,976.53,0.00
2024-12-08 16:51:43,51,972,15,36,584.81,977.00,0.00
2024-12-08 16:51:43,52,972,16,36,573.56,977.02,0.00
2024-12-08 16:51:43,51,972,15,36,584.62,977.02,0.00
2024-12-08 16:51:43,51,973,15,36,584.49,978.00,0.00
2024-12-08 16:51:43,52,973,15,37,573.25,978.02,0.00
2024-12-08 16:51:43,51,973,15,36,580.48,978.06,0.00
2024-12-08 16:51:43,51,974,15,36,583.36,979.00,0.00
2024-12-08 16:51:43,52,974,16,36,572.15,979.02,0.00
2024-12-08 16:51:43,52,975,16,36,571.63,980.00,0.00
2024-12-08 16:51:43,53,975,16,37,560.85,980.02,0.00
2024-12-08 16:51:43,52,975,15,37,571.44,980.02,0.00
2024-12-08 16:51:43,51,975,15,36,579.00,980.04,0.00
2024-12-08 16:51:43,51,976,15,36,581.70,981.00,0.00
2024-12-08 16:51:43,52,976,15,37,570.52,981.02,0.00
2024-12-08 16:51:43,51,976,14,37,570.16,981.67,0.00
2024-12-08 16:51:43,51,977,14,37,586.40,982.00,0.00
2024-12-08 16:51:43,52,977,14,38,575.12,982.02,0.00
2024-12-08 16:51:43,51,977,14,37,582.94,982.04,0.00
2024-12-08 16:51:43,51,978,14,37,585.64,983.00,0.00
2024-12-08 16:51:43,52,978,15,37,574.38,983.02,0.00
2024-12-08 16:51:43,53,977,16,37,552.14,983.89,0.00
2024-12-08 16:51:43,53,978,16,37,564.18,984.00,0.00
2024-12-08 16:51:43,54,978,17,37,553.74,984.02,0.00
2024-12-08 16:51:43,53,978,17,36,560.85,984.04,0.00
2024-12-08 16:51:43,53,979,17,36,581.67,985.00,0.00
2024-12-08 16:51:43,54,979,17,37,570.90,985.02,0.00
2024-12-08 16:51:43,54,980,17,37,570.08,986.00,0.00
2024-12-08 16:51:43,55,980,17,38,559.72,986.02,0.00
2024-12-08 16:51:43,54,980,17,37,566.80,986.04,0.00
2024-12-08 16:51:43,53,980,16,37,572.65,986.55,0.00
2024-12-08 16:51:43,53,981,16,37,587.13,987.00,0.00
2024-12-08 16:51:43,54,981,16,38,576.26,987.02,0.00
2024-12-08 16:51:43,54,982,16,38,575.32,988.00,0.00
2024-12-08 16:51:43,55,982,17,38,564.86,988.02,0.00
2024-12-08 16:51:43,54,982,17,37,572.22,988.04,0.00
2024-12-08 16:51:43,53,982,16,37,577.71,988.60,0.00
2024-12-08 16:51:43,53,983,16,37,585.28,989.00,0.00
2024-12-08 16:51:43,54,983,17,37,574.44,989.02,0.00
2024-12-08 16:51:43,53,983,16,37,569.25,989.92,0.00
2024-12-08 16:51:43,53,984,16,37,587.24,990.00,0.00
2024-12-08 16:51:43,54,984,17,37,576.36,990.02,0.00
2024-12-08 16:51:43,53,984,17,36,584.25,990.04,0.00
2024-12-08 16:51:43,53,985,17,36,586.52,991.00,0.00
2024-12-08 16:51:43,54,985,17,37,575.66,991.02,0.00
2024-12-08 16:51:43,54,986,17,37,574.42,992.00,0.00
2024-12-08 16:51:43,55,986,18,37,563.97,992.02,0.00
2024-12-08 16:51:43,54,986,18,36,571.67,992.04,0.00
2024-12-08 16:51:43,53,986,17,36,573.75,992.38,0.00
2024-12-08 16:51:43,53,987,17,36,586.74,993.00,0.00
2024-12-08 16:51:43,54,987,18,36,575.87,993.02,0.00
2024-12-08 16:51:43,54,988,18,36,574.90,994.00,0.00
2024-12-08 16:51:43,55,988,19,36,564.44,994.02,0.00
2024-12-08 16:51:43,54,988,19,35,571.96,994.04,0.00
2024-12-08 16:51:43,54,989,19,35,574.00,995.00,0.00
2024-12-08 16:51:43,55,989,20,35,563.57,995.02,0.00
2024-12-08 16:51:43,55,990,20,35,562.51,996.00,0.00
2024-12-08 16:51:43,56,990,21,35,552.47,996.02,0.00
2024-12-08 16:51:43,55,990,21,34,559.80,996.04,0.00
2024-12-08 16:51:43,54,990,20,34,569.46,996.11,0.00
2024-12-08 16:51:43,54,991,20,34,572.21,997.00,0.00
2024-12-08 16:51:43,55,991,20,35,561.81,997.02,0.00
2024-12-08 16:51:43,54,991,19,35,562.17,997.31,0.00
2024-12-08 16:51:43,53,991,18,35,571.01,997.51,0.00
2024-12-08 16:51:43,53,992,18,35,585.29,998.00,0.00
2024-12-08 16:51:43,54,992,19,35,574.45,998.02,0.00
2024-12-08 16:51:43,53,992,19,34,582.65,998.04,0.00
2024-12-08 16:51:44,53,993,19,34,584.93,999.00,0.00
2024-12-08 16:51:44,54,993,20,34,574.10,999.02,0.00
2024-12-08 16:51:44,54,994,20,34,572.85,1000.00,0.00
2024-12-08 16:51:44,55,994,20,35,562.43,1000.02,0.00
2024-12-08 16:51:44,54,994,20,34,570.26,1000.04,0.00
2024-12-08 16:51:44,54,995,20,34,572.31,1001.00,0.00
2024-12-08 16:51:44,55,995,21,34,561.90,1001.02,0.00
2024-12-08 16:51:44,54,995,20,34,561.45,1001.32,0.00
2024-12-08 16:51:44,54,996,20,34,573.59,1002.00,0.00
2024-12-08 16:51:44,55,996,20,35,563.16,1002.02,0.00
2024-12-08 16:51:44,54,996,20,34,571.18,1002.04,0.00
2024-12-08 16:51:44,53,996,19,34,577.06,1002.55,0.00
2024-12-08 16:51:44,53,997,19,34,584.17,1003.00,0.00
2024-12-08 16:51:44,54,997,19,35,573.35,1003.02,0.00
2024-12-08 16:51:44,53,997,18,35,575.16,1003.57,0.00
2024-12-08 16:51:44,53,998,18,35,582.63,1004.00,0.00
2024-12-08 16:51:44,54,998,19,35,571.84,1004.02,0.00
2024-12-08 16:51:44,53,998,19,34,580.36,1004.04,0.00
2024-12-08 16:51:44,52,998,18,34,579.17,1004.96,0.00
2024-12-08 16:51:44,52,999,18,34,598.13,1005.00,0.00
2024-12-08 16:51:44,53,999,19,34,586.84,1005.02,0.00
2024-12-08 16:51:44,53,1000,19,34,585.15,1006.00,0.00
2024-12-08 16:51:44,54,1000,19,35,574.31,1006.02,0.00
2024-12-08 16:51:44,53,1000,19,34,582.87,1006.04,0.00
2024-12-08 16:51:44,53,1001,19,34,585.16,1007.00,0.00
2024-12-08 16:51:44,54,1001,20,34,574.32,1007.02,0.00
2024-12-08 16:51:44,54,1002,20,34,572.64,1008.00,0.00
2024-12-08 16:51:44,55,1002,21,34,562.23,1008.02,0.00
2024-12-08 16:51:44,54,1002,21,33,570.40,1008.04,0.00
2024-12-08 16:51:44,54,1003,21,33,572.46,1009.00,0.00
2024-12-08 16:51:44,55,1003,22,33,562.06,1009.02,0.00
2024-12-08 16:51:44,54,1003,21,33,566.90,1009.17,0.00
2024-12-08 16:51:44,54,1004,21,33,577.71,1010.00,0.00
2024-12-08 16:51:44,55,1004,21,34,567.20,1010.02,0.00
2024-12-08 16:51:44,54,1004,21,33,575.65,1010.04,0.00
2024-12-08 16:51:44,54,1005,21,33,577.72,1011.00,0.00
2024-12-08 16:51:44,55,1005,22,33,567.21,1011.02,0.00
2024-12-08 16:51:44,54,1005,21,33,562.62,1011.54,0.00
2024-12-08 16:51:44,54,1006,21,33,576.99,1012.00,0.00
2024-12-08 16:51:44,55,1006,22,33,566.50,1012.02,0.00
2024-12-08 16:51:44,54,1006,22,32,574.37,1012.06,0.00
2024-12-08 16:51:44,54,1007,22,32,576.62,1013.00,0.00
2024-12-08 16:51:44,55,1007,22,33,566.13,1013.02,0.00
2024-12-08 16:51:44,55,1008,22,33,564.36,1014.00,0.00
2024-12-08 16:51:44,56,1008,22,34,554.28,1014.02,0.00
2024-12-08 16:51:44,55,1008,21,34,564.18,1014.02,0.00
2024-12-08 16:51:44,54,1008,21,33,572.38,1014.04,0.00
2024-12-08 16:51:44,53,1008,20,33,578.27,1014.55,0.00
2024-12-08 16:51:44,52,1008,19,33,581.79,1014.96,0.00
2024-12-08 16:51:44,52,1009,19,33,600.94,1015.00,0.00
2024-12-08 16:51:44,53,1009,20,33,589.60,1015.02,0.00
2024-12-08 16:51:44,52,1009,19,33,591.54,1015.58,0.00
2024-12-08 16:51:44,52,1010,19,33,599.27,1016.00,0.00
2024-12-08 16:51:44,53,1010,20,33,587.97,1016.02,0.00
2024-12-08 16:51:44,52,1010,20,32,597.13,1016.04,0.00
2024-12-08 16:51:44,52,1011,20,32,599.67,1017.00,0.00
2024-12-08 16:51:44,53,1011,20,33,588.35,1017.02,0.00
2024-12-08 16:51:44,53,1012,20,33,586.63,1018.00,0.00
2024-12-08 16:51:44,54,1012,20,34,575.76,1018.02,0.00
2024-12-08 16:51:44,53,1012,20,33,584.52,1018.04,0.00
2024-12-08 16:51:44,52,1012,19,33,589.43,1018.33,0.00
2024-12-08 16:51:44,52,1013,19,33,602.61,1019.00,0.00
2024-12-08 16:51:44,53,1013,20,33,591.24,1019.02,0.00
2024-12-08 16:51:44,53,1014,20,33,589.51,1020.00,0.00
2024-12-08 16:51:44,54,1014,21,33,578.60,1020.02,0.00
2024-12-08 16:51:44,53,1014,21,32,587.40,1020.04,0.00
2024-12-08 16:51:44,53,1015,21,32,589.70,1021.00,0.00
2024-12-08 16:51:44,54,1015,22,32,578.78,1021.02,0.00
2024-12-08 16:51:44,53,1015,21,32,585.47,1021.02,0.00
2024-12-08 16:51:44,53,1016,21,32,591.44,1022.00,0.00
2024-12-08 16:51:44,54,1016,21,33,580.49,1022.02,0.00
2024-12-08 16:51:44,53,1016,21,32,589.13,1022.02,0.00
2024-12-08 16:51:44,53,1017,21,32,591.25,1023.00,0.00
2024-12-08 16:51:44,54,1017,21,33,580.30,1023.02,0.00
2024-12-08 16:51:44,53,1017,20,33,574.32,1023.59,0.00
2024-12-08 16:51:44,53,1018,20,33,589.67,1024.00,0.00
2024-12-08 16:51:44,54,1018,20,34,578.75,1024.02,0.00
2024-12-08 16:51:44,53,1018,20,33,587.16,1024.02,0.00
2024-12-08 16:51:44,52,1018,19,33,585.93,1024.58,0.00
2024-12-08 16:51:44,52,1019,19,33,601.60,1025.00,0.00
2024-12-08 16:51:44,53,1019,19,34,590.24,1025.02,0.00
2024-12-08 16:51:44,53,1020,19,34,588.50,1026.00,0.00
2024-12-08 16:51:44,54,1020,19,35,577.60,1026.02,0.00
2024-12-08 16:51:44,53,1020,19,34,586.17,1026.02,0.00
2024-12-08 16:51:44,52,1020,18,34,591.45,1026.64,0.00
2024-12-08 16:51:44,52,1021,18,34,607.71,1027.00,0.00
2024-12-08 16:51:44,53,1021,19,34,596.24,1027.02,0.00
2024-12-08 16:51:44,52,1021,18,34,593.32,1027.50,0.00
2024-12-08 16:51:44,52,1022,18,34,608.30,1028.00,0.00
2024-12-08 16:51:44,53,1022,19,34,596.82,1028.02,0.00
2024-12-08 16:51:44,52,1022,19,33,605.93,1028.02,0.00
2024-12-08 16:51:44,51,1022,18,33,611.87,1028.63,0.00
2024-12-08 16:51:45,51,1023,18,33,620.43,1029.00,0.00
2024-12-08 16:51:45,52,1023,18,34,608.49,1029.02,0.00
2024-12-08 16:51:45,52,1024,18,34,606.91,1030.00,0.00
2024-12-08 16:51:45,53,1024,19,34,595.46,1030.02,0.00
2024-12-08 16:51:45,52,1024,19,33,604.33,1030.02,0.00
2024-12-08 16:51:45,51,1024,18,33,606.88,1030.45,0.00
2024-12-08 16:51:45,51,1025,18,33,621.83,1031.00,0.00
2024-12-08 16:51:45,52,1025,18,34,609.88,1031.02,0.00
2024-12-08 16:51:45,51,1025,17,34,605.71,1031.55,0.00
2024-12-08 16:51:45,51,1026,17,34,621.63,1032.00,0.00
2024-12-08 16:51:45,52,1026,17,35,609.67,1032.02,0.00
2024-12-08 16:51:45,51,1026,17,34,619.00,1032.02,0.00
2024-12-08 16:51:45,51,1027,17,34,621.62,1033.00,0.00
2024-12-08 16:51:45,52,1027,18,34,609.67,1033.02,0.00
2024-12-08 16:51:45,52,1028,18,34,608.07,1034.00,0.00
2024-12-08 16:51:45,53,1028,19,34,596.60,1034.02,0.00
2024-12-08 16:51:45,52,1028,19,33,605.69,1034.02,0.00
2024-12-08 16:51:45,52,1029,19,33,608.06,1035.00,0.00
2024-12-08 16:51:45,53,1029,19,34,596.59,1035.02,0.00
2024-12-08 16:51:45,52,1029,18,34,592.36,1035.52,0.00
2024-12-08 16:51:45,52,1030,18,34,607.65,1036.00,0.00
2024-12-08 16:51:45,53,1030,19,34,596.19,1036.02,0.00
2024-12-08 16:51:45,52,1030,19,33,604.87,1036.04,0.00
2024-12-08 16:51:45,51,1030,18,33,610.15,1036.35,0.00
2024-12-08 16:51:45,51,1031,18,33,624.23,1037.00,0.00
2024-12-08 16:51:45,52,1031,19,33,612.23,1037.02,0.00
2024-12-08 16:51:45,51,1031,18,33,608.78,1037.49,0.00
2024-12-08 16:51:45,51,1032,18,33,624.22,1038.00,0.00
2024-12-08 16:51:45,52,1032,19,33,612.22,1038.02,0.00
2024-12-08 16:51:45,51,1032,19,32,621.58,1038.04,0.00
2024-12-08 16:51:45,51,1033,19,32,624.42,1039.00,0.00
2024-12-08 16:51:45,52,1033,20,32,612.41,1039.02,0.00
2024-12-08 16:51:45,52,1034,20,32,610.81,1040.00,0.00
2024-12-08 16:51:45,53,1034,20,33,599.28,1040.02,0.00
2024-12-08 16:51:45,52,1034,20,32,608.21,1040.04,0.00
2024-12-08 16:51:45,52,1035,20,32,610.79,1041.00,0.00
2024-12-08 16:51:45,53,1035,20,33,599.27,1041.02,0.00
2024-12-08 16:51:45,53,1036,20,33,597.49,1042.00,0.00
2024-12-08 16:51:45,54,1036,21,33,586.43,1042.02,0.00
2024-12-08 16:51:45,53,1036,21,32,595.14,1042.04,0.00
2024-12-08 16:51:45,53,1037,21,32,597.48,1043.00,0.00
2024-12-08 16:51:45,54,1037,22,32,586.41,1043.02,0.00
2024-12-08 16:51:45,53,1037,21,32,581.45,1043.93,0.00
2024-12-08 16:51:45,53,1038,21,32,600.41,1044.00,0.00
2024-12-08 16:51:45,54,1038,22,32,589.29,1044.02,0.00
2024-12-08 16:51:45,53,1038,22,31,598.24,1044.04,0.00
2024-12-08 16:51:45,52,1038,21,31,608.58,1044.15,0.00
2024-12-08 16:51:45,52,1039,21,31,612.34,1045.00,0.00
2024-12-08 16:51:45,53,1039,22,31,600.78,1045.02,0.00
2024-12-08 16:51:45,52,1039,21,31,605.37,1045.21,0.00
2024-12-08 16:51:45,52,1040,21,31,617.75,1046.00,0.00
2024-12-08 16:51:45,53,1040,22,31,606.10,1046.02,0.00
2024-12-08 16:51:45,52,1040,22,30,615.74,1046.04,0.00
2024-12-08 16:51:45,52,1041,22,30,618.34,1047.00,0.00
2024-12-08 16:51:45,53,1041,23,30,606.68,1047.02,0.00
2024-12-08 16:51:45,52,1041,22,30,604.42,1047.42,0.00
2024-12-08 16:51:45,52,1042,22,30,618.93,1048.00,0.00
2024-12-08 16:51:45,53,1042,22,31,607.25,1048.02,0.00
2024-12-08 16:51:45,52,1042,22,30,615.51,1048.04,0.00
2024-12-08 16:51:45,52,1043,22,30,618.11,1049.00,0.00
2024-12-08 16:51:45,53,1043,23,30,606.45,1049.02,0.00
2024-12-08 16:51:45,53,1044,23,30,604.65,1050.00,0.00
2024-12-08 16:51:45,54,1044,23,31,593.45,1050.02,0.00
2024-12-08 16:51:45,53,1044,23,30,602.67,1050.04,0.00
2024-12-08 16:51:45,52,1044,22,30,611.29,1050.19,0.00
2024-12-08 16:51:45,52,1045,22,30,623.53,1051.00,0.00
2024-12-08 16:51:45,53,1045,23,30,611.77,1051.02,0.00
2024-12-08 16:51:45,53,1046,23,30,609.97,1052.00,0.00
2024-12-08 16:51:45,54,1046,24,30,598.67,1052.02,0.00
2024-12-08 16:51:45,53,1046,24,29,607.99,1052.04,0.00
2024-12-08 16:51:45,53,1047,24,29,610.35,1053.00,0.00
2024-12-08 16:51:45,54,1047,24,30,599.05,1053.02,0.00
2024-12-08 16:51:45,53,1047,23,30,594.11,1053.55,0.00
2024-12-08 16:51:45,53,1048,23,30,609.54,1054.00,0.00
2024-12-08 16:51:45,54,1048,24,30,598.25,1054.02,0.00
2024-12-08 16:51:45,53,1048,24,29,607.75,1054.04,0.00
2024-12-08 16:51:45,53,1049,24,29,610.12,1055.00,0.00
2024-12-08 16:51:45,54,1049,24,30,598.82,1055.02,0.00
2024-12-08 16:51:45,54,1050,24,30,596.84,1056.00,0.00
2024-12-08 16:51:45,55,1050,24,31,585.99,1056.02,0.00
2024-12-08 16:51:45,54,1050,24,30,595.28,1056.04,0.00
2024-12-08 16:51:45,54,1051,24,30,597.41,1057.00,0.00
2024-12-08 16:51:45,55,1051,24,31,586.55,1057.02,0.00
2024-12-08 16:51:45,54,1051,23,31,585.29,1057.11,0.00
2024-12-08 16:51:45,54,1052,23,31,596.01,1058.00,0.00
2024-12-08 16:51:45,55,1052,24,31,585.18,1058.02,0.00
2024-12-08 16:51:45,54,1052,24,30,594.25,1058.04,0.00
2024-12-08 16:51:45,54,1053,24,30,596.38,1059.00,0.00
2024-12-08 16:51:45,55,1053,25,30,585.54,1059.02,0.00
2024-12-08 16:51:46,55,1054,25,30,583.39,1060.00,0.00
2024-12-08 16:51:46,56,1054,25,31,572.98,1060.02,0.00
2024-12-08 16:51:46,55,1054,25,30,581.85,1060.04,0.00
2024-12-08 16:51:46,54,1054,24,30,586.63,1060.63,0.00
2024-12-08 16:51:46,54,1055,24,30,594.76,1061.00,0.00
2024-12-08 16:51:46,55,1055,24,31,583.94,1061.02,0.00
2024-12-08 16:51:46,55,1056,24,31,581.79,1062.00,0.00
2024-12-08 16:51:46,56,1056,24,32,571.40,1062.02,0.00
2024-12-08 16:51:46,55,1056,24,31,580.44,1062.04,0.00
2024-12-08 16:51:46,55,1057,24,31,582.34,1063.00,0.00
2024-12-08 16:51:46,56,1057,25,31,571.94,1063.02,0.00
2024-12-08 16:51:46,55,1057,24,31,566.35,1063.56,0.00
2024-12-08 16:51:46,55,1058,24,31,581.34,1064.00,0.00
2024-12-08 16:51:46,56,1058,24,32,570.96,1064.02,0.00
2024-12-08 16:51:46,55,1058,24,31,579.60,1064.04,0.00
2024-12-08 16:51:46,55,1059,24,31,581.50,1065.00,0.00
2024-12-08 16:51:46,56,1059,24,32,571.11,1065.02,0.00
2024-12-08 16:51:46,55,1059,23,32,567.57,1065.82,0.00
2024-12-08 16:51:46,55,1060,23,32,585.14,1066.00,0.00
2024-12-08 16:51:46,56,1060,24,32,574.70,1066.02,0.00
2024-12-08 16:51:46,55,1060,23,32,584.95,1066.02,0.00
2024-12-08 16:51:46,54,1060,23,31,593.41,1066.02,0.00
2024-12-08 16:51:46,54,1061,23,31,595.35,1067.00,0.00
2024-12-08 16:51:46,55,1061,23,32,584.53,1067.02,0.00
2024-12-08 16:51:46,54,1061,22,32,580.15,1067.52,0.00
2024-12-08 16:51:46,54,1062,22,32,595.12,1068.00,0.00
2024-12-08 16:51:46,55,1062,22,33,584.30,1068.02,0.00
2024-12-08 16:51:46,54,1062,22,32,592.55,1068.02,0.00
2024-12-08 16:51:46,53,1062,21,32,590.88,1068.57,0.00
2024-12-08 16:51:46,53,1063,21,32,606.72,1069.00,0.00
2024-12-08 16:51:46,54,1063,22,32,595.48,1069.02,0.00
2024-12-08 16:51:46,54,1064,22,32,594.35,1070.00,0.00
2024-12-08 16:51:46,55,1064,23,32,583.54,1070.02,0.00
2024-12-08 16:51:46,54,1064,23,31,591.77,1070.02,0.00
2024-12-08 16:51:46,54,1065,23,31,593.72,1071.00,0.00
2024-12-08 16:51:46,55,1065,23,32,582.92,1071.02,0.00
2024-12-08 16:51:46,55,1066,23,32,581.60,1072.00,0.00
2024-12-08 16:51:46,56,1066,23,33,571.21,1072.02,0.00
2024-12-08 16:51:46,55,1066,23,32,579.26,1072.02,0.00
2024-12-08 16:51:46,54,1066,22,32,576.18,1072.91,0.00
2024-12-08 16:51:46,54,1067,22,32,595.13,1073.00,0.00
2024-12-08 16:51:46,55,1067,22,33,584.30,1073.02,0.00
2024-12-08 16:51:46,54,1067,21,33,590.76,1073.06,0.00
2024-12-08 16:51:46,53,1067,20,33,599.52,1073.15,0.00
2024-12-08 16:51:46,53,1068,20,33,611.17,1074.00,0.00
2024-12-08 16:51:46,54,1068,21,33,599.86,1074.02,0.00
2024-12-08 16:51:46,53,1068,21,32,608.54,1074.02,0.00
2024-12-08 16:51:46,52,1068,20,32,617.61,1074.14,0.00
2024-12-08 16:51:46,52,1069,20,32,629.50,1075.00,0.00
2024-12-08 16:51:46,53,1069,20,33,617.63,1075.02,0.00
2024-12-08 16:51:46,53,1070,20,33,616.63,1076.00,0.00
2024-12-08 16:51:46,54,1070,21,33,605.21,1076.02,0.00
2024-12-08 16:51:46,53,1070,21,32,613.58,1076.02,0.00
2024-12-08 16:51:46,53,1071,21,32,615.78,1077.00,0.00
2024-12-08 16:51:46,54,1071,21,33,604.38,1077.02,0.00
2024-12-08 16:51:46,54,1072,21,33,603.60,1078.00,0.00
2024-12-08 16:51:46,55,1072,21,34,592.62,1078.02,0.00
2024-12-08 16:51:46,54,1072,21,33,600.40,1078.02,0.00
2024-12-08 16:51:46,53,1072,20,33,604.93,1078.66,0.00
2024-12-08 16:51:46,52,1072,19,33,613.24,1078.75,0.00
2024-12-08 16:51:46,52,1073,19,33,631.48,1079.00,0.00
2024-12-08 16:51:46,53,1073,19,34,619.57,1079.02,0.00
2024-12-08 16:51:46,53,1074,19,34,618.66,1080.00,0.00
2024-12-08 16:51:46,54,1074,20,34,607.20,1080.02,0.00
2024-12-08 16:51:46,53,1074,20,33,615.60,1080.02,0.00
2024-12-08 16:51:46,54,1073,20,34,600.72,1080.39,0.00
2024-12-08 16:51:46,53,1073,19,34,611.74,1080.55,0.00
2024-12-08 16:51:46,53,1074,19,34,627.59,1081.00,0.00
2024-12-08 16:51:46,54,1074,20,34,615.97,1081.02,0.00
2024-12-08 16:51:46,53,1074,19,34,616.73,1081.30,0.00
2024-12-08 16:51:46,53,1075,19,34,650.49,1082.00,0.00
2024-12-08 16:51:46,54,1075,20,34,638.44,1082.02,0.00
2024-12-08 16:51:46,53,1075,20,33,647.02,1082.04,0.00
2024-12-08 16:51:46,52,1075,19,33,659.26,1082.06,0.00
2024-12-08 16:51:46,52,1076,19,33,662.15,1083.00,0.00
2024-12-08 16:51:46,53,1076,19,34,649.66,1083.02,0.00
2024-12-08 16:51:46,52,1076,18,34,647.90,1083.75,0.00
2024-12-08 16:51:46,52,1077,18,34,666.25,1084.00,0.00
2024-12-08 16:51:46,53,1077,18,35,653.68,1084.02,0.00
2024-12-08 16:51:46,52,1077,18,34,662.92,1084.04,0.00
2024-12-08 16:51:46,52,1078,18,34,665.61,1085.00,0.00
2024-12-08 16:51:46,53,1078,19,34,653.06,1085.02,0.00
2024-12-08 16:51:46,53,1079,19,34,652.08,1086.00,0.00
2024-12-08 16:51:46,54,1079,20,34,640.00,1086.02,0.00
2024-12-08 16:51:46,53,1079,20,33,648.40,1086.04,0.00
2024-12-08 16:51:46,53,1080,20,33,650.83,1087.00,0.00
2024-12-08 16:51:46,54,1080,21,33,638.78,1087.02,0.00
2024-12-08 16:51:46,54,1081,21,33,637.69,1088.00,0.00
2024-12-08 16:51:46,55,1081,22,33,626.10,1088.02,0.00
2024-12-08 16:51:46,54,1081,22,32,634.27,1088.04,0.00
2024-12-08 16:51:47,54,1082,22,32,636.46,1089.00,0.00
2024-12-08 16:51:47,55,1082,22,33,624.89,1089.02,0.00
2024-12-08 16:51:47,54,1082,21,33,631.64,1089.09,0.00
2024-12-08 16:51:47,53,1082,20,33,637.52,1089.26,0.00
2024-12-08 16:51:47,53,1083,20,33,650.56,1090.00,0.00
2024-12-08 16:51:47,54,1083,21,33,638.52,1090.02,0.00
2024-12-08 16:51:47,53,1083,21,32,647.28,1090.04,0.00
2024-12-08 16:51:47,52,1083,20,32,658.91,1090.10,0.00
2024-12-08 16:51:47,52,1084,20,32,662.21,1091.00,0.00
2024-12-08 16:51:47,53,1084,20,33,649.72,1091.02,0.00
2024-12-08 16:51:47,53,1085,20,33,648.19,1092.00,0.00
2024-12-08 16:51:47,54,1085,20,34,636.18,1092.02,0.00
2024-12-08 16:51:47,53,1085,20,33,645.10,1092.04,0.00
2024-12-08 16:51:47,52,1085,19,33,649.32,1092.69,0.00
2024-12-08 16:51:47,52,1086,19,33,667.21,1093.00,0.00
2024-12-08 16:51:47,53,1086,20,33,654.62,1093.02,0.00
2024-12-08 16:51:47,53,1087,20,33,652.98,1094.00,0.00
2024-12-08 16:51:47,54,1087,21,33,640.88,1094.02,0.00
2024-12-08 16:51:47,53,1087,21,32,650.09,1094.04,0.00
2024-12-08 16:51:47,52,1087,20,32,661.98,1094.10,0.00
2024-12-08 16:51:47,52,1088,20,32,665.30,1095.00,0.00
2024-12-08 16:51:47,53,1088,20,33,652.75,1095.02,0.00
2024-12-08 16:51:47,53,1089,20,33,651.32,1096.00,0.00
2024-12-08 16:51:47,54,1089,20,34,639.26,1096.02,0.00
2024-12-08 16:51:47,53,1089,20,33,648.22,1096.04,0.00
2024-12-08 16:51:47,52,1089,19,33,656.48,1096.17,0.00
2024-12-08 16:51:47,52,1090,19,33,669.04,1097.00,0.00
2024-12-08 16:51:47,53,1090,19,34,656.42,1097.02,0.00
2024-12-08 16:51:47,52,1090,18,34,650.96,1097.58,0.00
2024-12-08 16:51:47,52,1091,18,34,667.75,1098.00,0.00
2024-12-08 16:51:47,53,1091,19,34,655.16,1098.02,0.00
2024-12-08 16:51:47,52,1091,19,33,664.59,1098.04,0.00
2024-12-08 16:51:47,52,1092,19,33,667.31,1099.00,0.00
2024-12-08 16:51:47,53,1092,19,34,654.72,1099.02,0.00
2024-12-08 16:51:47,54,1091,20,34,637.54,1099.15,0.00
2024-12-08 16:51:47,54,1092,20,34,652.90,1100.00,0.00
2024-12-08 16:51:47,55,1092,21,34,641.03,1100.02,0.00
2024-12-08 16:51:47,54,1092,21,33,650.05,1100.04,0.00
2024-12-08 16:51:47,54,1093,21,33,672.65,1101.00,0.00
2024-12-08 16:51:47,55,1093,21,34,660.42,1101.02,0.00
2024-12-08 16:51:47,54,1093,20,34,663.28,1101.20,0.00
2024-12-08 16:51:47,54,1094,20,34,675.45,1102.00,0.00
2024-12-08 16:51:47,55,1094,21,34,663.17,1102.02,0.00
2024-12-08 16:51:47,54,1094,21,33,672.39,1102.04,0.00
2024-12-08 16:51:47,54,1095,21,33,674.63,1103.00,0.00
2024-12-08 16:51:47,55,1095,22,33,662.37,1103.02,0.00
2024-12-08 16:51:47,54,1095,21,33,660.92,1103.41,0.00
2024-12-08 16:51:47,53,1095,20,33,671.62,1103.59,0.00
2024-12-08 16:51:47,53,1096,20,33,688.17,1104.00,0.00
2024-12-08 16:51:47,54,1096,21,33,675.43,1104.02,0.00
2024-12-08 16:51:47,53,1096,21,32,684.42,1104.04,0.00
2024-12-08 16:51:47,54,1095,22,32,664.20,1104.80,0.00
2024-12-08 16:51:47,54,1096,22,32,676.45,1105.00,0.00
2024-12-08 16:51:47,55,1096,22,33,664.15,1105.02,0.00
2024-12-08 16:51:47,55,1097,22,33,687.45,1106.00,0.00
2024-12-08 16:51:47,56,1097,22,34,675.18,1106.02,0.00
2024-12-08 16:51:47,55,1097,21,34,682.85,1106.07,0.00
2024-12-08 16:51:47,55,1098,21,34,688.45,1107.00,0.00
2024-12-08 16:51:47,56,1098,22,34,676.16,1107.02,0.00
2024-12-08 16:51:47,56,1099,22,34,674.02,1108.00,0.00
2024-12-08 16:51:47,57,1099,23,34,662.19,1108.02,0.00
2024-12-08 16:51:47,56,1099,23,33,671.25,1108.04,0.00
2024-12-08 16:51:47,55,1099,22,33,683.27,1108.06,0.00
2024-12-08 16:51:47,54,1099,21,33,690.27,1108.59,0.00
2024-12-08 16:51:47,54,1100,21,33,698.38,1109.00,0.00
2024-12-08 16:51:47,55,1100,21,34,685.68,1109.02,0.00
2024-12-08 16:51:47,54,1100,20,34,696.74,1109.02,0.00
2024-12-08 16:51:47,53,1100,19,34,705.09,1109.06,0.00
2024-12-08 16:51:47,53,1101,19,34,716.18,1110.00,0.00
2024-12-08 16:51:47,54,1101,20,34,702.92,1110.02,0.00
2024-12-08 16:51:47,53,1101,20,33,712.01,1110.04,0.00
2024-12-08 16:51:47,53,1102,20,33,714.52,1111.00,0.00
2024-12-08 16:51:47,54,1102,20,34,701.29,1111.02,0.00
2024-12-08 16:51:47,53,1102,19,34,707.23,1111.13,0.00
2024-12-08 16:51:47,53,1103,19,34,719.15,1112.00,0.00
2024-12-08 16:51:47,54,1103,20,34,705.83,1112.02,0.00
2024-12-08 16:51:47,53,1103,20,33,714.97,1112.04,0.00
2024-12-08 16:51:47,53,1104,20,33,717.48,1113.00,0.00
2024-12-08 16:51:47,54,1104,21,33,704.20,1113.02,0.00
2024-12-08 16:51:48,54,1105,21,33,702.67,1114.00,0.00
2024-12-08 16:51:48,55,1105,21,34,689.89,1114.02,0.00
2024-12-08 16:51:48,54,1105,21,33,698.35,1114.04,0.00
2024-12-08 16:51:48,54,1106,21,33,700.61,1115.00,0.00
2024-12-08 16:51:48,55,1106,22,33,687.87,1115.02,0.00
2024-12-08 16:51:48,55,1107,22,33,686.37,1116.00,0.00
2024-12-08 16:51:48,56,1107,22,34,674.12,1116.02,0.00
2024-12-08 16:51:48,55,1107,22,33,682.13,1116.04,0.00
2024-12-08 16:51:48,54,1107,21,33,680.54,1116.96,0.00
2024-12-08 16:51:48,54,1108,21,33,700.83,1117.00,0.00
2024-12-08 16:51:48,55,1108,22,33,688.09,1117.02,0.00
2024-12-08 16:51:48,55,1109,22,33,686.53,1118.00,0.00
2024-12-08 16:51:48,56,1109,23,33,674.27,1118.02,0.00
2024-12-08 16:51:48,55,1109,23,32,682.48,1118.04,0.00
2024-12-08 16:51:48,56,1108,24,32,661.78,1118.88,0.00
2024-12-08 16:51:48,56,1109,24,32,674.08,1119.00,0.00
2024-12-08 16:51:48,57,1109,24,33,662.25,1119.02,0.00
2024-12-08 16:51:48,57,1110,24,33,680.29,1120.00,0.00
2024-12-08 16:51:48,58,1110,24,34,668.56,1120.02,0.00
2024-12-08 16:51:48,57,1110,24,33,676.57,1120.04,0.00
2024-12-08 16:51:48,57,1111,24,33,678.14,1121.00,0.00
2024-12-08 16:51:48,58,1111,25,33,666.45,1121.02,0.00
2024-12-08 16:51:48,57,1111,24,33,668.07,1121.58,0.00
2024-12-08 16:51:48,56,1111,23,33,673.83,1121.86,0.00
2024-12-08 16:51:48,56,1112,23,33,692.37,1122.00,0.00
2024-12-08 16:51:48,57,1112,23,34,680.22,1122.02,0.00
2024-12-08 16:51:48,56,1112,23,33,688.38,1122.04,0.00
2024-12-08 16:51:48,56,1113,23,33,690.18,1123.00,0.00
2024-12-08 16:51:48,57,1113,24,33,678.07,1123.02,0.00
2024-12-08 16:51:48,56,1113,23,33,679.87,1123.59,0.00
2024-12-08 16:51:48,56,1114,23,33,688.21,1124.00,0.00
2024-12-08 16:51:48,57,1114,23,34,676.13,1124.02,0.00
2024-12-08 16:51:48,56,1114,23,33,684.41,1124.04,0.00
2024-12-08 16:51:48,55,1114,22,33,682.72,1124.96,0.00
2024-12-08 16:51:48,55,1115,22,33,702.78,1125.00,0.00
2024-12-08 16:51:48,56,1115,22,34,690.23,1125.02,0.00
2024-12-08 16:51:48,56,1116,22,34,688.05,1126.00,0.00
2024-12-08 16:51:48,57,1116,23,34,675.98,1126.02,0.00
2024-12-08 16:51:48,56,1116,23,33,684.44,1126.04,0.00
2024-12-08 16:51:48,56,1117,23,33,686.25,1127.00,0.00
2024-12-08 16:51:48,57,1117,24,33,674.21,1127.02,0.00
2024-12-08 16:51:48,57,1118,24,33,672.19,1128.00,0.00
2024-12-08 16:51:48,58,1118,24,34,660.60,1128.02,0.00
2024-12-08 16:51:48,57,1118,24,33,668.64,1128.04,0.00
2024-12-08 16:51:48,57,1119,24,33,670.21,1129.00,0.00
2024-12-08 16:51:48,58,1119,24,34,658.65,1129.02,0.00
2024-12-08 16:51:48,58,1120,24,34,656.44,1130.00,0.00
2024-12-08 16:51:48,59,1120,25,34,645.32,1130.02,0.00
2024-12-08 16:51:48,58,1120,25,33,653.14,1130.03,0.00
2024-12-08 16:51:48,57,1120,24,33,654.05,1130.79,0.00
2024-12-08 16:51:48,57,1121,24,33,671.66,1131.00,0.00
2024-12-08 16:51:48,58,1121,25,33,660.08,1131.02,0.00
2024-12-08 16:51:48,57,1121,24,33,660.48,1131.32,0.00
2024-12-08 16:51:48,57,1122,24,33,673.05,1132.00,0.00
2024-12-08 16:51:48,58,1122,25,33,661.45,1132.02,0.00
2024-12-08 16:51:48,57,1122,25,32,669.69,1132.04,0.00
2024-12-08 16:51:48,57,1123,25,32,670.84,1133.00,0.00
2024-12-08 16:51:48,58,1123,26,32,659.28,1133.02,0.00
2024-12-08 16:51:48,57,1123,25,32,664.70,1133.18,0.00
2024-12-08 16:51:48,56,1123,24,32,671.56,1133.30,0.00
2024-12-08 16:51:48,56,1124,24,32,684.39,1134.00,0.00
2024-12-08 16:51:48,57,1124,25,32,672.38,1134.02,0.00
2024-12-08 16:51:48,56,1124,25,31,681.16,1134.04,0.00
2024-12-08 16:51:48,56,1125,25,31,682.96,1135.00,0.00
2024-12-08 16:51:48,57,1125,25,32,670.98,1135.02,0.00
2024-12-08 16:51:48,57,1126,25,32,668.74,1136.00,0.00
2024-12-08 16:51:48,58,1126,26,32,657.21,1136.02,0.00
2024-12-08 16:51:48,57,1126,26,31,665.36,1136.04,0.00
2024-12-08 16:51:48,57,1127,26,31,666.94,1137.00,0.00
2024-12-08 16:51:48,58,1127,26,32,655.44,1137.02,0.00
2024-12-08 16:51:48,58,1128,26,32,653.30,1138.00,0.00
2024-12-08 16:51:48,59,1128,26,33,642.23,1138.02,0.00
2024-12-08 16:51:49,58,1128,26,32,650.17,1138.03,0.00
2024-12-08 16:51:49,57,1128,25,32,654.20,1138.63,0.00
2024-12-08 16:51:49,57,1129,25,32,670.25,1139.00,0.00
2024-12-08 16:51:49,58,1129,26,32,658.69,1139.02,0.00
2024-12-08 16:51:49,57,1129,25,32,659.97,1139.30,0.00
2024-12-08 16:51:49,57,1130,25,32,672.44,1140.00,0.00
2024-12-08 16:51:49,58,1130,26,32,660.84,1140.02,0.00
2024-12-08 16:51:49,57,1130,26,31,669.45,1140.04,0.00
2024-12-08 16:51:49,56,1130,25,31,674.82,1140.63,0.00
2024-12-08 16:51:49,56,1131,25,31,683.05,1141.00,0.00
2024-12-08 16:51:49,57,1131,25,32,671.06,1141.02,0.00
2024-12-08 16:51:49,56,1131,24,32,670.66,1141.36,0.00
2024-12-08 16:51:49,56,1132,24,32,684.15,1142.00,0.00
2024-12-08 16:51:49,57,1132,24,33,672.15,1142.02,0.00
2024-12-08 16:51:49,56,1132,24,32,681.11,1142.04,0.00
2024-12-08 16:51:49,56,1133,24,32,682.92,1143.00,0.00
2024-12-08 16:51:49,57,1133,24,33,670.94,1143.02,0.00
2024-12-08 16:51:49,57,1134,24,33,668.52,1144.00,0.00
2024-12-08 16:51:49,58,1134,25,33,656.99,1144.02,0.00
2024-12-08 16:51:49,57,1134,25,32,665.52,1144.04,0.00
2024-12-08 16:51:49,56,1134,24,32,668.97,1144.39,0.00
2024-12-08 16:51:49,56,1135,24,32,682.88,1145.00,0.00
2024-12-08 16:51:49,57,1135,24,33,670.90,1145.02,0.00
2024-12-08 16:51:49,58,1134,25,33,650.46,1145.50,0.00
2024-12-08 16:51:49,57,1134,24,33,660.76,1145.56,0.00
2024-12-08 16:51:49,56,1134,23,33,671.97,1145.63,0.00
2024-12-08 16:51:49,56,1135,23,33,688.42,1146.00,0.00
2024-12-08 16:51:49,57,1135,24,33,676.34,1146.02,0.00
2024-12-08 16:51:49,56,1135,24,32,685.56,1146.04,0.00
2024-12-08 16:51:49,55,1135,23,32,697.02,1146.13,0.00
2024-12-08 16:51:49,55,1136,23,32,720.94,1147.00,0.00
2024-12-08 16:51:49,56,1136,24,32,708.07,1147.02,0.00
2024-12-08 16:51:49,56,1137,24,32,705.61,1148.00,0.00
2024-12-08 16:51:49,57,1137,24,33,693.23,1148.02,0.00
2024-12-08 16:51:49,56,1137,24,32,702.95,1148.04,0.00
2024-12-08 16:51:49,56,1138,24,32,704.79,1149.00,0.00
2024-12-08 16:51:49,57,1138,24,33,692.42,1149.02,0.00
2024-12-08 16:51:49,57,1139,24,33,689.80,1150.00,0.00
2024-12-08 16:51:49,58,1139,25,33,677.90,1150.02,0.00
2024-12-08 16:51:49,57,1139,25,32,687.39,1150.04,0.00
2024-12-08 16:51:49,56,1139,24,32,692.40,1150.66,0.00
2024-12-08 16:51:49,56,1140,24,32,709.30,1151.00,0.00
2024-12-08 16:51:49,57,1140,25,32,696.86,1151.02,0.00
2024-12-08 16:51:49,57,1141,25,32,694.23,1152.00,0.00
2024-12-08 16:51:49,58,1141,26,32,682.26,1152.02,0.00
2024-12-08 16:51:49,57,1141,26,31,691.42,1152.05,0.00
2024-12-08 16:51:49,57,1142,26,31,693.22,1153.00,0.00
2024-12-08 16:51:49,58,1142,27,31,681.26,1153.02,0.00
2024-12-08 16:51:49,58,1143,27,31,678.47,1154.00,0.00
2024-12-08 16:51:49,59,1143,28,31,666.97,1154.02,0.00
2024-12-08 16:51:49,58,1143,28,30,675.90,1154.05,0.00
2024-12-08 16:51:49,58,1144,28,30,677.47,1155.00,0.00
2024-12-08 16:51:49,59,1144,28,31,665.98,1155.02,0.00
2024-12-08 16:51:49,58,1144,27,31,659.05,1155.62,0.00
2024-12-08 16:51:49,58,1145,27,31,674.86,1156.00,0.00
2024-12-08 16:51:49,59,1145,27,32,663.42,1156.02,0.00
2024-12-08 16:51:49,58,1145,27,31,671.49,1156.07,0.00
2024-12-08 16:51:49,58,1146,27,31,673.25,1157.00,0.00
2024-12-08 16:51:49,59,1146,28,31,661.84,1157.02,0.00
2024-12-08 16:51:49,59,1147,28,31,659.43,1158.00,0.00
2024-12-08 16:51:49,60,1147,29,31,648.44,1158.02,0.00
2024-12-08 16:51:49,59,1147,29,30,656.11,1158.07,0.00
2024-12-08 16:51:49,59,1148,29,30,657.64,1159.00,0.00
2024-12-08 16:51:49,60,1148,30,30,646.68,1159.02,0.00
2024-12-08 16:51:49,60,1149,30,30,644.25,1160.00,0.00
2024-12-08 16:51:49,61,1149,31,30,633.69,1160.02,0.00
2024-12-08 16:51:49,60,1149,31,29,641.17,1160.07,0.00
2024-12-08 16:51:49,59,1149,30,29,645.64,1160.64,0.00
2024-12-08 16:51:49,59,1150,30,29,653.57,1161.00,0.00
2024-12-08 16:51:49,60,1150,30,30,642.68,1161.02,0.00
2024-12-08 16:51:50,60,1151,30,30,640.30,1162.00,0.00
2024-12-08 16:51:50,61,1151,30,31,629.80,1162.02,0.00
2024-12-08 16:51:50,60,1151,30,30,636.83,1162.08,0.00
2024-12-08 16:51:50,59,1151,29,30,637.96,1162.44,0.00
2024-12-08 16:51:50,59,1152,29,30,651.54,1163.00,0.00
2024-12-08 16:51:50,60,1152,29,31,640.68,1163.02,0.00
2024-12-08 16:51:50,59,1152,28,31,646.43,1163.05,0.00
2024-12-08 16:51:50,59,1153,28,31,651.71,1164.00,0.00
2024-12-08 16:51:50,60,1153,29,31,640.85,1164.02,0.00
2024-12-08 16:51:50,59,1153,29,30,648.56,1164.07,0.00
2024-12-08 16:51:50,58,1153,28,30,658.97,1164.14,0.00
2024-12-08 16:51:50,58,1154,28,30,661.46,1165.00,0.00
2024-12-08 16:51:50,59,1154,29,30,650.25,1165.02,0.00
2024-12-08 16:51:50,59,1155,29,30,647.47,1166.00,0.00
2024-12-08 16:51:50,60,1155,30,30,636.68,1166.02,0.00
2024-12-08 16:51:50,59,1155,30,29,644.52,1166.07,0.00
2024-12-08 16:51:50,59,1156,30,29,645.65,1167.00,0.00
2024-12-08 16:51:50,60,1156,31,29,634.89,1167.02,0.00
2024-12-08 16:51:50,59,1156,30,29,645.11,1167.05,0.00
2024-12-08 16:51:50,59,1157,30,29,642.47,1168.00,0.00
2024-12-08 16:51:50,60,1157,31,29,631.76,1168.02,0.00
2024-12-08 16:51:50,59,1157,31,28,639.70,1168.05,0.00
2024-12-08 16:51:50,58,1157,30,28,649.76,1168.14,0.00
2024-12-08 16:51:50,58,1158,30,28,651.46,1169.00,0.00
2024-12-08 16:51:50,59,1158,31,28,640.42,1169.02,0.00
2024-12-08 16:51:50,58,1158,30,28,638.23,1169.38,0.00
2024-12-08 16:51:50,58,1159,30,28,651.53,1170.00,0.00
2024-12-08 16:51:50,59,1159,31,28,640.49,1170.02,0.00
2024-12-08 16:51:50,58,1159,31,27,648.72,1170.05,0.00
2024-12-08 16:51:50,58,1160,31,27,649.66,1171.00,0.00
2024-12-08 16:51:50,59,1160,31,28,638.65,1171.02,0.00
2024-12-08 16:51:50,58,1160,30,28,643.80,1171.02,0.00
2024-12-08 16:51:50,58,1161,30,28,647.93,1172.00,0.00
2024-12-08 16:51:50,59,1161,30,29,636.95,1172.02,0.00
2024-12-08 16:51:50,58,1161,30,28,644.51,1172.07,0.00
2024-12-08 16:51:50,57,1161,29,28,648.01,1172.09,0.00
2024-12-08 16:51:50,57,1162,29,28,656.78,1173.00,0.00
2024-12-08 16:51:50,58,1162,30,28,645.45,1173.02,0.00
2024-12-08 16:51:50,58,1163,30,28,641.49,1174.00,0.00
2024-12-08 16:51:50,59,1163,30,29,630.62,1174.02,0.00
2024-12-08 16:51:50,58,1163,30,28,638.27,1174.07,0.00
2024-12-08 16:51:50,58,1164,30,28,637.73,1175.00,0.00
2024-12-08 16:51:50,59,1164,31,28,626.92,1175.02,0.00
2024-12-08 16:51:50,59,1165,31,28,624.07,1176.00,0.00
2024-12-08 16:51:50,60,1165,32,28,613.67,1176.02,0.00
2024-12-08 16:51:50,59,1165,31,28,617.73,1176.09,0.00
2024-12-08 16:51:50,59,1166,31,28,619.45,1177.00,0.00
2024-12-08 16:51:50,60,1166,31,29,609.12,1177.02,0.00
2024-12-08 16:51:50,59,1166,31,28,618.46,1177.07,0.00
2024-12-08 16:51:50,59,1167,31,28,619.97,1178.00,0.00
2024-12-08 16:51:50,60,1167,32,28,609.64,1178.02,0.00
2024-12-08 16:51:50,59,1167,31,28,609.56,1178.58,0.00
2024-12-08 16:51:50,59,1168,31,28,618.25,1179.00,0.00
2024-12-08 16:51:50,60,1168,32,28,607.94,1179.02,0.00
2024-12-08 16:51:50,59,1168,32,27,615.06,1179.07,0.00
2024-12-08 16:51:50,58,1168,31,27,620.99,1179.47,0.00
2024-12-08 16:51:50,58,1169,31,27,627.23,1180.00,0.00
2024-12-08 16:51:50,59,1169,31,28,616.60,1180.02,0.00
2024-12-08 16:51:50,59,1170,31,28,614.98,1181.00,0.00
2024-12-08 16:51:50,60,1170,32,28,604.73,1181.02,0.00
2024-12-08 16:51:50,59,1170,32,27,611.58,1181.07,0.00
2024-12-08 16:51:50,58,1170,31,27,616.82,1181.53,0.00
2024-12-08 16:51:50,57,1170,30,27,627.38,1181.54,0.00
2024-12-08 16:51:50,57,1171,30,27,643.04,1182.00,0.00
2024-12-08 16:51:50,58,1171,31,27,631.96,1182.02,0.00
2024-12-08 16:51:50,57,1171,30,27,642.84,1182.02,0.00
2024-12-08 16:51:50,57,1172,30,27,641.42,1183.00,0.00
2024-12-08 16:51:50,58,1172,31,27,630.36,1183.02,0.00
2024-12-08 16:51:50,57,1172,31,26,638.11,1183.05,0.00
2024-12-08 16:51:50,57,1173,31,26,639.89,1184.00,0.00
2024-12-08 16:51:50,58,1173,31,27,628.85,1184.02,0.00
2024-12-08 16:51:50,58,1174,31,27,627.37,1185.00,0.00
2024-12-08 16:51:50,59,1174,32,27,616.74,1185.02,0.00
2024-12-08 16:51:50,58,1174,32,26,623.90,1185.05,0.00
2024-12-08 16:51:50,58,1175,32,26,625.45,1186.00,0.00
2024-12-08 16:51:50,59,1175,33,26,614.85,1186.02,0.00
2024-12-08 16:51:50,59,1176,33,26,613.34,1187.00,0.00
2024-12-08 16:51:50,60,1176,34,26,603.12,1187.02,0.00
2024-12-08 16:51:50,59,1176,34,25,610.13,1187.05,0.00
2024-12-08 16:51:51,59,1177,34,25,611.44,1188.00,0.00
2024-12-08 16:51:51,60,1177,34,26,601.25,1188.02,0.00
2024-12-08 16:51:51,59,1177,33,26,606.43,1188.10,0.00
2024-12-08 16:51:51,59,1178,33,26,610.08,1189.00,0.00
2024-12-08 16:51:51,60,1178,33,27,599.91,1189.02,0.00
2024-12-08 16:51:51,59,1178,33,26,606.86,1189.05,0.00
2024-12-08 16:51:51,58,1178,32,26,604.64,1189.83,0.00
2024-12-08 16:51:51,58,1179,32,26,623.24,1190.00,0.00
2024-12-08 16:51:51,59,1179,33,26,612.67,1190.02,0.00
2024-12-08 16:51:51,59,1180,33,26,611.23,1191.00,0.00
2024-12-08 16:51:51,60,1180,34,26,601.05,1191.02,0.00
2024-12-08 16:51:51,59,1180,34,25,608.01,1191.05,0.00
2024-12-08 16:51:51,59,1181,34,25,609.32,1192.00,0.00
2024-12-08 16:51:51,60,1181,35,25,599.17,1192.02,0.00
2024-12-08 16:51:51,59,1181,34,25,598.99,1192.56,0.00
2024-12-08 16:51:51,59,1182,34,25,607.93,1193.00,0.00
2024-12-08 16:51:51,60,1182,34,26,597.80,1193.02,0.00
2024-12-08 16:51:51,59,1182,34,25,604.90,1193.05,0.00
2024-12-08 16:51:51,59,1183,34,25,606.21,1194.00,0.00
2024-12-08 16:51:51,60,1183,34,26,596.11,1194.02,0.00
2024-12-08 16:51:51,59,1183,33,26,600.96,1194.10,0.00
2024-12-08 16:51:51,58,1183,32,26,602.80,1194.41,0.00
2024-12-08 16:51:51,58,1184,32,26,616.77,1195.00,0.00
2024-12-08 16:51:51,59,1184,32,27,606.32,1195.02,0.00
2024-12-08 16:51:51,58,1184,32,26,613.48,1195.05,0.00
2024-12-08 16:51:51,57,1184,31,26,618.86,1195.28,0.00
2024-12-08 16:51:51,57,1185,31,26,631.68,1196.00,0.00
2024-12-08 16:51:51,58,1185,31,27,620.79,1196.02,0.00
2024-12-08 16:51:51,57,1185,30,27,626.77,1196.07,0.00
2024-12-08 16:51:51,57,1186,30,27,630.39,1197.00,0.00
2024-12-08 16:51:51,58,1186,31,27,619.52,1197.02,0.00
2024-12-08 16:51:51,57,1186,31,26,627.24,1197.05,0.00
2024-12-08 16:51:51,56,1186,30,26,638.24,1197.07,0.00
2024-12-08 16:51:51,55,1186,29,26,635.75,1197.89,0.00
2024-12-08 16:51:51,55,1187,29,26,656.31,1198.00,0.00
2024-12-08 16:51:51,56,1187,30,26,644.59,1198.02,0.00
2024-12-08 16:51:51,55,1187,29,26,644.13,1198.55,0.00
2024-12-08 16:51:51,55,1188,29,26,660.81,1199.00,0.00
2024-12-08 16:51:51,56,1188,29,27,649.01,1199.02,0.00
2024-12-08 16:51:51,55,1188,29,26,656.67,1199.06,0.00
2024-12-08 16:51:51,55,1189,29,26,658.53,1200.00,0.00
2024-12-08 16:51:51,56,1189,29,27,646.77,1200.02,0.00
2024-12-08 16:51:51,55,1189,28,27,653.09,1200.09,0.00
2024-12-08 16:51:51,55,1190,28,27,656.42,1201.00,0.00
2024-12-08 16:51:51,56,1190,29,27,644.70,1201.02,0.00
2024-12-08 16:51:51,55,1190,29,26,652.27,1201.06,0.00
2024-12-08 16:51:51,54,1190,28,26,662.96,1201.17,0.00
2024-12-08 16:51:51,54,1191,28,26,666.06,1202.00,0.00
2024-12-08 16:51:51,55,1191,28,27,653.95,1202.02,0.00
2024-12-08 16:51:51,54,1191,27,27,665.83,1202.02,0.00
2024-12-08 16:51:51,54,1192,27,27,664.12,1203.00,0.00
2024-12-08 16:51:51,55,1192,27,28,652.05,1203.02,0.00
2024-12-08 16:51:51,54,1192,27,27,660.34,1203.04,0.00
2024-12-08 16:51:51,54,1193,27,27,661.10,1204.00,0.00
2024-12-08 16:51:51,55,1193,28,27,649.08,1204.02,0.00
2024-12-08 16:51:51,54,1193,27,27,660.87,1204.02,0.00
2024-12-08 16:51:51,54,1194,27,27,658.98,1205.00,0.00
2024-12-08 16:51:51,55,1194,27,28,647.00,1205.02,0.00
2024-12-08 16:51:51,54,1194,27,27,655.19,1205.02,0.00
2024-12-08 16:51:51,54,1195,27,27,656.21,1206.00,0.00
2024-12-08 16:51:51,55,1195,28,27,644.28,1206.02,0.00
2024-12-08 16:51:51,55,1196,28,27,643.15,1207.00,0.00
2024-12-08 16:51:51,56,1196,29,27,631.67,1207.02,0.00
2024-12-08 16:51:51,55,1196,29,26,639.64,1207.02,0.00
2024-12-08 16:51:51,55,1197,29,26,641.49,1208.00,0.00
2024-12-08 16:51:51,56,1197,30,26,630.04,1208.02,0.00
2024-12-08 16:51:51,55,1197,29,26,631.98,1208.18,0.00
2024-12-08 16:51:51,55,1198,29,26,644.47,1209.00,0.00
2024-12-08 16:51:51,56,1198,29,27,632.96,1209.02,0.00
2024-12-08 16:51:51,55,1198,29,26,641.17,1209.02,0.00
2024-12-08 16:51:51,55,1199,29,26,641.74,1210.00,0.00
2024-12-08 16:51:51,56,1199,30,26,630.28,1210.02,0.00
2024-12-08 16:51:51,55,1199,29,26,626.51,1210.44,0.00
2024-12-08 16:51:51,54,1199,28,26,637.30,1210.50,0.00
2024-12-08 16:51:51,54,1200,28,26,651.44,1211.00,0.00
2024-12-08 16:51:51,55,1200,29,26,639.60,1211.02,0.00
2024-12-08 16:51:51,54,1200,29,25,647.86,1211.04,0.00
2024-12-08 16:51:51,53,1200,28,25,654.58,1211.49,0.00
2024-12-08 16:51:51,53,1201,28,25,661.18,1212.00,0.00
2024-12-08 16:51:51,54,1201,28,26,648.94,1212.02,0.00
2024-12-08 16:51:51,53,1201,27,26,648.40,1212.09,0.00
2024-12-08 16:51:51,53,1202,27,26,660.30,1213.00,0.00
2024-12-08 16:51:52,54,1202,27,27,648.08,1213.02,0.00
2024-12-08 16:51:52,53,1202,26,27,660.30,1213.02,0.00
2024-12-08 16:51:52,52,1202,26,26,669.26,1213.02,0.00
2024-12-08 16:51:52,52,1203,26,26,680.76,1214.00,0.00
2024-12-08 16:51:52,53,1203,27,26,667.91,1214.02,0.00
2024-12-08 16:51:52,53,1204,27,26,666.68,1215.00,0.00
2024-12-08 16:51:52,54,1204,28,26,654.33,1215.02,0.00
2024-12-08 16:51:52,53,1204,28,25,663.24,1215.02,0.00
2024-12-08 16:51:52,53,1205,28,25,665.12,1216.00,0.00
2024-12-08 16:51:52,54,1205,29,25,652.80,1216.02,0.00
2024-12-08 16:51:52,53,1205,28,25,664.80,1216.02,0.00
2024-12-08 16:51:52,52,1205,27,25,667.32,1216.48,0.00
2024-12-08 16:51:52,52,1206,27,25,684.24,1217.00,0.00
2024-12-08 16:51:52,53,1206,27,26,671.33,1217.02,0.00
2024-12-08 16:51:52,52,1206,27,25,679.79,1217.02,0.00
2024-12-08 16:51:52,52,1207,27,25,681.93,1218.00,0.00
2024-12-08 16:51:52,53,1207,27,26,669.06,1218.02,0.00
2024-12-08 16:51:52,53,1208,27,26,668.32,1219.00,0.00
2024-12-08 16:51:52,54,1208,28,26,655.94,1219.02,0.00
2024-12-08 16:51:52,53,1208,28,25,664.18,1219.02,0.00
2024-12-08 16:51:52,53,1209,28,25,666.07,1220.00,0.00
2024-12-08 16:51:52,54,1209,28,26,653.74,1220.02,0.00
2024-12-08 16:51:52,53,1209,27,26,666.07,1220.02,0.00
2024-12-08 16:51:52,52,1209,27,25,660.83,1220.54,0.00
2024-12-08 16:51:52,52,1210,27,25,678.98,1221.00,0.00
2024-12-08 16:51:52,53,1210,28,25,666.17,1221.02,0.00
2024-12-08 16:51:52,52,1210,28,24,673.83,1221.04,0.00
2024-12-08 16:51:52,51,1210,27,24,681.95,1221.37,0.00
2024-12-08 16:51:52,51,1211,27,24,698.66,1222.00,0.00
2024-12-08 16:51:52,52,1211,28,24,685.22,1222.02,0.00
2024-12-08 16:51:52,52,1212,28,24,685.37,1223.00,0.00
2024-12-08 16:51:52,53,1212,29,24,672.44,1223.02,0.00
2024-12-08 16:51:52,52,1212,29,23,680.44,1223.04,0.00
2024-12-08 16:51:52,52,1213,29,23,683.34,1224.00,0.00
2024-12-08 16:51:52,53,1213,29,24,670.45,1224.02,0.00
2024-12-08 16:51:52,53,1214,29,24,670.42,1225.00,0.00
2024-12-08 16:51:52,54,1214,29,25,658.00,1225.02,0.00
2024-12-08 16:51:52,53,1214,29,24,665.80,1225.04,0.00
2024-12-08 16:51:52,52,1214,28,24,673.18,1225.48,0.00
2024-12-08 16:51:52,52,1215,28,24,681.31,1226.00,0.00
2024-12-08 16:51:52,53,1215,28,25,668.46,1226.02,0.00
2024-12-08 16:51:52,52,1215,27,25,681.08,1226.04,0.00
2024-12-08 16:51:52,52,1216,27,25,682.56,1227.00,0.00
2024-12-08 16:51:52,53,1216,27,26,669.68,1227.02,0.00
2024-12-08 16:51:52,52,1216,26,26,663.85,1227.77,0.00
2024-12-08 16:51:52,52,1217,26,26,684.79,1228.00,0.00
2024-12-08 16:51:52,53,1217,27,26,671.86,1228.02,0.00
2024-12-08 16:51:52,52,1217,26,26,684.33,1228.06,0.00
2024-12-08 16:51:52,51,1217,26,25,696.31,1228.10,0.00
2024-12-08 16:51:52,51,1218,26,25,700.23,1229.00,0.00
2024-12-08 16:51:52,52,1218,27,25,686.76,1229.02,0.00
2024-12-08 16:51:52,52,1219,27,25,687.29,1230.00,0.00
2024-12-08 16:51:52,53,1219,27,26,674.32,1230.02,0.00
2024-12-08 16:51:52,52,1219,26,26,686.60,1230.08,0.00
2024-12-08 16:51:52,52,1220,26,26,685.18,1231.00,0.00
2024-12-08 16:51:52,53,1220,27,26,672.25,1231.02,0.00
2024-12-08 16:51:52,52,1220,27,25,684.01,1231.08,0.00
2024-12-08 16:51:52,52,1221,27,25,687.34,1232.00,0.00
2024-12-08 16:51:52,53,1221,28,25,674.37,1232.02,0.00
2024-12-08 16:51:52,52,1221,27,25,686.18,1232.08,0.00
2024-12-08 16:51:52,52,1222,27,25,694.30,1233.00,0.00
2024-12-08 16:51:52,53,1222,27,26,681.20,1233.02,0.00
2024-12-08 16:51:52,53,1223,27,26,678.96,1234.00,0.00
2024-12-08 16:51:52,54,1223,28,26,666.39,1234.02,0.00
2024-12-08 16:51:52,53,1223,28,25,678.05,1234.08,0.00
2024-12-08 16:51:52,53,1224,28,25,681.14,1235.00,0.00
2024-12-08 16:51:52,54,1224,29,25,668.53,1235.02,0.00
2024-12-08 16:51:52,54,1225,29,25,668.78,1236.00,0.00
2024-12-08 16:51:52,55,1225,29,26,656.62,1236.02,0.00
2024-12-08 16:51:52,54,1225,28,26,655.82,1236.56,0.00
2024-12-08 16:51:52,54,1226,28,26,673.52,1237.00,0.00
2024-12-08 16:51:52,55,1226,29,26,661.28,1237.02,0.00
2024-12-08 16:51:52,54,1226,29,25,672.40,1237.09,0.00
2024-12-08 16:51:52,54,1227,29,25,675.44,1238.00,0.00
2024-12-08 16:51:52,55,1227,29,26,663.16,1238.02,0.00
2024-12-08 16:51:52,55,1228,29,26,663.36,1239.00,0.00
2024-12-08 16:51:52,56,1228,30,26,651.52,1239.02,0.00
2024-12-08 16:51:52,55,1228,29,26,663.02,1239.04,0.00
2024-12-08 16:51:52,54,1228,28,26,663.20,1239.65,0.00
2024-12-08 16:51:52,54,1229,28,26,682.04,1240.00,0.00
2024-12-08 16:51:52,55,1229,29,26,669.64,1240.02,0.00
2024-12-08 16:51:52,54,1229,29,25,680.92,1240.09,0.00
2024-12-08 16:51:52,54,1230,29,25,683.97,1241.00,0.00
2024-12-08 16:51:52,55,1230,30,25,671.54,1241.02,0.00
2024-12-08 16:51:53,55,1231,30,25,671.81,1242.00,0.00
2024-12-08 16:51:53,56,1231,31,25,659.82,1242.02,0.00
2024-12-08 16:51:53,56,1232,31,25,657.02,1243.00,0.00
2024-12-08 16:51:53,57,1232,32,25,645.49,1243.02,0.00
2024-12-08 16:51:53,56,1232,32,24,655.49,1243.11,0.00
2024-12-08 16:51:53,56,1233,32,24,658.21,1244.00,0.00
2024-12-08 16:51:53,57,1233,33,24,646.67,1244.02,0.00
2024-12-08 16:51:53,56,1233,32,24,642.09,1244.52,0.00
2024-12-08 16:51:53,56,1234,32,24,658.64,1245.00,0.00
2024-12-08 16:51:53,57,1234,33,24,647.09,1245.02,0.00
2024-12-08 16:51:53,57,1235,33,24,644.25,1246.00,0.00
2024-12-08 16:51:53,58,1235,33,25,633.14,1246.02,0.00
2024-12-08 16:51:53,57,1235,33,24,642.29,1246.12,0.00
2024-12-08 16:51:53,57,1236,33,24,644.98,1247.00,0.00
2024-12-08 16:51:53,58,1236,34,24,633.86,1247.02,0.00
2024-12-08 16:51:53,57,1236,33,24,642.57,1247.07,0.00
2024-12-08 16:51:53,56,1236,32,24,653.82,1247.09,0.00
2024-12-08 16:51:53,56,1237,32,24,660.79,1248.00,0.00
2024-12-08 16:51:53,57,1237,32,25,649.20,1248.02,0.00
2024-12-08 16:51:53,57,1238,32,25,646.22,1249.00,0.00
2024-12-08 16:51:53,58,1238,33,25,635.07,1249.02,0.00
2024-12-08 16:51:53,57,1238,33,24,645.13,1249.09,0.00
2024-12-08 16:51:53,57,1239,33,24,647.39,1250.00,0.00
2024-12-08 16:51:53,58,1239,33,25,636.23,1250.02,0.00
2024-12-08 16:51:53,58,1240,33,25,636.34,1251.00,0.00
2024-12-08 16:51:53,59,1240,33,26,625.55,1251.02,0.00
2024-12-08 16:51:53,58,1240,32,26,626.05,1251.50,0.00
2024-12-08 16:51:53,58,1241,32,26,633.30,1252.00,0.00
2024-12-08 16:51:53,59,1241,33,26,622.57,1252.02,0.00
2024-12-08 16:51:53,58,1241,32,26,632.56,1252.07,0.00
2024-12-08 16:51:53,57,1241,32,25,642.79,1252.11,0.00
2024-12-08 16:51:53,56,1241,31,25,647.39,1252.66,0.00
2024-12-08 16:51:53,55,1241,30,25,650.59,1252.85,0.00
2024-12-08 16:51:53,55,1242,30,25,671.64,1253.00,0.00
2024-12-08 16:51:53,56,1242,31,25,659.65,1253.02,0.00
2024-12-08 16:51:53,55,1242,30,25,669.82,1253.02,0.00
2024-12-08 16:51:53,55,1243,30,25,676.28,1254.00,0.00
2024-12-08 16:51:53,56,1243,31,25,664.20,1254.02,0.00
2024-12-08 16:51:53,55,1243,31,24,671.25,1254.09,0.00
2024-12-08 16:51:53,55,1244,31,24,674.05,1255.00,0.00
2024-12-08 16:51:53,56,1244,32,24,662.02,1255.02,0.00
2024-12-08 16:51:53,55,1244,31,24,663.85,1255.26,0.00
2024-12-08 16:51:53,55,1245,31,24,677.79,1256.00,0.00
2024-12-08 16:51:53,56,1245,32,24,665.68,1256.02,0.00
2024-12-08 16:51:53,55,1245,32,23,672.09,1256.09,0.00
2024-12-08 16:51:53,55,1246,32,23,674.90,1257.00,0.00
2024-12-08 16:51:53,56,1246,33,23,662.85,1257.02,0.00
2024-12-08 16:51:53,56,1247,33,23,662.92,1258.00,0.00
2024-12-08 16:51:53,57,1247,34,23,651.29,1258.02,0.00
2024-12-08 16:51:53,57,1248,34,23,648.27,1259.00,0.00
2024-12-08 16:51:53,58,1248,35,23,637.09,1259.02,0.00
2024-12-08 16:51:53,57,1248,34,23,647.39,1259.09,0.00
2024-12-08 16:51:53,56,1248,34,22,658.73,1259.09,0.00
2024-12-08 16:51:53,56,1249,34,22,661.27,1260.00,0.00
2024-12-08 16:51:53,57,1249,35,22,649.67,1260.02,0.00
2024-12-08 16:51:53,57,1250,35,22,649.32,1261.00,0.00
2024-12-08 16:51:53,58,1250,36,22,638.13,1261.02,0.00
2024-12-08 16:51:53,57,1250,35,22,648.83,1261.05,0.00
2024-12-08 16:51:53,56,1250,35,21,655.69,1261.07,0.00
2024-12-08 16:51:53,56,1251,35,21,658.01,1262.00,0.00
2024-12-08 16:51:53,57,1251,36,21,646.47,1262.02,0.00
2024-12-08 16:51:53,57,1252,36,21,646.19,1263.00,0.00
2024-12-08 16:51:53,58,1252,37,21,635.05,1263.02,0.00
2024-12-08 16:51:53,57,1252,37,20,640.87,1263.09,0.00
2024-12-08 16:51:53,57,1253,37,20,643.15,1264.00,0.00
2024-12-08 16:51:53,58,1253,37,21,632.06,1264.02,0.00
2024-12-08 16:51:53,57,1253,36,21,635.86,1264.16,0.00
2024-12-08 16:51:53,57,1254,36,21,647.88,1265.00,0.00
2024-12-08 16:51:53,58,1254,36,22,636.71,1265.02,0.00
2024-12-08 16:51:53,57,1254,35,22,647.25,1265.05,0.00
2024-12-08 16:51:53,56,1254,35,21,654.29,1265.07,0.00
2024-12-08 16:51:53,55,1254,34,21,666.19,1265.07,0.00
2024-12-08 16:51:53,55,1255,34,21,668.78,1266.00,0.00
2024-12-08 16:51:53,56,1255,35,21,656.84,1266.02,0.00
2024-12-08 16:51:53,55,1255,34,21,668.09,1266.02,0.00
2024-12-08 16:51:53,55,1256,34,21,674.61,1267.00,0.00
2024-12-08 16:51:53,56,1256,35,21,662.56,1267.02,0.00
2024-12-08 16:51:53,55,1256,35,20,669.77,1267.06,0.00
2024-12-08 16:51:53,54,1256,34,20,674.71,1267.65,0.00
2024-12-08 16:51:53,54,1257,34,20,684.59,1268.00,0.00
2024-12-08 16:51:53,55,1257,35,20,672.14,1268.02,0.00
2024-12-08 16:51:53,55,1258,35,20,672.07,1269.00,0.00
2024-12-08 16:51:53,56,1258,36,20,660.07,1269.02,0.00
2024-12-08 16:51:53,55,1258,36,19,666.54,1269.07,0.00
2024-12-08 16:51:53,55,1259,36,19,669.14,1270.00,0.00
2024-12-08 16:51:53,56,1259,37,19,657.19,1270.02,0.00
2024-12-08 16:51:54,56,1260,37,19,657.33,1271.00,0.00
2024-12-08 16:51:54,57,1260,37,20,645.80,1271.02,0.00
2024-12-08 16:51:54,57,1261,37,20,642.54,1272.00,0.00
2024-12-08 16:51:54,58,1261,38,20,631.46,1272.02,0.00
2024-12-08 16:51:54,57,1261,38,19,641.43,1272.09,0.00
2024-12-08 16:51:54,56,1261,37,19,648.26,1272.46,0.00
2024-12-08 16:51:54,56,1262,37,19,655.41,1273.00,0.00
2024-12-08 16:51:54,57,1262,37,20,643.91,1273.02,0.00
2024-12-08 16:51:54,57,1263,37,20,643.70,1274.00,0.00
2024-12-08 16:51:54,58,1263,38,20,632.60,1274.02,0.00
2024-12-08 16:51:54,57,1263,37,20,643.38,1274.04,0.00
2024-12-08 16:51:54,56,1263,37,19,649.87,1274.07,0.00
2024-12-08 16:51:54,56,1264,37,19,652.19,1275.00,0.00
2024-12-08 16:51:54,57,1264,37,20,640.75,1275.02,0.00
2024-12-08 16:51:54,56,1264,36,20,651.97,1275.02,0.00
2024-12-08 16:51:54,55,1264,35,20,652.78,1275.26,0.00
2024-12-08 16:51:54,55,1265,35,20,666.89,1276.00,0.00
2024-12-08 16:51:54,56,1265,36,20,654.98,1276.02,0.00
2024-12-08 16:51:54,55,1265,35,20,653.90,1276.24,0.00
2024-12-08 16:51:54,55,1266,35,20,667.80,1277.00,0.00
2024-12-08 16:51:54,56,1266,35,21,655.88,1277.02,0.00
2024-12-08 16:51:54,55,1266,34,21,667.35,1277.06,0.00
2024-12-08 16:51:54,54,1266,34,20,679.47,1277.06,0.00
2024-12-08 16:51:54,54,1267,34,20,682.12,1278.00,0.00
2024-12-08 16:51:54,55,1267,34,21,669.72,1278.02,0.00
2024-12-08 16:51:54,56,1266,34,22,648.56,1278.43,0.00
2024-12-08 16:51:54,56,1267,34,22,674.45,1279.00,0.00
2024-12-08 16:51:54,57,1267,35,22,662.62,1279.02,0.00
2024-12-08 16:51:54,56,1267,35,21,669.44,1279.05,0.00
2024-12-08 16:51:54,56,1268,35,21,694.41,1280.00,0.00
2024-12-08 16:51:54,57,1268,36,21,682.22,1280.02,0.00
2024-12-08 16:51:54,56,1268,35,21,682.56,1280.50,0.00
2024-12-08 16:51:54,56,1269,35,21,699.35,1281.00,0.00
2024-12-08 16:51:54,57,1269,36,21,687.08,1281.02,0.00
2024-12-08 16:51:54,56,1269,36,20,694.32,1281.05,0.00
2024-12-08 16:51:54,56,1270,36,20,696.46,1282.00,0.00
2024-12-08 16:51:54,57,1270,37,20,684.24,1282.02,0.00
2024-12-08 16:51:54,57,1271,37,20,684.04,1283.00,0.00
2024-12-08 16:51:54,58,1271,38,20,672.25,1283.02,0.00
2024-12-08 16:51:54,57,1271,37,20,683.60,1283.05,0.00
2024-12-08 16:51:54,56,1271,36,20,672.99,1283.96,0.00
2024-12-08 16:51:54,56,1272,36,20,695.48,1284.00,0.00
2024-12-08 16:51:54,57,1272,37,20,683.28,1284.02,0.00
2024-12-08 16:51:54,56,1272,37,19,694.58,1284.07,0.00
2024-12-08 16:51:54,56,1273,37,19,696.94,1285.00,0.00
2024-12-08 16:51:54,57,1273,37,20,684.71,1285.02,0.00
2024-12-08 16:51:54,56,1273,36,20,684.65,1285.30,0.00
2024-12-08 16:51:54,55,1273,35,20,695.46,1285.44,0.00
2024-12-08 16:51:54,55,1274,35,20,711.94,1286.00,0.00
2024-12-08 16:51:54,56,1274,36,20,699.23,1286.02,0.00
2024-12-08 16:51:54,55,1274,36,19,706.58,1286.07,0.00
2024-12-08 16:51:54,55,1275,36,19,709.22,1287.00,0.00
2024-12-08 16:51:54,56,1275,36,20,696.56,1287.02,0.00
2024-12-08 16:51:54,56,1276,36,20,696.02,1288.00,0.00
2024-12-08 16:51:54,57,1276,37,20,683.81,1288.02,0.00
2024-12-08 16:51:54,56,1276,37,19,690.98,1288.07,0.00
2024-12-08 16:51:54,55,1276,36,19,690.01,1288.80,0.00
2024-12-08 16:51:54,55,1277,36,19,711.03,1289.00,0.00
2024-12-08 16:51:54,56,1277,37,19,698.33,1289.02,0.00
2024-12-08 16:51:54,56,1278,37,19,697.71,1290.00,0.00
2024-12-08 16:51:54,57,1278,37,20,685.47,1290.02,0.00
2024-12-08 16:51:54,56,1278,37,19,692.89,1290.07,0.00
2024-12-08 16:51:54,55,1278,36,19,697.77,1290.67,0.00
2024-12-08 16:51:54,55,1279,36,19,707.90,1291.00,0.00
2024-12-08 16:51:54,56,1279,36,20,695.26,1291.02,0.00
2024-12-08 16:51:54,55,1279,35,20,697.40,1291.47,0.00
2024-12-08 16:51:54,55,1280,35,20,707.60,1292.00,0.00
2024-12-08 16:51:54,56,1280,36,20,694.96,1292.02,0.00
2024-12-08 16:51:54,55,1280,36,19,702.44,1292.07,0.00
2024-12-08 16:51:54,54,1280,35,19,697.57,1292.96,0.00
2024-12-08 16:51:54,54,1281,35,19,721.06,1293.00,0.00
2024-12-08 16:51:54,55,1281,35,20,707.95,1293.02,0.00
2024-12-08 16:51:54,55,1282,35,20,707.80,1294.00,0.00
2024-12-08 16:51:54,56,1282,36,20,695.16,1294.02,0.00
2024-12-08 16:51:54,55,1282,36,19,702.16,1294.09,0.00
2024-12-08 16:51:54,55,1283,36,19,704.73,1295.00,0.00
2024-12-08 16:51:54,56,1283,36,20,692.15,1295.02,0.00
2024-12-08 16:51:54,56,1284,36,20,691.28,1296.00,0.00
2024-12-08 16:51:54,57,1284,37,20,679.15,1296.02,0.00
2024-12-08 16:51:54,56,1284,36,20,690.14,1296.11,0.00
2024-12-08 16:51:54,55,1284,36,19,697.74,1296.11,0.00
2024-12-08 16:51:54,54,1284,35,19,707.12,1296.32,0.00
2024-12-08 16:51:54,54,1285,35,19,722.49,1297.00,0.00
2024-12-08 16:51:54,55,1285,36,19,709.35,1297.02,0.00
2024-12-08 16:51:54,54,1285,35,19,711.96,1297.15,0.00
2024-12-08 16:51:54,54,1286,35,19,725.46,1298.00,0.00
2024-12-08 16:51:54,55,1286,36,19,712.27,1298.02,0.00
2024-12-08 16:51:54,54,1286,36,18,718.99,1298.13,0.00
2024-12-08 16:51:54,54,1287,36,18,722.65,1299.00,0.00
2024-12-08 16:51:54,55,1287,36,19,709.51,1299.02,0.00
2024-12-08 16:51:55,54,1287,35,19,719.08,1299.17,0.00
2024-12-08 16:51:55,54,1288,35,19,728.02,1300.00,0.00
2024-12-08 16:51:55,55,1288,35,20,714.78,1300.02,0.00
2024-12-08 16:51:55,55,1289,35,20,712.53,1301.00,0.00
2024-12-08 16:51:55,56,1289,36,20,699.81,1301.02,0.00
2024-12-08 16:51:55,55,1289,35,20,711.60,1301.07,0.00
2024-12-08 16:51:55,54,1289,34,20,714.39,1301.13,0.00
2024-12-08 16:51:55,53,1289,34,19,726.40,1301.13,0.00
2024-12-08 16:51:55,53,1290,34,19,740.20,1302.00,0.00
2024-12-08 16:51:55,54,1290,35,19,726.50,1302.02,0.00
2024-12-08 16:51:55,53,1290,34,19,738.99,1302.11,0.00
2024-12-08 16:51:55,53,1291,34,19,741.36,1303.00,0.00
2024-12-08 16:51:55,54,1291,35,19,727.63,1303.02,0.00
2024-12-08 16:51:55,53,1291,34,19,728.13,1303.66,0.00
2024-12-08 16:51:55,53,1292,34,19,739.00,1304.00,0.00
2024-12-08 16:51:55,54,1292,34,20,725.31,1304.02,0.00
2024-12-08 16:51:55,53,1292,34,19,736.55,1304.11,0.00
2024-12-08 16:51:55,53,1293,34,19,740.30,1305.00,0.00
2024-12-08 16:51:55,54,1293,35,19,726.59,1305.02,0.00
2024-12-08 16:51:55,54,1294,35,19,727.29,1306.00,0.00
2024-12-08 16:51:55,55,1294,36,19,714.07,1306.02,0.00
2024-12-08 16:51:55,55,1295,36,19,711.42,1307.00,0.00
2024-12-08 16:51:55,56,1295,36,20,698.72,1307.02,0.00
2024-12-08 16:51:55,55,1295,35,20,711.18,1307.02,0.00
2024-12-08 16:51:55,54,1295,35,19,722.19,1307.11,0.00
2024-12-08 16:51:55,54,1296,35,19,725.61,1308.00,0.00
2024-12-08 16:51:55,55,1296,36,19,712.42,1308.02,0.00
2024-12-08 16:51:55,54,1296,35,19,721.50,1308.04,0.00
2024-12-08 16:51:55,54,1297,35,19,728.53,1309.00,0.00
2024-12-08 16:51:55,55,1297,35,20,715.28,1309.02,0.00
2024-12-08 16:51:55,55,1298,35,20,711.88,1310.00,0.00
2024-12-08 16:51:55,56,1298,36,20,699.17,1310.02,0.00
2024-12-08 16:51:55,55,1298,36,19,710.46,1310.09,0.00
2024-12-08 16:51:55,55,1299,36,19,712.55,1311.00,0.00
2024-12-08 16:51:55,56,1299,37,19,699.82,1311.02,0.00
2024-12-08 16:51:55,55,1299,36,19,712.31,1311.02,0.00
2024-12-08 16:51:55,54,1299,35,19,703.77,1311.96,0.00
2024-12-08 16:51:55,54,1300,35,19,727.60,1312.00,0.00
2024-12-08 16:51:55,55,1300,36,19,714.37,1312.02,0.00
2024-12-08 16:51:55,55,1301,36,19,712.58,1313.00,0.00
2024-12-08 16:51:55,56,1301,37,19,699.86,1313.02,0.00
2024-12-08 16:51:55,55,1301,37,18,707.13,1313.22,0.00
2024-12-08 16:51:55,56,1300,38,18,688.31,1313.73,0.00
2024-12-08 16:51:55,56,1301,38,18,702.84,1314.00,0.00
2024-12-08 16:51:55,57,1301,38,19,690.50,1314.02,0.00
2024-12-08 16:51:55,57,1302,38,19,714.94,1315.00,0.00
2024-12-08 16:51:55,58,1302,38,20,702.62,1315.02,0.00
2024-12-08 16:51:55,58,1303,38,20,700.59,1316.00,0.00
2024-12-08 16:51:55,59,1303,38,21,688.71,1316.02,0.00
2024-12-08 16:51:55,58,1303,37,21,699.91,1316.07,0.00
2024-12-08 16:51:55,57,1303,37,20,699.04,1316.19,0.00
2024-12-08 16:51:55,57,1304,37,20,712.03,1317.00,0.00
2024-12-08 16:51:55,58,1304,38,20,699.76,1317.02,0.00
2024-12-08 16:51:55,57,1304,37,20,711.35,1317.07,0.00
2024-12-08 16:51:55,56,1304,36,20,723.81,1317.07,0.00
2024-12-08 16:51:55,55,1304,35,20,723.20,1317.42,0.00
2024-12-08 16:51:55,55,1305,35,20,739.91,1318.00,0.00
2024-12-08 16:51:55,56,1305,36,20,726.69,1318.02,0.00
2024-12-08 16:51:55,55,1305,35,20,726.38,1318.26,0.00
2024-12-08 16:51:55,55,1306,35,20,740.79,1319.00,0.00
2024-12-08 16:51:55,56,1306,36,20,727.56,1319.02,0.00
2024-12-08 16:51:55,55,1306,35,20,740.07,1319.07,0.00
2024-12-08 16:51:55,54,1306,35,19,748.68,1319.22,0.00
2024-12-08 16:51:55,54,1307,35,19,753.61,1320.00,0.00
2024-12-08 16:51:55,55,1307,36,19,739.91,1320.02,0.00
2024-12-08 16:51:55,54,1307,35,19,737.10,1320.44,0.00
2024-12-08 16:51:55,54,1308,35,19,754.63,1321.00,0.00
2024-12-08 16:51:55,55,1308,36,19,740.91,1321.02,0.00
2024-12-08 16:51:55,54,1308,35,19,753.90,1321.07,0.00
2024-12-08 16:51:56,54,1309,35,19,752.33,1322.00,0.00
2024-12-08 16:51:56,55,1309,35,20,738.65,1322.02,0.00
2024-12-08 16:51:56,54,1309,35,19,748.43,1322.20,0.00
2024-12-08 16:51:56,54,1310,35,19,753.13,1323.00,0.00
2024-12-08 16:51:56,55,1310,35,20,739.43,1323.02,0.00
2024-12-08 16:51:56,54,1310,34,20,752.16,1323.09,0.00
2024-12-08 16:51:56,53,1310,33,20,747.18,1323.77,0.00
2024-12-08 16:51:56,53,1311,33,20,769.33,1324.00,0.00
2024-12-08 16:51:56,54,1311,33,21,755.08,1324.02,0.00
2024-12-08 16:51:56,53,1311,32,21,768.73,1324.06,0.00
2024-12-08 16:51:56,52,1311,31,21,783.27,1324.08,0.00
2024-12-08 16:51:56,52,1312,31,21,782.43,1325.00,0.00
2024-12-08 16:51:56,53,1312,32,21,767.67,1325.02,0.00
2024-12-08 16:51:56,52,1312,32,20,777.62,1325.17,0.00
2024-12-08 16:51:56,51,1312,31,20,786.92,1325.43,0.00
2024-12-08 16:51:56,51,1313,31,20,805.79,1326.00,0.00
2024-12-08 16:51:56,52,1313,32,20,790.29,1326.02,0.00
2024-12-08 16:51:56,52,1314,32,20,791.77,1327.00,0.00
2024-12-08 16:51:56,53,1314,33,20,776.83,1327.02,0.00
2024-12-08 16:51:56,52,1314,32,20,791.01,1327.08,0.00
2024-12-08 16:51:56,52,1315,32,20,789.55,1328.00,0.00
2024-12-08 16:51:56,53,1315,32,21,774.66,1328.02,0.00
2024-12-08 16:51:56,52,1315,32,20,785.24,1328.15,0.00
2024-12-08 16:51:56,52,1316,32,20,789.89,1329.00,0.00
2024-12-08 16:51:56,53,1316,33,20,774.99,1329.02,0.00
2024-12-08 16:51:56,52,1316,32,20,788.89,1329.10,0.00
2024-12-08 16:51:56,52,1317,32,20,791.13,1330.00,0.00
2024-12-08 16:51:56,53,1317,33,20,776.20,1330.02,0.00
2024-12-08 16:51:56,53,1318,33,20,773.52,1331.00,0.00
2024-12-08 16:51:56,54,1318,33,21,759.20,1331.02,0.00
2024-12-08 16:51:56,53,1318,33,20,770.03,1331.13,0.00
2024-12-08 16:51:56,53,1319,33,20,773.74,1332.00,0.00
2024-12-08 16:51:56,54,1319,33,21,759.41,1332.02,0.00
2024-12-08 16:51:56,53,1319,32,21,761.26,1332.49,0.00
2024-12-08 16:51:56,53,1320,32,21,779.97,1333.00,0.00
2024-12-08 16:51:56,54,1320,32,22,765.53,1333.02,0.00
2024-12-08 16:51:56,54,1321,32,22,762.89,1334.00,0.00
2024-12-08 16:51:56,55,1321,32,23,749.02,1334.02,0.00
2024-12-08 16:51:56,54,1321,31,23,762.65,1334.02,0.00
2024-12-08 16:51:56,53,1321,31,22,774.54,1334.11,0.00
2024-12-08 16:51:56,53,1322,31,22,778.37,1335.00,0.00
2024-12-08 16:51:56,54,1322,32,22,763.96,1335.02,0.00
2024-12-08 16:51:56,54,1323,32,22,765.07,1336.00,0.00
2024-12-08 16:51:56,55,1323,33,22,751.16,1336.02,0.00
2024-12-08 16:51:56,54,1323,32,22,752.62,1336.48,0.00
2024-12-08 16:51:56,54,1324,32,22,770.80,1337.00,0.00
2024-12-08 16:51:56,55,1324,33,22,756.78,1337.02,0.00
2024-12-08 16:51:56,54,1324,32,22,770.55,1337.02,0.00
2024-12-08 16:51:56,53,1324,32,21,781.10,1337.15,0.00
2024-12-08 16:51:56,53,1325,32,21,785.42,1338.00,0.00
2024-12-08 16:51:56,54,1325,33,21,770.88,1338.02,0.00
2024-12-08 16:51:56,54,1326,33,21,771.71,1339.00,0.00
2024-12-08 16:51:56,55,1326,34,21,757.68,1339.02,0.00
2024-12-08 16:51:56,55,1327,34,21,754.83,1340.00,0.00
2024-12-08 16:51:56,56,1327,35,21,741.35,1340.02,0.00
2024-12-08 16:51:56,55,1327,35,20,750.98,1340.16,0.00
2024-12-08 16:51:56,55,1328,35,20,754.91,1341.00,0.00
2024-12-08 16:51:56,56,1328,35,21,741.43,1341.02,0.00
2024-12-08 16:51:56,57,1327,35,22,714.45,1341.77,0.00
2024-12-08 16:51:56,57,1328,35,22,748.00,1342.00,0.00
2024-12-08 16:51:56,58,1328,35,23,735.11,1342.02,0.00
2024-12-08 16:51:56,57,1328,34,23,723.36,1342.95,0.00
2024-12-08 16:51:56,57,1329,34,23,769.79,1343.00,0.00
2024-12-08 16:51:56,58,1329,35,23,756.52,1343.02,0.00
2024-12-08 16:51:56,57,1329,35,22,766.06,1343.16,0.00
2024-12-08 16:51:56,57,1330,35,22,769.42,1344.00,0.00
2024-12-08 16:51:56,58,1330,36,22,756.16,1344.02,0.00
2024-12-08 16:51:56,58,1331,36,22,756.00,1345.00,0.00
2024-12-08 16:51:56,59,1331,37,22,743.19,1345.02,0.00
2024-12-08 16:51:56,59,1332,37,22,739.64,1346.00,0.00
2024-12-08 16:51:56,60,1332,37,23,727.31,1346.02,0.00
2024-12-08 16:51:56,59,1332,37,22,736.48,1346.15,0.00
2024-12-08 16:51:56,59,1333,37,22,739.27,1347.00,0.00
2024-12-08 16:51:56,60,1333,38,22,726.95,1347.02,0.00
2024-12-08 16:51:57,60,1334,38,22,726.32,1348.00,0.00
2024-12-08 16:51:57,61,1334,38,23,714.42,1348.02,0.00
2024-12-08 16:51:57,61,1335,38,23,710.24,1349.00,0.00
2024-12-08 16:51:57,62,1335,39,23,698.78,1349.02,0.00
2024-12-08 16:51:57,61,1335,38,23,709.39,1349.07,0.00
2024-12-08 16:51:57,60,1335,38,22,718.99,1349.15,0.00
2024-12-08 16:51:57,59,1335,37,22,723.31,1349.68,0.00
2024-12-08 16:51:57,59,1336,37,22,732.92,1350.00,0.00
2024-12-08 16:51:57,60,1336,38,22,720.70,1350.02,0.00
2024-12-08 16:51:57,59,1336,37,22,712.38,1350.68,0.00
2024-12-08 16:51:57,59,1337,37,22,731.16,1351.00,0.00
2024-12-08 16:51:57,60,1337,38,22,718.97,1351.02,0.00
2024-12-08 16:51:57,59,1337,37,22,718.85,1351.49,0.00
2024-12-08 16:51:57,59,1338,37,22,734.86,1352.00,0.00
2024-12-08 16:51:57,60,1338,38,22,722.61,1352.02,0.00
2024-12-08 16:51:57,59,1338,38,21,732.38,1352.15,0.00
2024-12-08 16:51:57,59,1339,38,21,733.99,1353.00,0.00
2024-12-08 16:51:57,60,1339,38,22,721.76,1353.02,0.00
2024-12-08 16:51:57,60,1340,38,22,720.30,1354.00,0.00
2024-12-08 16:51:57,61,1340,39,22,708.49,1354.02,0.00
2024-12-08 16:51:57,60,1340,38,22,707.59,1354.23,0.00
2024-12-08 16:51:57,60,1341,38,22,719.25,1355.00,0.00
2024-12-08 16:51:57,61,1341,39,22,707.46,1355.02,0.00
2024-12-08 16:51:57,60,1341,39,21,715.68,1355.20,0.00
2024-12-08 16:51:57,60,1342,39,21,717.99,1356.00,0.00
2024-12-08 16:51:57,61,1342,39,22,706.22,1356.02,0.00
2024-12-08 16:51:57,61,1343,39,22,705.08,1357.00,0.00
2024-12-08 16:51:57,62,1343,40,22,693.71,1357.02,0.00
2024-12-08 16:51:57,62,1344,40,22,689.46,1358.00,0.00
2024-12-08 16:51:57,63,1344,41,22,678.51,1358.02,0.00
2024-12-08 16:51:57,62,1344,40,22,687.52,1358.16,0.00
2024-12-08 16:51:57,61,1344,40,21,697.90,1358.18,0.00
2024-12-08 16:51:57,61,1345,40,21,700.02,1359.00,0.00
2024-12-08 16:51:57,62,1345,41,21,688.73,1359.02,0.00
2024-12-08 16:51:57,61,1345,40,21,696.70,1359.18,0.00
2024-12-08 16:51:57,61,1346,40,21,703.04,1360.00,0.00
2024-12-08 16:51:57,62,1346,41,21,691.70,1360.02,0.00
2024-12-08 16:51:57,62,1347,41,21,687.15,1361.00,0.00
2024-12-08 16:51:57,63,1347,41,22,676.24,1361.02,0.00
2024-12-08 16:51:57,62,1347,40,22,686.93,1361.02,0.00
2024-12-08 16:51:57,61,1347,40,21,695.32,1361.16,0.00
2024-12-08 16:51:57,61,1348,40,21,697.01,1362.00,0.00
2024-12-08 16:51:57,62,1348,41,21,685.77,1362.02,0.00
2024-12-08 16:51:57,61,1348,40,21,686.11,1362.46,0.00
2024-12-08 16:51:57,61,1349,40,21,696.28,1363.00,0.00
2024-12-08 16:51:57,62,1349,40,22,685.05,1363.02,0.00
2024-12-08 16:51:57,61,1349,39,22,687.47,1363.33,0.00
2024-12-08 16:51:57,62,1348,39,23,674.05,1363.53,0.00
2024-12-08 16:51:57,62,1349,39,23,688.14,1364.00,0.00
2024-12-08 16:51:57,63,1349,39,24,677.22,1364.02,0.00
2024-12-08 16:51:57,62,1349,39,23,685.09,1364.18,0.00
2024-12-08 16:51:57,61,1349,38,23,689.66,1364.67,0.00
2024-12-08 16:51:57,61,1350,38,23,721.19,1365.00,0.00
2024-12-08 16:51:57,62,1350,39,23,709.56,1365.02,0.00
2024-12-08 16:51:57,62,1351,39,23,708.81,1366.00,0.00
2024-12-08 16:51:57,63,1351,40,23,697.56,1366.02,0.00
2024-12-08 16:51:57,62,1351,39,23,707.30,1366.11,0.00
2024-12-08 16:51:57,62,1352,39,23,704.85,1367.00,0.00
2024-12-08 16:51:57,63,1352,39,24,693.66,1367.02,0.00
2024-12-08 16:51:57,62,1352,38,24,704.63,1367.02,0.00
2024-12-08 16:51:57,61,1352,38,23,713.75,1367.15,0.00
2024-12-08 16:51:57,61,1353,38,23,715.62,1368.00,0.00
2024-12-08 16:51:57,62,1353,38,24,704.08,1368.02,0.00
2024-12-08 16:51:57,61,1353,37,24,712.51,1368.16,0.00
2024-12-08 16:51:57,61,1354,37,24,719.51,1369.00,0.00
2024-12-08 16:51:57,62,1354,38,24,707.91,1369.02,0.00
2024-12-08 16:51:57,61,1354,37,24,719.29,1369.02,0.00
2024-12-08 16:51:57,60,1354,36,24,718.42,1369.63,0.00
2024-12-08 16:51:57,60,1355,36,24,727.97,1370.00,0.00
2024-12-08 16:51:57,61,1355,37,24,716.04,1370.02,0.00
2024-12-08 16:51:58,60,1355,37,23,724.59,1370.18,0.00
2024-12-08 16:51:58,60,1356,37,23,727.59,1371.00,0.00
2024-12-08 16:51:58,61,1356,38,23,715.66,1371.02,0.00
2024-12-08 16:51:58,61,1357,38,23,715.08,1372.00,0.00
2024-12-08 16:51:58,62,1357,38,24,703.54,1372.02,0.00
2024-12-08 16:51:58,62,1358,38,24,699.84,1373.00,0.00
2024-12-08 16:51:58,63,1358,38,25,688.73,1373.02,0.00
2024-12-08 16:51:58,62,1358,38,24,696.99,1373.18,0.00
2024-12-08 16:51:58,61,1358,37,24,704.94,1373.43,0.00
2024-12-08 16:51:58,61,1359,37,24,710.94,1374.00,0.00
2024-12-08 16:51:58,62,1359,37,25,699.47,1374.02,0.00
2024-12-08 16:51:58,61,1359,36,25,709.81,1374.10,0.00
2024-12-08 16:51:58,62,1358,37,25,685.18,1374.79,0.00
2024-12-08 16:51:58,62,1359,37,25,701.68,1375.00,0.00
2024-12-08 16:51:58,63,1359,37,26,690.54,1375.02,0.00
2024-12-08 16:51:58,63,1360,37,26,708.41,1376.00,0.00
2024-12-08 16:51:58,64,1360,38,26,697.34,1376.02,0.00
2024-12-08 16:51:58,63,1360,38,25,706.25,1376.16,0.00
2024-12-08 16:51:58,62,1360,37,25,701.34,1376.89,0.00
2024-12-08 16:51:58,62,1361,37,25,722.08,1377.00,0.00
2024-12-08 16:51:58,63,1361,37,26,710.62,1377.02,0.00
2024-12-08 16:51:58,62,1361,36,26,719.36,1377.18,0.00
2024-12-08 16:51:58,61,1361,35,26,731.10,1377.18,0.00
2024-12-08 16:51:58,61,1362,35,26,738.38,1378.00,0.00
2024-12-08 16:51:58,62,1362,36,26,726.47,1378.02,0.00
2024-12-08 16:51:58,62,1363,36,26,722.76,1379.00,0.00
2024-12-08 16:51:58,63,1363,37,26,711.29,1379.02,0.00
2024-12-08 16:51:58,62,1363,36,26,722.54,1379.02,0.00
2024-12-08 16:51:58,61,1363,36,25,731.48,1379.16,0.00
2024-12-08 16:51:58,61,1364,36,25,734.01,1380.00,0.00
2024-12-08 16:51:58,62,1364,37,25,722.17,1380.02,0.00
2024-12-08 16:51:58,62,1365,37,25,721.25,1381.00,0.00
2024-12-08 16:51:58,63,1365,38,25,709.80,1381.02,0.00
2024-12-08 16:51:58,62,1365,37,25,721.03,1381.02,0.00
2024-12-08 16:51:58,62,1366,37,25,717.22,1382.00,0.00
2024-12-08 16:51:58,63,1366,38,25,705.83,1382.02,0.00
2024-12-08 16:51:58,62,1366,38,24,715.02,1382.15,0.00
2024-12-08 16:51:58,62,1367,38,24,717.07,1383.00,0.00
2024-12-08 16:51:58,63,1367,39,24,705.69,1383.02,0.00
2024-12-08 16:51:58,63,1368,39,24,704.43,1384.00,0.00
2024-12-08 16:51:58,64,1368,39,25,693.42,1384.02,0.00
2024-12-08 16:51:58,63,1368,38,25,704.21,1384.02,0.00
2024-12-08 16:51:58,62,1368,38,24,709.34,1384.13,0.00
2024-12-08 16:51:58,62,1369,38,24,711.29,1385.00,0.00
2024-12-08 16:51:58,63,1369,39,24,700.00,1385.02,0.00
2024-12-08 16:51:58,62,1369,38,24,692.98,1385.63,0.00
2024-12-08 16:51:58,62,1370,38,24,710.44,1386.00,0.00
2024-12-08 16:51:58,63,1370,38,25,699.16,1386.02,0.00
2024-12-08 16:51:58,62,1370,37,25,710.21,1386.02,0.00
2024-12-08 16:51:58,61,1370,36,25,721.35,1386.05,0.00
2024-12-08 16:51:58,61,1371,36,25,718.05,1387.00,0.00
2024-12-08 16:51:58,62,1371,36,26,706.47,1387.02,0.00
2024-12-08 16:51:58,61,1371,36,25,716.04,1387.13,0.00
2024-12-08 16:51:58,60,1371,35,25,715.72,1387.38,0.00
2024-12-08 16:51:58,60,1372,35,25,730.66,1388.00,0.00
2024-12-08 16:51:58,61,1372,36,25,718.68,1388.02,0.00
2024-12-08 16:51:58,60,1372,35,25,717.72,1388.63,0.00
2024-12-08 16:51:58,60,1373,35,25,730.13,1389.00,0.00
2024-12-08 16:51:58,61,1373,35,26,718.17,1389.02,0.00
2024-12-08 16:51:58,60,1373,34,26,717.02,1389.63,0.00
2024-12-08 16:51:58,60,1374,34,26,726.09,1390.00,0.00
2024-12-08 16:51:58,61,1374,34,27,714.18,1390.02,0.00
2024-12-08 16:51:58,60,1374,34,26,724.03,1390.13,0.00
2024-12-08 16:51:58,60,1375,34,26,726.38,1391.00,0.00
2024-12-08 16:51:58,61,1375,34,27,714.47,1391.02,0.00
2024-12-08 16:51:58,61,1376,34,27,713.46,1392.00,0.00
2024-12-08 16:51:58,62,1376,35,27,701.95,1392.02,0.00
2024-12-08 16:51:58,61,1376,35,26,707.10,1392.13,0.00
2024-12-08 16:51:58,60,1376,34,26,714.64,1392.43,0.00
2024-12-08 16:51:58,59,1376,33,26,715.85,1392.71,0.00
2024-12-08 16:51:59,59,1377,33,26,735.65,1393.00,0.00
2024-12-08 16:51:59,60,1377,33,27,723.39,1393.02,0.00
2024-12-08 16:51:59,59,1377,32,27,719.39,1393.64,0.00
2024-12-08 16:51:59,59,1378,32,27,738.31,1394.00,0.00
2024-12-08 16:51:59,60,1378,32,28,726.00,1394.02,0.00
2024-12-08 16:51:59,60,1379,32,28,726.42,1395.00,0.00
2024-12-08 16:51:59,61,1379,33,28,714.51,1395.02,0.00
2024-12-08 16:51:59,60,1379,32,28,715.50,1395.45,0.00
2024-12-08 16:51:59,60,1380,32,28,731.47,1396.00,0.00
2024-12-08 16:51:59,61,1380,32,29,719.47,1396.02,0.00
2024-12-08 16:51:59,60,1380,32,28,728.00,1396.13,0.00
2024-12-08 16:51:59,60,1381,32,28,730.36,1397.00,0.00
2024-12-08 16:51:59,61,1381,32,29,718.39,1397.02,0.00
2024-12-08 16:51:59,60,1381,31,29,713.96,1397.47,0.00
2024-12-08 16:51:59,60,1382,31,29,730.18,1398.00,0.00
2024-12-08 16:51:59,61,1382,32,29,718.21,1398.02,0.00
2024-12-08 16:51:59,60,1382,32,28,724.61,1398.13,0.00
2024-12-08 16:51:59,59,1382,31,28,726.95,1398.44,0.00
2024-12-08 16:51:59,59,1383,31,28,743.23,1399.00,0.00
2024-12-08 16:51:59,60,1383,31,29,730.84,1399.02,0.00
2024-12-08 16:51:59,59,1383,30,29,741.13,1399.17,0.00
2024-12-08 16:51:59,58,1383,29,29,753.42,1399.17,0.00
2024-12-08 16:51:59,58,1384,29,29,761.66,1400.00,0.00
2024-12-08 16:51:59,59,1384,30,29,748.75,1400.02,0.00
2024-12-08 16:51:59,58,1384,29,29,760.35,1400.10,0.00
2024-12-08 16:51:59,58,1385,29,29,757.99,1401.00,0.00
2024-12-08 16:51:59,59,1385,30,29,745.14,1401.02,0.00
2024-12-08 16:51:59,58,1385,30,28,755.84,1401.16,0.00
2024-12-08 16:51:59,58,1386,30,28,759.01,1402.00,0.00
2024-12-08 16:51:59,59,1386,31,28,746.15,1402.02,0.00
2024-12-08 16:51:59,59,1387,31,28,745.00,1403.00,0.00
2024-12-08 16:51:59,60,1387,31,29,732.59,1403.02,0.00
2024-12-08 16:51:59,59,1387,31,28,738.61,1403.15,0.00
2024-12-08 16:51:59,59,1388,31,28,741.49,1404.00,0.00
2024-12-08 16:51:59,60,1388,31,29,729.13,1404.02,0.00
2024-12-08 16:51:59,60,1389,31,29,727.84,1405.00,0.00
2024-12-08 16:51:59,61,1389,31,30,715.91,1405.02,0.00
2024-12-08 16:51:59,60,1389,30,30,727.37,1405.03,0.00
2024-12-08 16:51:59,59,1389,30,29,734.01,1405.14,0.00
2024-12-08 16:51:59,58,1389,29,29,743.45,1405.16,0.00
2024-12-08 16:51:59,58,1390,29,29,756.32,1406.00,0.00
2024-12-08 16:51:59,59,1390,29,30,743.50,1406.02,0.00
2024-12-08 16:51:59,59,1391,29,30,742.38,1407.00,0.00
2024-12-08 16:51:59,60,1391,29,31,730.00,1407.02,0.00
2024-12-08 16:51:59,59,1391,29,30,735.62,1407.15,0.00
2024-12-08 16:51:59,59,1392,29,30,738.51,1408.00,0.00
2024-12-08 16:51:59,60,1392,30,30,726.20,1408.02,0.00
2024-12-08 16:51:59,59,1392,29,30,724.47,1408.68,0.00
2024-12-08 16:51:59,59,1393,29,30,737.64,1409.00,0.00
2024-12-08 16:51:59,60,1393,29,31,725.34,1409.02,0.00
2024-12-08 16:51:59,59,1393,29,30,730.97,1409.15,0.00
2024-12-08 16:51:59,59,1394,29,30,733.86,1410.00,0.00
2024-12-08 16:51:59,60,1394,29,31,721.63,1410.02,0.00
2024-12-08 16:51:59,59,1394,28,31,725.04,1410.22,0.00
2024-12-08 16:51:59,59,1395,28,31,738.44,1411.00,0.00
2024-12-08 16:51:59,60,1395,29,31,726.14,1411.02,0.00
2024-12-08 16:51:59,59,1395,28,31,721.98,1411.24,0.00
2024-12-08 16:51:59,59,1396,28,31,735.62,1412.00,0.00
2024-12-08 16:51:59,60,1396,29,31,723.36,1412.02,0.00
2024-12-08 16:51:59,59,1396,28,31,733.49,1412.15,0.00
2024-12-08 16:51:59,58,1396,27,31,746.13,1412.16,0.00
2024-12-08 16:51:59,57,1396,27,30,758.49,1412.18,0.00
2024-12-08 16:51:59,57,1397,27,30,762.22,1413.00,0.00
2024-12-08 16:51:59,58,1397,28,30,749.08,1413.02,0.00
2024-12-08 16:51:59,57,1397,27,30,761.98,1413.02,0.00
2024-12-08 16:51:59,56,1397,26,30,775.33,1413.02,0.00
2024-12-08 16:51:59,55,1397,25,30,789.17,1413.02,0.00
2024-12-08 16:51:59,55,1398,25,30,789.73,1414.00,0.00
2024-12-08 16:51:59,56,1398,25,31,775.63,1414.02,0.00
2024-12-08 16:51:59,56,1399,25,31,772.39,1415.00,0.00
2024-12-08 16:51:59,57,1399,26,31,758.84,1415.02,0.00
2024-12-08 16:51:59,56,1399,25,31,772.19,1415.02,0.00
2024-12-08 16:51:59,55,1399,25,30,784.45,1415.11,0.00
2024-12-08 16:51:59,55,1400,25,30,787.82,1416.00,0.00
2024-12-08 16:51:59,56,1400,25,31,773.75,1416.02,0.00
2024-12-08 16:51:59,55,1400,24,31,776.93,1416.42,0.00
2024-12-08 16:51:59,55,1401,24,31,790.36,1417.00,0.00
2024-12-08 16:51:59,56,1401,24,32,776.25,1417.02,0.00
2024-12-08 16:51:59,55,1401,23,32,772.92,1417.56,0.00
2024-12-08 16:51:59,55,1402,23,32,792.81,1418.00,0.00
2024-12-08 16:51:59,56,1402,23,33,778.65,1418.02,0.00
2024-12-08 16:51:59,55,1402,22,33,791.92,1418.07,0.00
2024-12-08 16:51:59,54,1402,22,32,801.86,1418.09,0.00
2024-12-08 16:51:59,54,1403,22,32,805.30,1419.00,0.00
2024-12-08 16:51:59,55,1403,22,33,790.66,1419.02,0.00
2024-12-08 16:51:59,54,1403,21,33,799.79,1419.06,0.00
2024-12-08 16:51:59,54,1404,21,33,807.97,1420.00,0.00
2024-12-08 16:51:59,55,1404,22,33,793.28,1420.02,0.00
2024-12-08 16:51:59,54,1404,21,33,803.51,1420.04,0.00
2024-12-08 16:51:59,54,1405,21,33,811.44,1421.00,0.00
2024-12-08 16:51:59,55,1405,22,33,796.68,1421.02,0.00
2024-12-08 16:51:59,54,1405,22,32,810.13,1421.06,0.00
2024-12-08 16:52:00,54,1406,22,32,813.06,1422.00,0.00
2024-12-08 16:52:00,55,1406,22,33,798.28,1422.02,0.00
2024-12-08 16:52:00,55,1407,22,33,797.82,1423.00,0.00
2024-12-08 16:52:00,56,1407,23,33,783.58,1423.02,0.00
2024-12-08 16:52:00,55,1407,23,32,791.88,1423.06,0.00
2024-12-08 16:52:00,55,1408,23,32,794.50,1424.00,0.00
2024-12-08 16:52:00,56,1408,23,33,780.31,1424.02,0.00
2024-12-08 16:52:00,56,1409,23,33,779.72,1425.00,0.00
2024-12-08 16:52:00,57,1409,23,34,766.04,1425.02,0.00
2024-12-08 16:52:00,56,1409,23,33,774.13,1425.05,0.00
2024-12-08 16:52:00,56,1410,23,33,776.45,1426.00,0.00
2024-12-08 16:52:00,57,1410,23,34,762.83,1426.02,0.00
2024-12-08 16:52:00,56,1410,22,34,766.32,1426.18,0.00
2024-12-08 16:52:00,56,1411,22,34,780.56,1427.00,0.00
2024-12-08 16:52:00,57,1411,23,34,766.87,1427.02,0.00
2024-12-08 16:52:00,56,1411,23,33,774.71,1427.05,0.00
2024-12-08 16:52:00,56,1412,23,33,777.03,1428.00,0.00
2024-12-08 16:52:00,57,1412,24,33,763.39,1428.02,0.00
2024-12-08 16:52:00,56,1412,23,33,770.41,1428.07,0.00
2024-12-08 16:52:00,56,1413,23,33,783.18,1429.00,0.00
2024-12-08 16:52:00,57,1413,24,33,769.44,1429.02,0.00
2024-12-08 16:52:00,56,1413,24,32,777.58,1429.05,0.00
2024-12-08 16:52:00,56,1414,24,32,779.90,1430.00,0.00
2024-12-08 16:52:00,57,1414,25,32,766.22,1430.02,0.00
2024-12-08 16:52:00,57,1415,25,32,766.01,1431.00,0.00
2024-12-08 16:52:00,58,1415,25,33,752.81,1431.02,0.00
2024-12-08 16:52:00,57,1415,24,33,755.10,1431.44,0.00
2024-12-08 16:52:00,56,1415,23,33,768.10,1431.46,0.00
2024-12-08 16:52:00,55,1415,22,33,767.29,1431.96,0.00
2024-12-08 16:52:00,55,1416,22,33,792.83,1432.00,0.00
2024-12-08 16:52:00,56,1416,23,33,778.67,1432.02,0.00
2024-12-08 16:52:00,55,1416,23,32,792.05,1432.06,0.00
2024-12-08 16:52:00,55,1417,23,32,794.68,1433.00,0.00
2024-12-08 16:52:00,56,1417,23,33,780.49,1433.02,0.00
2024-12-08 16:52:00,55,1417,22,33,780.14,1433.67,0.00
2024-12-08 16:52:00,55,1418,22,33,794.20,1434.00,0.00
2024-12-08 16:52:00,56,1418,22,34,780.02,1434.02,0.00
2024-12-08 16:52:00,55,1418,22,33,788.47,1434.06,0.00
2024-12-08 16:52:00,55,1419,22,33,791.10,1435.00,0.00
2024-12-08 16:52:00,56,1419,22,34,776.98,1435.02,0.00
2024-12-08 16:52:00,56,1420,22,34,776.37,1436.00,0.00
2024-12-08 16:52:00,57,1420,23,34,762.75,1436.02,0.00
2024-12-08 16:52:00,56,1420,23,33,770.99,1436.05,0.00
2024-12-08 16:52:00,55,1420,22,33,779.64,1436.44,0.00
2024-12-08 16:52:00,55,1421,22,33,787.60,1437.00,0.00
2024-12-08 16:52:00,56,1421,23,33,773.54,1437.02,0.00
2024-12-08 16:52:00,55,1421,22,33,765.17,1437.85,0.00
2024-12-08 16:52:00,55,1422,22,33,789.32,1438.00,0.00
2024-12-08 16:52:00,56,1422,23,33,775.23,1438.02,0.00
2024-12-08 16:52:00,55,1422,23,32,784.10,1438.06,0.00
2024-12-08 16:52:00,55,1423,23,32,786.73,1439.00,0.00
2024-12-08 16:52:00,56,1423,24,32,772.68,1439.02,0.00
2024-12-08 16:52:00,55,1423,23,32,780.72,1439.07,0.00
2024-12-08 16:52:00,55,1424,23,32,794.09,1440.00,0.00
2024-12-08 16:52:00,56,1424,23,33,779.91,1440.02,0.00
2024-12-08 16:52:00,55,1424,23,32,788.85,1440.06,0.00
2024-12-08 16:52:00,55,1425,23,32,791.49,1441.00,0.00
2024-12-08 16:52:00,56,1425,24,32,777.36,1441.02,0.00
2024-12-08 16:52:00,55,1425,23,32,791.23,1441.02,0.00
2024-12-08 16:52:00,55,1426,23,32,798.60,1442.00,0.00
2024-12-08 16:52:00,56,1426,23,33,784.34,1442.02,0.00
2024-12-08 16:52:00,55,1426,22,33,797.93,1442.06,0.00
2024-12-08 16:52:00,54,1426,21,33,812.71,1442.06,0.00
2024-12-08 16:52:00,54,1427,21,33,810.33,1443.00,0.00
2024-12-08 16:52:00,55,1427,22,33,795.59,1443.02,0.00
2024-12-08 16:52:00,54,1427,22,32,809.00,1443.07,0.00
2024-12-08 16:52:00,54,1428,22,32,812.22,1444.00,0.00
2024-12-08 16:52:00,55,1428,23,32,797.46,1444.02,0.00
2024-12-08 16:52:00,54,1428,22,32,811.56,1444.06,0.00
2024-12-08 16:52:00,54,1429,22,32,819.87,1445.00,0.00
2024-12-08 16:52:00,55,1429,23,32,804.96,1445.02,0.00
2024-12-08 16:52:00,55,1430,23,32,801.84,1446.00,0.00
2024-12-08 16:52:00,56,1430,23,33,787.52,1446.02,0.00
2024-12-08 16:52:00,55,1430,23,32,800.80,1446.07,0.00
2024-12-08 16:52:00,54,1430,22,32,809.92,1446.48,0.00
2024-12-08 16:52:00,54,1431,22,32,818.84,1447.00,0.00
2024-12-08 16:52:00,55,1431,23,32,803.95,1447.02,0.00
2024-12-08 16:52:00,54,1431,22,32,818.25,1447.06,0.00
2024-12-08 16:52:00,54,1432,22,32,826.58,1448.00,0.00
2024-12-08 16:52:00,55,1432,22,33,811.55,1448.02,0.00
2024-12-08 16:52:00,54,1432,22,32,820.69,1448.06,0.00
2024-12-08 16:52:00,54,1433,22,32,823.66,1449.00,0.00
2024-12-08 16:52:00,55,1433,22,33,808.69,1449.02,0.00
2024-12-08 16:52:00,55,1434,22,33,807.81,1450.00,0.00
2024-12-08 16:52:00,56,1434,23,33,793.39,1450.02,0.00
2024-12-08 16:52:00,55,1434,23,32,802.02,1450.06,0.00
2024-12-08 16:52:01,55,1435,23,32,804.68,1451.00,0.00
2024-12-08 16:52:01,56,1435,23,33,790.31,1451.02,0.00
2024-12-08 16:52:01,56,1436,23,33,789.43,1452.00,0.00
2024-12-08 16:52:01,57,1436,23,34,775.58,1452.02,0.00
2024-12-08 16:52:01,56,1436,22,34,789.17,1452.02,0.00
2024-12-08 16:52:01,55,1436,22,33,798.24,1452.04,0.00
2024-12-08 16:52:01,54,1436,21,33,806.64,1452.48,0.00
2024-12-08 16:52:01,53,1436,20,33,821.45,1452.51,0.00
2024-12-08 16:52:01,53,1437,20,33,831.10,1453.00,0.00
2024-12-08 16:52:01,54,1437,21,33,815.71,1453.02,0.00
2024-12-08 16:52:01,54,1438,21,33,814.68,1454.00,0.00
2024-12-08 16:52:01,55,1438,22,33,799.87,1454.02,0.00
2024-12-08 16:52:01,54,1438,22,32,809.57,1454.04,0.00
2024-12-08 16:52:01,54,1439,22,32,812.28,1455.00,0.00
2024-12-08 16:52:01,55,1439,23,32,797.51,1455.02,0.00
2024-12-08 16:52:01,55,1440,23,32,796.45,1456.00,0.00
2024-12-08 16:52:01,56,1440,23,33,782.23,1456.02,0.00
2024-12-08 16:52:01,55,1440,23,32,791.43,1456.04,0.00
2024-12-08 16:52:01,55,1441,23,32,793.82,1457.00,0.00
2024-12-08 16:52:01,56,1441,23,33,779.64,1457.02,0.00
2024-12-08 16:52:01,55,1441,22,33,784.55,1457.06,0.00
2024-12-08 16:52:01,55,1442,22,33,797.81,1458.00,0.00
2024-12-08 16:52:01,56,1442,22,34,783.56,1458.02,0.00
2024-12-08 16:52:01,55,1442,22,33,793.04,1458.04,0.00
2024-12-08 16:52:01,54,1442,21,33,788.45,1458.87,0.00
2024-12-08 16:52:01,54,1443,21,33,813.67,1459.00,0.00
2024-12-08 16:52:01,55,1443,22,33,798.88,1459.02,0.00
2024-12-08 16:52:01,55,1444,22,33,797.74,1460.00,0.00
2024-12-08 16:52:01,56,1444,22,34,783.49,1460.02,0.00
2024-12-08 16:52:01,55,1444,22,33,792.96,1460.04,0.00
2024-12-08 16:52:01,55,1445,22,33,795.36,1461.00,0.00
2024-12-08 16:52:01,56,1445,22,34,781.16,1461.02,0.00
2024-12-08 16:52:01,55,1445,21,34,772.04,1461.67,0.00
2024-12-08 16:52:01,55,1446,21,34,794.07,1462.00,0.00
2024-12-08 16:52:01,56,1446,21,35,779.89,1462.02,0.00
2024-12-08 16:52:01,55,1446,21,34,789.55,1462.04,0.00
2024-12-08 16:52:01,54,1446,20,34,798.13,1462.46,0.00
2024-12-08 16:52:01,53,1446,19,34,812.79,1462.49,0.00
2024-12-08 16:52:01,53,1447,19,34,822.24,1463.00,0.00
2024-12-08 16:52:01,54,1447,20,34,807.02,1463.02,0.00
2024-12-08 16:52:01,54,1448,20,34,805.81,1464.00,0.00
2024-12-08 16:52:01,55,1448,20,35,791.16,1464.02,0.00
2024-12-08 16:52:01,54,1448,20,34,801.20,1464.04,0.00
2024-12-08 16:52:01,54,1449,20,34,803.92,1465.00,0.00
2024-12-08 16:52:01,55,1449,21,34,789.30,1465.02,0.00
2024-12-08 16:52:01,54,1449,20,34,795.55,1465.15,0.00
2024-12-08 16:52:01,54,1450,20,34,810.71,1466.00,0.00
2024-12-08 16:52:01,55,1450,21,34,795.97,1466.02,0.00
2024-12-08 16:52:01,54,1450,21,33,805.29,1466.06,0.00
2024-12-08 16:52:01,54,1451,21,33,808.28,1467.00,0.00
2024-12-08 16:52:01,55,1451,21,34,793.58,1467.02,0.00
2024-12-08 16:52:01,54,1451,20,34,795.71,1467.52,0.00
2024-12-08 16:52:01,54,1452,20,34,807.41,1468.00,0.00
2024-12-08 16:52:01,55,1452,21,34,792.72,1468.02,0.00
2024-12-08 16:52:01,54,1452,21,33,802.25,1468.06,0.00
2024-12-08 16:52:01,55,1451,22,33,785.58,1468.24,0.00
2024-12-08 16:52:01,54,1451,21,33,807.71,1468.59,0.00
2024-12-08 16:52:01,54,1452,21,33,829.21,1469.00,0.00
2024-12-08 16:52:01,55,1452,21,34,814.14,1469.02,0.00
2024-12-08 16:52:01,55,1453,21,34,839.52,1470.00,0.00
2024-12-08 16:52:01,56,1453,22,34,824.53,1470.02,0.00
2024-12-08 16:52:01,55,1453,22,33,834.72,1470.06,0.00
2024-12-08 16:52:01,55,1454,22,33,837.42,1471.00,0.00
2024-12-08 16:52:01,56,1454,23,33,822.46,1471.02,0.00
2024-12-08 16:52:01,56,1455,23,33,820.61,1472.00,0.00
2024-12-08 16:52:01,57,1455,24,33,806.21,1472.02,0.00
2024-12-08 16:52:01,56,1455,24,32,816.14,1472.05,0.00
2024-12-08 16:52:01,55,1455,23,32,830.20,1472.11,0.00
2024-12-08 16:52:01,55,1456,23,32,833.68,1473.00,0.00
2024-12-08 16:52:01,56,1456,23,33,818.80,1473.02,0.00
2024-12-08 16:52:01,56,1457,23,33,816.68,1474.00,0.00
2024-12-08 16:52:01,57,1457,23,34,802.35,1474.02,0.00
2024-12-08 16:52:01,56,1457,23,33,812.47,1474.05,0.00
2024-12-08 16:52:01,55,1457,22,33,808.25,1474.96,0.00
2024-12-08 16:52:01,55,1458,22,33,834.55,1475.00,0.00
2024-12-08 16:52:01,56,1458,22,34,819.65,1475.02,0.00
2024-12-08 16:52:01,55,1458,21,34,827.04,1475.04,0.00
2024-12-08 16:52:01,55,1459,21,34,834.85,1476.00,0.00
2024-12-08 16:52:01,56,1459,22,34,819.94,1476.02,0.00
2024-12-08 16:52:01,55,1459,22,33,830.82,1476.04,0.00
2024-12-08 16:52:01,54,1459,21,33,831.91,1476.46,0.00
2024-12-08 16:52:01,54,1460,21,33,851.70,1477.00,0.00
2024-12-08 16:52:01,55,1460,21,34,836.22,1477.02,0.00
2024-12-08 16:52:02,54,1460,20,34,835.44,1477.37,0.00
2024-12-08 16:52:02,54,1461,20,34,853.92,1478.00,0.00
2024-12-08 16:52:02,55,1461,20,35,838.39,1478.02,0.00
2024-12-08 16:52:02,54,1461,20,34,850.09,1478.04,0.00
2024-12-08 16:52:02,54,1462,20,34,852.86,1479.00,0.00
2024-12-08 16:52:02,55,1462,20,35,837.35,1479.02,0.00
2024-12-08 16:52:02,54,1462,19,35,852.58,1479.02,0.00
2024-12-08 16:52:02,53,1462,18,35,853.90,1479.64,0.00
2024-12-08 16:52:02,53,1463,18,35,876.79,1480.00,0.00
2024-12-08 16:52:02,54,1463,19,35,860.56,1480.02,0.00
2024-12-08 16:52:02,53,1463,18,35,867.58,1480.02,0.00
2024-12-08 16:52:02,52,1463,18,34,879.99,1480.02,0.00
2024-12-08 16:52:02,52,1464,18,34,894.54,1481.00,0.00
2024-12-08 16:52:02,53,1464,18,35,877.67,1481.02,0.00
2024-12-08 16:52:02,52,1464,17,35,887.74,1481.10,0.00
2024-12-08 16:52:02,51,1464,16,35,901.41,1481.18,0.00
2024-12-08 16:52:02,51,1465,16,35,918.80,1482.00,0.00
2024-12-08 16:52:02,52,1465,17,35,901.13,1482.02,0.00
2024-12-08 16:52:02,52,1466,17,35,905.36,1483.00,0.00
2024-12-08 16:52:02,53,1466,18,35,888.28,1483.02,0.00
2024-12-08 16:52:02,52,1466,17,35,892.56,1483.50,0.00
2024-12-08 16:52:02,52,1467,17,35,905.46,1484.00,0.00
2024-12-08 16:52:02,53,1467,17,36,888.38,1484.02,0.00
2024-12-08 16:52:02,53,1468,17,36,885.61,1485.00,0.00
2024-12-08 16:52:02,54,1468,18,36,869.21,1485.02,0.00
2024-12-08 16:52:02,53,1468,18,35,884.49,1485.02,0.00
2024-12-08 16:52:02,53,1469,18,35,887.33,1486.00,0.00
2024-12-08 16:52:02,54,1469,19,35,870.90,1486.02,0.00
2024-12-08 16:52:02,54,1470,19,35,867.94,1487.00,0.00
2024-12-08 16:52:02,55,1470,20,35,852.16,1487.02,0.00
2024-12-08 16:52:02,54,1470,20,34,864.91,1487.02,0.00
2024-12-08 16:52:02,54,1471,20,34,867.43,1488.00,0.00
2024-12-08 16:52:02,55,1471,21,34,851.65,1488.02,0.00
2024-12-08 16:52:02,55,1472,21,34,848.64,1489.00,0.00
2024-12-08 16:52:02,56,1472,21,35,833.48,1489.02,0.00
2024-12-08 16:52:02,55,1472,21,34,845.93,1489.02,0.00
2024-12-08 16:52:02,55,1473,21,34,848.12,1490.00,0.00
2024-12-08 16:52:02,56,1473,21,35,832.98,1490.02,0.00
2024-12-08 16:52:02,56,1474,21,35,829.69,1491.00,0.00
2024-12-08 16:52:02,57,1474,21,36,815.13,1491.02,0.00
2024-12-08 16:52:02,56,1474,21,35,827.29,1491.02,0.00
2024-12-08 16:52:02,56,1475,21,35,829.18,1492.00,0.00
2024-12-08 16:52:02,57,1475,22,35,814.63,1492.02,0.00
2024-12-08 16:52:02,57,1476,22,35,811.74,1493.00,0.00
2024-12-08 16:52:02,58,1476,23,35,797.74,1493.02,0.00
2024-12-08 16:52:02,57,1476,23,34,809.12,1493.02,0.00
2024-12-08 16:52:02,56,1476,22,34,805.75,1493.91,0.00
2024-12-08 16:52:02,56,1477,22,34,831.16,1494.00,0.00
2024-12-08 16:52:02,57,1477,22,35,816.58,1494.02,0.00
2024-12-08 16:52:02,56,1477,21,35,822.14,1494.16,0.00
2024-12-08 16:52:02,56,1478,21,35,836.79,1495.00,0.00
2024-12-08 16:52:02,57,1478,21,36,822.11,1495.02,0.00
2024-12-08 16:52:02,56,1478,20,36,823.44,1495.55,0.00
2024-12-08 16:52:02,55,1478,19,36,833.80,1495.76,0.00
2024-12-08 16:52:02,55,1479,19,36,857.62,1496.00,0.00
2024-12-08 16:52:02,56,1479,20,36,842.31,1496.02,0.00
2024-12-08 16:52:02,56,1480,20,36,839.41,1497.00,0.00
2024-12-08 16:52:02,57,1480,21,36,824.69,1497.02,0.00
2024-12-08 16:52:02,56,1480,21,35,836.21,1497.05,0.00
2024-12-08 16:52:02,56,1481,21,35,838.63,1498.00,0.00
2024-12-08 16:52:02,57,1481,21,36,823.92,1498.02,0.00
2024-12-08 16:52:02,57,1482,21,36,821.67,1499.00,0.00
2024-12-08 16:52:02,58,1482,22,36,807.50,1499.02,0.00
2024-12-08 16:52:02,57,1482,22,35,817.73,1499.05,0.00
2024-12-08 16:52:02,56,1482,21,35,817.37,1499.73,0.00
2024-12-08 16:52:02,56,1483,21,35,840.32,1500.00,0.00
2024-12-08 16:52:02,57,1483,22,35,825.58,1500.02,0.00
2024-12-08 16:52:02,57,1484,22,35,823.44,1501.00,0.00
2024-12-08 16:52:02,58,1484,22,36,809.24,1501.02,0.00
2024-12-08 16:52:02,57,1484,22,35,819.49,1501.05,0.00
2024-12-08 16:52:02,57,1485,22,35,821.61,1502.00,0.00
2024-12-08 16:52:02,58,1485,22,36,807.45,1502.02,0.00
2024-12-08 16:52:02,57,1485,22,35,820.30,1502.04,0.00
2024-12-08 16:52:02,57,1486,22,35,822.16,1503.00,0.00
2024-12-08 16:52:02,58,1486,22,36,807.99,1503.02,0.00
2024-12-08 16:52:02,57,1486,22,35,821.63,1503.02,0.00
2024-12-08 16:52:02,56,1486,21,35,826.43,1503.68,0.00
2024-12-08 16:52:02,55,1486,20,35,834.78,1503.89,0.00
2024-12-08 16:52:02,55,1487,20,35,860.56,1504.00,0.00
2024-12-08 16:52:02,56,1487,21,35,845.19,1504.02,0.00
2024-12-08 16:52:02,55,1487,20,35,835.96,1504.93,0.00
2024-12-08 16:52:02,55,1488,20,35,862.29,1505.00,0.00
2024-12-08 16:52:02,56,1488,20,36,846.89,1505.02,0.00
2024-12-08 16:52:02,55,1488,20,35,859.55,1505.02,0.00
2024-12-08 16:52:03,55,1489,20,35,861.76,1506.00,0.00
2024-12-08 16:52:03,56,1489,20,36,846.37,1506.02,0.00
2024-12-08 16:52:03,55,1489,19,36,847.53,1506.04,0.00
2024-12-08 16:52:03,54,1489,18,36,853.74,1506.69,0.00
2024-12-08 16:52:03,54,1490,18,36,877.15,1507.00,0.00
2024-12-08 16:52:03,55,1490,19,36,861.20,1507.02,0.00
2024-12-08 16:52:03,54,1490,19,35,874.64,1507.02,0.00
2024-12-08 16:52:03,53,1490,18,35,882.84,1507.43,0.00
2024-12-08 16:52:03,53,1491,18,35,903.19,1508.00,0.00
2024-12-08 16:52:03,54,1491,19,35,886.46,1508.02,0.00
2024-12-08 16:52:03,53,1491,18,35,896.37,1508.09,0.00
2024-12-08 16:52:03,53,1492,18,35,901.21,1509.00,0.00
2024-12-08 16:52:03,54,1492,18,36,884.52,1509.02,0.00
2024-12-08 16:52:03,53,1492,18,35,896.95,1509.04,0.00
2024-12-08 16:52:03,53,1493,18,35,900.10,1510.00,0.00
2024-12-08 16:52:03,54,1493,19,35,883.43,1510.02,0.00
2024-12-08 16:52:03,53,1493,18,35,899.67,1510.04,0.00
2024-12-08 16:52:03,52,1493,17,35,902.27,1510.33,0.00
2024-12-08 16:52:03,52,1494,17,35,921.64,1511.00,0.00
2024-12-08 16:52:03,53,1494,17,36,904.25,1511.02,0.00
2024-12-08 16:52:03,52,1494,17,35,916.71,1511.04,0.00
2024-12-08 16:52:03,52,1495,17,35,920.22,1512.00,0.00
2024-12-08 16:52:03,53,1495,17,36,902.86,1512.02,0.00
2024-12-08 16:52:03,53,1496,17,36,900.71,1513.00,0.00
2024-12-08 16:52:03,54,1496,17,37,884.03,1513.02,0.00
2024-12-08 16:52:03,53,1496,17,36,895.87,1513.04,0.00
2024-12-08 16:52:03,52,1496,16,36,899.47,1513.44,0.00
2024-12-08 16:52:03,52,1497,16,36,920.56,1514.00,0.00
2024-12-08 16:52:03,53,1497,16,37,903.19,1514.02,0.00
2024-12-08 16:52:03,52,1497,15,37,913.60,1514.10,0.00
2024-12-08 16:52:03,51,1497,14,37,929.49,1514.10,0.00
2024-12-08 16:52:03,51,1498,14,37,946.12,1515.00,0.00
2024-12-08 16:52:03,52,1498,14,38,927.93,1515.02,0.00
2024-12-08 16:52:03,51,1498,14,37,941.37,1515.04,0.00
2024-12-08 16:52:03,51,1499,14,37,945.26,1516.00,0.00
2024-12-08 16:52:03,52,1499,14,38,927.08,1516.02,0.00
2024-12-08 16:52:03,51,1499,13,38,922.30,1516.51,0.00
2024-12-08 16:52:03,51,1500,13,38,944.99,1517.00,0.00
2024-12-08 16:52:03,52,1500,14,38,926.82,1517.02,0.00
2024-12-08 16:52:03,51,1500,14,37,940.24,1517.04,0.00
2024-12-08 16:52:03,51,1501,14,37,944.12,1518.00,0.00
2024-12-08 16:52:03,52,1501,14,38,925.97,1518.02,0.00
2024-12-08 16:52:03,52,1502,14,38,923.41,1519.00,0.00
2024-12-08 16:52:03,53,1502,15,38,905.99,1519.02,0.00
2024-12-08 16:52:03,52,1502,15,37,919.04,1519.04,0.00
2024-12-08 16:52:03,52,1503,15,37,922.56,1520.00,0.00
2024-12-08 16:52:03,53,1503,16,37,905.15,1520.02,0.00
2024-12-08 16:52:03,53,1504,16,37,903.20,1521.00,0.00
2024-12-08 16:52:03,54,1504,16,38,886.47,1521.02,0.00
2024-12-08 16:52:03,53,1504,16,37,898.33,1521.04,0.00
2024-12-08 16:52:03,53,1505,16,37,901.50,1522.00,0.00
2024-12-08 16:52:03,54,1505,17,37,884.80,1522.02,0.00
2024-12-08 16:52:03,54,1506,17,37,882.70,1523.00,0.00
2024-12-08 16:52:03,55,1506,17,38,866.65,1523.02,0.00
2024-12-08 16:52:03,54,1506,17,37,878.19,1523.04,0.00
2024-12-08 16:52:03,54,1507,17,37,881.02,1524.00,0.00
2024-12-08 16:52:03,55,1507,18,37,865.00,1524.02,0.00
2024-12-08 16:52:03,54,1507,17,37,873.99,1524.11,0.00
2024-12-08 16:52:03,53,1507,16,37,877.13,1524.45,0.00
2024-12-08 16:52:03,53,1508,16,37,897.94,1525.00,0.00
2024-12-08 16:52:03,54,1508,17,37,881.32,1525.02,0.00
2024-12-08 16:52:03,53,1508,17,36,893.63,1525.04,0.00
2024-12-08 16:52:03,53,1509,17,36,896.81,1526.00,0.00
2024-12-08 16:52:03,54,1509,17,37,880.20,1526.02,0.00
2024-12-08 16:52:03,54,1510,17,37,877.88,1527.00,0.00
2024-12-08 16:52:03,55,1510,18,37,861.92,1527.02,0.00
2024-12-08 16:52:03,54,1510,18,36,873.64,1527.04,0.00
2024-12-08 16:52:03,53,1510,17,36,871.70,1527.93,0.00
2024-12-08 16:52:03,53,1511,17,36,899.42,1528.00,0.00
2024-12-08 16:52:03,54,1511,18,36,882.77,1528.02,0.00
2024-12-08 16:52:03,54,1512,18,36,880.37,1529.00,0.00
2024-12-08 16:52:03,55,1512,19,36,864.36,1529.02,0.00
2024-12-08 16:52:03,54,1512,19,35,876.41,1529.04,0.00
2024-12-08 16:52:03,53,1512,18,35,877.70,1529.45,0.00
2024-12-08 16:52:03,53,1513,18,35,898.58,1530.00,0.00
2024-12-08 16:52:03,54,1513,19,35,881.94,1530.02,0.00
2024-12-08 16:52:03,53,1513,18,35,879.03,1530.79,0.00
2024-12-08 16:52:03,53,1514,18,35,904.90,1531.00,0.00
2024-12-08 16:52:03,54,1514,19,35,888.14,1531.02,0.00
2024-12-08 16:52:03,53,1514,19,34,901.14,1531.04,0.00
2024-12-08 16:52:03,53,1515,19,34,904.33,1532.00,0.00
2024-12-08 16:52:03,54,1515,19,35,887.58,1532.02,0.00
2024-12-08 16:52:03,53,1515,18,35,896.55,1532.13,0.00
2024-12-08 16:52:04,53,1516,18,35,901.65,1533.00,0.00
2024-12-08 16:52:04,54,1516,19,35,884.96,1533.02,0.00
2024-12-08 16:52:04,53,1516,19,34,897.89,1533.04,0.00
2024-12-08 16:52:04,52,1516,18,34,914.01,1533.10,0.00
2024-12-08 16:52:04,51,1516,17,34,916.85,1533.84,0.00
2024-12-08 16:52:04,51,1517,17,34,944.64,1534.00,0.00
2024-12-08 16:52:04,52,1517,18,34,926.48,1534.02,0.00
2024-12-08 16:52:04,51,1517,17,34,919.95,1534.57,0.00
2024-12-08 16:52:04,51,1518,17,34,943.75,1535.00,0.00
2024-12-08 16:52:04,52,1518,18,34,925.60,1535.02,0.00
2024-12-08 16:52:04,51,1518,18,33,939.25,1535.06,0.00
2024-12-08 16:52:04,51,1519,18,33,943.46,1536.00,0.00
2024-12-08 16:52:04,52,1519,19,33,925.32,1536.02,0.00
2024-12-08 16:52:04,52,1520,19,33,922.67,1537.00,0.00
2024-12-08 16:52:04,53,1520,20,33,905.26,1537.02,0.00
2024-12-08 16:52:04,52,1520,20,32,918.24,1537.06,0.00
2024-12-08 16:52:04,52,1521,20,32,922.09,1538.00,0.00
2024-12-08 16:52:04,53,1521,21,32,904.69,1538.02,0.00
2024-12-08 16:52:04,53,1522,21,32,902.58,1539.00,0.00
2024-12-08 16:52:04,54,1522,21,33,885.87,1539.02,0.00
2024-12-08 16:52:04,53,1522,21,32,897.65,1539.06,0.00
2024-12-08 16:52:04,53,1523,21,32,901.13,1540.00,0.00
2024-12-08 16:52:04,54,1523,21,33,884.44,1540.02,0.00
2024-12-08 16:52:04,53,1523,21,32,900.84,1540.02,0.00
2024-12-08 16:52:04,53,1524,21,32,898.73,1541.00,0.00
2024-12-08 16:52:04,54,1524,21,33,882.08,1541.02,0.00
2024-12-08 16:52:04,53,1524,21,32,894.37,1541.04,0.00
2024-12-08 16:52:04,54,1523,22,32,877.81,1541.07,0.00
2024-12-08 16:52:04,54,1524,22,32,899.79,1542.00,0.00
2024-12-08 16:52:04,55,1524,23,32,883.43,1542.02,0.00
2024-12-08 16:52:04,55,1525,23,32,917.18,1543.00,0.00
2024-12-08 16:52:04,56,1525,23,33,900.80,1543.02,0.00
2024-12-08 16:52:04,56,1526,23,33,905.20,1544.00,0.00
2024-12-08 16:52:04,57,1526,23,34,889.32,1544.02,0.00
2024-12-08 16:52:04,56,1526,22,34,890.75,1544.61,0.00
2024-12-08 16:52:04,56,1527,22,34,907.12,1545.00,0.00
2024-12-08 16:52:04,57,1527,22,35,891.20,1545.02,0.00
2024-12-08 16:52:04,57,1528,22,35,888.40,1546.00,0.00
2024-12-08 16:52:04,58,1528,23,35,873.08,1546.02,0.00
2024-12-08 16:52:04,57,1528,23,34,883.79,1546.04,0.00
2024-12-08 16:52:04,56,1528,22,34,877.42,1546.93,0.00
2024-12-08 16:52:04,56,1529,22,34,903.99,1547.00,0.00
2024-12-08 16:52:04,57,1529,23,34,888.13,1547.02,0.00
2024-12-08 16:52:04,56,1529,22,34,892.97,1547.20,0.00
2024-12-08 16:52:04,56,1530,22,34,908.69,1548.00,0.00
2024-12-08 16:52:04,57,1530,23,34,892.75,1548.02,0.00
2024-12-08 16:52:04,56,1530,23,33,905.65,1548.04,0.00
2024-12-08 16:52:04,56,1531,23,33,907.89,1549.00,0.00
2024-12-08 16:52:04,57,1531,24,33,891.97,1549.02,0.00
2024-12-08 16:52:04,57,1532,24,33,888.19,1550.00,0.00
2024-12-08 16:52:04,58,1532,24,34,872.88,1550.02,0.00
2024-12-08 16:52:04,57,1532,24,33,885.47,1550.04,0.00
2024-12-08 16:52:04,57,1533,24,33,887.40,1551.00,0.00
2024-12-08 16:52:04,58,1533,25,33,872.10,1551.02,0.00
2024-12-08 16:52:04,58,1534,25,33,868.12,1552.00,0.00
2024-12-08 16:52:04,59,1534,25,34,853.40,1552.02,0.00
2024-12-08 16:52:04,58,1534,25,33,865.71,1552.03,0.00
2024-12-08 16:52:04,58,1535,25,33,867.34,1553.00,0.00
2024-12-08 16:52:04,59,1535,25,34,852.64,1553.02,0.00
2024-12-08 16:52:04,58,1535,24,34,852.08,1553.07,0.00
2024-12-08 16:52:04,58,1536,24,34,864.95,1554.00,0.00
2024-12-08 16:52:04,59,1536,24,35,850.29,1554.02,0.00
2024-12-08 16:52:04,58,1536,24,34,862.54,1554.03,0.00
2024-12-08 16:52:04,57,1536,23,34,857.00,1554.67,0.00
2024-12-08 16:52:04,57,1537,23,34,879.32,1555.00,0.00
2024-12-08 16:52:04,58,1537,23,35,864.16,1555.02,0.00
2024-12-08 16:52:04,57,1537,22,35,866.33,1555.28,0.00
2024-12-08 16:52:04,58,1536,23,35,846.48,1555.64,0.00
2024-12-08 16:52:04,58,1537,23,35,873.84,1556.00,0.00
2024-12-08 16:52:04,59,1537,24,35,859.03,1556.02,0.00
2024-12-08 16:52:04,58,1537,24,34,871.16,1556.03,0.00
2024-12-08 16:52:04,57,1537,23,34,868.96,1556.56,0.00
2024-12-08 16:52:04,57,1538,23,34,917.06,1557.00,0.00
2024-12-08 16:52:04,58,1538,23,35,901.25,1557.02,0.00
2024-12-08 16:52:04,58,1539,23,35,897.76,1558.00,0.00
2024-12-08 16:52:04,59,1539,23,36,882.55,1558.02,0.00
2024-12-08 16:52:04,58,1539,23,35,894.27,1558.03,0.00
2024-12-08 16:52:05,58,1540,23,35,895.92,1559.00,0.00
2024-12-08 16:52:05,59,1540,24,35,880.73,1559.02,0.00
2024-12-08 16:52:05,59,1541,24,35,877.18,1560.00,0.00
2024-12-08 16:52:05,60,1541,24,36,862.56,1560.02,0.00
2024-12-08 16:52:05,59,1541,24,35,874.01,1560.03,0.00
2024-12-08 16:52:05,58,1541,23,35,880.28,1560.60,0.00
2024-12-08 16:52:05,58,1542,23,35,890.53,1561.00,0.00
2024-12-08 16:52:05,59,1542,24,35,875.43,1561.02,0.00
2024-12-08 16:52:05,58,1542,23,35,871.07,1561.47,0.00
2024-12-08 16:52:05,58,1543,23,35,890.02,1562.00,0.00
2024-12-08 16:52:05,59,1543,24,35,874.94,1562.02,0.00
2024-12-08 16:52:05,58,1543,24,34,887.06,1562.03,0.00
2024-12-08 16:52:05,58,1544,24,34,888.70,1563.00,0.00
2024-12-08 16:52:05,59,1544,24,35,873.64,1563.02,0.00
2024-12-08 16:52:05,59,1545,24,35,870.27,1564.00,0.00
2024-12-08 16:52:05,60,1545,24,36,855.76,1564.02,0.00
2024-12-08 16:52:05,59,1545,24,35,866.56,1564.05,0.00
2024-12-08 16:52:05,59,1546,24,35,868.17,1565.00,0.00
2024-12-08 16:52:05,60,1546,24,36,853.70,1565.02,0.00
2024-12-08 16:52:05,59,1546,23,36,851.80,1565.14,0.00
2024-12-08 16:52:05,59,1547,23,36,865.32,1566.00,0.00
2024-12-08 16:52:05,60,1547,24,36,850.90,1566.02,0.00
2024-12-08 16:52:05,59,1547,23,36,865.06,1566.02,0.00
2024-12-08 16:52:05,58,1547,23,35,876.20,1566.03,0.00
2024-12-08 16:52:05,57,1547,22,35,891.52,1566.04,0.00
2024-12-08 16:52:05,57,1548,22,35,904.46,1567.00,0.00
2024-12-08 16:52:05,58,1548,22,36,888.86,1567.02,0.00
2024-12-08 16:52:05,57,1548,21,36,889.11,1567.65,0.00
2024-12-08 16:52:05,57,1549,21,36,901.44,1568.00,0.00
2024-12-08 16:52:05,58,1549,22,36,885.89,1568.02,0.00
2024-12-08 16:52:05,57,1549,22,35,897.32,1568.04,0.00
2024-12-08 16:52:05,57,1550,22,35,899.26,1569.00,0.00
2024-12-08 16:52:05,58,1550,22,36,883.75,1569.02,0.00
2024-12-08 16:52:05,57,1550,21,36,881.95,1569.37,0.00
2024-12-08 16:52:05,57,1551,21,36,899.99,1570.00,0.00
2024-12-08 16:52:05,58,1551,21,37,884.48,1570.02,0.00
2024-12-08 16:52:05,57,1551,21,36,896.14,1570.04,0.00
2024-12-08 16:52:05,57,1552,21,36,898.09,1571.00,0.00
2024-12-08 16:52:05,58,1552,22,36,882.60,1571.02,0.00
2024-12-08 16:52:05,57,1552,21,36,891.22,1571.11,0.00
2024-12-08 16:52:05,56,1552,20,36,894.08,1571.80,0.00
2024-12-08 16:52:05,56,1553,20,36,919.20,1572.00,0.00
2024-12-08 16:52:05,57,1553,20,37,903.07,1572.02,0.00
2024-12-08 16:52:05,56,1553,20,36,915.55,1572.04,0.00
2024-12-08 16:52:05,56,1554,20,36,917.82,1573.00,0.00
2024-12-08 16:52:05,57,1554,20,37,901.71,1573.02,0.00
2024-12-08 16:52:05,57,1555,20,37,898.32,1574.00,0.00
2024-12-08 16:52:05,58,1555,20,38,882.83,1574.02,0.00
2024-12-08 16:52:05,57,1555,20,37,894.73,1574.04,0.00
2024-12-08 16:52:05,57,1556,20,37,896.68,1575.00,0.00
2024-12-08 16:52:05,58,1556,21,37,881.22,1575.02,0.00
2024-12-08 16:52:05,58,1557,21,37,877.80,1576.00,0.00
2024-12-08 16:52:05,59,1557,22,37,862.92,1576.02,0.00
2024-12-08 16:52:05,58,1557,22,36,874.54,1576.03,0.00
2024-12-08 16:52:05,58,1558,22,36,876.18,1577.00,0.00
2024-12-08 16:52:05,59,1558,23,36,861.33,1577.02,0.00
2024-12-08 16:52:05,59,1559,23,36,858.22,1578.00,0.00
2024-12-08 16:52:05,60,1559,23,37,843.92,1578.02,0.00
2024-12-08 16:52:05,59,1559,23,36,854.75,1578.03,0.00
2024-12-08 16:52:05,58,1559,22,36,859.17,1578.31,0.00
2024-12-08 16:52:05,57,1559,21,36,868.94,1578.65,0.00
2024-12-08 16:52:05,57,1560,21,36,891.33,1579.00,0.00
2024-12-08 16:52:05,58,1560,22,36,875.96,1579.02,0.00
2024-12-08 16:52:05,58,1561,22,36,872.94,1580.00,0.00
2024-12-08 16:52:05,59,1561,22,37,858.15,1580.02,0.00
2024-12-08 16:52:05,58,1561,22,36,869.40,1580.03,0.00
2024-12-08 16:52:05,58,1562,22,36,871.04,1581.00,0.00
2024-12-08 16:52:05,59,1562,22,37,856.28,1581.02,0.00
2024-12-08 16:52:05,58,1562,21,37,855.28,1581.67,0.00
2024-12-08 16:52:05,58,1563,21,37,867.88,1582.00,0.00
2024-12-08 16:52:05,59,1563,22,37,853.17,1582.02,0.00
2024-12-08 16:52:05,58,1563,22,36,864.61,1582.03,0.00
2024-12-08 16:52:05,57,1563,21,36,859.38,1582.97,0.00
2024-12-08 16:52:05,57,1564,21,36,886.61,1583.00,0.00
2024-12-08 16:52:05,58,1564,21,37,871.32,1583.02,0.00
2024-12-08 16:52:05,57,1564,20,37,872.10,1583.37,0.00
2024-12-08 16:52:05,57,1565,20,37,890.31,1584.00,0.00
2024-12-08 16:52:05,58,1565,20,38,874.96,1584.02,0.00
2024-12-08 16:52:05,57,1565,20,37,887.26,1584.04,0.00
2024-12-08 16:52:05,57,1566,20,37,889.20,1585.00,0.00
2024-12-08 16:52:05,58,1566,20,38,873.87,1585.02,0.00
2024-12-08 16:52:06,58,1567,20,38,870.54,1586.00,0.00
2024-12-08 16:52:06,59,1567,20,39,855.79,1586.02,0.00
2024-12-08 16:52:06,58,1567,20,38,867.81,1586.03,0.00
2024-12-08 16:52:06,57,1567,19,38,870.27,1586.14,0.00
2024-12-08 16:52:06,57,1568,19,38,884.98,1587.00,0.00
2024-12-08 16:52:06,58,1568,20,38,869.72,1587.02,0.00
2024-12-08 16:52:06,57,1568,19,38,874.81,1587.18,0.00
2024-12-08 16:52:06,57,1569,19,38,890.08,1588.00,0.00
2024-12-08 16:52:06,58,1569,20,38,874.73,1588.02,0.00
2024-12-08 16:52:06,57,1569,20,37,887.57,1588.04,0.00
2024-12-08 16:52:06,57,1570,20,37,889.52,1589.00,0.00
2024-12-08 16:52:06,58,1570,21,37,874.19,1589.02,0.00
2024-12-08 16:52:06,57,1570,20,37,874.48,1589.07,0.00
2024-12-08 16:52:06,57,1571,20,37,888.13,1590.00,0.00
2024-12-08 16:52:06,58,1571,20,38,872.82,1590.02,0.00
2024-12-08 16:52:06,57,1571,20,37,885.90,1590.04,0.00
2024-12-08 16:52:06,56,1571,19,37,892.64,1590.61,0.00
2024-12-08 16:52:06,55,1571,18,37,908.42,1590.64,0.00
2024-12-08 16:52:06,55,1572,18,37,920.27,1591.00,0.00
2024-12-08 16:52:06,56,1572,18,38,903.83,1591.02,0.00
2024-12-08 16:52:06,56,1573,18,38,900.14,1592.00,0.00
2024-12-08 16:52:06,57,1573,18,39,884.35,1592.02,0.00
2024-12-08 16:52:06,56,1573,18,38,897.86,1592.04,0.00
2024-12-08 16:52:06,55,1573,17,38,894.76,1592.96,0.00
2024-12-08 16:52:06,55,1574,17,38,923.16,1593.00,0.00
2024-12-08 16:52:06,56,1574,17,39,906.68,1593.02,0.00
2024-12-08 16:52:06,55,1574,16,39,906.48,1593.36,0.00
2024-12-08 16:52:06,55,1575,16,39,925.77,1594.00,0.00
2024-12-08 16:52:06,56,1575,16,40,909.24,1594.02,0.00
2024-12-08 16:52:06,55,1575,16,39,925.48,1594.02,0.00
2024-12-08 16:52:06,54,1575,16,38,940.26,1594.02,0.00
2024-12-08 16:52:06,53,1575,15,38,948.53,1594.28,0.00
2024-12-08 16:52:06,52,1575,14,38,961.65,1594.62,0.00
2024-12-08 16:52:06,52,1576,14,38,986.50,1595.00,0.00
2024-12-08 16:52:06,53,1576,14,39,967.88,1595.02,0.00
2024-12-08 16:52:06,52,1576,13,39,963.64,1595.48,0.00
2024-12-08 16:52:06,53,1575,13,40,942.29,1595.72,0.00
2024-12-08 16:52:06,53,1576,13,40,973.26,1596.00,0.00
2024-12-08 16:52:06,54,1576,13,41,955.24,1596.02,0.00
2024-12-08 16:52:06,53,1576,13,40,970.85,1596.02,0.00
2024-12-08 16:52:06,52,1576,12,40,981.32,1596.27,0.00
2024-12-08 16:52:06,52,1577,12,40,1031.60,1597.00,0.00
2024-12-08 16:52:06,53,1577,12,41,1012.14,1597.02,0.00
2024-12-08 16:52:06,52,1577,11,41,1013.19,1597.08,0.00
2024-12-08 16:52:06,51,1577,10,41,1033.06,1597.08,0.00
2024-12-08 16:52:06,51,1578,10,41,1050.29,1598.00,0.00
2024-12-08 16:52:06,52,1578,10,42,1030.10,1598.02,0.00
2024-12-08 16:52:06,51,1578,10,41,1047.47,1598.02,0.00
2024-12-08 16:52:06,51,1579,10,41,1051.26,1599.00,0.00
2024-12-08 16:52:06,52,1579,10,42,1031.05,1599.02,0.00
2024-12-08 16:52:06,51,1579,9,42,1044.38,1599.06,0.00
2024-12-08 16:52:06,51,1580,9,42,1053.25,1600.00,0.00
2024-12-08 16:52:06,52,1580,10,42,1032.99,1600.02,0.00
2024-12-08 16:52:06,51,1580,9,42,1033.21,1600.29,0.00
2024-12-08 16:52:06,51,1581,9,42,1053.83,1601.00,0.00
2024-12-08 16:52:06,52,1581,9,43,1033.57,1601.02,0.00
2024-12-08 16:52:06,51,1581,9,42,1048.82,1601.04,0.00
2024-12-08 16:52:06,51,1582,9,42,1052.92,1602.00,0.00
2024-12-08 16:52:06,52,1582,10,42,1032.67,1602.02,0.00
2024-12-08 16:52:06,52,1583,10,42,1029.93,1603.00,0.00
2024-12-08 16:52:06,53,1583,11,42,1010.49,1603.02,0.00
2024-12-08 16:52:06,52,1583,11,41,1024.38,1603.04,0.00
2024-12-08 16:52:06,51,1583,10,41,1032.61,1603.71,0.00
2024-12-08 16:52:06,52,1582,10,42,1011.58,1603.81,0.00
2024-12-08 16:52:06,52,1583,10,42,1042.29,1604.00,0.00
2024-12-08 16:52:06,53,1583,10,43,1022.63,1604.02,0.00
2024-12-08 16:52:06,53,1584,10,43,1049.91,1605.00,0.00
2024-12-08 16:52:06,54,1584,10,44,1030.47,1605.02,0.00
2024-12-08 16:52:06,53,1584,10,43,1044.77,1605.04,0.00
2024-12-08 16:52:06,53,1585,10,43,1048.14,1606.00,0.00
2024-12-08 16:52:06,54,1585,11,43,1028.73,1606.02,0.00
2024-12-08 16:52:06,53,1585,10,43,1040.29,1606.11,0.00
2024-12-08 16:52:06,53,1586,10,43,1044.85,1607.00,0.00
2024-12-08 16:52:06,54,1586,11,43,1025.50,1607.02,0.00
2024-12-08 16:52:06,53,1586,11,42,1040.01,1607.04,0.00
2024-12-08 16:52:06,53,1587,11,42,1043.38,1608.00,0.00
2024-12-08 16:52:06,54,1587,12,42,1024.06,1608.02,0.00
2024-12-08 16:52:06,53,1587,11,42,1015.50,1608.62,0.00
2024-12-08 16:52:06,53,1588,11,42,1040.08,1609.00,0.00
2024-12-08 16:52:06,54,1588,11,43,1020.82,1609.02,0.00
2024-12-08 16:52:06,53,1588,11,42,1035.23,1609.04,0.00
2024-12-08 16:52:06,52,1588,10,42,1037.14,1609.52,0.00
2024-12-08 16:52:06,52,1589,10,42,1060.74,1610.00,0.00
2024-12-08 16:52:06,53,1589,10,43,1040.73,1610.02,0.00
2024-12-08 16:52:06,53,1590,10,43,1037.73,1611.00,0.00
2024-12-08 16:52:06,54,1590,11,43,1018.51,1611.02,0.00
2024-12-08 16:52:06,53,1590,11,42,1033.17,1611.04,0.00
2024-12-08 16:52:06,53,1591,11,42,1036.55,1612.00,0.00
2024-12-08 16:52:06,54,1591,12,42,1017.35,1612.02,0.00
2024-12-08 16:52:06,54,1592,12,42,1014.10,1613.00,0.00
2024-12-08 16:52:06,55,1592,12,43,995.66,1613.02,0.00
2024-12-08 16:52:06,54,1592,12,42,1009.92,1613.04,0.00
2024-12-08 16:52:06,54,1593,12,42,1012.93,1614.00,0.00
2024-12-08 16:52:06,55,1593,12,43,994.52,1614.02,0.00
2024-12-08 16:52:06,55,1594,12,43,991.26,1615.00,0.00
2024-12-08 16:52:06,56,1594,13,43,973.56,1615.02,0.00
2024-12-08 16:52:06,55,1594,13,42,986.27,1615.04,0.00
2024-12-08 16:52:06,54,1594,12,42,999.01,1615.37,0.00
2024-12-08 16:52:07,53,1594,11,42,1010.55,1615.72,0.00
2024-12-08 16:52:07,53,1595,11,42,1036.68,1616.00,0.00
2024-12-08 16:52:07,54,1595,12,42,1017.48,1616.02,0.00
2024-12-08 16:52:07,54,1596,12,42,1014.22,1617.00,0.00
2024-12-08 16:52:07,55,1596,13,42,995.78,1617.02,0.00
2024-12-08 16:52:07,54,1596,13,41,1009.13,1617.04,0.00
2024-12-08 16:52:07,55,1595,13,42,978.63,1617.85,0.00
2024-12-08 16:52:07,55,1596,13,42,1019.93,1618.00,0.00
2024-12-08 16:52:07,56,1596,14,42,1001.72,1618.02,0.00
2024-12-08 16:52:07,56,1597,14,42,1026.91,1619.00,0.00
2024-12-08 16:52:07,57,1597,14,43,1008.89,1619.02,0.00
2024-12-08 16:52:07,56,1597,14,42,1022.28,1619.04,0.00
2024-12-08 16:52:07,55,1597,13,42,1031.28,1619.31,0.00
2024-12-08 16:52:07,55,1598,13,42,1050.05,1620.00,0.00
2024-12-08 16:52:07,56,1598,13,43,1031.30,1620.02,0.00
2024-12-08 16:52:07,55,1598,12,43,1035.14,1620.29,0.00
2024-12-08 16:52:07,55,1599,12,43,1053.65,1621.00,0.00
2024-12-08 16:52:07,56,1599,13,43,1034.83,1621.02,0.00
2024-12-08 16:52:07,55,1599,13,42,1049.23,1621.04,0.00
2024-12-08 16:52:07,55,1600,13,42,1051.94,1622.00,0.00
2024-12-08 16:52:07,56,1600,13,43,1033.16,1622.02,0.00
2024-12-08 16:52:07,56,1601,13,43,1029.45,1623.00,0.00
2024-12-08 16:52:07,57,1601,14,43,1011.39,1623.02,0.00
2024-12-08 16:52:07,56,1601,14,42,1025.39,1623.04,0.00
2024-12-08 16:52:07,56,1602,14,42,1027.76,1624.00,0.00
2024-12-08 16:52:07,57,1602,14,43,1009.73,1624.02,0.00
2024-12-08 16:52:07,56,1602,13,43,1001.68,1624.59,0.00
2024-12-08 16:52:07,56,1603,13,43,1024.33,1625.00,0.00
2024-12-08 16:52:07,57,1603,13,44,1006.36,1625.02,0.00
2024-12-08 16:52:07,56,1603,13,43,1020.27,1625.04,0.00
2024-12-08 16:52:07,55,1603,12,43,1018.74,1625.58,0.00
2024-12-08 16:52:07,55,1604,12,43,1041.82,1626.00,0.00
2024-12-08 16:52:07,56,1604,13,43,1023.22,1626.02,0.00
2024-12-08 16:52:07,56,1605,13,43,1019.49,1627.00,0.00
2024-12-08 16:52:07,57,1605,13,44,1001.60,1627.02,0.00
2024-12-08 16:52:07,56,1605,13,43,1015.71,1627.04,0.00
2024-12-08 16:52:07,56,1606,13,43,1018.08,1628.00,0.00
2024-12-08 16:52:07,57,1606,13,44,1000.22,1628.02,0.00
2024-12-08 16:52:07,56,1606,12,44,1017.79,1628.02,0.00
2024-12-08 16:52:07,55,1606,11,44,1012.57,1628.89,0.00
2024-12-08 16:52:07,55,1607,11,44,1040.49,1629.00,0.00
2024-12-08 16:52:07,56,1607,11,45,1021.91,1629.02,0.00
2024-12-08 16:52:07,55,1607,11,44,1036.93,1629.02,0.00
2024-12-08 16:52:07,55,1608,11,44,1039.35,1630.00,0.00
2024-12-08 16:52:07,56,1608,11,45,1020.79,1630.02,0.00
2024-12-08 16:52:07,56,1609,11,45,1017.04,1631.00,0.00
2024-12-08 16:52:07,57,1609,12,45,999.20,1631.02,0.00
2024-12-08 16:52:07,56,1609,12,44,1012.11,1631.05,0.00
2024-12-08 16:52:07,55,1609,11,44,1012.08,1631.93,0.00
2024-12-08 16:52:07,55,1610,11,44,1040.62,1632.00,0.00
2024-12-08 16:52:07,56,1610,11,45,1022.04,1632.02,0.00
2024-12-08 16:52:07,55,1610,10,45,1017.70,1632.87,0.00
2024-12-08 16:52:07,55,1611,10,45,1045.42,1633.00,0.00
2024-12-08 16:52:07,56,1611,10,46,1026.75,1633.02,0.00
2024-12-08 16:52:07,56,1612,10,46,1023.00,1634.00,0.00
2024-12-08 16:52:07,57,1612,11,46,1005.05,1634.02,0.00
2024-12-08 16:52:07,56,1612,11,45,1018.34,1634.05,0.00
2024-12-08 16:52:07,55,1612,10,45,1023.92,1634.78,0.00
2024-12-08 16:52:07,55,1613,10,45,1050.26,1635.00,0.00
2024-12-08 16:52:07,56,1613,11,45,1031.51,1635.02,0.00
2024-12-08 16:52:07,56,1614,11,45,1027.76,1636.00,0.00
2024-12-08 16:52:07,57,1614,11,46,1009.73,1636.02,0.00
2024-12-08 16:52:07,56,1614,11,45,1023.09,1636.05,0.00
2024-12-08 16:52:07,56,1615,11,45,1025.76,1637.00,0.00
2024-12-08 16:52:07,57,1615,12,45,1007.76,1637.02,0.00
2024-12-08 16:52:07,57,1616,12,45,1003.78,1638.00,0.00
2024-12-08 16:52:07,58,1616,12,46,986.47,1638.02,0.00
2024-12-08 16:52:07,57,1616,12,45,999.47,1638.05,0.00
2024-12-08 16:52:07,57,1617,12,45,1001.80,1639.00,0.00
2024-12-08 16:52:07,58,1617,13,45,984.53,1639.02,0.00
2024-12-08 16:52:07,58,1618,13,45,980.32,1640.00,0.00
2024-12-08 16:52:07,59,1618,14,45,963.71,1640.02,0.00
2024-12-08 16:52:07,58,1618,14,44,976.09,1640.05,0.00
2024-12-08 16:52:07,58,1619,14,44,978.09,1641.00,0.00
2024-12-08 16:52:07,59,1619,15,44,961.51,1641.02,0.00
2024-12-08 16:52:07,59,1620,15,44,957.09,1642.00,0.00
2024-12-08 16:52:07,60,1620,15,45,941.14,1642.02,0.00
2024-12-08 16:52:07,59,1620,15,44,953.20,1642.05,0.00
2024-12-08 16:52:07,59,1621,15,44,954.89,1643.00,0.00
2024-12-08 16:52:07,60,1621,15,45,938.97,1643.02,0.00
2024-12-08 16:52:07,60,1622,15,45,934.34,1644.00,0.00
2024-12-08 16:52:07,61,1622,16,45,919.02,1644.02,0.00
2024-12-08 16:52:07,60,1622,16,44,933.79,1644.03,0.00
2024-12-08 16:52:07,59,1622,16,43,946.56,1644.03,0.00
2024-12-08 16:52:07,58,1622,15,43,943.02,1644.97,0.00
2024-12-08 16:52:07,58,1623,15,43,970.83,1645.00,0.00
2024-12-08 16:52:07,59,1623,15,44,954.38,1645.02,0.00
2024-12-08 16:52:08,59,1624,15,44,949.94,1646.00,0.00
2024-12-08 16:52:08,60,1624,15,45,934.10,1646.02,0.00
2024-12-08 16:52:08,59,1624,15,44,946.03,1646.03,0.00
2024-12-08 16:52:08,58,1624,14,44,947.25,1646.50,0.00
2024-12-08 16:52:08,58,1625,14,44,967.75,1647.00,0.00
2024-12-08 16:52:08,59,1625,14,45,951.35,1647.02,0.00
2024-12-08 16:52:08,59,1626,14,45,947.13,1648.00,0.00
2024-12-08 16:52:08,60,1626,15,45,931.35,1648.02,0.00
2024-12-08 16:52:08,59,1626,15,44,943.22,1648.03,0.00
2024-12-08 16:52:08,59,1627,15,44,944.63,1649.00,0.00
2024-12-08 16:52:08,60,1627,15,45,928.89,1649.02,0.00
2024-12-08 16:52:08,59,1627,15,44,940.44,1649.02,0.00
2024-12-08 16:52:08,59,1628,15,44,941.57,1650.00,0.00
2024-12-08 16:52:08,60,1628,15,45,925.88,1650.02,0.00
2024-12-08 16:52:08,60,1629,15,45,921.72,1651.00,0.00
2024-12-08 16:52:08,61,1629,15,46,906.61,1651.02,0.00
2024-12-08 16:52:08,60,1629,15,45,918.69,1651.02,0.00
2024-12-08 16:52:08,60,1630,15,45,919.52,1652.00,0.00
2024-12-08 16:52:08,61,1630,16,45,904.45,1652.02,0.00
2024-12-08 16:52:08,60,1630,15,45,893.92,1652.95,0.00
2024-12-08 16:52:08,60,1631,15,45,920.67,1653.00,0.00
2024-12-08 16:52:08,61,1631,15,46,905.58,1653.02,0.00
2024-12-08 16:52:08,60,1631,15,45,917.64,1653.02,0.00
2024-12-08 16:52:08,60,1632,15,45,918.47,1654.00,0.00
2024-12-08 16:52:08,61,1632,16,45,903.42,1654.02,0.00
2024-12-08 16:52:08,60,1632,15,45,900.96,1654.35,0.00
2024-12-08 16:52:08,59,1632,14,45,910.28,1654.71,0.00
2024-12-08 16:52:08,59,1633,14,45,933.76,1655.00,0.00
2024-12-08 16:52:08,60,1633,14,46,918.20,1655.02,0.00
2024-12-08 16:52:08,59,1633,14,45,930.96,1655.02,0.00
2024-12-08 16:52:08,59,1634,14,45,932.08,1656.00,0.00
2024-12-08 16:52:08,60,1634,14,46,916.55,1656.02,0.00
2024-12-08 16:52:08,59,1634,13,46,914.28,1656.42,0.00
2024-12-08 16:52:08,59,1635,13,46,933.21,1657.00,0.00
2024-12-08 16:52:08,60,1635,13,47,917.65,1657.02,0.00
2024-12-08 16:52:08,59,1635,13,46,930.68,1657.02,0.00
2024-12-08 16:52:08,59,1636,13,46,931.80,1658.00,0.00
2024-12-08 16:52:08,60,1636,13,47,916.27,1658.02,0.00
2024-12-08 16:52:08,59,1636,12,47,913.97,1658.42,0.00
2024-12-08 16:52:08,58,1636,11,47,925.61,1658.69,0.00
2024-12-08 16:52:08,58,1637,11,47,949.30,1659.00,0.00
2024-12-08 16:52:08,59,1637,11,48,933.21,1659.02,0.00
2024-12-08 16:52:08,58,1637,11,47,947.01,1659.02,0.00
2024-12-08 16:52:08,57,1637,10,47,952.13,1659.40,0.00
2024-12-08 16:52:08,57,1638,10,47,971.78,1660.00,0.00
2024-12-08 16:52:08,58,1638,10,48,955.02,1660.02,0.00
2024-12-08 16:52:08,57,1638,9,48,955.21,1660.68,0.00
2024-12-08 16:52:08,57,1639,9,48,967.87,1661.00,0.00
2024-12-08 16:52:08,58,1639,10,48,951.19,1661.02,0.00
2024-12-08 16:52:08,57,1639,10,47,964.96,1661.02,0.00
2024-12-08 16:52:08,56,1639,9,47,964.06,1661.57,0.00
2024-12-08 16:52:08,56,1640,9,47,986.94,1662.00,0.00
2024-12-08 16:52:08,57,1640,9,48,969.62,1662.02,0.00
2024-12-08 16:52:08,57,1641,9,48,965.54,1663.00,0.00
2024-12-08 16:52:08,58,1641,9,49,948.89,1663.02,0.00
2024-12-08 16:52:08,57,1641,9,48,962.91,1663.02,0.00
2024-12-08 16:52:08,57,1642,9,48,964.66,1664.00,0.00
2024-12-08 16:52:08,58,1642,9,49,948.03,1664.02,0.00
2024-12-08 16:52:08,57,1642,8,49,938.35,1664.97,0.00
2024-12-08 16:52:08,57,1643,8,49,966.99,1665.00,0.00
2024-12-08 16:52:08,58,1643,9,49,950.32,1665.02,0.00
2024-12-08 16:52:08,57,1643,9,48,964.66,1665.02,0.00
2024-12-08 16:52:08,56,1643,8,48,959.13,1665.68,0.00
2024-12-08 16:52:08,56,1644,8,48,983.78,1666.00,0.00
2024-12-08 16:52:08,57,1644,8,49,966.52,1666.02,0.00
2024-12-08 16:52:08,56,1644,7,49,959.92,1666.57,0.00
2024-12-08 16:52:08,56,1645,7,49,982.88,1667.00,0.00
2024-12-08 16:52:08,57,1645,8,49,965.64,1667.02,0.00
2024-12-08 16:52:08,56,1645,8,48,977.82,1667.02,0.00
2024-12-08 16:52:08,55,1645,7,48,992.33,1667.22,0.00
2024-12-08 16:52:08,55,1646,7,48,998.02,1668.00,0.00
2024-12-08 16:52:08,56,1646,7,49,980.20,1668.02,0.00
2024-12-08 16:52:08,56,1647,7,49,976.31,1669.00,0.00
2024-12-08 16:52:08,57,1647,7,50,959.18,1669.02,0.00
2024-12-08 16:52:08,56,1647,7,49,974.52,1669.02,0.00
2024-12-08 16:52:08,56,1648,7,49,976.60,1670.00,0.00
2024-12-08 16:52:08,57,1648,8,49,959.47,1670.02,0.00
2024-12-08 16:52:08,56,1648,7,49,950.01,1670.96,0.00
2024-12-08 16:52:08,56,1649,7,49,979.27,1671.00,0.00
2024-12-08 16:52:08,57,1649,7,50,962.09,1671.02,0.00
2024-12-08 16:52:08,56,1649,7,49,977.78,1671.02,0.00
2024-12-08 16:52:08,56,1650,7,49,979.86,1672.00,0.00
2024-12-08 16:52:08,57,1650,8,49,962.67,1672.02,0.00
2024-12-08 16:52:08,56,1650,7,49,960.49,1672.18,0.00
2024-12-08 16:52:08,55,1650,6,49,977.11,1672.22,0.00
2024-12-08 16:52:08,54,1650,5,49,987.43,1672.69,0.00
2024-12-08 16:52:08,54,1651,5,49,1013.40,1673.00,0.00
2024-12-08 16:52:08,55,1651,5,50,994.98,1673.02,0.00
2024-12-08 16:52:08,54,1651,5,49,1012.47,1673.02,0.00
2024-12-08 16:52:09,54,1652,5,49,1015.25,1674.00,0.00
2024-12-08 16:52:09,55,1652,6,49,996.79,1674.02,0.00
2024-12-08 16:52:09,55,1653,6,49,993.12,1675.00,0.00
2024-12-08 16:52:09,56,1653,7,49,975.39,1675.02,0.00
2024-12-08 16:52:09,55,1653,7,48,992.51,1675.02,0.00
2024-12-08 16:52:09,55,1654,7,48,994.93,1676.00,0.00
2024-12-08 16:52:09,56,1654,8,48,977.17,1676.02,0.00
2024-12-08 16:52:09,56,1655,8,48,973.26,1677.00,0.00
2024-12-08 16:52:09,57,1655,9,48,956.18,1677.02,0.00
2024-12-08 16:52:09,56,1655,9,47,972.96,1677.02,0.00
2024-12-08 16:52:09,56,1656,9,47,975.04,1678.00,0.00
2024-12-08 16:52:09,57,1656,10,47,957.93,1678.02,0.00
2024-12-08 16:52:09,56,1656,10,46,968.74,1678.02,0.00
2024-12-08 16:52:09,56,1657,10,46,970.82,1679.00,0.00
2024-12-08 16:52:09,57,1657,11,46,953.79,1679.02,0.00
2024-12-08 16:52:09,56,1657,11,45,964.52,1679.02,0.00
2024-12-08 16:52:09,56,1658,11,45,966.60,1680.00,0.00
2024-12-08 16:52:09,57,1658,12,45,949.64,1680.02,0.00
2024-12-08 16:52:09,57,1659,12,45,945.49,1681.00,0.00
2024-12-08 16:52:09,58,1659,12,46,929.19,1681.02,0.00
2024-12-08 16:52:09,57,1659,12,45,945.19,1681.02,0.00
2024-12-08 16:52:09,57,1660,12,45,946.94,1682.00,0.00
2024-12-08 16:52:09,58,1660,12,46,930.61,1682.02,0.00
2024-12-08 16:52:09,58,1661,12,46,926.23,1683.00,0.00
2024-12-08 16:52:09,59,1661,13,46,910.53,1683.02,0.00
2024-12-08 16:52:09,58,1661,13,45,925.94,1683.02,0.00
2024-12-08 16:52:09,57,1661,12,45,927.25,1683.79,0.00
2024-12-08 16:52:09,57,1662,12,45,953.38,1684.00,0.00
2024-12-08 16:52:09,58,1662,12,46,936.94,1684.02,0.00
2024-12-08 16:52:09,57,1662,12,45,947.18,1684.02,0.00
2024-12-08 16:52:09,57,1663,12,45,948.92,1685.00,0.00
2024-12-08 16:52:09,58,1663,13,45,932.56,1685.02,0.00
2024-12-08 16:52:09,57,1663,13,44,942.71,1685.02,0.00
2024-12-08 16:52:09,56,1663,12,44,948.16,1685.70,0.00
2024-12-08 16:52:09,56,1664,12,44,961.32,1686.00,0.00
2024-12-08 16:52:09,57,1664,12,45,944.46,1686.02,0.00
2024-12-08 16:52:09,56,1664,11,45,938.36,1686.52,0.00
2024-12-08 16:52:09,56,1665,11,45,960.69,1687.00,0.00
2024-12-08 16:52:09,57,1665,12,45,943.83,1687.02,0.00
2024-12-08 16:52:09,57,1666,12,45,939.65,1688.00,0.00
2024-12-08 16:52:09,58,1666,13,45,923.45,1688.02,0.00
2024-12-08 16:52:09,57,1666,13,44,936.70,1688.07,0.00
2024-12-08 16:52:09,57,1667,13,44,939.32,1689.00,0.00
2024-12-08 16:52:09,58,1667,14,44,923.13,1689.02,0.00
2024-12-08 16:52:09,57,1667,14,43,939.02,1689.02,0.00
2024-12-08 16:52:09,57,1668,14,43,935.59,1690.00,0.00
2024-12-08 16:52:09,58,1668,15,43,919.46,1690.02,0.00
2024-12-08 16:52:09,57,1668,15,42,931.75,1690.07,0.00
2024-12-08 16:52:09,57,1669,15,42,934.36,1691.00,0.00
2024-12-08 16:52:09,58,1669,16,42,918.25,1691.02,0.00
2024-12-08 16:52:09,58,1670,16,42,914.44,1692.00,0.00
2024-12-08 16:52:09,59,1670,16,43,898.94,1692.02,0.00
2024-12-08 16:52:09,58,1670,16,42,910.95,1692.07,0.00
2024-12-08 16:52:09,58,1671,16,42,913.23,1693.00,0.00
2024-12-08 16:52:09,59,1671,16,43,897.75,1693.02,0.00
2024-12-08 16:52:09,58,1671,15,43,896.91,1693.66,0.00
2024-12-08 16:52:09,58,1672,15,43,909.59,1694.00,0.00
2024-12-08 16:52:09,59,1672,15,44,894.17,1694.02,0.00
2024-12-08 16:52:09,58,1672,15,43,906.09,1694.07,0.00
2024-12-08 16:52:09,57,1672,14,43,911.11,1694.67,0.00
2024-12-08 16:52:09,57,1673,14,43,935.41,1695.00,0.00
2024-12-08 16:52:09,58,1673,14,44,919.28,1695.02,0.00
2024-12-08 16:52:09,57,1673,13,44,917.72,1695.67,0.00
2024-12-08 16:52:09,57,1674,13,44,942.05,1696.00,0.00
2024-12-08 16:52:09,58,1674,13,45,925.80,1696.02,0.00
2024-12-08 16:52:09,57,1674,13,44,938.48,1696.07,0.00
2024-12-08 16:52:09,56,1674,12,44,945.25,1696.66,0.00
2024-12-08 16:52:09,56,1675,12,44,957.92,1697.00,0.00
2024-12-08 16:52:09,57,1675,13,44,941.11,1697.02,0.00
2024-12-08 16:52:09,56,1675,12,44,940.95,1697.66,0.00
2024-12-08 16:52:09,56,1676,12,44,953.63,1698.00,0.00
2024-12-08 16:52:09,57,1676,13,44,936.90,1698.02,0.00
2024-12-08 16:52:09,56,1676,13,43,950.30,1698.07,0.00
2024-12-08 16:52:09,56,1677,13,43,953.28,1699.00,0.00
2024-12-08 16:52:09,57,1677,14,43,936.56,1699.02,0.00
2024-12-08 16:52:09,57,1678,14,43,932.34,1700.00,0.00
2024-12-08 16:52:09,58,1678,15,43,916.26,1700.02,0.00
2024-12-08 16:52:09,57,1678,15,42,929.06,1700.07,0.00
2024-12-08 16:52:09,56,1678,14,42,943.27,1700.20,0.00
2024-12-08 16:52:09,56,1679,14,42,948.33,1701.00,0.00
2024-12-08 16:52:09,57,1679,14,43,931.69,1701.02,0.00
2024-12-08 16:52:09,57,1680,14,43,927.46,1702.00,0.00
2024-12-08 16:52:09,58,1680,15,43,911.47,1702.02,0.00
2024-12-08 16:52:09,57,1680,15,42,924.48,1702.07,0.00
2024-12-08 16:52:09,56,1680,14,42,920.84,1702.96,0.00
2024-12-08 16:52:09,56,1681,14,42,950.66,1703.00,0.00
2024-12-08 16:52:09,57,1681,15,42,933.98,1703.02,0.00
2024-12-08 16:52:10,57,1682,15,42,929.75,1704.00,0.00
2024-12-08 16:52:10,58,1682,16,42,913.72,1704.02,0.00
2024-12-08 16:52:10,57,1682,16,41,927.06,1704.07,0.00
2024-12-08 16:52:10,57,1683,16,41,929.70,1705.00,0.00
2024-12-08 16:52:10,58,1683,16,42,913.67,1705.02,0.00
2024-12-08 16:52:10,59,1682,16,43,881.72,1705.70,0.00
2024-12-08 16:52:10,59,1683,16,43,899.57,1706.00,0.00
2024-12-08 16:52:10,60,1683,17,43,884.58,1706.02,0.00
2024-12-08 16:52:10,59,1683,17,42,897.27,1706.07,0.00
2024-12-08 16:52:10,59,1684,17,42,928.17,1707.00,0.00
2024-12-08 16:52:10,60,1684,17,43,912.70,1707.02,0.00
2024-12-08 16:52:10,60,1685,17,43,908.06,1708.00,0.00
2024-12-08 16:52:10,61,1685,17,44,893.17,1708.02,0.00
2024-12-08 16:52:10,60,1685,17,43,905.78,1708.07,0.00
2024-12-08 16:52:10,60,1686,17,43,907.45,1709.00,0.00
2024-12-08 16:52:10,61,1686,17,44,892.57,1709.02,0.00
2024-12-08 16:52:10,61,1687,17,44,887.83,1710.00,0.00
2024-12-08 16:52:10,62,1687,18,44,873.52,1710.02,0.00
2024-12-08 16:52:10,61,1687,18,43,887.55,1710.02,0.00
2024-12-08 16:52:10,60,1687,18,42,900.64,1710.05,0.00
2024-12-08 16:52:10,59,1687,17,42,905.78,1710.66,0.00
2024-12-08 16:52:10,58,1687,16,42,913.50,1710.88,0.00
2024-12-08 16:52:10,58,1688,16,42,941.02,1711.00,0.00
2024-12-08 16:52:10,59,1688,16,43,925.07,1711.02,0.00
2024-12-08 16:52:10,58,1688,15,43,915.01,1711.93,0.00
2024-12-08 16:52:10,58,1689,15,43,943.39,1712.00,0.00
2024-12-08 16:52:10,59,1689,16,43,927.40,1712.02,0.00
2024-12-08 16:52:10,58,1689,16,42,941.33,1712.05,0.00
2024-12-08 16:52:10,57,1689,15,42,947.33,1712.68,0.00
2024-12-08 16:52:10,56,1689,14,42,958.26,1712.86,0.00
2024-12-08 16:52:10,56,1690,14,42,986.53,1713.00,0.00
2024-12-08 16:52:10,57,1690,14,43,969.22,1713.02,0.00
2024-12-08 16:52:10,56,1690,14,42,986.22,1713.02,0.00
2024-12-08 16:52:10,55,1690,13,42,986.99,1713.67,0.00
2024-12-08 16:52:10,55,1691,13,42,1000.35,1714.00,0.00
2024-12-08 16:52:10,56,1691,14,42,982.49,1714.02,0.00
2024-12-08 16:52:10,55,1691,14,41,998.48,1714.04,0.00
2024-12-08 16:52:10,55,1692,14,41,1001.25,1715.00,0.00
2024-12-08 16:52:10,56,1692,15,41,983.37,1715.02,0.00
2024-12-08 16:52:10,56,1693,15,41,979.34,1716.00,0.00
2024-12-08 16:52:10,57,1693,16,41,962.16,1716.02,0.00
2024-12-08 16:52:10,56,1693,16,40,976.89,1716.04,0.00
2024-12-08 16:52:10,56,1694,16,40,979.30,1717.00,0.00
2024-12-08 16:52:10,57,1694,17,40,962.12,1717.02,0.00
2024-12-08 16:52:10,56,1694,17,39,979.00,1717.02,0.00
2024-12-08 16:52:10,56,1695,17,39,974.96,1718.00,0.00
2024-12-08 16:52:10,57,1695,17,40,957.86,1718.02,0.00
2024-12-08 16:52:10,56,1695,17,39,973.12,1718.02,0.00
2024-12-08 16:52:10,55,1695,16,39,979.59,1718.69,0.00
2024-12-08 16:52:10,55,1696,16,39,993.27,1719.00,0.00
2024-12-08 16:52:10,56,1696,17,39,975.53,1719.02,0.00
2024-12-08 16:52:10,56,1697,17,39,971.49,1720.00,0.00
2024-12-08 16:52:10,57,1697,18,39,954.45,1720.02,0.00
2024-12-08 16:52:10,56,1697,18,38,969.65,1720.02,0.00
2024-12-08 16:52:10,56,1698,18,38,971.75,1721.00,0.00
2024-12-08 16:52:10,57,1698,18,39,954.70,1721.02,0.00
2024-12-08 16:52:10,57,1699,18,39,950.42,1722.00,0.00
2024-12-08 16:52:10,58,1699,19,39,934.04,1722.02,0.00
2024-12-08 16:52:10,57,1699,19,38,948.91,1722.02,0.00
2024-12-08 16:52:10,57,1700,19,38,950.67,1723.00,0.00
2024-12-08 16:52:10,58,1700,19,39,934.28,1723.02,0.00
2024-12-08 16:52:10,58,1701,19,39,929.77,1724.00,0.00
2024-12-08 16:52:10,59,1701,20,39,914.01,1724.02,0.00
2024-12-08 16:52:10,58,1701,20,38,928.58,1724.02,0.00
2024-12-08 16:52:10,58,1702,20,38,930.01,1725.00,0.00
2024-12-08 16:52:10,59,1702,20,39,914.25,1725.02,0.00
2024-12-08 16:52:10,59,1703,20,39,909.51,1726.00,0.00
2024-12-08 16:52:10,60,1703,20,40,894.36,1726.02,0.00
2024-12-08 16:52:10,59,1703,20,39,908.34,1726.02,0.00
2024-12-08 16:52:10,58,1703,19,39,912.24,1726.40,0.00
2024-12-08 16:52:10,58,1704,19,39,931.98,1727.00,0.00
2024-12-08 16:52:10,59,1704,19,40,916.19,1727.02,0.00
2024-12-08 16:52:10,59,1705,19,40,911.45,1728.00,0.00
2024-12-08 16:52:10,60,1705,20,40,896.26,1728.02,0.00
2024-12-08 16:52:10,59,1705,20,39,910.57,1728.02,0.00
2024-12-08 16:52:10,59,1706,20,39,911.68,1729.00,0.00
2024-12-08 16:52:10,60,1706,20,40,896.49,1729.02,0.00
2024-12-08 16:52:10,59,1706,19,40,888.08,1729.86,0.00
2024-12-08 16:52:10,59,1707,19,40,915.14,1730.00,0.00
2024-12-08 16:52:10,60,1707,20,40,899.89,1730.02,0.00
2024-12-08 16:52:10,59,1707,20,39,914.55,1730.02,0.00
2024-12-08 16:52:10,59,1708,20,39,915.67,1731.00,0.00
2024-12-08 16:52:10,60,1708,20,40,900.41,1731.02,0.00
2024-12-08 16:52:10,59,1708,19,40,892.03,1731.86,0.00
2024-12-08 16:52:10,59,1709,19,40,919.13,1732.00,0.00
2024-12-08 16:52:10,60,1709,19,41,903.81,1732.02,0.00
2024-12-08 16:52:10,59,1709,19,40,918.55,1732.02,0.00
2024-12-08 16:52:10,58,1709,18,40,918.36,1732.83,0.00
2024-12-08 16:52:10,58,1710,18,40,945.38,1733.00,0.00
2024-12-08 16:52:10,59,1710,18,41,929.36,1733.02,0.00
2024-12-08 16:52:10,59,1711,18,41,924.60,1734.00,0.00
2024-12-08 16:52:11,60,1711,19,41,909.19,1734.02,0.00
2024-12-08 16:52:11,59,1711,19,40,924.02,1734.02,0.00
2024-12-08 16:52:11,59,1712,19,40,925.14,1735.00,0.00
2024-12-08 16:52:11,60,1712,20,40,909.72,1735.02,0.00
2024-12-08 16:52:11,59,1712,19,40,909.36,1735.37,0.00
2024-12-08 16:52:11,58,1712,18,40,918.98,1735.72,0.00
2024-12-08 16:52:11,58,1713,18,40,944.32,1736.00,0.00
2024-12-08 16:52:11,59,1713,19,40,928.32,1736.02,0.00
2024-12-08 16:52:11,58,1713,19,39,944.02,1736.02,0.00
2024-12-08 16:52:11,58,1714,19,39,945.47,1737.00,0.00
2024-12-08 16:52:11,59,1714,20,39,929.44,1737.02,0.00
2024-12-08 16:52:11,58,1714,20,38,939.18,1737.02,0.00
2024-12-08 16:52:11,57,1714,19,38,951.75,1737.21,0.00
2024-12-08 16:52:11,57,1715,19,38,969.01,1738.00,0.00
2024-12-08 16:52:11,58,1715,20,38,952.30,1738.02,0.00
2024-12-08 16:52:11,57,1715,20,37,962.61,1738.02,0.00
2024-12-08 16:52:11,57,1716,20,37,964.38,1739.00,0.00
2024-12-08 16:52:11,58,1716,21,37,947.75,1739.02,0.00
2024-12-08 16:52:11,57,1716,21,36,957.97,1739.02,0.00
2024-12-08 16:52:11,57,1717,21,36,959.75,1740.00,0.00
2024-12-08 16:52:11,58,1717,22,36,943.20,1740.02,0.00
2024-12-08 16:52:11,57,1717,22,35,953.34,1740.02,0.00
2024-12-08 16:52:11,57,1718,22,35,955.11,1741.00,0.00
2024-12-08 16:52:11,58,1718,23,35,938.64,1741.02,0.00
2024-12-08 16:52:11,57,1718,22,35,946.29,1741.18,0.00
2024-12-08 16:52:11,56,1718,21,35,954.26,1741.38,0.00
2024-12-08 16:52:11,56,1719,21,35,974.90,1742.00,0.00
2024-12-08 16:52:11,57,1719,22,35,957.79,1742.02,0.00
2024-12-08 16:52:11,56,1719,22,34,974.59,1742.02,0.00
2024-12-08 16:52:11,56,1720,22,34,976.70,1743.00,0.00
2024-12-08 16:52:11,57,1720,23,34,959.57,1743.02,0.00
2024-12-08 16:52:11,56,1720,23,33,970.17,1743.02,0.00
2024-12-08 16:52:11,56,1721,23,33,972.28,1744.00,0.00
2024-12-08 16:52:11,57,1721,24,33,955.22,1744.02,0.00
2024-12-08 16:52:11,56,1721,24,32,965.74,1744.02,0.00
2024-12-08 16:52:11,55,1721,23,32,972.19,1744.66,0.00
2024-12-08 16:52:11,55,1722,23,32,985.45,1745.00,0.00
2024-12-08 16:52:11,56,1722,23,33,967.85,1745.02,0.00
2024-12-08 16:52:11,56,1723,23,33,963.73,1746.00,0.00
2024-12-08 16:52:11,57,1723,23,34,946.82,1746.02,0.00
2024-12-08 16:52:11,56,1723,23,33,963.42,1746.02,0.00
2024-12-08 16:52:11,55,1723,22,33,964.31,1746.49,0.00
2024-12-08 16:52:11,55,1724,22,33,987.53,1747.00,0.00
2024-12-08 16:52:11,56,1724,23,33,969.90,1747.02,0.00
2024-12-08 16:52:11,56,1725,23,33,965.77,1748.00,0.00
2024-12-08 16:52:11,57,1725,24,33,948.83,1748.02,0.00
2024-12-08 16:52:11,56,1725,24,32,965.46,1748.02,0.00
2024-12-08 16:52:11,55,1725,23,32,979.88,1748.18,0.00
2024-12-08 16:52:11,55,1726,23,32,985.16,1749.00,0.00
2024-12-08 16:52:11,56,1726,23,33,967.57,1749.02,0.00
2024-12-08 16:52:11,55,1726,23,32,978.49,1749.02,0.00
2024-12-08 16:52:11,55,1727,23,32,980.95,1750.00,0.00
2024-12-08 16:52:11,56,1727,24,32,963.44,1750.02,0.00
2024-12-08 16:52:11,55,1727,23,32,963.45,1750.66,0.00
2024-12-08 16:52:11,56,1726,24,32,944.44,1750.79,0.00
2024-12-08 16:52:11,56,1727,24,32,963.36,1751.00,0.00
2024-12-08 16:52:11,57,1727,25,32,946.46,1751.02,0.00
2024-12-08 16:52:11,56,1727,25,31,963.05,1751.02,0.00
2024-12-08 16:52:11,56,1728,25,31,996.45,1752.00,0.00
2024-12-08 16:52:11,57,1728,25,32,978.97,1752.02,0.00
2024-12-08 16:52:11,57,1729,25,32,974.61,1753.00,0.00
2024-12-08 16:52:11,58,1729,25,33,957.80,1753.02,0.00
2024-12-08 16:52:11,57,1729,25,32,974.30,1753.02,0.00
2024-12-08 16:52:11,56,1729,24,32,970.98,1753.57,0.00
2024-12-08 16:52:11,56,1730,24,32,995.08,1754.00,0.00
2024-12-08 16:52:11,57,1730,24,33,977.62,1754.02,0.00
2024-12-08 16:52:11,57,1731,24,33,973.25,1755.00,0.00
2024-12-08 16:52:11,58,1731,25,33,956.47,1755.02,0.00
2024-12-08 16:52:11,57,1731,25,32,970.80,1755.04,0.00
2024-12-08 16:52:11,56,1731,24,32,977.47,1755.64,0.00
2024-12-08 16:52:11,56,1732,24,32,990.26,1756.00,0.00
2024-12-08 16:52:11,57,1732,24,33,972.89,1756.02,0.00
2024-12-08 16:52:11,57,1733,24,33,968.51,1757.00,0.00
2024-12-08 16:52:11,58,1733,25,33,951.81,1757.02,0.00
2024-12-08 16:52:11,57,1733,25,32,966.35,1757.04,0.00
2024-12-08 16:52:11,56,1733,24,32,972.31,1757.66,0.00
2024-12-08 16:52:11,56,1734,24,32,997.98,1758.00,0.00
2024-12-08 16:52:11,57,1734,24,33,980.47,1758.02,0.00
2024-12-08 16:52:11,57,1735,24,33,976.09,1759.00,0.00
2024-12-08 16:52:11,58,1735,25,33,959.26,1759.02,0.00
2024-12-08 16:52:11,57,1735,25,32,973.93,1759.04,0.00
2024-12-08 16:52:11,56,1735,24,32,970.54,1759.59,0.00
2024-12-08 16:52:11,56,1736,24,32,995.03,1760.00,0.00
2024-12-08 16:52:11,57,1736,25,32,977.57,1760.02,0.00
2024-12-08 16:52:11,56,1736,24,32,985.95,1760.16,0.00
2024-12-08 16:52:11,56,1737,24,32,990.56,1761.00,0.00
2024-12-08 16:52:11,57,1737,24,33,973.18,1761.02,0.00
2024-12-08 16:52:11,56,1737,24,32,988.05,1761.05,0.00
2024-12-08 16:52:11,56,1738,24,32,990.81,1762.00,0.00
2024-12-08 16:52:11,57,1738,25,32,973.43,1762.02,0.00
2024-12-08 16:52:11,57,1739,25,32,969.51,1763.00,0.00
2024-12-08 16:52:11,58,1739,25,33,952.80,1763.02,0.00
2024-12-08 16:52:11,57,1739,25,32,965.80,1763.05,0.00
2024-12-08 16:52:11,57,1740,25,32,968.21,1764.00,0.00
2024-12-08 16:52:11,58,1740,25,33,951.51,1764.02,0.00
2024-12-08 16:52:12,58,1741,25,33,947.55,1765.00,0.00
2024-12-08 16:52:12,59,1741,26,33,931.49,1765.02,0.00
2024-12-08 16:52:12,58,1741,25,33,946.95,1765.03,0.00
2024-12-08 16:52:12,57,1741,25,32,960.77,1765.04,0.00
2024-12-08 16:52:12,56,1741,24,32,964.63,1765.70,0.00
2024-12-08 16:52:12,56,1742,24,32,991.03,1766.00,0.00
2024-12-08 16:52:12,57,1742,25,32,973.64,1766.02,0.00
2024-12-08 16:52:12,57,1743,25,32,969.47,1767.00,0.00
2024-12-08 16:52:12,58,1743,26,32,952.75,1767.02,0.00
2024-12-08 16:52:12,57,1743,26,31,966.68,1767.04,0.00
2024-12-08 16:52:12,57,1744,26,31,968.77,1768.00,0.00
2024-12-08 16:52:12,58,1744,27,31,952.07,1768.02,0.00
2024-12-08 16:52:12,59,1743,28,31,905.29,1768.80,0.00
2024-12-08 16:52:12,59,1744,28,31,935.43,1769.00,0.00
2024-12-08 16:52:12,60,1744,29,31,919.84,1769.02,0.00
2024-12-08 16:52:12,59,1744,29,30,933.03,1769.03,0.00
2024-12-08 16:52:12,59,1745,29,30,964.46,1770.00,0.00
2024-12-08 16:52:12,60,1745,29,31,948.38,1770.02,0.00
2024-12-08 16:52:12,59,1745,28,31,941.38,1770.48,0.00
2024-12-08 16:52:12,58,1745,27,31,954.34,1770.66,0.00
2024-12-08 16:52:12,58,1746,27,31,979.03,1771.00,0.00
2024-12-08 16:52:12,59,1746,28,31,962.44,1771.02,0.00
2024-12-08 16:52:12,58,1746,28,30,976.89,1771.03,0.00
2024-12-08 16:52:12,57,1746,27,30,991.90,1771.16,0.00
2024-12-08 16:52:12,56,1746,26,30,996.77,1771.43,0.00
2024-12-08 16:52:12,56,1747,26,30,1018.68,1772.00,0.00
2024-12-08 16:52:12,57,1747,27,30,1000.81,1772.02,0.00
2024-12-08 16:52:12,57,1748,27,30,996.43,1773.00,0.00
2024-12-08 16:52:12,58,1748,27,31,979.25,1773.02,0.00
2024-12-08 16:52:12,57,1748,27,30,993.32,1773.04,0.00
2024-12-08 16:52:12,57,1749,27,30,995.44,1774.00,0.00
2024-12-08 16:52:12,58,1749,27,31,978.28,1774.02,0.00
2024-12-08 16:52:12,57,1749,26,31,973.08,1774.79,0.00
2024-12-08 16:52:12,57,1750,26,31,1000.64,1775.00,0.00
2024-12-08 16:52:12,58,1750,26,32,983.38,1775.02,0.00
2024-12-08 16:52:12,57,1750,26,31,996.59,1775.05,0.00
2024-12-08 16:52:12,57,1751,26,31,999.02,1776.00,0.00
2024-12-08 16:52:12,58,1751,27,31,981.79,1776.02,0.00
2024-12-08 16:52:12,57,1751,26,31,990.16,1776.16,0.00
2024-12-08 16:52:12,57,1752,26,31,995.01,1777.00,0.00
2024-12-08 16:52:12,58,1752,27,31,977.85,1777.02,0.00
2024-12-08 16:52:12,57,1752,27,30,991.59,1777.05,0.00
2024-12-08 16:52:12,56,1752,26,30,1007.74,1777.14,0.00
2024-12-08 16:52:12,56,1753,26,30,1012.08,1778.00,0.00
2024-12-08 16:52:12,57,1753,27,30,994.32,1778.02,0.00
2024-12-08 16:52:12,56,1753,26,30,988.14,1778.48,0.00
2024-12-08 16:52:12,56,1754,26,30,1011.06,1779.00,0.00
2024-12-08 16:52:12,57,1754,27,30,993.32,1779.02,0.00
2024-12-08 16:52:12,56,1754,26,30,1010.74,1779.02,0.00
2024-12-08 16:52:12,55,1754,26,29,1025.89,1779.04,0.00
2024-12-08 16:52:12,55,1755,26,29,1028.73,1780.00,0.00
2024-12-08 16:52:12,56,1755,27,29,1010.36,1780.02,0.00
2024-12-08 16:52:12,56,1756,27,29,1006.15,1781.00,0.00
2024-12-08 16:52:12,57,1756,27,30,988.50,1781.02,0.00
2024-12-08 16:52:12,56,1756,27,29,1003.29,1781.04,0.00
2024-12-08 16:52:12,56,1757,27,29,1005.76,1782.00,0.00
2024-12-08 16:52:12,57,1757,27,30,988.12,1782.02,0.00
2024-12-08 16:52:12,57,1758,27,30,983.67,1783.00,0.00
2024-12-08 16:52:12,58,1758,27,31,966.71,1783.02,0.00
2024-12-08 16:52:12,57,1758,27,30,981.17,1783.04,0.00
2024-12-08 16:52:12,56,1758,26,30,988.60,1783.29,0.00
2024-12-08 16:52:12,56,1759,26,30,1008.17,1784.00,0.00
2024-12-08 16:52:12,57,1759,27,30,990.48,1784.02,0.00
2024-12-08 16:52:12,57,1760,27,30,986.02,1785.00,0.00
2024-12-08 16:52:12,58,1760,28,30,969.02,1785.02,0.00
2024-12-08 16:52:12,57,1760,28,29,983.52,1785.04,0.00
2024-12-08 16:52:12,56,1760,27,29,980.54,1785.93,0.00
2024-12-08 16:52:12,56,1761,27,29,1011.21,1786.00,0.00
2024-12-08 16:52:12,57,1761,27,30,993.47,1786.02,0.00
2024-12-08 16:52:12,56,1761,26,30,1005.15,1786.02,0.00
2024-12-08 16:52:12,55,1761,25,30,1005.94,1786.64,0.00
2024-12-08 16:52:12,55,1762,25,30,1032.20,1787.00,0.00
2024-12-08 16:52:12,56,1762,26,30,1013.77,1787.02,0.00
2024-12-08 16:52:12,55,1762,26,29,1029.93,1787.02,0.00
2024-12-08 16:52:12,54,1762,25,29,1038.74,1787.02,0.00
2024-12-08 16:52:12,54,1763,25,29,1054.89,1788.00,0.00
2024-12-08 16:52:12,55,1763,25,30,1035.71,1788.02,0.00
2024-12-08 16:52:12,55,1764,25,30,1031.88,1789.00,0.00
2024-12-08 16:52:12,56,1764,25,31,1013.45,1789.02,0.00
2024-12-08 16:52:12,55,1764,25,30,1028.63,1789.02,0.00
2024-12-08 16:52:12,55,1765,25,30,1031.16,1790.00,0.00
2024-12-08 16:52:12,56,1765,26,30,1012.74,1790.02,0.00
2024-12-08 16:52:12,55,1765,25,30,1006.63,1790.49,0.00
2024-12-08 16:52:12,55,1766,25,30,1030.43,1791.00,0.00
2024-12-08 16:52:12,56,1766,25,31,1012.03,1791.02,0.00
2024-12-08 16:52:12,55,1766,25,30,1026.85,1791.02,0.00
2024-12-08 16:52:12,55,1767,25,30,1029.38,1792.00,0.00
2024-12-08 16:52:12,56,1767,26,30,1010.99,1792.02,0.00
2024-12-08 16:52:12,55,1767,25,30,1005.46,1792.47,0.00
2024-12-08 16:52:12,54,1767,24,30,1020.55,1792.67,0.00
2024-12-08 16:52:12,54,1768,24,30,1048.03,1793.00,0.00
2024-12-08 16:52:12,55,1768,25,30,1028.97,1793.02,0.00
2024-12-08 16:52:12,54,1768,25,29,1044.38,1793.02,0.00
2024-12-08 16:52:12,54,1769,25,29,1047.28,1794.00,0.00
2024-12-08 16:52:12,55,1769,26,29,1028.24,1794.02,0.00
2024-12-08 16:52:12,54,1769,25,29,1030.10,1794.30,0.00
2024-12-08 16:52:12,54,1770,25,29,1051.19,1795.00,0.00
2024-12-08 16:52:12,55,1770,26,29,1032.08,1795.02,0.00
2024-12-08 16:52:13,54,1770,26,28,1047.53,1795.02,0.00
2024-12-08 16:52:13,54,1771,26,28,1050.45,1796.00,0.00
2024-12-08 16:52:13,55,1771,27,28,1031.35,1796.02,0.00
2024-12-08 16:52:13,55,1772,27,28,1027.42,1797.00,0.00
2024-12-08 16:52:13,56,1772,27,29,1009.07,1797.02,0.00
2024-12-08 16:52:13,55,1772,27,28,1024.15,1797.02,0.00
2024-12-08 16:52:13,54,1772,26,28,1020.63,1797.96,0.00
2024-12-08 16:52:13,54,1773,26,28,1053.28,1798.00,0.00
2024-12-08 16:52:13,55,1773,27,28,1034.13,1798.02,0.00
2024-12-08 16:52:13,55,1774,27,28,1030.13,1799.00,0.00
2024-12-08 16:52:13,56,1774,27,29,1011.73,1799.02,0.00
2024-12-08 16:52:13,55,1774,27,28,1027.18,1799.02,0.00
2024-12-08 16:52:13,55,1775,27,28,1029.72,1800.00,0.00
2024-12-08 16:52:13,56,1775,28,28,1011.33,1800.02,0.00
2024-12-08 16:52:13,56,1776,28,28,1007.50,1801.00,0.00
2024-12-08 16:52:13,57,1776,29,28,989.82,1801.02,0.00
2024-12-08 16:52:13,56,1776,29,27,1004.60,1801.02,0.00
2024-12-08 16:52:13,56,1777,29,27,1006.77,1802.00,0.00
2024-12-08 16:52:13,57,1777,29,28,989.11,1802.02,0.00
2024-12-08 16:52:13,56,1777,28,28,999.06,1802.09,0.00
2024-12-08 16:52:13,56,1778,28,28,1003.31,1803.00,0.00
2024-12-08 16:52:13,57,1778,28,29,985.71,1803.02,0.00
2024-12-08 16:52:13,56,1778,28,28,1000.41,1803.02,0.00
2024-12-08 16:52:13,55,1778,27,28,1017.63,1803.07,0.00
2024-12-08 16:52:13,54,1778,26,28,1019.04,1803.83,0.00
2024-12-08 16:52:13,54,1779,26,28,1049.56,1804.00,0.00
2024-12-08 16:52:13,55,1779,26,29,1030.48,1804.02,0.00
2024-12-08 16:52:13,54,1779,25,29,1041.89,1804.07,0.00
2024-12-08 16:52:13,54,1780,25,29,1045.80,1805.00,0.00
2024-12-08 16:52:13,55,1780,25,30,1026.78,1805.02,0.00
2024-12-08 16:52:13,54,1780,25,29,1043.12,1805.02,0.00
2024-12-08 16:52:13,54,1781,25,29,1046.04,1806.00,0.00
2024-12-08 16:52:13,55,1781,26,29,1027.02,1806.02,0.00
2024-12-08 16:52:13,54,1781,25,29,1019.65,1806.87,0.00
2024-12-08 16:52:13,54,1782,25,29,1050.86,1807.00,0.00
2024-12-08 16:52:13,55,1782,25,30,1031.75,1807.02,0.00
2024-12-08 16:52:13,54,1782,25,29,1048.51,1807.02,0.00
2024-12-08 16:52:13,54,1783,25,29,1051.44,1808.00,0.00
2024-12-08 16:52:13,55,1783,25,30,1032.32,1808.02,0.00
2024-12-08 16:52:13,54,1783,24,30,1021.43,1808.69,0.00
2024-12-08 16:52:13,54,1784,24,30,1049.46,1809.00,0.00
2024-12-08 16:52:13,55,1784,24,31,1030.38,1809.02,0.00
2024-12-08 16:52:13,54,1784,24,30,1043.10,1809.06,0.00
2024-12-08 16:52:13,54,1785,24,30,1046.68,1810.00,0.00
2024-12-08 16:52:13,55,1785,25,30,1027.65,1810.02,0.00
2024-12-08 16:52:13,54,1785,24,30,1029.37,1810.30,0.00
2024-12-08 16:52:13,53,1785,23,30,1043.22,1810.60,0.00
2024-12-08 16:52:14,53,1786,23,30,1070.50,1811.00,0.00
2024-12-08 16:52:14,54,1786,23,31,1050.68,1811.02,0.00
2024-12-08 16:52:14,53,1786,23,30,1064.36,1811.06,0.00
2024-12-08 16:52:14,52,1786,22,30,1074.02,1811.67,0.00
2024-12-08 16:52:14,52,1787,22,30,1089.25,1812.00,0.00
2024-12-08 16:52:14,53,1787,23,30,1068.70,1812.02,0.00
2024-12-08 16:52:14,52,1787,22,30,1088.94,1812.02,0.00
2024-12-08 16:52:14,51,1787,21,30,1085.29,1812.49,0.00
2024-12-08 16:52:14,51,1788,21,30,1111.97,1813.00,0.00
2024-12-08 16:52:14,52,1788,22,30,1090.59,1813.02,0.00
2024-12-08 16:52:14,51,1788,22,29,1105.58,1813.04,0.00
2024-12-08 16:52:14,51,1788,22,29,1110.10,1814.00,0.00
2024-12-08 16:52:14,52,1788,22,30,1088.75,1814.02,0.00
2024-12-08 16:52:14,52,1789,22,30,1086.40,1815.00,0.00
2024-12-08 16:52:14,53,1789,22,31,1065.90,1815.02,0.00
2024-12-08 16:52:14,52,1789,22,30,1079.43,1815.06,0.00
2024-12-08 16:52:14,51,1789,21,30,1081.65,1815.84,0.00
2024-12-08 16:52:14,51,1790,21,30,1114.53,1816.00,0.00
2024-12-08 16:52:14,52,1790,21,31,1093.09,1816.02,0.00
2024-12-08 16:52:14,52,1791,21,31,1090.61,1817.00,0.00
2024-12-08 16:52:14,53,1791,22,31,1070.03,1817.02,0.00
2024-12-08 16:52:14,52,1791,22,30,1083.99,1817.06,0.00
2024-12-08 16:52:14,52,1792,22,30,1088.42,1818.00,0.00
2024-12-08 16:52:14,53,1792,23,30,1067.88,1818.02,0.00
2024-12-08 16:52:14,53,1793,23,30,1065.59,1819.00,0.00
2024-12-08 16:52:14,54,1793,23,31,1045.85,1819.02,0.00
2024-12-08 16:52:14,53,1793,23,30,1059.42,1819.06,0.00
2024-12-08 16:52:14,53,1794,23,30,1063.43,1820.00,0.00
2024-12-08 16:52:14,54,1794,24,30,1043.73,1820.02,0.00
2024-12-08 16:52:14,54,1795,24,30,1041.62,1821.00,0.00
2024-12-08 16:52:14,55,1795,24,31,1022.68,1821.02,0.00
2024-12-08 16:52:14,54,1795,24,30,1035.23,1821.07,0.00
2024-12-08 16:52:14,53,1795,23,30,1044.05,1821.66,0.00
2024-12-08 16:52:14,53,1796,23,30,1058.76,1822.00,0.00
2024-12-08 16:52:14,54,1796,23,31,1039.15,1822.02,0.00
2024-12-08 16:52:14,54,1797,23,31,1037.13,1823.00,0.00
2024-12-08 16:52:14,55,1797,24,31,1018.28,1823.02,0.00
2024-12-08 16:52:14,54,1797,23,31,1036.13,1823.07,0.00
2024-12-08 16:52:14,53,1797,23,30,1050.17,1823.08,0.00
2024-12-08 16:52:14,52,1797,22,30,1060.76,1823.62,0.00
2024-12-08 16:52:14,52,1798,22,30,1075.08,1824.00,0.00
2024-12-08 16:52:14,53,1798,23,30,1054.80,1824.02,0.00
2024-12-08 16:52:14,52,1798,22,30,1048.65,1824.52,0.00
2024-12-08 16:52:14,52,1799,22,30,1075.32,1825.00,0.00
2024-12-08 16:52:14,53,1799,22,31,1055.03,1825.02,0.00
2024-12-08 16:52:14,52,1799,22,30,1068.32,1825.08,0.00
2024-12-08 16:52:14,52,1800,22,30,1073.10,1826.00,0.00
2024-12-08 16:52:14,53,1800,23,30,1052.86,1826.02,0.00
2024-12-08 16:52:14,53,1801,23,30,1051.01,1827.00,0.00
2024-12-08 16:52:14,54,1801,23,31,1031.54,1827.02,0.00
2024-12-08 16:52:14,53,1801,23,30,1044.13,1827.08,0.00
2024-12-08 16:52:15,53,1802,23,30,1048.48,1828.00,0.00
2024-12-08 16:52:15,54,1802,23,31,1029.06,1828.02,0.00
2024-12-08 16:52:15,54,1803,23,31,1027.17,1829.00,0.00
2024-12-08 16:52:15,55,1803,24,31,1008.49,1829.02,0.00
2024-12-08 16:52:15,54,1803,24,30,1020.74,1829.07,0.00
2024-12-08 16:52:15,53,1803,23,30,1039.66,1829.09,0.00
2024-12-08 16:52:15,52,1803,22,30,1047.18,1829.35,0.00
2024-12-08 16:52:15,52,1804,22,30,1070.87,1830.00,0.00
2024-12-08 16:52:15,53,1804,22,31,1050.66,1830.02,0.00
2024-12-08 16:52:15,53,1805,22,31,1049.82,1831.00,0.00
2024-12-08 16:52:15,54,1805,23,31,1030.38,1831.02,0.00
2024-12-08 16:52:15,53,1805,22,31,1045.72,1831.11,0.00
2024-12-08 16:52:15,52,1805,22,30,1058.79,1831.12,0.00
2024-12-08 16:52:15,52,1806,22,30,1078.38,1832.00,0.00
2024-12-08 16:52:15,53,1806,22,31,1058.03,1832.02,0.00
2024-12-08 16:52:15,52,1806,21,31,1076.99,1832.08,0.00
2024-12-08 16:52:15,51,1806,20,31,1097.89,1832.08,0.00
2024-12-08 16:52:15,51,1807,20,31,1099.10,1833.00,0.00
2024-12-08 16:52:15,52,1807,20,32,1077.97,1833.02,0.00
2024-12-08 16:52:15,51,1807,20,31,1090.14,1833.10,0.00
2024-12-08 16:52:15,51,1808,20,31,1095.75,1834.00,0.00
2024-12-08 16:52:15,52,1808,21,31,1074.67,1834.02,0.00
2024-12-08 16:52:15,51,1808,20,31,1091.79,1834.02,0.00
2024-12-08 16:52:15,51,1809,20,31,1103.18,1835.00,0.00
2024-12-08 16:52:15,52,1809,20,32,1081.96,1835.02,0.00
2024-12-08 16:52:15,51,1809,20,31,1094.92,1835.08,0.00
2024-12-08 16:52:15,51,1810,20,31,1100.18,1836.00,0.00
2024-12-08 16:52:15,52,1810,21,31,1079.02,1836.02,0.00
2024-12-08 16:52:15,52,1811,21,31,1077.70,1837.00,0.00
2024-12-08 16:52:15,53,1811,21,32,1057.36,1837.02,0.00
2024-12-08 16:52:15,52,1811,21,31,1069.94,1837.08,0.00
2024-12-08 16:52:15,51,1811,20,31,1090.92,1837.08,0.00
2024-12-08 16:52:15,51,1812,20,31,1096.18,1838.00,0.00
2024-12-08 16:52:15,52,1812,20,32,1075.10,1838.02,0.00
2024-12-08 16:52:15,51,1812,19,32,1070.09,1838.78,0.00
2024-12-08 16:52:15,51,1813,19,32,1102.34,1839.00,0.00
2024-12-08 16:52:15,52,1813,19,33,1081.14,1839.02,0.00
2024-12-08 16:52:15,51,1813,18,33,1073.68,1839.82,0.00
2024-12-08 16:52:15,51,1814,18,33,1106.64,1840.00,0.00
2024-12-08 16:52:15,52,1814,19,33,1085.36,1840.02,0.00
2024-12-08 16:52:15,51,1814,19,32,1104.15,1840.12,0.00
2024-12-08 16:52:15,51,1815,19,32,1110.13,1841.00,0.00
2024-12-08 16:52:15,52,1815,20,32,1088.78,1841.02,0.00
2024-12-08 16:52:15,52,1816,20,32,1087.97,1842.00,0.00
2024-12-08 16:52:15,53,1816,21,32,1067.45,1842.02,0.00
2024-12-08 16:52:15,52,1816,21,31,1078.79,1842.12,0.00
2024-12-08 16:52:15,52,1817,21,31,1084.31,1843.00,0.00
2024-12-08 16:52:15,53,1817,21,32,1063.85,1843.02,0.00
2024-12-08 16:52:15,52,1817,20,32,1067.45,1843.56,0.00
2024-12-08 16:52:15,52,1818,20,32,1083.59,1844.00,0.00
2024-12-08 16:52:15,53,1818,20,33,1063.14,1844.02,0.00
2024-12-08 16:52:15,52,1818,20,32,1074.75,1844.12,0.00
2024-12-08 16:52:15,51,1818,19,32,1076.72,1844.82,0.00
2024-12-08 16:52:15,51,1819,19,32,1109.76,1845.00,0.00
2024-12-08 16:52:15,52,1819,19,33,1088.42,1845.02,0.00
2024-12-08 16:52:15,52,1820,19,33,1087.54,1846.00,0.00
2024-12-08 16:52:15,53,1820,19,34,1067.02,1846.02,0.00
2024-12-08 16:52:15,52,1820,19,33,1078.33,1846.12,0.00
2024-12-08 16:52:15,51,1820,18,33,1076.86,1846.92,0.00
2024-12-08 16:52:15,51,1821,18,33,1111.69,1847.00,0.00
2024-12-08 16:52:15,52,1821,18,34,1090.31,1847.02,0.00
2024-12-08 16:52:15,52,1822,18,34,1089.57,1848.00,0.00
2024-12-08 16:52:15,53,1822,18,35,1069.02,1848.02,0.00
2024-12-08 16:52:15,52,1822,18,34,1080.35,1848.12,0.00
2024-12-08 16:52:15,51,1822,17,34,1077.76,1848.88,0.00
2024-12-08 16:52:15,51,1823,17,34,1111.94,1849.00,0.00
2024-12-08 16:52:15,52,1823,17,35,1090.55,1849.02,0.00
2024-12-08 16:52:15,52,1824,17,35,1089.72,1850.00,0.00
2024-12-08 16:52:15,53,1824,17,36,1069.16,1850.02,0.00
2024-12-08 16:52:15,52,1824,17,35,1080.84,1850.12,0.00
2024-12-08 16:52:15,52,1825,17,35,1086.39,1851.00,0.00
2024-12-08 16:52:15,53,1825,18,35,1065.89,1851.02,0.00
2024-12-08 16:52:15,52,1825,17,35,1086.03,1851.02,0.00
2024-12-08 16:52:15,52,1826,17,35,1085.66,1852.00,0.00
2024-12-08 16:52:15,53,1826,17,36,1065.17,1852.02,0.00
2024-12-08 16:52:15,52,1826,17,35,1077.13,1852.10,0.00
2024-12-08 16:52:16,52,1827,17,35,1082.33,1853.00,0.00
2024-12-08 16:52:16,53,1827,17,36,1061.90,1853.02,0.00
2024-12-08 16:52:16,52,1827,16,36,1071.65,1853.08,0.00
2024-12-08 16:52:16,52,1828,16,36,1083.62,1854.00,0.00
2024-12-08 16:52:16,53,1828,16,37,1063.18,1854.02,0.00
2024-12-08 16:52:16,53,1829,16,37,1059.55,1855.00,0.00
2024-12-08 16:52:16,54,1829,16,38,1039.93,1855.02,0.00
2024-12-08 16:52:16,53,1829,15,38,1057.47,1855.09,0.00
2024-12-08 16:52:16,52,1829,15,37,1076.73,1855.10,0.00
2024-12-08 16:52:16,52,1830,15,37,1096.21,1856.00,0.00
2024-12-08 16:52:16,53,1830,16,37,1075.53,1856.02,0.00
2024-12-08 16:52:16,53,1831,16,37,1075.50,1857.00,0.00
2024-12-08 16:52:16,54,1831,16,38,1055.58,1857.02,0.00
2024-12-08 16:52:16,53,1831,15,38,1056.88,1857.66,0.00
2024-12-08 16:52:16,53,1832,15,38,1071.87,1858.00,0.00
2024-12-08 16:52:16,54,1832,16,38,1052.02,1858.02,0.00
2024-12-08 16:52:16,53,1832,16,37,1069.78,1858.09,0.00
2024-12-08 16:52:16,52,1832,15,37,1082.11,1858.46,0.00
2024-12-08 16:52:16,52,1833,15,37,1108.25,1859.00,0.00
2024-12-08 16:52:16,53,1833,15,38,1087.34,1859.02,0.00
2024-12-08 16:52:16,52,1833,14,38,1083.75,1859.46,0.00
2024-12-08 16:52:16,52,1834,14,38,1109.92,1860.00,0.00
2024-12-08 16:52:16,53,1834,14,39,1088.97,1860.02,0.00
2024-12-08 16:52:16,53,1835,14,39,1088.79,1861.00,0.00
2024-12-08 16:52:16,54,1835,15,39,1068.63,1861.02,0.00
2024-12-08 16:52:16,54,1836,15,39,1064.72,1862.00,0.00
2024-12-08 16:52:16,55,1836,15,40,1045.36,1862.02,0.00
2024-12-08 16:52:16,54,1836,15,39,1056.11,1862.09,0.00
2024-12-08 16:52:16,54,1837,15,39,1060.46,1863.00,0.00
2024-12-08 16:52:16,55,1837,15,40,1041.18,1863.02,0.00
2024-12-08 16:52:16,54,1837,15,39,1058.75,1863.09,0.00
2024-12-08 16:52:16,54,1838,15,39,1063.10,1864.00,0.00
2024-12-08 16:52:16,55,1838,16,39,1043.77,1864.02,0.00
2024-12-08 16:52:16,54,1838,15,39,1032.92,1864.96,0.00
2024-12-08 16:52:16,54,1839,15,39,1066.78,1865.00,0.00
2024-12-08 16:52:16,55,1839,16,39,1047.39,1865.02,0.00
2024-12-08 16:52:16,54,1839,16,38,1058.50,1865.09,0.00
2024-12-08 16:52:16,54,1840,16,38,1062.86,1866.00,0.00
2024-12-08 16:52:16,55,1840,17,38,1043.54,1866.02,0.00
2024-12-08 16:52:16,55,1841,17,38,1042.41,1867.00,0.00
2024-12-08 16:52:16,56,1841,18,38,1023.80,1867.02,0.00
2024-12-08 16:52:16,55,1841,18,37,1034.62,1867.09,0.00
2024-12-08 16:52:16,54,1841,17,37,1028.70,1867.96,0.00
2024-12-08 16:52:16,54,1842,17,37,1062.62,1868.00,0.00
2024-12-08 16:52:16,55,1842,18,37,1043.30,1868.02,0.00
2024-12-08 16:52:16,54,1842,17,37,1062.27,1868.02,0.00
2024-12-08 16:52:16,53,1842,16,37,1052.52,1868.87,0.00
2024-12-08 16:52:16,53,1843,16,37,1085.43,1869.00,0.00
2024-12-08 16:52:16,54,1843,17,37,1065.33,1869.02,0.00
2024-12-08 16:52:16,53,1843,17,36,1077.68,1869.08,0.00
2024-12-08 16:52:16,52,1843,16,36,1089.29,1869.56,0.00
2024-12-08 16:52:16,52,1844,16,36,1102.94,1870.00,0.00
2024-12-08 16:52:16,53,1844,16,37,1082.13,1870.02,0.00
2024-12-08 16:52:16,52,1844,15,37,1093.61,1870.12,0.00
2024-12-08 16:52:16,52,1845,15,37,1113.60,1871.00,0.00
2024-12-08 16:52:16,53,1845,15,38,1092.59,1871.02,0.00
2024-12-08 16:52:16,52,1845,14,38,1113.24,1871.02,0.00
2024-12-08 16:52:16,51,1845,14,37,1127.74,1871.06,0.00
2024-12-08 16:52:16,50,1845,13,37,1148.82,1871.10,0.00
2024-12-08 16:52:16,50,1846,13,37,1170.00,1872.00,0.00
2024-12-08 16:52:16,51,1846,13,38,1147.06,1872.02,0.00
2024-12-08 16:52:16,50,1846,12,38,1160.64,1872.04,0.00
2024-12-08 16:52:16,50,1847,12,38,1173.25,1873.00,0.00
2024-12-08 16:52:16,51,1847,13,38,1150.24,1873.02,0.00
2024-12-08 16:52:16,50,1847,13,37,1166.51,1873.04,0.00
2024-12-08 16:52:16,50,1848,13,37,1171.62,1874.00,0.00
2024-12-08 16:52:16,51,1848,13,38,1148.65,1874.02,0.00
2024-12-08 16:52:16,50,1848,12,38,1151.87,1874.32,0.00
2024-12-08 16:52:16,50,1849,12,38,1177.12,1875.00,0.00
2024-12-08 16:52:16,51,1849,13,38,1154.04,1875.02,0.00
2024-12-08 16:52:16,50,1849,13,37,1170.38,1875.04,0.00
2024-12-08 16:52:16,50,1850,13,37,1175.50,1876.00,0.00
2024-12-08 16:52:16,51,1850,13,38,1152.45,1876.02,0.00
2024-12-08 16:52:16,51,1851,13,38,1150.48,1877.00,0.00
2024-12-08 16:52:16,52,1851,14,38,1128.36,1877.02,0.00
2024-12-08 16:52:16,51,1851,13,38,1150.12,1877.02,0.00
2024-12-08 16:52:16,50,1851,13,37,1165.99,1877.04,0.00
2024-12-08 16:52:16,49,1851,12,37,1169.60,1877.84,0.00
2024-12-08 16:52:16,49,1852,12,37,1204.99,1878.00,0.00
2024-12-08 16:52:16,50,1852,12,38,1180.89,1878.02,0.00
2024-12-08 16:52:16,50,1853,12,38,1178.40,1879.00,0.00
2024-12-08 16:52:16,51,1853,13,38,1155.30,1879.02,0.00
2024-12-08 16:52:16,50,1853,13,37,1171.65,1879.04,0.00
2024-12-08 16:52:16,49,1853,12,37,1195.18,1879.06,0.00
2024-12-08 16:52:16,49,1854,12,37,1201.17,1880.00,0.00
2024-12-08 16:52:16,50,1854,13,37,1177.15,1880.02,0.00
2024-12-08 16:52:16,50,1855,13,37,1174.39,1881.00,0.00
2024-12-08 16:52:16,51,1855,14,37,1151.36,1881.02,0.00
2024-12-08 16:52:16,50,1855,14,36,1168.00,1881.04,0.00
2024-12-08 16:52:16,49,1855,13,36,1191.46,1881.06,0.00
2024-12-08 16:52:17,49,1856,13,36,1197.46,1882.00,0.00
2024-12-08 16:52:17,50,1856,13,37,1173.51,1882.02,0.00
2024-12-08 16:52:17,49,1856,12,37,1185.17,1882.02,0.00
2024-12-08 16:52:17,49,1857,12,37,1198.09,1883.00,0.00
2024-12-08 16:52:17,50,1857,13,37,1174.13,1883.02,0.00
2024-12-08 16:52:17,49,1857,13,36,1190.42,1883.04,0.00
2024-12-08 16:52:17,49,1858,13,36,1196.04,1884.00,0.00
2024-12-08 16:52:17,50,1858,14,36,1172.12,1884.02,0.00
2024-12-08 16:52:17,50,1859,14,36,1169.81,1885.00,0.00
2024-12-08 16:52:17,51,1859,15,36,1146.87,1885.02,0.00
2024-12-08 16:52:17,50,1859,15,35,1162.65,1885.04,0.00
2024-12-08 16:52:17,50,1860,15,35,1167.79,1886.00,0.00
2024-12-08 16:52:17,51,1860,16,35,1144.89,1886.02,0.00
2024-12-08 16:52:17,51,1861,16,35,1142.94,1887.00,0.00
2024-12-08 16:52:17,52,1861,17,35,1120.96,1887.02,0.00
2024-12-08 16:52:17,51,1861,17,34,1135.55,1887.04,0.00
2024-12-08 16:52:17,52,1860,18,34,1103.86,1887.62,0.00
2024-12-08 16:52:17,52,1861,18,34,1126.28,1888.00,0.00
2024-12-08 16:52:17,53,1861,18,35,1105.03,1888.02,0.00
2024-12-08 16:52:17,52,1861,17,35,1100.36,1888.46,0.00
2024-12-08 16:52:17,52,1862,17,35,1163.20,1889.00,0.00
2024-12-08 16:52:17,53,1862,17,36,1141.26,1889.02,0.00
2024-12-08 16:52:17,52,1862,17,35,1159.21,1889.02,0.00
2024-12-08 16:52:17,51,1862,16,35,1167.87,1889.69,0.00
2024-12-08 16:52:17,51,1863,16,35,1199.24,1890.00,0.00
2024-12-08 16:52:17,52,1863,17,35,1176.18,1890.02,0.00
2024-12-08 16:52:17,52,1864,17,35,1173.19,1891.00,0.00
2024-12-08 16:52:17,53,1864,17,36,1151.05,1891.02,0.00
2024-12-08 16:52:17,52,1864,17,35,1167.01,1891.02,0.00
2024-12-08 16:52:17,51,1864,16,35,1179.78,1891.57,0.00
2024-12-08 16:52:17,51,1865,16,35,1194.19,1892.00,0.00
2024-12-08 16:52:17,52,1865,16,36,1171.23,1892.02,0.00
2024-12-08 16:52:17,52,1866,16,36,1167.84,1893.00,0.00
2024-12-08 16:52:17,53,1866,16,37,1145.81,1893.02,0.00
2024-12-08 16:52:17,52,1866,16,36,1162.02,1893.02,0.00
2024-12-08 16:52:17,51,1866,15,36,1160.90,1893.96,0.00
2024-12-08 16:52:17,51,1867,15,36,1197.31,1894.00,0.00
2024-12-08 16:52:17,52,1867,15,37,1174.29,1894.02,0.00
2024-12-08 16:52:17,52,1868,15,37,1170.90,1895.00,0.00
2024-12-08 16:52:17,53,1868,15,38,1148.81,1895.02,0.00
2024-12-08 16:52:17,52,1868,15,37,1165.07,1895.02,0.00
2024-12-08 16:52:17,51,1868,14,37,1175.96,1895.63,0.00
2024-12-08 16:52:17,51,1869,14,37,1206.35,1896.00,0.00
2024-12-08 16:52:17,52,1869,15,37,1183.16,1896.02,0.00
2024-12-08 16:52:17,51,1869,14,37,1187.89,1896.29,0.00
2024-12-08 16:52:17,51,1870,14,37,1212.20,1897.00,0.00
2024-12-08 16:52:17,52,1870,14,38,1188.89,1897.02,0.00
2024-12-08 16:52:17,51,1870,14,37,1204.40,1897.06,0.00
2024-12-08 16:52:17,51,1871,14,37,1209.49,1898.00,0.00
2024-12-08 16:52:17,52,1871,14,38,1186.23,1898.02,0.00
2024-12-08 16:52:17,51,1871,13,38,1190.94,1898.61,0.00
2024-12-08 16:52:17,51,1872,13,38,1211.30,1899.00,0.00
2024-12-08 16:52:17,52,1872,13,39,1188.00,1899.02,0.00
2024-12-08 16:52:17,51,1872,12,39,1174.71,1899.96,0.00
2024-12-08 16:52:17,51,1873,12,39,1211.24,1900.00,0.00
2024-12-08 16:52:17,52,1873,12,40,1187.95,1900.02,0.00
2024-12-08 16:52:17,51,1873,12,39,1201.66,1900.28,0.00
2024-12-08 16:52:17,51,1874,12,39,1210.76,1901.00,0.00
2024-12-08 16:52:17,52,1874,12,40,1187.47,1901.02,0.00
2024-12-08 16:52:17,52,1875,12,40,1188.65,1902.00,0.00
2024-12-08 16:52:17,53,1875,12,41,1166.22,1902.02,0.00
2024-12-08 16:52:17,53,1876,12,41,1162.53,1903.00,0.00
2024-12-08 16:52:17,54,1876,13,41,1141.00,1903.02,0.00
2024-12-08 16:52:17,53,1876,13,40,1154.01,1903.26,0.00
2024-12-08 16:52:17,52,1876,12,40,1164.18,1903.65,0.00
2024-12-08 16:52:17,52,1877,12,40,1194.47,1904.00,0.00
2024-12-08 16:52:17,53,1877,12,41,1171.94,1904.02,0.00
2024-12-08 16:52:17,52,1877,11,41,1173.59,1904.69,0.00
2024-12-08 16:52:17,52,1878,11,41,1204.63,1905.00,0.00
2024-12-08 16:52:17,53,1878,12,41,1181.90,1905.02,0.00
2024-12-08 16:52:17,53,1879,12,41,1182.03,1906.00,0.00
2024-12-08 16:52:17,54,1879,13,41,1160.14,1906.02,0.00
2024-12-08 16:52:17,54,1880,13,41,1156.15,1907.00,0.00
2024-12-08 16:52:17,55,1880,13,42,1135.13,1907.02,0.00
2024-12-08 16:52:17,54,1880,13,41,1148.82,1907.26,0.00
2024-12-08 16:52:17,54,1881,13,41,1156.41,1908.00,0.00
2024-12-08 16:52:17,55,1881,14,41,1135.38,1908.02,0.00
2024-12-08 16:52:17,54,1881,13,41,1123.16,1908.93,0.00
2024-12-08 16:52:17,54,1882,13,41,1157.14,1909.00,0.00
2024-12-08 16:52:17,55,1882,13,42,1136.11,1909.02,0.00
2024-12-08 16:52:17,55,1883,13,42,1131.84,1910.00,0.00
2024-12-08 16:52:17,56,1883,13,43,1111.63,1910.02,0.00
2024-12-08 16:52:17,55,1883,13,42,1127.00,1910.09,0.00
2024-12-08 16:52:17,55,1884,13,42,1131.04,1911.00,0.00
2024-12-08 16:52:17,56,1884,13,43,1110.84,1911.02,0.00
2024-12-08 16:52:17,55,1884,12,43,1100.33,1911.96,0.00
2024-12-08 16:52:18,55,1885,12,43,1134.41,1912.00,0.00
2024-12-08 16:52:18,56,1885,12,44,1114.16,1912.02,0.00
2024-12-08 16:52:18,55,1885,12,43,1128.92,1912.24,0.00
2024-12-08 16:52:18,55,1886,12,43,1135.70,1913.00,0.00
2024-12-08 16:52:18,56,1886,13,43,1115.42,1913.02,0.00
2024-12-08 16:52:18,56,1887,13,43,1110.88,1914.00,0.00
2024-12-08 16:52:18,57,1887,14,43,1091.39,1914.02,0.00
2024-12-08 16:52:18,57,1888,14,43,1086.58,1915.00,0.00
2024-12-08 16:52:18,58,1888,14,44,1067.85,1915.02,0.00
2024-12-08 16:52:18,57,1888,14,43,1079.87,1915.04,0.00
2024-12-08 16:52:18,57,1889,14,43,1082.11,1916.00,0.00
2024-12-08 16:52:18,58,1889,14,44,1063.45,1916.02,0.00
2024-12-08 16:52:18,57,1889,14,43,1081.10,1916.04,0.00
2024-12-08 16:52:18,57,1890,14,43,1083.35,1917.00,0.00
2024-12-08 16:52:18,58,1890,15,43,1064.67,1917.02,0.00
2024-12-08 16:52:18,57,1890,15,42,1082.34,1917.04,0.00
2024-12-08 16:52:18,56,1890,14,42,1078.25,1917.96,0.00
2024-12-08 16:52:18,56,1891,14,42,1111.83,1918.00,0.00
2024-12-08 16:52:18,57,1891,15,42,1092.33,1918.02,0.00
2024-12-08 16:52:18,57,1892,15,42,1087.51,1919.00,0.00
2024-12-08 16:52:18,58,1892,16,42,1068.76,1919.02,0.00
2024-12-08 16:52:18,57,1892,16,41,1085.49,1919.04,0.00
2024-12-08 16:52:18,57,1893,16,41,1087.74,1920.00,0.00
2024-12-08 16:52:18,58,1893,16,42,1068.98,1920.02,0.00
2024-12-08 16:52:18,58,1894,16,42,1063.91,1921.00,0.00
2024-12-08 16:52:18,59,1894,16,43,1045.88,1921.02,0.00
2024-12-08 16:52:18,58,1894,16,42,1062.26,1921.03,0.00
2024-12-08 16:52:18,58,1895,16,42,1064.13,1922.00,0.00
2024-12-08 16:52:18,59,1895,16,43,1046.10,1922.02,0.00
2024-12-08 16:52:18,58,1895,16,42,1062.48,1922.03,0.00
2024-12-08 16:52:18,58,1896,16,42,1064.35,1923.00,0.00
2024-12-08 16:52:18,59,1896,17,42,1046.31,1923.02,0.00
2024-12-08 16:52:18,59,1897,17,42,1040.99,1924.00,0.00
2024-12-08 16:52:18,60,1897,18,42,1023.64,1924.02,0.00
2024-12-08 16:52:18,59,1897,18,41,1039.69,1924.03,0.00
2024-12-08 16:52:18,59,1898,18,41,1041.20,1925.00,0.00
2024-12-08 16:52:18,60,1898,19,41,1023.85,1925.02,0.00
2024-12-08 16:52:18,59,1898,18,41,1021.31,1925.71,0.00
2024-12-08 16:52:18,58,1898,17,41,1030.42,1925.91,0.00
2024-12-08 16:52:18,58,1899,17,41,1062.03,1926.00,0.00
2024-12-08 16:52:18,59,1899,17,42,1044.03,1926.02,0.00
2024-12-08 16:52:18,58,1899,17,41,1059.71,1926.02,0.00
2024-12-08 16:52:18,58,1900,17,41,1061.25,1927.00,0.00
2024-12-08 16:52:18,59,1900,17,42,1043.27,1927.02,0.00
2024-12-08 16:52:18,58,1900,17,41,1060.92,1927.02,0.00
2024-12-08 16:52:18,57,1900,16,41,1066.68,1927.70,0.00
2024-12-08 16:52:18,57,1901,16,41,1081.45,1928.00,0.00
2024-12-08 16:52:18,58,1901,16,42,1062.80,1928.02,0.00
2024-12-08 16:52:18,57,1901,16,41,1074.34,1928.02,0.00
2024-12-08 16:52:18,56,1901,15,41,1069.62,1928.96,0.00
2024-12-08 16:52:18,56,1902,15,41,1103.40,1929.00,0.00
2024-12-08 16:52:18,57,1902,16,41,1084.04,1929.02,0.00
2024-12-08 16:52:18,56,1902,16,40,1096.16,1929.02,0.00
2024-12-08 16:52:18,56,1903,16,40,1098.45,1930.00,0.00
2024-12-08 16:52:18,57,1903,17,40,1079.18,1930.02,0.00
2024-12-08 16:52:18,56,1903,17,39,1091.22,1930.02,0.00
2024-12-08 16:52:18,56,1904,17,39,1093.51,1931.00,0.00
2024-12-08 16:52:18,57,1904,17,40,1074.32,1931.02,0.00
2024-12-08 16:52:18,56,1904,16,40,1084.16,1931.14,0.00
2024-12-08 16:52:18,55,1904,15,40,1095.52,1931.33,0.00
2024-12-08 16:52:18,55,1905,15,40,1118.10,1932.00,0.00
2024-12-08 16:52:18,56,1905,15,41,1098.13,1932.02,0.00
2024-12-08 16:52:18,55,1905,15,40,1115.99,1932.02,0.00
2024-12-08 16:52:18,55,1906,15,40,1118.68,1933.00,0.00
2024-12-08 16:52:18,56,1906,16,40,1098.70,1933.02,0.00
2024-12-08 16:52:18,55,1906,15,40,1104.36,1933.26,0.00
2024-12-08 16:52:18,55,1907,15,40,1125.59,1934.00,0.00
2024-12-08 16:52:18,56,1907,16,40,1105.49,1934.02,0.00
2024-12-08 16:52:18,55,1907,16,39,1123.48,1934.02,0.00
2024-12-08 16:52:18,55,1908,16,39,1126.17,1935.00,0.00
2024-12-08 16:52:18,56,1908,16,40,1106.06,1935.02,0.00
2024-12-08 16:52:18,56,1909,16,40,1101.45,1936.00,0.00
2024-12-08 16:52:18,57,1909,16,41,1082.12,1936.02,0.00
2024-12-08 16:52:18,56,1909,16,40,1099.72,1936.02,0.00
2024-12-08 16:52:18,55,1909,15,40,1114.85,1936.20,0.00
2024-12-08 16:52:18,55,1910,15,40,1135.08,1937.00,0.00
2024-12-08 16:52:18,56,1910,15,41,1114.81,1937.02,0.00
2024-12-08 16:52:18,55,1910,14,41,1116.43,1937.07,0.00
2024-12-08 16:52:18,54,1910,13,41,1125.24,1937.69,0.00
2024-12-08 16:52:18,54,1911,13,41,1155.26,1938.00,0.00
2024-12-08 16:52:18,55,1911,13,42,1134.26,1938.02,0.00
2024-12-08 16:52:18,54,1911,13,41,1153.47,1938.02,0.00
2024-12-08 16:52:18,53,1911,12,41,1168.72,1938.21,0.00
2024-12-08 16:52:18,53,1912,12,41,1190.47,1939.00,0.00
2024-12-08 16:52:18,54,1912,13,41,1168.43,1939.02,0.00
2024-12-08 16:52:18,53,1912,12,41,1176.27,1939.21,0.00
2024-12-08 16:52:18,53,1913,12,41,1198.04,1940.00,0.00
2024-12-08 16:52:18,54,1913,13,41,1175.86,1940.02,0.00
2024-12-08 16:52:18,53,1913,13,40,1196.58,1940.02,0.00
2024-12-08 16:52:19,53,1914,13,40,1200.12,1941.00,0.00
2024-12-08 16:52:19,54,1914,14,40,1177.90,1941.02,0.00
2024-12-08 16:52:19,53,1914,13,40,1167.48,1941.62,0.00
2024-12-08 16:52:19,53,1915,13,40,1197.08,1942.00,0.00
2024-12-08 16:52:19,54,1915,14,40,1174.91,1942.02,0.00
2024-12-08 16:52:19,53,1915,14,39,1193.42,1942.04,0.00
2024-12-08 16:52:19,54,1914,15,39,1165.69,1942.37,0.00
2024-12-08 16:52:19,54,1915,15,39,1190.99,1943.00,0.00
2024-12-08 16:52:19,55,1915,15,40,1169.33,1943.02,0.00
2024-12-08 16:52:19,55,1916,15,40,1200.33,1944.00,0.00
2024-12-08 16:52:19,56,1916,16,40,1178.90,1944.02,0.00
2024-12-08 16:52:19,55,1916,16,39,1197.16,1944.04,0.00
2024-12-08 16:52:19,55,1917,16,39,1200.24,1945.00,0.00
2024-12-08 16:52:19,56,1917,17,39,1178.81,1945.02,0.00
2024-12-08 16:52:19,56,1918,17,39,1174.20,1946.00,0.00
2024-12-08 16:52:19,57,1918,17,40,1153.60,1946.02,0.00
2024-12-08 16:52:19,56,1918,17,39,1171.43,1946.04,0.00
2024-12-08 16:52:19,55,1918,16,39,1170.62,1946.91,0.00
2024-12-08 16:52:19,55,1919,16,39,1204.31,1947.00,0.00
2024-12-08 16:52:19,56,1919,17,39,1182.80,1947.02,0.00
2024-12-08 16:52:19,56,1920,17,39,1178.19,1948.00,0.00
2024-12-08 16:52:19,57,1920,18,39,1157.52,1948.02,0.00
2024-12-08 16:52:19,56,1920,18,38,1175.42,1948.04,0.00
2024-12-08 16:52:19,56,1921,18,38,1178.10,1949.00,0.00
2024-12-08 16:52:19,57,1921,18,39,1157.43,1949.02,0.00
2024-12-08 16:52:19,57,1922,18,39,1152.55,1950.00,0.00
2024-12-08 16:52:19,58,1922,18,40,1132.68,1950.02,0.00
2024-12-08 16:52:19,57,1922,18,39,1149.82,1950.04,0.00
2024-12-08 16:52:19,57,1923,18,39,1152.12,1951.00,0.00
2024-12-08 16:52:19,58,1923,18,40,1132.25,1951.02,0.00
2024-12-08 16:52:19,57,1923,17,40,1127.23,1951.81,0.00
2024-12-08 16:52:19,57,1924,17,40,1157.84,1952.00,0.00
2024-12-08 16:52:19,58,1924,18,40,1137.88,1952.02,0.00
2024-12-08 16:52:19,57,1924,18,39,1155.11,1952.04,0.00
2024-12-08 16:52:19,57,1925,18,39,1157.41,1953.00,0.00
2024-12-08 16:52:19,58,1925,18,40,1137.45,1953.02,0.00
2024-12-08 16:52:19,58,1926,18,40,1132.31,1954.00,0.00
2024-12-08 16:52:19,59,1926,18,41,1113.12,1954.02,0.00
2024-12-08 16:52:19,58,1926,18,40,1128.61,1954.05,0.00
2024-12-08 16:52:19,57,1926,17,40,1134.87,1954.40,0.00
2024-12-08 16:52:19,57,1927,17,40,1157.91,1955.00,0.00
2024-12-08 16:52:19,58,1927,18,40,1137.94,1955.02,0.00
2024-12-08 16:52:19,58,1928,18,40,1133.25,1956.00,0.00
2024-12-08 16:52:19,59,1928,18,41,1114.04,1956.02,0.00
2024-12-08 16:52:19,58,1928,18,40,1127.87,1956.07,0.00
2024-12-08 16:52:19,58,1929,18,40,1130.45,1957.00,0.00
2024-12-08 16:52:19,59,1929,18,41,1111.29,1957.02,0.00
2024-12-08 16:52:19,58,1929,17,41,1107.89,1957.74,0.00
2024-12-08 16:52:19,58,1930,17,41,1136.77,1958.00,0.00
2024-12-08 16:52:19,59,1930,18,41,1117.50,1958.02,0.00
2024-12-08 16:52:19,58,1930,18,40,1130.71,1958.09,0.00
2024-12-08 16:52:19,58,1931,18,40,1133.63,1959.00,0.00
2024-12-08 16:52:19,59,1931,18,41,1114.42,1959.02,0.00
2024-12-08 16:52:19,58,1931,17,41,1110.71,1959.76,0.00
2024-12-08 16:52:19,58,1932,17,41,1139.96,1960.00,0.00
2024-12-08 16:52:19,59,1932,17,42,1120.64,1960.02,0.00
2024-12-08 16:52:19,58,1932,17,41,1134.23,1960.09,0.00
2024-12-08 16:52:19,58,1933,17,41,1137.16,1961.00,0.00
2024-12-08 16:52:19,59,1933,18,41,1117.88,1961.02,0.00
2024-12-08 16:52:19,58,1933,17,41,1113.54,1961.78,0.00
2024-12-08 16:52:19,58,1934,17,41,1143.15,1962.00,0.00
2024-12-08 16:52:19,59,1934,18,41,1123.77,1962.02,0.00
2024-12-08 16:52:19,58,1934,18,40,1137.75,1962.09,0.00
2024-12-08 16:52:19,57,1934,17,40,1145.65,1962.70,0.00
2024-12-08 16:52:19,57,1935,17,40,1160.70,1963.00,0.00
2024-12-08 16:52:19,58,1935,17,41,1140.69,1963.02,0.00
2024-12-08 16:52:19,58,1936,17,41,1135.69,1964.00,0.00
2024-12-08 16:52:19,59,1936,17,42,1116.44,1964.02,0.00
2024-12-08 16:52:19,58,1936,17,41,1130.62,1964.09,0.00
2024-12-08 16:52:19,58,1937,17,41,1133.56,1965.00,0.00
2024-12-08 16:52:19,59,1937,17,42,1114.34,1965.02,0.00
2024-12-08 16:52:19,58,1937,16,42,1107.05,1965.85,0.00
2024-12-08 16:52:19,58,1938,16,42,1138.02,1966.00,0.00
2024-12-08 16:52:19,59,1938,16,43,1118.73,1966.02,0.00
2024-12-08 16:52:19,58,1938,16,42,1133.29,1966.09,0.00
2024-12-08 16:52:19,57,1938,15,42,1139.59,1966.72,0.00
2024-12-08 16:52:19,57,1939,15,42,1168.81,1967.00,0.00
2024-12-08 16:52:19,58,1939,15,43,1148.66,1967.02,0.00
2024-12-08 16:52:19,58,1940,15,43,1143.48,1968.00,0.00
2024-12-08 16:52:19,59,1940,15,44,1124.09,1968.02,0.00
2024-12-08 16:52:19,58,1940,15,43,1138.74,1968.09,0.00
2024-12-08 16:52:19,58,1941,15,43,1141.68,1969.00,0.00
2024-12-08 16:52:19,59,1941,16,43,1122.33,1969.02,0.00
2024-12-08 16:52:19,59,1942,16,43,1126.11,1970.00,0.00
2024-12-08 16:52:19,60,1942,17,43,1107.34,1970.02,0.00
2024-12-08 16:52:20,60,1943,17,43,1107.47,1971.00,0.00
2024-12-08 16:52:20,61,1943,18,43,1089.32,1971.02,0.00
2024-12-08 16:52:20,61,1944,18,43,1084.50,1972.00,0.00
2024-12-08 16:52:20,62,1944,18,44,1067.01,1972.02,0.00
2024-12-08 16:52:20,61,1944,18,43,1079.66,1972.08,0.00
2024-12-08 16:52:20,61,1945,18,43,1081.49,1973.00,0.00
2024-12-08 16:52:20,62,1945,19,43,1064.05,1973.02,0.00
2024-12-08 16:52:20,62,1946,19,43,1058.04,1974.00,0.00
2024-12-08 16:52:20,63,1946,20,43,1041.25,1974.02,0.00
2024-12-08 16:52:20,62,1946,20,42,1052.00,1974.07,0.00
2024-12-08 16:52:20,62,1947,20,42,1053.16,1975.00,0.00
2024-12-08 16:52:20,63,1947,20,43,1036.45,1975.02,0.00
2024-12-08 16:52:20,62,1947,20,42,1050.62,1975.07,0.00
2024-12-08 16:52:20,62,1948,20,42,1051.78,1976.00,0.00
2024-12-08 16:52:20,63,1948,20,43,1035.09,1976.02,0.00
2024-12-08 16:52:20,63,1949,20,43,1028.75,1977.00,0.00
2024-12-08 16:52:20,64,1949,21,43,1012.67,1977.02,0.00
2024-12-08 16:52:20,63,1949,21,42,1026.55,1977.06,0.00
2024-12-08 16:52:20,63,1950,21,42,1027.38,1978.00,0.00
2024-12-08 16:52:20,64,1950,21,43,1011.33,1978.02,0.00
2024-12-08 16:52:20,63,1950,20,43,1005.74,1978.75,0.00
2024-12-08 16:52:20,63,1951,20,43,1032.30,1979.00,0.00
2024-12-08 16:52:20,64,1951,21,43,1016.17,1979.02,0.00
2024-12-08 16:52:20,63,1951,21,42,1030.42,1979.06,0.00
2024-12-08 16:52:20,63,1952,21,42,1031.25,1980.00,0.00
2024-12-08 16:52:20,64,1952,21,43,1015.14,1980.02,0.00
2024-12-08 16:52:20,63,1952,20,43,1006.91,1980.52,0.00
2024-12-08 16:52:20,64,1951,21,43,984.31,1980.91,0.00
2024-12-08 16:52:20,64,1952,21,43,1027.72,1981.00,0.00
2024-12-08 16:52:20,65,1952,21,44,1011.91,1981.02,0.00
2024-12-08 16:52:20,64,1952,20,44,1027.10,1981.03,0.00
2024-12-08 16:52:20,63,1952,20,43,1042.46,1981.05,0.00
2024-12-08 16:52:20,63,1953,20,43,1074.45,1982.00,0.00
2024-12-08 16:52:20,64,1953,21,43,1057.66,1982.02,0.00
2024-12-08 16:52:20,64,1954,21,43,1051.07,1983.00,0.00
2024-12-08 16:52:20,65,1954,22,43,1034.90,1983.02,0.00
2024-12-08 16:52:20,64,1954,22,42,1049.83,1983.05,0.00
2024-12-08 16:52:20,64,1955,22,42,1050.05,1984.00,0.00
2024-12-08 16:52:20,65,1955,22,43,1033.89,1984.02,0.00
2024-12-08 16:52:20,64,1955,21,43,1040.17,1984.20,0.00
2024-12-08 16:52:20,63,1955,20,43,1037.98,1984.60,0.00
2024-12-08 16:52:20,63,1956,20,43,1061.90,1985.00,0.00
2024-12-08 16:52:20,64,1956,20,44,1045.30,1985.02,0.00
2024-12-08 16:52:20,63,1956,20,43,1059.38,1985.06,0.00
2024-12-08 16:52:20,62,1956,19,43,1073.94,1985.19,0.00
2024-12-08 16:52:20,62,1957,19,43,1077.65,1986.00,0.00
2024-12-08 16:52:20,63,1957,20,43,1060.54,1986.02,0.00
2024-12-08 16:52:20,63,1958,20,43,1054.72,1987.00,0.00
2024-12-08 16:52:20,64,1958,20,44,1038.24,1987.02,0.00
2024-12-08 16:52:20,63,1958,19,44,1054.40,1987.02,0.00
2024-12-08 16:52:20,62,1958,18,44,1071.09,1987.02,0.00
2024-12-08 16:52:20,61,1958,18,43,1081.81,1987.02,0.00
2024-12-08 16:52:20,61,1959,18,43,1082.35,1988.00,0.00
2024-12-08 16:52:20,62,1959,19,43,1064.90,1988.02,0.00
2024-12-08 16:52:20,62,1960,19,43,1058.69,1989.00,0.00
2024-12-08 16:52:20,63,1960,19,44,1041.89,1989.02,0.00
2024-12-08 16:52:20,62,1960,19,43,1058.05,1989.02,0.00
2024-12-08 16:52:20,62,1961,19,43,1058.26,1990.00,0.00
2024-12-08 16:52:20,63,1961,19,44,1041.47,1990.02,0.00
2024-12-08 16:52:20,62,1961,18,44,1048.68,1990.18,0.00
2024-12-08 16:52:20,61,1961,17,44,1065.54,1990.18,0.00
2024-12-08 16:52:20,61,1962,17,44,1069.30,1991.00,0.00
2024-12-08 16:52:20,62,1962,17,45,1052.05,1991.02,0.00
2024-12-08 16:52:20,61,1962,17,44,1068.97,1991.02,0.00
2024-12-08 16:52:20,60,1962,16,44,1062.42,1991.97,0.00
2024-12-08 16:52:20,60,1963,16,44,1094.97,1992.00,0.00
2024-12-08 16:52:20,61,1963,17,44,1077.02,1992.02,0.00
2024-12-08 16:52:20,60,1963,17,43,1094.64,1992.02,0.00
2024-12-08 16:52:20,59,1963,16,43,1090.39,1992.93,0.00
2024-12-08 16:52:20,59,1964,16,43,1122.87,1993.00,0.00
2024-12-08 16:52:20,60,1964,17,43,1104.16,1993.02,0.00
2024-12-08 16:52:20,59,1964,16,43,1097.97,1993.80,0.00
2024-12-08 16:52:20,59,1965,16,43,1127.88,1994.00,0.00
2024-12-08 16:52:20,60,1965,16,44,1109.08,1994.02,0.00
2024-12-08 16:52:20,59,1965,16,43,1127.20,1994.02,0.00
2024-12-08 16:52:20,58,1965,15,43,1143.59,1994.17,0.00
2024-12-08 16:52:20,57,1965,14,43,1154.67,1994.63,0.00
2024-12-08 16:52:20,57,1966,14,43,1168.60,1995.00,0.00
2024-12-08 16:52:20,58,1966,14,44,1148.45,1995.02,0.00
2024-12-08 16:52:20,57,1966,13,44,1148.58,1995.68,0.00
2024-12-08 16:52:20,57,1967,13,44,1163.54,1996.00,0.00
2024-12-08 16:52:20,58,1967,14,44,1143.48,1996.02,0.00
2024-12-08 16:52:20,57,1967,14,43,1163.19,1996.02,0.00
2024-12-08 16:52:20,56,1967,13,43,1159.22,1996.96,0.00
2024-12-08 16:52:20,56,1968,13,43,1194.18,1997.00,0.00
2024-12-08 16:52:20,57,1968,14,43,1173.23,1997.02,0.00
2024-12-08 16:52:20,57,1969,14,43,1168.21,1998.00,0.00
2024-12-08 16:52:20,58,1969,15,43,1148.07,1998.02,0.00
2024-12-08 16:52:20,57,1969,15,42,1167.16,1998.02,0.00
2024-12-08 16:52:20,57,1970,15,42,1169.15,1999.00,0.00
2024-12-08 16:52:20,58,1970,15,43,1148.99,1999.02,0.00
2024-12-08 16:52:20,57,1970,14,43,1145.13,1999.46,0.00
2024-12-08 16:52:21,57,1971,14,43,1169.73,2000.00,0.00
2024-12-08 16:52:21,58,1971,14,44,1149.56,2000.02,0.00
2024-12-08 16:52:21,57,1971,14,43,1169.03,2000.02,0.00
2024-12-08 16:52:21,56,1971,13,43,1165.81,2000.95,0.00
2024-12-08 16:52:21,56,1972,13,43,1200.51,2001.00,0.00
2024-12-08 16:52:21,57,1972,14,43,1179.44,2001.02,0.00
2024-12-08 16:52:21,57,1973,14,43,1174.41,2002.00,0.00
2024-12-08 16:52:21,58,1973,14,44,1154.17,2002.02,0.00
2024-12-08 16:52:21,57,1973,14,43,1174.06,2002.02,0.00
2024-12-08 16:52:21,57,1974,14,43,1176.05,2003.00,0.00
2024-12-08 16:52:21,58,1974,15,43,1155.78,2003.02,0.00
2024-12-08 16:52:21,58,1975,15,43,1150.48,2004.00,0.00
2024-12-08 16:52:21,59,1975,15,44,1130.98,2004.02,0.00
2024-12-08 16:52:21,58,1975,15,43,1148.76,2004.03,0.00
2024-12-08 16:52:21,58,1976,15,43,1150.71,2005.00,0.00
2024-12-08 16:52:21,59,1976,15,44,1131.21,2005.02,0.00
2024-12-08 16:52:21,58,1976,14,44,1119.78,2005.95,0.00
2024-12-08 16:52:21,58,1977,14,44,1153.36,2006.00,0.00
2024-12-08 16:52:21,59,1977,15,44,1133.81,2006.02,0.00
2024-12-08 16:52:21,58,1977,15,43,1151.98,2006.03,0.00
2024-12-08 16:52:21,58,1978,15,43,1153.93,2007.00,0.00
2024-12-08 16:52:21,59,1978,15,44,1134.38,2007.02,0.00
2024-12-08 16:52:21,58,1978,15,43,1147.01,2007.02,0.00
2024-12-08 16:52:21,59,1977,15,44,1126.23,2007.12,0.00
2024-12-08 16:52:21,59,1978,15,44,1153.32,2008.00,0.00
2024-12-08 16:52:21,60,1978,15,45,1134.10,2008.02,0.00
2024-12-08 16:52:21,59,1978,14,45,1136.65,2008.05,0.00
2024-12-08 16:52:21,59,1979,14,45,1186.24,2009.00,0.00
2024-12-08 16:52:21,60,1979,14,46,1166.47,2009.02,0.00
2024-12-08 16:52:21,59,1979,14,45,1185.22,2009.02,0.00
2024-12-08 16:52:21,58,1979,13,45,1192.87,2009.10,0.00
2024-12-08 16:52:21,58,1980,13,45,1210.07,2010.00,0.00
2024-12-08 16:52:21,59,1980,14,45,1189.56,2010.02,0.00
2024-12-08 16:52:21,59,1981,14,45,1184.01,2011.00,0.00
2024-12-08 16:52:21,60,1981,15,45,1164.28,2011.02,0.00
2024-12-08 16:52:21,59,1981,15,44,1183.33,2011.02,0.00
2024-12-08 16:52:21,59,1982,15,44,1184.60,2012.00,0.00
2024-12-08 16:52:21,60,1982,16,44,1164.86,2012.02,0.00
2024-12-08 16:52:21,61,1981,16,45,1138.84,2012.07,0.00
2024-12-08 16:52:21,61,1982,16,45,1141.71,2013.00,0.00
2024-12-08 16:52:21,62,1982,16,46,1123.30,2013.02,0.00
2024-12-08 16:52:21,61,1982,16,45,1140.72,2013.02,0.00
2024-12-08 16:52:21,61,1983,16,45,1174.31,2014.00,0.00
2024-12-08 16:52:21,62,1983,16,46,1155.37,2014.02,0.00
2024-12-08 16:52:21,62,1984,16,46,1159.57,2015.00,0.00
2024-12-08 16:52:21,63,1984,17,46,1141.17,2015.02,0.00
2024-12-08 16:52:21,63,1985,17,46,1143.94,2016.00,0.00
2024-12-08 16:52:21,64,1985,18,46,1126.07,2016.02,0.00
2024-12-08 16:52:21,64,1986,18,46,1125.94,2017.00,0.00
2024-12-08 16:52:21,65,1986,19,46,1108.62,2017.02,0.00
2024-12-08 16:52:21,66,1985,19,47,1072.28,2017.73,0.00
2024-12-08 16:52:21,66,1986,19,47,1092.32,2018.00,0.00
2024-12-08 16:52:21,67,1986,19,48,1076.02,2018.02,0.00
2024-12-08 16:52:21,66,1986,19,47,1087.74,2018.02,0.00
2024-12-08 16:52:21,65,1986,18,47,1102.23,2018.12,0.00
2024-12-08 16:52:21,65,1987,18,47,1134.74,2019.00,0.00
2024-12-08 16:52:21,66,1987,19,47,1117.55,2019.02,0.00
2024-12-08 16:52:21,65,1987,19,46,1128.84,2019.02,0.00
2024-12-08 16:52:21,64,1987,18,46,1133.03,2019.34,0.00
2024-12-08 16:52:21,64,1988,18,46,1151.78,2020.00,0.00
2024-12-08 16:52:21,65,1988,19,46,1134.06,2020.02,0.00
2024-12-08 16:52:21,64,1988,19,45,1145.79,2020.02,0.00
2024-12-08 16:52:21,64,1989,19,45,1145.41,2021.00,0.00
2024-12-08 16:52:21,65,1989,20,45,1127.78,2021.02,0.00
2024-12-08 16:52:21,65,1990,20,45,1120.88,2022.00,0.00
2024-12-08 16:52:21,66,1990,21,45,1103.89,2022.02,0.00
2024-12-08 16:52:21,65,1990,21,44,1120.25,2022.02,0.00
2024-12-08 16:52:21,64,1990,20,44,1114.96,2022.59,0.00
2024-12-08 16:52:21,64,1991,20,44,1138.64,2023.00,0.00
2024-12-08 16:52:21,65,1991,21,44,1121.12,2023.02,0.00
2024-12-08 16:52:21,64,1991,20,44,1119.34,2023.66,0.00
2024-12-08 16:52:21,64,1992,20,44,1131.61,2024.00,0.00
2024-12-08 16:52:21,65,1992,21,44,1114.20,2024.02,0.00
2024-12-08 16:52:21,64,1992,21,43,1130.66,2024.02,0.00
2024-12-08 16:52:21,64,1993,21,43,1130.27,2025.00,0.00
2024-12-08 16:52:21,65,1993,21,44,1112.88,2025.02,0.00
2024-12-08 16:52:21,65,1994,21,44,1105.95,2026.00,0.00
2024-12-08 16:52:21,66,1994,22,44,1089.19,2026.02,0.00
2024-12-08 16:52:21,65,1994,22,43,1104.70,2026.02,0.00
2024-12-08 16:52:21,65,1995,22,43,1104.00,2027.00,0.00
2024-12-08 16:52:21,66,1995,23,43,1087.28,2027.02,0.00
2024-12-08 16:52:21,66,1996,23,43,1080.13,2028.00,0.00
2024-12-08 16:52:21,67,1996,23,44,1064.01,2028.02,0.00
2024-12-08 16:52:21,66,1996,23,43,1079.21,2028.02,0.00
2024-12-08 16:52:21,65,1996,22,43,1075.03,2028.88,0.00
2024-12-08 16:52:22,65,1997,22,43,1103.84,2029.00,0.00
2024-12-08 16:52:22,66,1997,23,43,1087.12,2029.02,0.00
2024-12-08 16:52:22,66,1998,23,43,1079.96,2030.00,0.00
2024-12-08 16:52:22,67,1998,24,43,1063.85,2030.02,0.00
2024-12-08 16:52:22,66,1998,24,42,1079.35,2030.02,0.00
2024-12-08 16:52:22,65,1998,23,42,1092.13,2030.20,0.00
2024-12-08 16:52:22,65,1999,23,42,1095.11,2031.00,0.00
2024-12-08 16:52:22,66,1999,23,43,1078.51,2031.02,0.00
2024-12-08 16:52:22,65,1999,22,43,1062.61,2031.69,0.00
2024-12-08 16:52:22,65,2000,22,43,1087.83,2032.00,0.00
2024-12-08 16:52:22,66,2000,22,44,1071.35,2032.02,0.00
2024-12-08 16:52:22,65,2000,22,43,1087.21,2032.02,0.00
2024-12-08 16:52:22,64,2000,21,43,1100.75,2032.19,0.00
2024-12-08 16:52:22,63,2000,20,43,1106.40,2032.44,0.00
2024-12-08 16:52:22,63,2001,20,43,1127.76,2033.00,0.00
2024-12-08 16:52:22,64,2001,21,43,1110.14,2033.02,0.00
2024-12-08 16:52:22,64,2002,21,43,1103.37,2034.00,0.00
2024-12-08 16:52:22,65,2002,22,43,1086.40,2034.02,0.00
2024-12-08 16:52:22,64,2002,22,42,1103.06,2034.02,0.00
2024-12-08 16:52:22,64,2003,22,42,1102.64,2035.00,0.00
2024-12-08 16:52:22,65,2003,23,42,1085.68,2035.02,0.00
2024-12-08 16:52:22,64,2003,22,42,1077.77,2035.64,0.00
2024-12-08 16:52:22,64,2004,22,42,1102.52,2036.00,0.00
2024-12-08 16:52:22,65,2004,22,43,1085.56,2036.02,0.00
2024-12-08 16:52:22,64,2004,22,42,1102.20,2036.02,0.00
2024-12-08 16:52:22,64,2005,22,42,1101.79,2037.00,0.00
2024-12-08 16:52:22,65,2005,22,43,1084.84,2037.02,0.00
2024-12-08 16:52:22,64,2005,22,42,1095.11,2037.02,0.00
2024-12-08 16:52:22,63,2005,21,42,1092.65,2037.52,0.00
2024-12-08 16:52:22,63,2006,21,42,1115.62,2038.00,0.00
2024-12-08 16:52:22,64,2006,21,43,1098.19,2038.02,0.00
2024-12-08 16:52:22,63,2006,20,43,1087.08,2038.59,0.00
2024-12-08 16:52:22,63,2007,20,43,1111.31,2039.00,0.00
2024-12-08 16:52:22,64,2007,21,43,1093.95,2039.02,0.00
2024-12-08 16:52:22,63,2007,21,42,1110.99,2039.02,0.00
2024-12-08 16:52:22,62,2007,20,42,1114.26,2039.42,0.00
2024-12-08 16:52:22,62,2008,20,42,1135.72,2040.00,0.00
2024-12-08 16:52:22,63,2008,21,42,1117.69,2040.02,0.00
2024-12-08 16:52:22,62,2008,21,41,1128.81,2040.02,0.00
2024-12-08 16:52:22,61,2008,20,41,1143.02,2040.21,0.00
2024-12-08 16:52:22,61,2009,20,41,1147.54,2041.00,0.00
2024-12-08 16:52:22,62,2009,20,42,1129.03,2041.02,0.00
2024-12-08 16:52:22,62,2010,20,42,1122.67,2042.00,0.00
2024-12-08 16:52:22,63,2010,21,42,1104.85,2042.02,0.00
2024-12-08 16:52:22,62,2010,21,41,1122.01,2042.02,0.00
2024-12-08 16:52:22,61,2010,20,41,1127.33,2042.67,0.00
2024-12-08 16:52:22,61,2011,20,41,1140.96,2043.00,0.00
2024-12-08 16:52:22,62,2011,21,41,1122.56,2043.02,0.00
2024-12-08 16:52:22,61,2011,20,41,1130.30,2043.21,0.00
2024-12-08 16:52:22,61,2012,20,41,1134.82,2044.00,0.00
2024-12-08 16:52:22,62,2012,21,41,1116.51,2044.02,0.00
2024-12-08 16:52:22,61,2012,21,40,1134.48,2044.02,0.00
2024-12-08 16:52:22,60,2012,20,40,1140.42,2044.67,0.00
2024-12-08 16:52:22,60,2013,20,40,1154.29,2045.00,0.00
2024-12-08 16:52:22,61,2013,20,41,1135.37,2045.02,0.00
2024-12-08 16:52:22,60,2013,20,40,1147.14,2045.02,0.00
2024-12-08 16:52:22,60,2014,20,40,1148.04,2046.00,0.00
2024-12-08 16:52:22,61,2014,21,40,1129.22,2046.02,0.00
2024-12-08 16:52:22,60,2014,21,39,1140.88,2046.02,0.00
2024-12-08 16:52:22,59,2014,20,39,1135.09,2046.97,0.00
2024-12-08 16:52:22,59,2015,20,39,1169.11,2047.00,0.00
2024-12-08 16:52:22,60,2015,21,39,1149.62,2047.02,0.00
2024-12-08 16:52:22,59,2015,21,38,1161.82,2047.02,0.00
2024-12-08 16:52:22,59,2016,21,38,1163.08,2048.00,0.00
2024-12-08 16:52:22,60,2016,21,39,1143.70,2048.02,0.00
2024-12-08 16:52:22,59,2016,21,38,1155.80,2048.02,0.00
2024-12-08 16:52:22,59,2017,21,38,1157.05,2049.00,0.00
2024-12-08 16:52:22,60,2017,21,39,1137.77,2049.02,0.00
2024-12-08 16:52:22,59,2017,20,39,1139.00,2049.07,0.00
2024-12-08 16:52:22,59,2018,20,39,1155.19,2050.00,0.00
2024-12-08 16:52:22,60,2018,21,39,1135.93,2050.02,0.00
2024-12-08 16:52:22,59,2018,21,38,1154.14,2050.02,0.00
2024-12-08 16:52:22,59,2019,21,38,1155.40,2051.00,0.00
2024-12-08 16:52:22,60,2019,21,39,1136.15,2051.02,0.00
2024-12-08 16:52:22,60,2020,21,39,1130.20,2052.00,0.00
2024-12-08 16:52:22,61,2020,22,39,1111.67,2052.02,0.00
2024-12-08 16:52:22,60,2020,22,38,1128.83,2052.02,0.00
2024-12-08 16:52:22,60,2021,22,38,1129.73,2053.00,0.00
2024-12-08 16:52:22,61,2021,22,39,1111.21,2053.02,0.00
2024-12-08 16:52:22,61,2022,22,39,1105.01,2054.00,0.00
2024-12-08 16:52:22,62,2022,22,40,1087.19,2054.02,0.00
2024-12-08 16:52:22,61,2022,22,39,1104.00,2054.02,0.00
2024-12-08 16:52:22,60,2022,21,39,1108.35,2054.70,0.00
2024-12-08 16:52:22,60,2023,21,39,1122.95,2055.00,0.00
2024-12-08 16:52:22,61,2023,22,39,1104.54,2055.02,0.00
2024-12-08 16:52:22,60,2023,21,39,1089.35,2055.68,0.00
2024-12-08 16:52:22,60,2024,21,39,1117.33,2056.00,0.00
2024-12-08 16:52:22,61,2024,21,40,1099.01,2056.02,0.00
2024-12-08 16:52:22,60,2024,21,39,1116.30,2056.02,0.00
2024-12-08 16:52:22,60,2025,21,39,1117.19,2057.00,0.00
2024-12-08 16:52:22,61,2025,22,39,1098.87,2057.02,0.00
2024-12-08 16:52:23,61,2026,22,39,1092.66,2058.00,0.00
2024-12-08 16:52:23,62,2026,23,39,1075.03,2058.02,0.00
2024-12-08 16:52:23,61,2026,23,38,1091.65,2058.02,0.00
2024-12-08 16:52:23,60,2026,22,38,1093.05,2058.77,0.00
2024-12-08 16:52:23,60,2027,22,38,1122.73,2059.00,0.00
2024-12-08 16:52:23,61,2027,22,39,1104.33,2059.02,0.00
2024-12-08 16:52:23,61,2028,22,39,1098.11,2060.00,0.00
2024-12-08 16:52:23,62,2028,23,39,1080.40,2060.02,0.00
2024-12-08 16:52:23,61,2028,23,38,1097.43,2060.02,0.00
2024-12-08 16:52:23,60,2028,22,38,1091.83,2060.93,0.00
2024-12-08 16:52:23,60,2029,22,38,1124.85,2061.00,0.00
2024-12-08 16:52:23,61,2029,22,39,1106.41,2061.02,0.00
2024-12-08 16:52:23,61,2030,22,39,1100.19,2062.00,0.00
2024-12-08 16:52:23,62,2030,22,40,1082.44,2062.02,0.00
2024-12-08 16:52:23,61,2030,22,39,1098.84,2062.03,0.00
2024-12-08 16:52:23,60,2030,21,39,1100.48,2062.47,0.00
2024-12-08 16:52:23,60,2031,21,39,1124.23,2063.00,0.00
2024-12-08 16:52:23,61,2031,22,39,1105.80,2063.02,0.00
2024-12-08 16:52:23,61,2032,22,39,1099.57,2064.00,0.00
2024-12-08 16:52:23,62,2032,22,40,1081.83,2064.02,0.00
2024-12-08 16:52:23,61,2032,22,39,1098.55,2064.03,0.00
2024-12-08 16:52:23,60,2032,21,39,1091.33,2064.67,0.00
2024-12-08 16:52:23,59,2032,20,39,1109.14,2064.70,0.00
2024-12-08 16:52:23,59,2033,20,39,1138.09,2065.00,0.00
2024-12-08 16:52:23,60,2033,21,39,1119.12,2065.02,0.00
2024-12-08 16:52:23,60,2034,21,39,1113.12,2066.00,0.00
2024-12-08 16:52:23,61,2034,22,39,1094.87,2066.02,0.00
2024-12-08 16:52:23,60,2034,22,38,1112.09,2066.03,0.00
2024-12-08 16:52:23,60,2035,22,38,1113.31,2067.00,0.00
2024-12-08 16:52:23,61,2035,22,39,1095.06,2067.02,0.00
2024-12-08 16:52:23,60,2035,21,39,1107.46,2067.02,0.00
2024-12-08 16:52:23,60,2036,21,39,1115.23,2068.00,0.00
2024-12-08 16:52:23,61,2036,21,40,1096.95,2068.02,0.00
2024-12-08 16:52:23,60,2036,21,39,1114.54,2068.02,0.00
2024-12-08 16:52:23,59,2036,20,39,1120.60,2068.39,0.00
2024-12-08 16:52:23,59,2037,20,39,1143.45,2069.00,0.00
2024-12-08 16:52:23,60,2037,21,39,1124.39,2069.02,0.00
2024-12-08 16:52:23,60,2038,21,39,1118.38,2070.00,0.00
2024-12-08 16:52:23,61,2038,21,40,1100.05,2070.02,0.00
2024-12-08 16:52:23,60,2038,21,39,1118.04,2070.02,0.00
2024-12-08 16:52:23,59,2038,20,39,1122.90,2070.70,0.00
2024-12-08 16:52:23,59,2039,20,39,1137.89,2071.00,0.00
2024-12-08 16:52:23,60,2039,21,39,1118.92,2071.02,0.00
2024-12-08 16:52:23,59,2039,21,38,1130.51,2071.02,0.00
2024-12-08 16:52:23,59,2040,21,38,1131.76,2072.00,0.00
2024-12-08 16:52:23,60,2040,21,39,1112.90,2072.02,0.00
2024-12-08 16:52:23,60,2041,21,39,1106.87,2073.00,0.00
2024-12-08 16:52:23,61,2041,22,39,1088.73,2073.02,0.00
2024-12-08 16:52:23,60,2041,22,38,1106.18,2073.02,0.00
2024-12-08 16:52:23,59,2041,21,38,1100.57,2073.61,0.00
2024-12-08 16:52:23,59,2042,21,38,1127.93,2074.00,0.00
2024-12-08 16:52:23,60,2042,22,38,1109.14,2074.02,0.00
2024-12-08 16:52:23,60,2043,22,38,1103.10,2075.00,0.00
2024-12-08 16:52:23,61,2043,22,39,1085.02,2075.02,0.00
2024-12-08 16:52:23,60,2043,22,38,1102.75,2075.02,0.00
2024-12-08 16:52:23,60,2044,22,38,1103.63,2076.00,0.00
2024-12-08 16:52:23,61,2044,23,38,1085.54,2076.02,0.00
2024-12-08 16:52:23,61,2045,23,38,1083.65,2077.00,0.00
2024-12-08 16:52:23,62,2045,23,39,1066.17,2077.02,0.00
2024-12-08 16:52:23,61,2045,23,38,1076.50,2077.02,0.00
2024-12-08 16:52:23,61,2046,23,38,1077.02,2078.00,0.00
2024-12-08 16:52:23,62,2046,23,39,1059.65,2078.02,0.00
2024-12-08 16:52:23,61,2046,22,39,1065.83,2078.23,0.00
2024-12-08 16:52:23,61,2047,22,39,1070.96,2079.00,0.00
2024-12-08 16:52:23,62,2047,23,39,1053.68,2079.02,0.00
2024-12-08 16:52:23,61,2047,23,38,1070.28,2079.02,0.00
2024-12-08 16:52:23,60,2047,22,38,1062.38,2079.97,0.00
2024-12-08 16:52:23,60,2048,22,38,1096.37,2080.00,0.00
2024-12-08 16:52:23,61,2048,22,39,1078.40,2080.02,0.00
2024-12-08 16:52:23,61,2049,22,39,1072.22,2081.00,0.00
2024-12-08 16:52:23,62,2049,22,40,1054.93,2081.02,0.00
2024-12-08 16:52:23,61,2049,22,39,1071.54,2081.02,0.00
2024-12-08 16:52:23,61,2050,22,39,1072.05,2082.00,0.00
2024-12-08 16:52:23,62,2050,23,39,1054.76,2082.02,0.00
2024-12-08 16:52:23,61,2050,22,39,1061.56,2082.18,0.00
2024-12-08 16:52:23,61,2051,22,39,1065.97,2083.00,0.00
2024-12-08 16:52:23,62,2051,23,39,1048.78,2083.02,0.00
2024-12-08 16:52:23,61,2051,23,38,1065.29,2083.02,0.00
2024-12-08 16:52:23,61,2052,23,38,1065.80,2084.00,0.00
2024-12-08 16:52:23,62,2052,23,39,1048.61,2084.02,0.00
2024-12-08 16:52:23,62,2053,23,39,1042.23,2085.00,0.00
2024-12-08 16:52:23,63,2053,23,40,1025.68,2085.02,0.00
2024-12-08 16:52:23,62,2053,23,39,1041.89,2085.02,0.00
2024-12-08 16:52:23,61,2053,22,39,1034.77,2085.92,0.00
2024-12-08 16:52:23,61,2054,22,39,1067.32,2086.00,0.00
2024-12-08 16:52:23,62,2054,23,39,1050.10,2086.02,0.00
2024-12-08 16:52:23,61,2054,22,39,1056.08,2086.21,0.00
2024-12-08 16:52:24,60,2054,21,39,1063.85,2086.70,0.00
2024-12-08 16:52:24,60,2055,21,39,1079.06,2087.00,0.00
2024-12-08 16:52:24,61,2055,22,39,1061.37,2087.02,0.00
2024-12-08 16:52:24,60,2055,22,38,1078.71,2087.02,0.00
2024-12-08 16:52:24,60,2056,22,38,1079.58,2088.00,0.00
2024-12-08 16:52:24,61,2056,22,39,1061.88,2088.02,0.00
2024-12-08 16:52:24,60,2056,22,38,1072.62,2088.02,0.00
2024-12-08 16:52:24,59,2056,21,38,1085.93,2088.10,0.00
2024-12-08 16:52:24,58,2056,20,38,1103.23,2088.17,0.00
2024-12-08 16:52:24,58,2057,20,38,1122.45,2089.00,0.00
2024-12-08 16:52:24,59,2057,21,38,1103.42,2089.02,0.00
2024-12-08 16:52:24,58,2057,21,37,1115.24,2089.02,0.00
2024-12-08 16:52:24,57,2057,20,37,1120.91,2089.12,0.00
2024-12-08 16:52:24,56,2057,19,37,1128.91,2089.70,0.00
2024-12-08 16:52:24,56,2058,19,37,1160.11,2090.00,0.00
2024-12-08 16:52:24,57,2058,20,37,1139.75,2090.02,0.00
2024-12-08 16:52:24,56,2058,20,36,1152.64,2090.02,0.00
2024-12-08 16:52:24,55,2058,19,36,1170.97,2090.15,0.00
2024-12-08 16:52:24,55,2059,19,36,1176.44,2091.00,0.00
2024-12-08 16:52:24,56,2059,20,36,1155.43,2091.02,0.00
2024-12-08 16:52:24,55,2059,19,36,1151.00,2091.15,0.00
2024-12-08 16:52:24,55,2060,19,36,1171.68,2092.00,0.00
2024-12-08 16:52:24,56,2060,19,37,1150.76,2092.02,0.00
2024-12-08 16:52:24,55,2060,19,36,1171.30,2092.02,0.00
2024-12-08 16:52:24,55,2061,19,36,1174.14,2093.00,0.00
2024-12-08 16:52:24,56,2061,19,37,1153.18,2093.02,0.00
2024-12-08 16:52:24,55,2061,19,36,1166.15,2093.02,0.00
2024-12-08 16:52:24,55,2062,19,36,1168.99,2094.00,0.00
2024-12-08 16:52:24,56,2062,19,37,1148.12,2094.02,0.00
2024-12-08 16:52:24,55,2062,18,37,1147.85,2094.67,0.00
2024-12-08 16:52:24,55,2062,18,37,1164.07,2095.00,0.00
2024-12-08 16:52:24,56,2062,19,37,1143.29,2095.02,0.00
2024-12-08 16:52:24,55,2062,19,36,1162.55,2095.04,0.00
2024-12-08 16:52:24,55,2063,19,36,1165.77,2096.00,0.00
2024-12-08 16:52:24,56,2063,19,37,1144.96,2096.02,0.00
2024-12-08 16:52:24,55,2063,18,37,1155.89,2096.13,0.00
2024-12-08 16:52:24,54,2063,17,37,1174.60,2096.19,0.00
2024-12-08 16:52:24,54,2064,17,37,1196.86,2097.00,0.00
2024-12-08 16:52:24,55,2064,18,37,1175.10,2097.02,0.00
2024-12-08 16:52:24,54,2064,18,36,1195.70,2097.04,0.00
2024-12-08 16:52:24,54,2065,18,36,1199.37,2098.00,0.00
2024-12-08 16:52:24,55,2065,19,36,1177.57,2098.02,0.00
2024-12-08 16:52:24,55,2066,19,36,1172.79,2099.00,0.00
2024-12-08 16:52:24,56,2066,20,36,1151.84,2099.02,0.00
2024-12-08 16:52:24,55,2066,20,35,1169.73,2099.04,0.00
2024-12-08 16:52:24,55,2067,20,35,1172.96,2100.00,0.00
2024-12-08 16:52:24,56,2067,20,36,1152.02,2100.02,0.00
2024-12-08 16:52:24,56,2068,20,36,1147.37,2101.00,0.00
2024-12-08 16:52:24,57,2068,21,36,1127.24,2101.02,0.00
2024-12-08 16:52:24,56,2068,21,35,1143.99,2101.04,0.00
2024-12-08 16:52:24,55,2068,20,35,1145.72,2101.80,0.00
2024-12-08 16:52:24,55,2069,20,35,1179.87,2102.00,0.00
2024-12-08 16:52:24,56,2069,21,35,1158.80,2102.02,0.00
2024-12-08 16:52:24,56,2070,21,35,1154.26,2103.00,0.00
2024-12-08 16:52:24,57,2070,21,36,1134.01,2103.02,0.00
2024-12-08 16:52:24,56,2070,21,35,1150.50,2103.04,0.00
2024-12-08 16:52:24,56,2071,21,35,1153.30,2104.00,0.00
2024-12-08 16:52:24,57,2071,22,35,1133.07,2104.02,0.00
2024-12-08 16:52:24,57,2072,22,35,1128.38,2105.00,0.00
2024-12-08 16:52:24,58,2072,23,35,1108.93,2105.02,0.00
2024-12-08 16:52:24,57,2072,23,34,1125.06,2105.04,0.00
2024-12-08 16:52:24,57,2073,23,34,1127.44,2106.00,0.00
2024-12-08 16:52:24,58,2073,24,34,1108.00,2106.02,0.00
2024-12-08 16:52:24,58,2074,24,34,1103.97,2107.00,0.00
2024-12-08 16:52:24,59,2074,24,35,1085.26,2107.02,0.00
2024-12-08 16:52:24,58,2074,24,34,1099.98,2107.03,0.00
2024-12-08 16:52:24,57,2074,23,34,1105.54,2107.68,0.00
2024-12-08 16:52:24,57,2075,23,34,1121.29,2108.00,0.00
2024-12-08 16:52:24,58,2075,24,34,1101.95,2108.02,0.00
2024-12-08 16:52:24,57,2075,23,34,1088.99,2108.60,0.00
2024-12-08 16:52:24,57,2076,23,34,1117.75,2109.00,0.00
2024-12-08 16:52:24,58,2076,24,34,1098.48,2109.02,0.00
2024-12-08 16:52:24,57,2076,24,33,1114.05,2109.04,0.00
2024-12-08 16:52:24,57,2077,24,33,1116.43,2110.00,0.00
2024-12-08 16:52:24,58,2077,24,34,1097.18,2110.02,0.00
2024-12-08 16:52:24,57,2077,23,34,1093.86,2110.09,0.00
2024-12-08 16:52:24,56,2077,22,34,1101.23,2110.66,0.00
2024-12-08 16:52:24,56,2078,22,34,1132.00,2111.00,0.00
2024-12-08 16:52:24,57,2078,23,34,1112.14,2111.02,0.00
2024-12-08 16:52:24,56,2078,23,33,1128.61,2111.04,0.00
2024-12-08 16:52:24,55,2078,22,33,1146.47,2111.13,0.00
2024-12-08 16:52:24,54,2078,21,33,1156.63,2111.65,0.00
2024-12-08 16:52:24,54,2079,21,33,1188.56,2112.00,0.00
2024-12-08 16:52:24,55,2079,22,33,1166.95,2112.02,0.00
2024-12-08 16:52:24,55,2080,22,33,1162.65,2113.00,0.00
2024-12-08 16:52:24,56,2080,23,33,1141.89,2113.02,0.00
2024-12-08 16:52:24,55,2080,23,32,1158.81,2113.04,0.00
2024-12-08 16:52:24,55,2081,23,32,1162.05,2114.00,0.00
2024-12-08 16:52:24,56,2081,24,32,1141.30,2114.02,0.00
2024-12-08 16:52:24,55,2081,24,31,1161.67,2114.02,0.00
2024-12-08 16:52:25,55,2082,24,31,1158.44,2115.00,0.00
2024-12-08 16:52:25,56,2082,24,32,1137.76,2115.02,0.00
2024-12-08 16:52:25,55,2082,24,31,1154.21,2115.02,0.00
2024-12-08 16:52:25,55,2083,24,31,1157.07,2116.00,0.00
2024-12-08 16:52:25,56,2083,24,32,1136.41,2116.02,0.00
2024-12-08 16:52:25,55,2083,23,32,1126.50,2116.55,0.00
2024-12-08 16:52:25,55,2084,23,32,1155.69,2117.00,0.00
2024-12-08 16:52:25,56,2084,24,32,1135.05,2117.02,0.00
2024-12-08 16:52:25,55,2084,24,31,1151.07,2117.02,0.00
2024-12-08 16:52:25,54,2084,23,31,1151.74,2117.48,0.00
2024-12-08 16:52:25,54,2085,23,31,1180.34,2118.00,0.00
2024-12-08 16:52:25,55,2085,24,31,1158.88,2118.02,0.00
2024-12-08 16:52:25,55,2086,24,31,1155.61,2119.00,0.00
2024-12-08 16:52:25,56,2086,25,31,1134.97,2119.02,0.00
2024-12-08 16:52:25,55,2086,25,30,1151.37,2119.02,0.00
2024-12-08 16:52:25,54,2086,24,30,1170.76,2119.11,0.00
2024-12-08 16:52:25,54,2087,24,30,1175.99,2120.00,0.00
2024-12-08 16:52:25,55,2087,24,31,1154.61,2120.02,0.00
2024-12-08 16:52:25,54,2087,23,31,1144.55,2120.85,0.00
2024-12-08 16:52:25,54,2088,23,31,1180.79,2121.00,0.00
2024-12-08 16:52:25,55,2088,24,31,1159.32,2121.02,0.00
2024-12-08 16:52:25,54,2088,24,30,1176.47,2121.02,0.00
2024-12-08 16:52:25,54,2089,24,30,1179.78,2122.00,0.00
2024-12-08 16:52:25,55,2089,24,31,1158.33,2122.02,0.00
2024-12-08 16:52:25,54,2089,23,31,1170.57,2122.07,0.00
2024-12-08 16:52:25,53,2089,22,31,1192.12,2122.09,0.00
2024-12-08 16:52:25,53,2090,22,31,1198.93,2123.00,0.00
2024-12-08 16:52:25,54,2090,23,31,1176.72,2123.02,0.00
2024-12-08 16:52:25,53,2090,23,30,1194.52,2123.02,0.00
2024-12-08 16:52:25,53,2091,23,30,1198.29,2124.00,0.00
2024-12-08 16:52:25,54,2091,23,31,1176.10,2124.02,0.00
2024-12-08 16:52:25,53,2091,22,31,1177.33,2124.62,0.00
2024-12-08 16:52:25,53,2092,22,31,1194.30,2125.00,0.00
2024-12-08 16:52:25,54,2092,23,31,1172.18,2125.02,0.00
2024-12-08 16:52:25,53,2092,23,30,1190.29,2125.02,0.00
2024-12-08 16:52:25,53,2093,23,30,1193.61,2126.00,0.00
2024-12-08 16:52:25,54,2093,24,30,1171.51,2126.02,0.00
2024-12-08 16:52:25,54,2094,24,30,1166.81,2127.00,0.00
2024-12-08 16:52:25,55,2094,24,31,1145.60,2127.02,0.00
2024-12-08 16:52:25,54,2094,24,30,1162.88,2127.02,0.00
2024-12-08 16:52:25,54,2095,24,30,1165.24,2128.00,0.00
2024-12-08 16:52:25,55,2095,24,31,1144.06,2128.02,0.00
2024-12-08 16:52:25,54,2095,23,31,1155.24,2128.11,0.00
2024-12-08 16:52:25,54,2096,23,31,1160.85,2129.00,0.00
2024-12-08 16:52:25,55,2096,24,31,1139.74,2129.02,0.00
2024-12-08 16:52:25,54,2096,24,30,1156.51,2129.02,0.00
2024-12-08 16:52:25,53,2096,23,30,1148.68,2129.96,0.00
2024-12-08 16:52:25,53,2097,23,30,1188.09,2130.00,0.00
2024-12-08 16:52:25,54,2097,24,30,1166.08,2130.02,0.00
2024-12-08 16:52:25,54,2098,24,30,1161.40,2131.00,0.00
2024-12-08 16:52:25,55,2098,24,31,1140.28,2131.02,0.00
2024-12-08 16:52:25,54,2098,24,30,1157.06,2131.02,0.00
2024-12-08 16:52:25,54,2099,24,30,1158.91,2132.00,0.00
2024-12-08 16:52:25,55,2099,24,31,1137.84,2132.02,0.00
2024-12-08 16:52:25,55,2100,24,31,1132.79,2133.00,0.00
2024-12-08 16:52:25,56,2100,25,31,1112.56,2133.02,0.00
2024-12-08 16:52:25,55,2100,25,30,1128.91,2133.02,0.00
2024-12-08 16:52:25,55,2101,25,30,1130.24,2134.00,0.00
2024-12-08 16:52:25,56,2101,25,31,1110.06,2134.02,0.00
2024-12-08 16:52:25,55,2101,24,31,1129.11,2134.02,0.00
2024-12-08 16:52:25,54,2101,23,31,1127.50,2134.63,0.00
2024-12-08 16:52:25,54,2102,23,31,1159.38,2135.00,0.00
2024-12-08 16:52:25,55,2102,23,32,1138.30,2135.02,0.00
2024-12-08 16:52:25,54,2102,23,31,1155.43,2135.02,0.00
2024-12-08 16:52:25,53,2102,22,31,1175.25,2135.11,0.00
2024-12-08 16:52:25,52,2102,21,31,1172.87,2135.92,0.00
2024-12-08 16:52:25,52,2103,21,31,1212.36,2136.00,0.00
2024-12-08 16:52:25,53,2103,21,32,1189.48,2136.02,0.00
2024-12-08 16:52:25,52,2103,20,32,1190.42,2136.58,0.00
2024-12-08 16:52:25,52,2104,20,32,1207.63,2137.00,0.00
2024-12-08 16:52:25,53,2104,20,33,1184.84,2137.02,0.00
2024-12-08 16:52:25,52,2104,20,32,1203.11,2137.02,0.00
2024-12-08 16:52:25,52,2105,20,32,1205.75,2138.00,0.00
2024-12-08 16:52:25,53,2105,20,33,1183.00,2138.02,0.00
2024-12-08 16:52:25,53,2106,20,33,1178.30,2139.00,0.00
2024-12-08 16:52:25,54,2106,20,34,1156.48,2139.02,0.00
2024-12-08 16:52:25,53,2106,20,33,1174.26,2139.02,0.00
2024-12-08 16:52:25,53,2107,20,33,1176.42,2140.00,0.00
2024-12-08 16:52:25,54,2107,21,33,1154.64,2140.02,0.00
2024-12-08 16:52:25,53,2107,20,33,1155.02,2140.04,0.00
2024-12-08 16:52:25,52,2107,20,32,1172.05,2140.23,0.00
2024-12-08 16:52:25,52,2108,20,32,1197.22,2141.00,0.00
2024-12-08 16:52:25,53,2108,20,33,1174.63,2141.02,0.00
2024-12-08 16:52:25,52,2108,20,32,1193.10,2141.02,0.00
2024-12-08 16:52:25,51,2108,19,32,1204.54,2141.59,0.00
2024-12-08 16:52:25,51,2109,19,32,1221.22,2142.00,0.00
2024-12-08 16:52:25,52,2109,19,33,1197.73,2142.02,0.00
2024-12-08 16:52:25,51,2109,18,33,1188.26,2142.53,0.00
2024-12-08 16:52:25,51,2110,18,33,1220.53,2143.00,0.00
2024-12-08 16:52:25,52,2110,18,34,1197.06,2143.02,0.00
2024-12-08 16:52:25,51,2110,18,33,1216.33,2143.02,0.00
2024-12-08 16:52:25,50,2110,17,33,1220.27,2143.46,0.00
2024-12-08 16:52:25,49,2110,16,33,1242.76,2143.57,0.00
2024-12-08 16:52:26,49,2111,16,33,1277.65,2144.00,0.00
2024-12-08 16:52:26,50,2111,16,34,1252.10,2144.02,0.00
2024-12-08 16:52:26,50,2112,16,34,1249.36,2145.00,0.00
2024-12-08 16:52:26,51,2112,16,35,1224.86,2145.02,0.00
2024-12-08 16:52:26,50,2112,16,34,1244.64,2145.02,0.00
2024-12-08 16:52:26,49,2112,15,34,1257.34,2145.61,0.00
2024-12-08 16:52:26,49,2113,15,34,1275.59,2146.00,0.00
2024-12-08 16:52:26,50,2113,15,35,1250.08,2146.02,0.00
2024-12-08 16:52:26,49,2113,14,35,1246.57,2146.76,0.00
2024-12-08 16:52:26,49,2114,14,35,1285.34,2147.00,0.00
2024-12-08 16:52:26,50,2114,14,36,1259.63,2147.02,0.00
2024-12-08 16:52:26,49,2114,14,35,1280.52,2147.02,0.00
2024-12-08 16:52:26,48,2114,13,35,1291.32,2147.69,0.00
2024-12-08 16:52:26,48,2115,13,35,1329.62,2148.00,0.00
2024-12-08 16:52:26,49,2115,14,35,1302.49,2148.02,0.00
2024-12-08 16:52:26,49,2116,14,35,1299.58,2149.00,0.00
2024-12-08 16:52:26,50,2116,15,35,1273.59,2149.02,0.00
2024-12-08 16:52:26,49,2116,15,34,1295.20,2149.02,0.00
2024-12-08 16:52:26,49,2117,15,34,1301.07,2150.00,0.00
2024-12-08 16:52:26,50,2117,15,35,1275.04,2150.02,0.00
2024-12-08 16:52:26,50,2118,15,35,1271.77,2151.00,0.00
2024-12-08 16:52:26,51,2118,15,36,1246.83,2151.02,0.00
2024-12-08 16:52:26,50,2118,15,35,1267.46,2151.02,0.00
2024-12-08 16:52:26,50,2119,15,35,1272.79,2152.00,0.00
2024-12-08 16:52:26,51,2119,15,36,1247.83,2152.02,0.00
2024-12-08 16:52:26,50,2119,14,36,1236.76,2152.96,0.00
2024-12-08 16:52:26,50,2120,14,36,1278.98,2153.00,0.00
2024-12-08 16:52:26,51,2120,15,36,1253.90,2153.02,0.00
2024-12-08 16:52:26,50,2120,15,35,1275.10,2153.02,0.00
2024-12-08 16:52:26,50,2121,15,35,1280.43,2154.00,0.00
2024-12-08 16:52:26,51,2121,16,35,1255.33,2154.02,0.00
2024-12-08 16:52:26,51,2122,16,35,1252.18,2155.00,0.00
2024-12-08 16:52:26,52,2122,17,35,1228.10,2155.02,0.00
2024-12-08 16:52:26,51,2122,17,34,1247.95,2155.02,0.00
2024-12-08 16:52:26,50,2122,16,34,1270.79,2155.10,0.00
2024-12-08 16:52:26,50,2123,16,34,1277.82,2156.00,0.00
2024-12-08 16:52:26,51,2123,17,34,1252.76,2156.02,0.00
2024-12-08 16:52:26,51,2124,17,34,1249.27,2157.00,0.00
2024-12-08 16:52:26,52,2124,18,34,1225.25,2157.02,0.00
2024-12-08 16:52:26,51,2124,18,33,1245.46,2157.02,0.00
2024-12-08 16:52:26,51,2125,18,33,1250.27,2158.00,0.00
2024-12-08 16:52:26,52,2125,18,34,1226.23,2158.02,0.00
2024-12-08 16:52:26,51,2125,17,34,1232.99,2158.26,0.00
2024-12-08 16:52:26,51,2126,17,34,1259.74,2159.00,0.00
2024-12-08 16:52:26,52,2126,17,35,1235.52,2159.02,0.00
2024-12-08 16:52:26,51,2126,16,35,1249.54,2159.10,0.00
2024-12-08 16:52:26,51,2127,16,35,1257.77,2160.00,0.00
2024-12-08 16:52:26,52,2127,16,36,1233.58,2160.02,0.00
2024-12-08 16:52:26,51,2127,16,35,1251.84,2160.04,0.00
2024-12-08 16:52:26,50,2127,15,35,1274.68,2160.08,0.00
2024-12-08 16:52:26,50,2128,15,35,1298.60,2161.00,0.00
2024-12-08 16:52:26,51,2128,15,36,1273.13,2161.02,0.00
2024-12-08 16:52:26,51,2129,15,36,1270.69,2162.00,0.00
2024-12-08 16:52:26,52,2129,15,37,1246.25,2162.02,0.00
2024-12-08 16:52:26,51,2129,15,36,1264.75,2162.04,0.00
2024-12-08 16:52:26,50,2129,14,36,1265.96,2162.86,0.00
2024-12-08 16:52:26,50,2130,14,36,1306.29,2163.00,0.00
2024-12-08 16:52:26,51,2130,14,37,1280.67,2163.02,0.00
2024-12-08 16:52:26,50,2130,13,37,1278.93,2163.76,0.00
2024-12-08 16:52:26,50,2131,13,37,1317.20,2164.00,0.00
2024-12-08 16:52:26,51,2131,14,37,1291.37,2164.02,0.00
2024-12-08 16:52:26,50,2131,14,36,1311.14,2164.04,0.00
2024-12-08 16:52:26,50,2132,14,36,1316.95,2165.00,0.00
2024-12-08 16:52:26,51,2132,14,37,1291.12,2165.02,0.00
2024-12-08 16:52:26,50,2132,13,37,1301.36,2165.04,0.00
2024-12-08 16:52:26,49,2132,12,37,1317.76,2165.10,0.00
2024-12-08 16:52:26,49,2133,12,37,1343.12,2166.00,0.00
2024-12-08 16:52:26,50,2133,12,38,1316.25,2166.02,0.00
2024-12-08 16:52:26,49,2133,12,37,1336.04,2166.04,0.00
2024-12-08 16:52:26,48,2133,11,37,1363.84,2166.04,0.00
2024-12-08 16:52:26,48,2134,11,37,1388.85,2167.00,0.00
2024-12-08 16:52:26,49,2134,12,37,1360.51,2167.02,0.00
2024-12-08 16:52:26,48,2134,11,37,1361.32,2167.06,0.00
2024-12-08 16:52:26,48,2135,11,37,1386.78,2168.00,0.00
2024-12-08 16:52:26,49,2135,11,38,1358.48,2168.02,0.00
2024-12-08 16:52:26,48,2135,11,37,1386.33,2168.02,0.00
2024-12-08 16:52:26,47,2135,11,36,1408.45,2168.02,0.00
2024-12-08 16:52:26,47,2136,11,36,1415.56,2169.00,0.00
2024-12-08 16:52:26,48,2136,12,36,1386.07,2169.02,0.00
2024-12-08 16:52:26,49,2135,12,37,1315.18,2169.84,0.00
2024-12-08 16:52:26,49,2136,12,37,1359.61,2170.00,0.00
2024-12-08 16:52:26,50,2136,12,38,1332.42,2170.02,0.00
2024-12-08 16:52:26,49,2136,12,37,1351.64,2170.02,0.00
2024-12-08 16:52:26,49,2137,12,37,1401.89,2171.00,0.00
2024-12-08 16:52:26,50,2137,13,37,1373.85,2171.02,0.00
2024-12-08 16:52:26,49,2137,12,37,1385.53,2171.14,0.00
2024-12-08 16:52:26,49,2138,12,37,1411.84,2172.00,0.00
2024-12-08 16:52:26,50,2138,13,37,1383.60,2172.02,0.00
2024-12-08 16:52:26,49,2138,13,36,1403.42,2172.02,0.00
2024-12-08 16:52:26,49,2139,13,36,1409.39,2173.00,0.00
2024-12-08 16:52:26,50,2139,13,37,1381.20,2173.02,0.00
2024-12-08 16:52:26,50,2140,13,37,1379.93,2174.00,0.00
2024-12-08 16:52:27,51,2140,14,37,1352.87,2174.02,0.00
2024-12-08 16:52:27,50,2140,13,37,1358.63,2174.60,0.00
2024-12-08 16:52:27,50,2141,13,37,1376.33,2175.00,0.00
2024-12-08 16:52:27,51,2141,13,38,1349.35,2175.02,0.00
2024-12-08 16:52:27,50,2141,13,37,1375.47,2175.04,0.00
2024-12-08 16:52:27,50,2142,13,37,1381.32,2176.00,0.00
2024-12-08 16:52:27,51,2142,14,37,1354.23,2176.02,0.00
2024-12-08 16:52:27,50,2142,13,37,1360.58,2176.58,0.00
2024-12-08 16:52:27,50,2143,13,37,1395.29,2177.00,0.00
2024-12-08 16:52:27,51,2143,14,37,1367.93,2177.02,0.00
2024-12-08 16:52:27,50,2143,14,36,1386.15,2177.04,0.00
2024-12-08 16:52:27,50,2144,14,36,1392.01,2178.00,0.00
2024-12-08 16:52:27,51,2144,15,36,1364.72,2178.02,0.00
2024-12-08 16:52:27,50,2144,14,36,1356.15,2178.90,0.00
2024-12-08 16:52:27,50,2145,14,36,1397.61,2179.00,0.00
2024-12-08 16:52:27,51,2145,14,37,1370.21,2179.02,0.00
2024-12-08 16:52:27,50,2145,13,37,1397.18,2179.04,0.00
2024-12-08 16:52:27,50,2146,13,37,1394.33,2180.00,0.00
2024-12-08 16:52:27,51,2146,13,38,1366.99,2180.02,0.00
2024-12-08 16:52:27,50,2146,13,37,1393.46,2180.04,0.00
2024-12-08 16:52:27,50,2147,13,37,1399.33,2181.00,0.00
2024-12-08 16:52:27,51,2147,13,38,1371.89,2181.02,0.00
2024-12-08 16:52:27,51,2148,13,38,1369.06,2182.00,0.00
2024-12-08 16:52:27,52,2148,13,39,1342.73,2182.02,0.00
2024-12-08 16:52:27,51,2148,13,38,1359.65,2182.04,0.00
2024-12-08 16:52:27,50,2148,12,38,1383.84,2182.06,0.00
2024-12-08 16:52:27,50,2149,12,38,1407.60,2183.00,0.00
2024-12-08 16:52:27,51,2149,12,39,1380.00,2183.02,0.00
2024-12-08 16:52:27,51,2150,12,39,1377.23,2184.00,0.00
2024-12-08 16:52:27,52,2150,13,39,1350.75,2184.02,0.00
2024-12-08 16:52:27,51,2150,13,38,1367.82,2184.04,0.00
2024-12-08 16:52:27,50,2150,12,38,1372.92,2184.82,0.00
2024-12-08 16:52:27,50,2151,12,38,1412.82,2185.00,0.00
2024-12-08 16:52:27,51,2151,13,38,1385.12,2185.02,0.00
2024-12-08 16:52:27,51,2152,13,38,1382.83,2186.00,0.00
2024-12-08 16:52:27,52,2152,14,38,1356.24,2186.02,0.00
2024-12-08 16:52:27,52,2153,14,38,1352.23,2187.00,0.00
2024-12-08 16:52:27,53,2153,15,38,1326.72,2187.02,0.00
2024-12-08 16:52:27,52,2153,15,37,1351.40,2187.04,0.00
2024-12-08 16:52:27,52,2154,15,37,1356.22,2188.00,0.00
2024-12-08 16:52:27,53,2154,15,38,1330.63,2188.02,0.00
2024-12-08 16:52:27,53,2155,15,38,1328.26,2189.00,0.00
2024-12-08 16:52:27,54,2155,15,39,1303.67,2189.02,0.00
2024-12-08 16:52:27,53,2155,15,38,1319.59,2189.04,0.00
2024-12-08 16:52:27,53,2156,15,38,1323.91,2190.00,0.00
2024-12-08 16:52:27,54,2156,15,39,1299.39,2190.02,0.00
2024-12-08 16:52:27,54,2157,15,39,1297.53,2191.00,0.00
2024-12-08 16:52:27,55,2157,15,40,1273.94,2191.02,0.00
2024-12-08 16:52:27,54,2157,15,39,1288.61,2191.04,0.00
2024-12-08 16:52:27,54,2158,15,39,1292.44,2192.00,0.00
2024-12-08 16:52:27,55,2158,15,40,1268.94,2192.02,0.00
2024-12-08 16:52:27,54,2158,14,40,1269.18,2192.67,0.00
2024-12-08 16:52:27,54,2159,14,40,1302.70,2193.00,0.00
2024-12-08 16:52:27,55,2159,14,41,1279.01,2193.02,0.00
2024-12-08 16:52:27,54,2159,14,40,1294.17,2193.04,0.00
2024-12-08 16:52:27,53,2159,13,40,1291.88,2193.91,0.00
2024-12-08 16:52:27,53,2160,13,40,1331.28,2194.00,0.00
2024-12-08 16:52:27,54,2160,13,41,1306.62,2194.02,0.00
2024-12-08 16:52:27,53,2160,12,41,1317.25,2194.15,0.00
2024-12-08 16:52:27,53,2161,12,41,1340.58,2195.00,0.00
2024-12-08 16:52:27,54,2161,12,42,1315.76,2195.02,0.00
2024-12-08 16:52:27,53,2161,12,41,1331.89,2195.04,0.00
2024-12-08 16:52:27,53,2162,12,41,1336.22,2196.00,0.00
2024-12-08 16:52:27,54,2162,12,42,1311.48,2196.02,0.00
2024-12-08 16:52:27,53,2162,11,42,1312.74,2196.32,0.00
2024-12-08 16:52:27,53,2163,11,42,1339.73,2197.00,0.00
2024-12-08 16:52:27,54,2163,11,43,1314.92,2197.02,0.00
2024-12-08 16:52:27,53,2163,11,42,1331.44,2197.04,0.00
2024-12-08 16:52:27,52,2163,10,42,1342.39,2197.31,0.00
2024-12-08 16:52:27,52,2164,10,42,1369.92,2198.00,0.00
2024-12-08 16:52:27,53,2164,10,43,1344.07,2198.02,0.00
2024-12-08 16:52:27,52,2164,9,43,1332.10,2198.65,0.00
2024-12-08 16:52:27,52,2165,9,43,1367.05,2199.00,0.00
2024-12-08 16:52:27,53,2165,9,44,1341.26,2199.02,0.00
2024-12-08 16:52:27,52,2165,9,43,1359.02,2199.04,0.00
2024-12-08 16:52:27,51,2165,8,43,1364.84,2199.41,0.00
2024-12-08 16:52:27,51,2166,8,43,1395.46,2200.00,0.00
2024-12-08 16:52:27,52,2166,8,44,1368.63,2200.02,0.00
2024-12-08 16:52:27,51,2166,7,44,1372.07,2200.61,0.00
2024-12-08 16:52:27,51,2167,7,44,1406.91,2201.00,0.00
2024-12-08 16:52:27,52,2167,7,45,1379.86,2201.02,0.00
2024-12-08 16:52:27,51,2167,7,44,1399.15,2201.04,0.00
2024-12-08 16:52:27,50,2167,6,44,1399.69,2201.58,0.00
2024-12-08 16:52:27,50,2168,6,44,1434.82,2202.00,0.00
2024-12-08 16:52:27,51,2168,7,44,1406.69,2202.02,0.00
2024-12-08 16:52:27,50,2168,6,44,1409.66,2202.70,0.00
2024-12-08 16:52:27,50,2169,6,44,1447.37,2203.00,0.00
2024-12-08 16:52:27,51,2169,6,45,1418.99,2203.02,0.00
2024-12-08 16:52:27,50,2169,6,44,1439.88,2203.04,0.00
2024-12-08 16:52:27,50,2170,6,44,1445.82,2204.00,0.00
2024-12-08 16:52:27,51,2170,6,45,1417.47,2204.02,0.00
2024-12-08 16:52:28,51,2171,6,45,1413.79,2205.00,0.00
2024-12-08 16:52:28,52,2171,6,46,1386.61,2205.02,0.00
2024-12-08 16:52:28,51,2171,6,45,1406.88,2205.04,0.00
2024-12-08 16:52:28,50,2171,5,45,1407.41,2205.96,0.00
2024-12-08 16:52:28,50,2172,5,45,1450.67,2206.00,0.00
2024-12-08 16:52:28,51,2172,6,45,1422.22,2206.02,0.00
2024-12-08 16:52:28,50,2172,5,45,1423.92,2206.40,0.00
2024-12-08 16:52:28,50,2173,5,45,1455.30,2207.00,0.00
2024-12-08 16:52:28,51,2173,5,46,1426.76,2207.02,0.00
2024-12-08 16:52:28,50,2173,5,45,1448.23,2207.04,0.00
2024-12-08 16:52:28,50,2174,5,45,1454.19,2208.00,0.00
2024-12-08 16:52:28,51,2174,6,45,1425.67,2208.02,0.00
2024-12-08 16:52:28,51,2175,6,45,1421.99,2209.00,0.00
2024-12-08 16:52:28,52,2175,7,45,1394.64,2209.02,0.00
2024-12-08 16:52:28,51,2175,7,44,1415.49,2209.04,0.00
2024-12-08 16:52:28,51,2176,7,44,1420.90,2210.00,0.00
2024-12-08 16:52:28,52,2176,7,45,1393.57,2210.02,0.00
2024-12-08 16:52:28,51,2176,6,45,1419.17,2210.02,0.00
2024-12-08 16:52:28,51,2177,6,45,1432.81,2211.00,0.00
2024-12-08 16:52:28,52,2177,7,45,1405.26,2211.02,0.00
2024-12-08 16:52:28,51,2177,7,44,1426.32,2211.04,0.00
2024-12-08 16:52:28,51,2178,7,44,1431.73,2212.00,0.00
2024-12-08 16:52:28,52,2178,7,45,1404.19,2212.02,0.00
2024-12-08 16:52:28,52,2179,7,45,1399.66,2213.00,0.00
2024-12-08 16:52:28,53,2179,8,45,1373.25,2213.02,0.00
2024-12-08 16:52:28,52,2179,8,44,1394.98,2213.02,0.00
2024-12-08 16:52:28,52,2180,8,44,1398.28,2214.00,0.00
2024-12-08 16:52:28,53,2180,8,45,1371.90,2214.02,0.00
2024-12-08 16:52:28,52,2180,7,45,1360.26,2214.96,0.00
2024-12-08 16:52:28,52,2181,7,45,1402.03,2215.00,0.00
2024-12-08 16:52:28,53,2181,8,45,1375.57,2215.02,0.00
2024-12-08 16:52:28,52,2181,8,44,1397.34,2215.02,0.00
2024-12-08 16:52:28,51,2181,7,44,1398.26,2215.51,0.00
2024-12-08 16:52:28,51,2182,7,44,1431.23,2216.00,0.00
2024-12-08 16:52:28,52,2182,7,45,1403.71,2216.02,0.00
2024-12-08 16:52:28,52,2183,7,45,1397.75,2217.00,0.00
2024-12-08 16:52:28,53,2183,7,46,1371.38,2217.02,0.00
2024-12-08 16:52:28,52,2183,7,45,1393.49,2217.02,0.00
2024-12-08 16:52:28,52,2184,7,45,1396.07,2218.00,0.00
2024-12-08 16:52:28,53,2184,7,46,1369.73,2218.02,0.00
2024-12-08 16:52:28,52,2184,6,46,1359.34,2218.92,0.00
2024-12-08 16:52:28,52,2185,6,46,1400.36,2219.00,0.00
2024-12-08 16:52:28,53,2185,6,47,1373.94,2219.02,0.00
2024-12-08 16:52:28,53,2186,6,47,1367.68,2220.00,0.00
2024-12-08 16:52:28,54,2186,6,48,1342.35,2220.02,0.00
2024-12-08 16:52:28,53,2186,6,47,1361.82,2220.06,0.00
2024-12-08 16:52:28,52,2186,5,47,1365.74,2220.83,0.00
2024-12-08 16:52:28,52,2187,5,47,1404.75,2221.00,0.00
2024-12-08 16:52:28,53,2187,5,48,1378.25,2221.02,0.00
2024-12-08 16:52:28,53,2188,5,48,1374.95,2222.00,0.00
2024-12-08 16:52:28,54,2188,6,48,1349.49,2222.02,0.00
2024-12-08 16:52:28,53,2188,5,48,1343.41,2222.43,0.00
2024-12-08 16:52:28,53,2189,5,48,1373.21,2223.00,0.00
2024-12-08 16:52:28,54,2189,5,49,1347.78,2223.02,0.00
2024-12-08 16:52:28,53,2189,5,48,1371.11,2223.02,0.00
2024-12-08 16:52:28,53,2190,5,48,1373.65,2224.00,0.00
2024-12-08 16:52:28,54,2190,6,48,1348.21,2224.02,0.00
2024-12-08 16:52:28,53,2190,6,47,1371.77,2224.09,0.00
2024-12-08 16:52:28,52,2190,6,46,1396.03,2224.15,0.00
2024-12-08 16:52:28,52,2191,6,46,1403.46,2225.00,0.00
2024-12-08 16:52:28,53,2191,6,47,1376.98,2225.02,0.00
2024-12-08 16:52:28,53,2192,6,47,1375.51,2226.00,0.00
2024-12-08 16:52:28,54,2192,7,47,1350.04,2226.02,0.00
2024-12-08 16:52:28,54,2193,7,47,1345.28,2227.00,0.00
2024-12-08 16:52:28,55,2193,7,48,1320.83,2227.02,0.00
2024-12-08 16:52:28,54,2193,6,48,1313.53,2227.80,0.00
2024-12-08 16:52:28,54,2194,6,48,1350.42,2228.00,0.00
2024-12-08 16:52:28,55,2194,6,49,1325.86,2228.02,0.00
2024-12-08 16:52:28,55,2195,6,49,1320.78,2229.00,0.00
2024-12-08 16:52:28,56,2195,6,50,1297.20,2229.02,0.00
2024-12-08 16:52:28,55,2195,6,49,1315.92,2229.05,0.00
2024-12-08 16:52:28,54,2195,5,49,1337.44,2229.17,0.00
2024-12-08 16:52:28,54,2196,5,49,1344.19,2230.00,0.00
2024-12-08 16:52:28,55,2196,5,50,1319.75,2230.02,0.00
2024-12-08 16:52:28,54,2196,5,49,1343.78,2230.02,0.00
2024-12-08 16:52:28,53,2196,5,48,1356.98,2230.17,0.00
2024-12-08 16:52:28,52,2196,4,48,1359.16,2230.94,0.00
2024-12-08 16:52:28,52,2197,4,48,1400.81,2231.00,0.00
2024-12-08 16:52:28,53,2197,5,48,1374.38,2231.02,0.00
2024-12-08 16:52:28,53,2198,5,48,1372.00,2232.00,0.00
2024-12-08 16:52:28,54,2198,5,49,1346.60,2232.02,0.00
2024-12-08 16:52:28,54,2199,5,49,1341.82,2233.00,0.00
2024-12-08 16:52:28,55,2199,6,49,1317.43,2233.02,0.00
2024-12-08 16:52:28,54,2199,6,48,1338.14,2233.17,0.00
2024-12-08 16:52:28,54,2200,6,48,1344.91,2234.00,0.00
2024-12-08 16:52:28,55,2200,6,49,1320.45,2234.02,0.00
2024-12-08 16:52:28,54,2200,5,49,1322.91,2234.63,0.00
2024-12-08 16:52:29,54,2201,5,49,1356.31,2235.00,0.00
2024-12-08 16:52:29,55,2201,6,49,1331.65,2235.02,0.00
2024-12-08 16:52:29,54,2201,6,48,1344.35,2235.17,0.00
2024-12-08 16:52:29,54,2202,6,48,1351.12,2236.00,0.00
2024-12-08 16:52:29,55,2202,7,48,1326.56,2236.02,0.00
2024-12-08 16:52:29,54,2202,6,48,1316.47,2236.93,0.00
2024-12-08 16:52:29,54,2203,6,48,1356.28,2237.00,0.00
2024-12-08 16:52:29,55,2203,6,49,1331.62,2237.02,0.00
2024-12-08 16:52:29,55,2204,6,49,1326.52,2238.00,0.00
2024-12-08 16:52:29,56,2204,7,49,1302.84,2238.02,0.00
2024-12-08 16:52:29,55,2204,7,48,1322.49,2238.16,0.00
2024-12-08 16:52:29,55,2205,7,48,1328.74,2239.00,0.00
2024-12-08 16:52:29,56,2205,8,48,1305.02,2239.02,0.00
2024-12-08 16:52:29,56,2206,8,48,1302.59,2240.00,0.00
2024-12-08 16:52:29,57,2206,8,49,1279.74,2240.02,0.00
2024-12-08 16:52:29,56,2206,8,48,1291.02,2240.16,0.00
2024-12-08 16:52:29,56,2207,8,48,1296.77,2241.00,0.00
2024-12-08 16:52:29,57,2207,8,49,1274.02,2241.02,0.00
2024-12-08 16:52:29,56,2207,8,48,1288.77,2241.04,0.00
2024-12-08 16:52:29,56,2208,8,48,1291.74,2242.00,0.00
2024-12-08 16:52:29,57,2208,9,48,1269.08,2242.02,0.00
2024-12-08 16:52:29,57,2209,9,48,1266.28,2243.00,0.00
2024-12-08 16:52:29,58,2209,10,48,1244.44,2243.02,0.00
2024-12-08 16:52:29,57,2209,10,47,1256.07,2243.14,0.00
2024-12-08 16:52:29,57,2210,10,47,1260.94,2244.00,0.00
2024-12-08 16:52:29,58,2210,10,48,1239.20,2244.02,0.00
2024-12-08 16:52:29,58,2211,10,48,1236.30,2245.00,0.00
2024-12-08 16:52:29,59,2211,11,48,1215.34,2245.02,0.00
2024-12-08 16:52:29,58,2211,11,47,1226.64,2245.14,0.00
2024-12-08 16:52:29,58,2212,11,47,1231.04,2246.00,0.00
2024-12-08 16:52:29,59,2212,12,47,1210.17,2246.02,0.00
2024-12-08 16:52:29,59,2213,12,47,1207.10,2247.00,0.00
2024-12-08 16:52:29,60,2213,13,47,1186.98,2247.02,0.00
2024-12-08 16:52:29,59,2213,13,46,1197.98,2247.14,0.00
2024-12-08 16:52:29,60,2212,13,47,1176.91,2247.22,0.00
2024-12-08 16:52:29,59,2212,12,47,1192.34,2247.95,0.00
2024-12-08 16:52:29,59,2213,12,47,1229.32,2248.00,0.00
2024-12-08 16:52:29,60,2213,13,47,1208.84,2248.02,0.00
2024-12-08 16:52:29,59,2213,13,46,1227.05,2248.10,0.00
2024-12-08 16:52:29,59,2214,13,46,1265.03,2249.00,0.00
2024-12-08 16:52:29,60,2214,13,47,1243.94,2249.02,0.00
2024-12-08 16:52:29,59,2214,13,46,1255.13,2249.12,0.00
2024-12-08 16:52:29,59,2215,13,46,1258.72,2250.00,0.00
2024-12-08 16:52:29,60,2215,14,46,1237.74,2250.02,0.00
2024-12-08 16:52:29,59,2215,13,46,1236.37,2250.39,0.00
2024-12-08 16:52:29,58,2215,12,46,1253.75,2250.57,0.00
2024-12-08 16:52:29,58,2216,12,46,1283.16,2251.00,0.00
2024-12-08 16:52:29,59,2216,13,46,1261.41,2251.02,0.00
2024-12-08 16:52:29,58,2216,13,45,1273.47,2251.12,0.00
2024-12-08 16:52:29,58,2217,13,45,1277.51,2252.00,0.00
2024-12-08 16:52:29,59,2217,14,45,1255.86,2252.02,0.00
2024-12-08 16:52:29,58,2217,14,44,1277.13,2252.02,0.00
2024-12-08 16:52:29,58,2218,14,44,1274.74,2253.00,0.00
2024-12-08 16:52:29,59,2218,14,45,1253.13,2253.02,0.00
2024-12-08 16:52:29,58,2218,14,44,1269.69,2253.05,0.00
2024-12-08 16:52:29,58,2219,14,44,1272.20,2254.00,0.00
2024-12-08 16:52:29,59,2219,15,44,1250.63,2254.02,0.00
2024-12-08 16:52:29,59,2220,15,44,1246.78,2255.00,0.00
2024-12-08 16:52:29,60,2220,16,44,1226.00,2255.02,0.00
2024-12-08 16:52:29,59,2220,16,43,1239.14,2255.09,0.00
2024-12-08 16:52:29,59,2221,16,43,1241.98,2256.00,0.00
2024-12-08 16:52:29,60,2221,17,43,1221.28,2256.02,0.00
2024-12-08 16:52:29,59,2221,17,42,1233.59,2256.10,0.00
2024-12-08 16:52:29,58,2221,16,42,1241.94,2256.67,0.00
2024-12-08 16:52:29,58,2222,16,42,1258.12,2257.00,0.00
2024-12-08 16:52:29,59,2222,16,43,1236.79,2257.02,0.00
2024-12-08 16:52:29,59,2223,16,43,1233.17,2258.00,0.00
2024-12-08 16:52:29,60,2223,16,44,1212.61,2258.02,0.00
2024-12-08 16:52:29,59,2223,16,43,1225.15,2258.10,0.00
2024-12-08 16:52:29,59,2224,16,43,1228.35,2259.00,0.00
2024-12-08 16:52:29,60,2224,17,43,1207.88,2259.02,0.00
2024-12-08 16:52:29,60,2225,17,43,1204.09,2260.00,0.00
2024-12-08 16:52:29,61,2225,18,43,1184.35,2260.02,0.00
2024-12-08 16:52:29,60,2225,18,42,1196.57,2260.10,0.00
2024-12-08 16:52:29,59,2225,17,42,1193.33,2260.85,0.00
2024-12-08 16:52:29,59,2226,17,42,1228.29,2261.00,0.00
2024-12-08 16:52:29,60,2226,17,43,1207.82,2261.02,0.00
2024-12-08 16:52:29,59,2226,17,42,1227.91,2261.02,0.00
2024-12-08 16:52:29,58,2226,16,42,1228.88,2261.57,0.00
2024-12-08 16:52:30,58,2227,16,42,1254.80,2262.00,0.00
2024-12-08 16:52:30,59,2227,16,43,1233.53,2262.02,0.00
2024-12-08 16:52:30,58,2227,16,42,1254.41,2262.02,0.00
2024-12-08 16:52:30,57,2227,15,42,1248.02,2262.88,0.00
2024-12-08 16:52:30,57,2228,15,42,1285.03,2263.00,0.00
2024-12-08 16:52:30,58,2228,16,42,1262.87,2263.02,0.00
2024-12-08 16:52:30,57,2228,15,42,1249.33,2263.90,0.00
2024-12-08 16:52:30,57,2229,15,42,1286.75,2264.00,0.00
2024-12-08 16:52:30,58,2229,16,42,1264.56,2264.02,0.00
2024-12-08 16:52:30,58,2230,16,42,1258.48,2265.00,0.00
2024-12-08 16:52:30,59,2230,17,42,1237.15,2265.02,0.00
2024-12-08 16:52:30,58,2230,17,41,1256.53,2265.05,0.00
2024-12-08 16:52:30,58,2231,17,41,1259.04,2266.00,0.00
2024-12-08 16:52:30,59,2231,17,42,1237.70,2266.02,0.00
2024-12-08 16:52:30,58,2231,17,41,1258.65,2266.02,0.00
2024-12-08 16:52:30,58,2232,17,41,1253.55,2267.00,0.00
2024-12-08 16:52:30,59,2232,18,41,1232.31,2267.02,0.00
2024-12-08 16:52:30,58,2232,18,40,1249.65,2267.03,0.00
2024-12-08 16:52:30,58,2233,18,40,1251.76,2268.00,0.00
2024-12-08 16:52:30,59,2233,19,40,1230.54,2268.02,0.00
2024-12-08 16:52:30,59,2234,19,40,1224.96,2269.00,0.00
2024-12-08 16:52:30,60,2234,19,41,1204.55,2269.02,0.00
2024-12-08 16:52:30,59,2234,19,40,1224.58,2269.02,0.00
2024-12-08 16:52:30,58,2234,19,39,1242.56,2269.02,0.00
2024-12-08 16:52:30,58,2235,19,39,1244.28,2270.00,0.00
2024-12-08 16:52:30,59,2235,20,39,1223.19,2270.02,0.00
2024-12-08 16:52:30,59,2236,20,39,1217.12,2271.00,0.00
2024-12-08 16:52:30,60,2236,20,40,1196.84,2271.02,0.00
2024-12-08 16:52:30,59,2236,20,39,1214.43,2271.02,0.00
2024-12-08 16:52:30,58,2236,19,39,1224.15,2271.52,0.00
2024-12-08 16:52:30,57,2236,18,39,1228.42,2271.95,0.00
2024-12-08 16:52:30,57,2237,18,39,1267.11,2272.00,0.00
2024-12-08 16:52:30,58,2237,18,40,1245.26,2272.02,0.00
2024-12-08 16:52:30,58,2238,18,40,1239.15,2273.00,0.00
2024-12-08 16:52:30,59,2238,18,41,1218.15,2273.02,0.00
2024-12-08 16:52:30,58,2238,18,40,1236.80,2273.02,0.00
2024-12-08 16:52:30,58,2239,18,40,1238.52,2274.00,0.00
2024-12-08 16:52:30,59,2239,19,40,1217.53,2274.02,0.00
2024-12-08 16:52:30,59,2240,19,40,1211.23,2275.00,0.00
2024-12-08 16:52:30,60,2240,20,40,1191.04,2275.02,0.00
2024-12-08 16:52:30,59,2240,20,39,1209.30,2275.02,0.00
2024-12-08 16:52:30,58,2240,19,39,1214.38,2275.71,0.00
2024-12-08 16:52:30,58,2241,19,39,1231.47,2276.00,0.00
2024-12-08 16:52:30,59,2241,20,39,1210.60,2276.02,0.00
2024-12-08 16:52:30,58,2241,19,39,1201.28,2276.85,0.00
2024-12-08 16:52:30,59,2240,19,40,1179.06,2276.95,0.00
2024-12-08 16:52:30,59,2241,19,40,1217.69,2277.00,0.00
2024-12-08 16:52:30,60,2241,20,40,1197.40,2277.02,0.00
2024-12-08 16:52:30,59,2241,20,39,1216.15,2277.02,0.00
2024-12-08 16:52:30,59,2242,20,39,1256.07,2278.00,0.00
2024-12-08 16:52:30,60,2242,20,40,1235.13,2278.02,0.00
2024-12-08 16:52:30,59,2242,19,40,1235.31,2278.59,0.00
2024-12-08 16:52:30,59,2243,19,40,1249.51,2279.00,0.00
2024-12-08 16:52:30,60,2243,19,41,1228.69,2279.02,0.00
2024-12-08 16:52:30,59,2243,19,40,1248.36,2279.02,0.00
2024-12-08 16:52:30,58,2243,18,40,1256.21,2279.62,0.00
2024-12-08 16:52:30,58,2244,18,40,1271.43,2280.00,0.00
2024-12-08 16:52:30,59,2244,18,41,1249.88,2280.02,0.00
2024-12-08 16:52:30,59,2245,18,41,1243.47,2281.00,0.00
2024-12-08 16:52:30,60,2245,19,41,1222.75,2281.02,0.00
2024-12-08 16:52:30,59,2245,19,40,1242.31,2281.02,0.00
2024-12-08 16:52:30,58,2245,18,40,1237.47,2281.91,0.00
2024-12-08 16:52:30,58,2246,18,40,1274.91,2282.00,0.00
2024-12-08 16:52:30,59,2246,18,41,1253.30,2282.02,0.00
2024-12-08 16:52:30,59,2247,18,41,1246.88,2283.00,0.00
2024-12-08 16:52:30,60,2247,19,41,1226.10,2283.02,0.00
2024-12-08 16:52:30,59,2247,19,40,1246.11,2283.02,0.00
2024-12-08 16:52:30,58,2247,18,40,1253.10,2283.66,0.00
2024-12-08 16:52:30,58,2248,18,40,1269.11,2284.00,0.00
2024-12-08 16:52:30,59,2248,18,41,1247.60,2284.02,0.00
2024-12-08 16:52:30,58,2248,17,41,1256.18,2284.22,0.00
2024-12-08 16:52:30,58,2249,17,41,1262.58,2285.00,0.00
2024-12-08 16:52:30,59,2249,17,42,1241.18,2285.02,0.00
2024-12-08 16:52:30,58,2249,17,41,1262.18,2285.02,0.00
2024-12-08 16:52:30,58,2250,17,41,1263.92,2286.00,0.00
2024-12-08 16:52:30,59,2250,18,41,1242.50,2286.02,0.00
2024-12-08 16:52:30,59,2251,18,41,1236.06,2287.00,0.00
2024-12-08 16:52:30,60,2251,18,42,1215.46,2287.02,0.00
2024-12-08 16:52:30,59,2251,18,41,1235.67,2287.02,0.00
2024-12-08 16:52:30,59,2252,18,41,1236.99,2288.00,0.00
2024-12-08 16:52:30,60,2252,19,41,1216.37,2288.02,0.00
2024-12-08 16:52:30,60,2253,19,41,1209.66,2289.00,0.00
2024-12-08 16:52:30,61,2253,20,41,1189.83,2289.02,0.00
2024-12-08 16:52:30,60,2253,20,40,1208.89,2289.02,0.00
2024-12-08 16:52:30,60,2254,20,40,1209.80,2290.00,0.00
2024-12-08 16:52:30,61,2254,21,40,1189.97,2290.02,0.00
2024-12-08 16:52:31,60,2254,20,40,1173.06,2290.65,0.00
2024-12-08 16:52:31,60,2255,20,40,1203.46,2291.00,0.00
2024-12-08 16:52:31,61,2255,21,40,1183.73,2291.02,0.00
2024-12-08 16:52:31,60,2255,21,39,1202.70,2291.02,0.00
2024-12-08 16:52:31,60,2256,21,39,1203.60,2292.00,0.00
2024-12-08 16:52:31,61,2256,22,39,1183.87,2292.02,0.00
2024-12-08 16:52:31,61,2257,22,39,1176.87,2293.00,0.00
2024-12-08 16:52:31,62,2257,23,39,1157.89,2293.02,0.00
2024-12-08 16:52:31,61,2257,23,38,1176.12,2293.02,0.00
2024-12-08 16:52:31,61,2258,23,38,1176.63,2294.00,0.00
2024-12-08 16:52:31,62,2258,23,39,1157.65,2294.02,0.00
2024-12-08 16:52:31,61,2258,22,39,1146.94,2294.84,0.00
2024-12-08 16:52:31,61,2259,22,39,1180.91,2295.00,0.00
2024-12-08 16:52:31,62,2259,23,39,1161.86,2295.02,0.00
2024-12-08 16:52:31,61,2259,23,38,1180.15,2295.02,0.00
2024-12-08 16:52:31,61,2260,23,38,1180.67,2296.00,0.00
2024-12-08 16:52:31,62,2260,23,39,1161.63,2296.02,0.00
2024-12-08 16:52:31,62,2261,23,39,1154.35,2297.00,0.00
2024-12-08 16:52:31,63,2261,24,39,1136.03,2297.02,0.00
2024-12-08 16:52:31,62,2261,24,38,1153.98,2297.02,0.00
2024-12-08 16:52:31,61,2261,23,38,1157.02,2297.71,0.00
2024-12-08 16:52:31,60,2261,22,38,1166.10,2297.92,0.00
2024-12-08 16:52:31,60,2262,22,38,1202.54,2298.00,0.00
2024-12-08 16:52:31,61,2262,23,38,1182.83,2298.02,0.00
2024-12-08 16:52:31,60,2262,23,37,1194.50,2298.02,0.00
2024-12-08 16:52:31,60,2263,23,37,1195.40,2299.00,0.00
2024-12-08 16:52:31,61,2263,23,38,1175.80,2299.02,0.00
2024-12-08 16:52:31,60,2263,23,37,1187.35,2299.02,0.00
2024-12-08 16:52:31,59,2263,22,37,1186.62,2299.51,0.00
2024-12-08 16:52:31,59,2264,22,37,1214.63,2300.00,0.00
2024-12-08 16:52:31,60,2264,23,37,1194.39,2300.02,0.00
2024-12-08 16:52:31,59,2264,23,36,1206.44,2300.02,0.00
2024-12-08 16:52:31,58,2264,22,36,1210.52,2300.72,0.00
2024-12-08 16:52:31,58,2265,22,36,1244.04,2301.00,0.00
2024-12-08 16:52:31,59,2265,23,36,1222.96,2301.02,0.00
2024-12-08 16:52:31,58,2265,23,35,1235.71,2301.02,0.00
2024-12-08 16:52:31,58,2266,23,35,1237.44,2302.00,0.00
2024-12-08 16:52:31,59,2266,24,35,1216.47,2302.02,0.00
2024-12-08 16:52:31,59,2267,24,35,1209.97,2303.00,0.00
2024-12-08 16:52:31,60,2267,25,35,1189.80,2303.02,0.00
2024-12-08 16:52:31,59,2267,25,34,1209.58,2303.02,0.00
2024-12-08 16:52:31,58,2267,24,34,1225.73,2303.22,0.00
2024-12-08 16:52:31,58,2268,24,34,1232.16,2304.00,0.00
2024-12-08 16:52:31,59,2268,25,34,1211.28,2304.02,0.00
2024-12-08 16:52:31,59,2269,25,34,1204.77,2305.00,0.00
2024-12-08 16:52:31,60,2269,26,34,1184.69,2305.02,0.00
2024-12-08 16:52:31,59,2269,26,33,1204.38,2305.02,0.00
2024-12-08 16:52:31,59,2270,26,33,1205.68,2306.00,0.00
2024-12-08 16:52:31,60,2270,27,33,1185.59,2306.02,0.00
2024-12-08 16:52:31,60,2271,27,33,1178.80,2307.00,0.00
2024-12-08 16:52:31,61,2271,28,33,1159.47,2307.02,0.00
2024-12-08 16:52:31,60,2271,28,32,1178.41,2307.02,0.00
2024-12-08 16:52:31,59,2271,27,32,1193.64,2307.22,0.00
2024-12-08 16:52:31,58,2271,26,32,1213.82,2307.22,0.00
2024-12-08 16:52:31,58,2272,26,32,1220.26,2308.00,0.00
2024-12-08 16:52:31,59,2272,26,33,1199.58,2308.02,0.00
2024-12-08 16:52:31,58,2272,26,32,1211.91,2308.02,0.00
2024-12-08 16:52:31,57,2272,25,32,1218.21,2308.12,0.00
2024-12-08 16:52:31,57,2273,25,32,1238.97,2309.00,0.00
2024-12-08 16:52:31,58,2273,25,33,1217.61,2309.02,0.00
2024-12-08 16:52:31,57,2273,24,33,1218.32,2309.09,0.00
2024-12-08 16:52:31,56,2273,23,33,1227.17,2309.66,0.00
2024-12-08 16:52:31,56,2274,23,33,1260.81,2310.00,0.00
2024-12-08 16:52:31,57,2274,23,34,1238.69,2310.02,0.00
2024-12-08 16:52:31,56,2274,23,33,1259.99,2310.04,0.00
2024-12-08 16:52:31,56,2275,23,33,1263.01,2311.00,0.00
2024-12-08 16:52:31,57,2275,23,34,1240.85,2311.02,0.00
2024-12-08 16:52:31,57,2276,23,34,1234.90,2312.00,0.00
2024-12-08 16:52:31,58,2276,23,35,1213.61,2312.02,0.00
2024-12-08 16:52:31,57,2276,23,34,1234.09,2312.04,0.00
2024-12-08 16:52:31,57,2277,23,34,1236.65,2313.00,0.00
2024-12-08 16:52:31,58,2277,24,34,1215.33,2313.02,0.00
2024-12-08 16:52:31,57,2277,23,34,1197.17,2313.67,0.00
2024-12-08 16:52:31,57,2278,23,34,1230.28,2314.00,0.00
2024-12-08 16:52:31,58,2278,23,35,1209.07,2314.02,0.00
2024-12-08 16:52:31,57,2278,23,34,1229.47,2314.04,0.00
2024-12-08 16:52:31,56,2278,22,34,1249.58,2314.11,0.00
2024-12-08 16:52:31,56,2279,22,34,1254.23,2315.00,0.00
2024-12-08 16:52:31,57,2279,23,34,1232.23,2315.02,0.00
2024-12-08 16:52:31,57,2280,23,34,1226.26,2316.00,0.00
2024-12-08 16:52:31,58,2280,24,34,1205.12,2316.02,0.00
2024-12-08 16:52:31,57,2280,24,33,1225.04,2316.04,0.00
2024-12-08 16:52:31,56,2280,23,33,1218.48,2316.96,0.00
2024-12-08 16:52:32,56,2281,23,33,1259.04,2317.00,0.00
2024-12-08 16:52:32,57,2281,24,33,1236.95,2317.02,0.00
2024-12-08 16:52:32,57,2282,24,33,1230.98,2318.00,0.00
2024-12-08 16:52:32,58,2282,24,34,1209.76,2318.02,0.00
2024-12-08 16:52:32,57,2282,24,33,1229.35,2318.04,0.00
2024-12-08 16:52:32,57,2283,24,33,1231.92,2319.00,0.00
2024-12-08 16:52:32,58,2283,24,34,1210.68,2319.02,0.00
2024-12-08 16:52:32,57,2283,23,34,1219.75,2319.18,0.00
2024-12-08 16:52:32,57,2284,23,34,1225.53,2320.00,0.00
2024-12-08 16:52:32,58,2284,24,34,1204.40,2320.02,0.00
2024-12-08 16:52:32,57,2284,24,33,1224.31,2320.04,0.00
2024-12-08 16:52:32,56,2284,23,33,1232.62,2320.34,0.00
2024-12-08 16:52:32,56,2285,23,33,1259.14,2321.00,0.00
2024-12-08 16:52:32,57,2285,23,34,1237.05,2321.02,0.00
2024-12-08 16:52:32,57,2286,23,34,1231.07,2322.00,0.00
2024-12-08 16:52:32,58,2286,23,35,1209.84,2322.02,0.00
2024-12-08 16:52:32,57,2286,23,34,1229.44,2322.04,0.00
2024-12-08 16:52:32,56,2286,22,34,1220.59,2322.66,0.00
2024-12-08 16:52:32,55,2286,21,34,1242.37,2322.67,0.00
2024-12-08 16:52:32,55,2287,21,34,1277.23,2323.00,0.00
2024-12-08 16:52:32,56,2287,22,34,1254.42,2323.02,0.00
2024-12-08 16:52:32,55,2287,21,34,1257.06,2323.31,0.00
2024-12-08 16:52:32,54,2287,20,34,1271.93,2323.67,0.00
2024-12-08 16:52:32,54,2288,20,34,1307.47,2324.00,0.00
2024-12-08 16:52:32,55,2288,21,34,1283.69,2324.02,0.00
2024-12-08 16:52:32,54,2288,21,33,1305.31,2324.04,0.00
2024-12-08 16:52:32,54,2289,21,33,1309.32,2325.00,0.00
2024-12-08 16:52:32,55,2289,21,34,1285.51,2325.02,0.00
2024-12-08 16:52:32,55,2290,21,34,1280.15,2326.00,0.00
2024-12-08 16:52:32,56,2290,21,35,1257.29,2326.02,0.00
2024-12-08 16:52:32,55,2290,21,34,1278.03,2326.04,0.00
2024-12-08 16:52:32,55,2291,21,34,1281.54,2327.00,0.00
2024-12-08 16:52:32,56,2291,21,35,1258.66,2327.02,0.00
2024-12-08 16:52:32,56,2292,21,35,1252.96,2328.00,0.00
2024-12-08 16:52:32,57,2292,21,36,1230.98,2328.02,0.00
2024-12-08 16:52:32,56,2292,21,35,1249.64,2328.05,0.00
2024-12-08 16:52:32,55,2292,20,35,1253.90,2328.44,0.00
2024-12-08 16:52:32,55,2293,20,35,1283.49,2329.00,0.00
2024-12-08 16:52:32,56,2293,20,36,1260.57,2329.02,0.00
2024-12-08 16:52:32,55,2293,20,35,1283.07,2329.02,0.00
2024-12-08 16:52:32,54,2293,19,35,1280.54,2329.11,0.00
2024-12-08 16:52:32,54,2294,19,35,1303.51,2330.00,0.00
2024-12-08 16:52:32,55,2294,20,35,1279.81,2330.02,0.00
2024-12-08 16:52:32,54,2294,20,34,1299.63,2330.04,0.00
2024-12-08 16:52:32,54,2295,20,34,1303.63,2331.00,0.00
2024-12-08 16:52:32,55,2295,21,34,1279.93,2331.02,0.00
2024-12-08 16:52:32,55,2296,21,34,1274.76,2332.00,0.00
2024-12-08 16:52:32,56,2296,22,34,1252.00,2332.02,0.00
2024-12-08 16:52:32,55,2296,22,33,1271.37,2332.04,0.00
2024-12-08 16:52:32,55,2297,22,33,1274.88,2333.00,0.00
2024-12-08 16:52:32,56,2297,23,33,1252.12,2333.02,0.00
2024-12-08 16:52:32,56,2298,23,33,1247.12,2334.00,0.00
2024-12-08 16:52:32,57,2298,24,33,1225.24,2334.02,0.00
2024-12-08 16:52:32,56,2298,24,32,1243.37,2334.04,0.00
2024-12-08 16:52:32,56,2299,24,32,1246.40,2335.00,0.00
2024-12-08 16:52:32,57,2299,24,33,1224.54,2335.02,0.00
2024-12-08 16:52:32,57,2300,24,33,1219.46,2336.00,0.00
2024-12-08 16:52:32,58,2300,25,33,1198.43,2336.02,0.00
2024-12-08 16:52:32,57,2300,25,32,1216.18,2336.04,0.00
2024-12-08 16:52:32,56,2300,24,32,1223.16,2336.66,0.00
2024-12-08 16:52:32,55,2300,23,32,1230.19,2336.96,0.00
2024-12-08 16:52:32,55,2301,23,32,1271.85,2337.00,0.00
2024-12-08 16:52:32,56,2301,23,33,1249.14,2337.02,0.00
2024-12-08 16:52:32,55,2301,22,33,1247.64,2337.07,0.00
2024-12-08 16:52:32,55,2302,22,33,1268.99,2338.00,0.00
2024-12-08 16:52:32,56,2302,23,33,1246.33,2338.02,0.00
2024-12-08 16:52:32,55,2302,23,32,1264.75,2338.04,0.00
2024-12-08 16:52:32,54,2302,22,32,1270.98,2338.39,0.00
2024-12-08 16:52:32,54,2303,22,32,1300.41,2339.00,0.00
2024-12-08 16:52:32,55,2303,23,32,1276.77,2339.02,0.00
2024-12-08 16:52:32,55,2304,23,32,1272.90,2340.00,0.00
2024-12-08 16:52:32,56,2304,24,32,1250.17,2340.02,0.00
2024-12-08 16:52:32,55,2304,24,31,1268.22,2340.04,0.00
2024-12-08 16:52:32,55,2305,24,31,1271.74,2341.00,0.00
2024-12-08 16:52:32,56,2305,25,31,1249.03,2341.02,0.00
2024-12-08 16:52:32,56,2306,25,31,1245.05,2342.00,0.00
2024-12-08 16:52:32,57,2306,25,32,1223.20,2342.02,0.00
2024-12-08 16:52:32,56,2306,25,31,1240.45,2342.04,0.00
2024-12-08 16:52:32,56,2307,25,31,1243.48,2343.00,0.00
2024-12-08 16:52:32,57,2307,25,32,1221.67,2343.02,0.00
2024-12-08 16:52:32,57,2308,25,32,1218.63,2344.00,0.00
2024-12-08 16:52:32,58,2308,26,32,1197.62,2344.02,0.00
2024-12-08 16:52:32,57,2308,26,31,1212.87,2344.04,0.00
2024-12-08 16:52:32,57,2309,26,31,1215.44,2345.00,0.00
2024-12-08 16:52:32,58,2309,26,32,1194.49,2345.02,0.00
2024-12-08 16:52:32,57,2309,25,32,1192.37,2345.65,0.00
2024-12-08 16:52:32,57,2310,25,32,1211.15,2346.00,0.00
2024-12-08 16:52:32,58,2310,25,33,1190.27,2346.02,0.00
2024-12-08 16:52:32,57,2310,25,32,1207.45,2346.04,0.00
2024-12-08 16:52:33,57,2311,25,32,1210.02,2347.00,0.00
2024-12-08 16:52:33,58,2311,25,33,1189.16,2347.02,0.00
2024-12-08 16:52:33,57,2311,24,33,1198.53,2347.16,0.00
2024-12-08 16:52:33,56,2311,23,33,1201.37,2347.77,0.00
2024-12-08 16:52:33,56,2312,23,33,1238.01,2348.00,0.00
2024-12-08 16:52:33,57,2312,24,33,1216.29,2348.02,0.00
2024-12-08 16:52:33,56,2312,24,32,1233.82,2348.04,0.00
2024-12-08 16:52:33,56,2313,24,32,1236.86,2349.00,0.00
2024-12-08 16:52:33,57,2313,25,32,1215.16,2349.02,0.00
2024-12-08 16:52:33,56,2313,24,32,1224.73,2349.16,0.00
2024-12-08 16:52:33,56,2314,24,32,1232.81,2350.00,0.00
2024-12-08 16:52:33,57,2314,25,32,1211.18,2350.02,0.00
2024-12-08 16:52:33,56,2314,25,31,1228.62,2350.04,0.00
2024-12-08 16:52:33,56,2315,25,31,1231.66,2351.00,0.00
2024-12-08 16:52:33,57,2315,26,31,1210.05,2351.02,0.00
2024-12-08 16:52:33,56,2315,25,31,1231.24,2351.02,0.00
2024-12-08 16:52:33,56,2316,25,31,1227.16,2352.00,0.00
2024-12-08 16:52:33,57,2316,25,32,1205.63,2352.02,0.00
2024-12-08 16:52:33,56,2316,25,31,1223.80,2352.02,0.00
2024-12-08 16:52:33,56,2317,25,31,1226.42,2353.00,0.00
2024-12-08 16:52:33,57,2317,26,31,1204.90,2353.02,0.00
2024-12-08 16:52:33,56,2317,25,31,1215.94,2353.11,0.00
2024-12-08 16:52:33,56,2318,25,31,1222.06,2354.00,0.00
2024-12-08 16:52:33,57,2318,26,31,1200.62,2354.02,0.00
2024-12-08 16:52:33,56,2318,26,30,1219.11,2354.02,0.00
2024-12-08 16:52:33,56,2319,26,30,1221.73,2355.00,0.00
2024-12-08 16:52:33,57,2319,26,31,1200.30,2355.02,0.00
2024-12-08 16:52:33,57,2320,26,31,1195.39,2356.00,0.00
2024-12-08 16:52:33,58,2320,27,31,1174.78,2356.02,0.00
2024-12-08 16:52:33,57,2320,27,30,1192.50,2356.02,0.00
2024-12-08 16:52:33,56,2320,26,30,1212.13,2356.09,0.00
2024-12-08 16:52:33,56,2321,26,30,1216.41,2357.00,0.00
2024-12-08 16:52:33,57,2321,26,31,1195.07,2357.02,0.00
2024-12-08 16:52:33,56,2321,25,31,1203.41,2357.14,0.00
2024-12-08 16:52:33,56,2322,25,31,1225.77,2358.00,0.00
2024-12-08 16:52:33,57,2322,26,31,1204.27,2358.02,0.00
2024-12-08 16:52:33,56,2322,26,30,1222.82,2358.02,0.00
2024-12-08 16:52:33,55,2322,25,30,1218.50,2358.55,0.00
2024-12-08 16:52:33,55,2323,25,30,1250.94,2359.00,0.00
2024-12-08 16:52:33,56,2323,26,30,1228.61,2359.02,0.00
2024-12-08 16:52:33,56,2324,26,30,1223.49,2360.00,0.00
2024-12-08 16:52:33,57,2324,27,30,1202.03,2360.02,0.00
2024-12-08 16:52:33,56,2324,27,29,1220.96,2360.02,0.00
2024-12-08 16:52:33,56,2325,27,29,1223.59,2361.00,0.00
2024-12-08 16:52:33,57,2325,28,29,1202.12,2361.02,0.00
2024-12-08 16:52:33,57,2326,28,29,1196.90,2362.00,0.00
2024-12-08 16:52:33,58,2326,29,29,1176.26,2362.02,0.00
2024-12-08 16:52:33,57,2326,29,28,1194.41,2362.02,0.00
2024-12-08 16:52:33,57,2327,29,28,1196.58,2363.00,0.00
2024-12-08 16:52:33,58,2327,30,28,1175.95,2363.02,0.00
2024-12-08 16:52:33,58,2328,30,28,1172.45,2364.00,0.00
2024-12-08 16:52:33,59,2328,30,29,1152.58,2364.02,0.00
2024-12-08 16:52:33,58,2328,30,28,1167.97,2364.02,0.00
2024-12-08 16:52:33,57,2328,29,28,1176.52,2364.53,0.00
2024-12-08 16:52:33,56,2328,28,28,1195.79,2364.61,0.00
2024-12-08 16:52:33,56,2329,28,28,1212.09,2365.00,0.00
2024-12-08 16:52:33,57,2329,28,29,1190.83,2365.02,0.00
2024-12-08 16:52:33,56,2329,27,29,1202.39,2365.07,0.00
2024-12-08 16:52:33,56,2330,27,29,1209.10,2366.00,0.00
2024-12-08 16:52:33,57,2330,27,30,1187.89,2366.02,0.00
2024-12-08 16:52:33,56,2330,27,29,1204.45,2366.02,0.00
2024-12-08 16:52:33,55,2330,26,29,1225.50,2366.05,0.00
2024-12-08 16:52:33,54,2330,25,29,1237.11,2366.52,0.00
2024-12-08 16:52:33,53,2330,24,29,1249.35,2366.72,0.00
2024-12-08 16:52:33,53,2331,24,29,1287.50,2367.00,0.00
2024-12-08 16:52:33,54,2331,25,29,1263.66,2367.02,0.00
2024-12-08 16:52:33,53,2331,24,29,1277.68,2367.06,0.00
2024-12-08 16:52:33,52,2331,23,29,1291.46,2367.52,0.00
2024-12-08 16:52:33,52,2332,23,29,1309.92,2368.00,0.00
2024-12-08 16:52:33,53,2332,23,30,1285.20,2368.02,0.00
2024-12-08 16:52:33,52,2332,23,29,1304.00,2368.04,0.00
2024-12-08 16:52:33,52,2333,23,29,1309.10,2369.00,0.00
2024-12-08 16:52:33,53,2333,23,30,1284.40,2369.02,0.00
2024-12-08 16:52:33,52,2333,22,30,1274.95,2369.81,0.00
2024-12-08 16:52:33,52,2334,22,30,1316.11,2370.00,0.00
2024-12-08 16:52:33,53,2334,23,30,1291.28,2370.02,0.00
2024-12-08 16:52:33,52,2334,23,29,1306.55,2370.06,0.00
2024-12-08 16:52:33,52,2335,23,29,1312.11,2371.00,0.00
2024-12-08 16:52:33,53,2335,23,30,1287.35,2371.02,0.00
2024-12-08 16:52:33,52,2335,22,30,1296.20,2371.17,0.00
2024-12-08 16:52:33,52,2336,22,30,1322.70,2372.00,0.00
2024-12-08 16:52:33,53,2336,22,31,1297.74,2372.02,0.00
2024-12-08 16:52:33,52,2336,22,30,1313.58,2372.06,0.00
2024-12-08 16:52:33,52,2337,22,30,1319.15,2373.00,0.00
2024-12-08 16:52:33,53,2337,23,30,1294.26,2373.02,0.00
2024-12-08 16:52:33,53,2338,23,30,1292.65,2374.00,0.00
2024-12-08 16:52:33,54,2338,24,30,1268.71,2374.02,0.00
2024-12-08 16:52:33,53,2338,23,30,1291.67,2374.04,0.00
2024-12-08 16:52:33,52,2338,23,29,1308.75,2374.04,0.00
2024-12-08 16:52:33,52,2339,23,29,1332.13,2375.00,0.00
2024-12-08 16:52:33,53,2339,23,30,1307.00,2375.02,0.00
2024-12-08 16:52:33,53,2340,23,30,1305.11,2376.00,0.00
2024-12-08 16:52:33,54,2340,24,30,1280.94,2376.02,0.00
2024-12-08 16:52:33,53,2340,24,29,1297.49,2376.04,0.00
2024-12-08 16:52:34,52,2340,23,29,1321.54,2376.08,0.00
2024-12-08 16:52:34,51,2340,22,29,1318.31,2376.90,0.00
2024-12-08 16:52:34,51,2341,22,29,1362.66,2377.00,0.00
2024-12-08 16:52:34,52,2341,23,29,1336.45,2377.02,0.00
2024-12-08 16:52:34,51,2341,22,29,1339.21,2377.61,0.00
2024-12-08 16:52:34,51,2342,22,29,1360.51,2378.00,0.00
2024-12-08 16:52:34,52,2342,23,29,1334.35,2378.02,0.00
2024-12-08 16:52:34,51,2342,23,28,1353.05,2378.04,0.00
2024-12-08 16:52:34,50,2342,22,28,1369.34,2378.50,0.00
2024-12-08 16:52:34,50,2343,22,28,1386.33,2379.00,0.00
2024-12-08 16:52:34,51,2343,22,29,1359.15,2379.02,0.00
2024-12-08 16:52:34,51,2344,22,29,1356.78,2380.00,0.00
2024-12-08 16:52:34,52,2344,22,30,1330.68,2380.02,0.00
2024-12-08 16:52:34,51,2344,22,29,1349.31,2380.04,0.00
2024-12-08 16:52:34,50,2344,21,29,1344.62,2380.96,0.00
2024-12-08 16:52:34,50,2345,21,29,1391.31,2381.00,0.00
2024-12-08 16:52:34,51,2345,21,30,1364.03,2381.02,0.00
2024-12-08 16:52:34,51,2346,21,30,1362.57,2382.00,0.00
2024-12-08 16:52:34,52,2346,21,31,1336.37,2382.02,0.00
2024-12-08 16:52:34,51,2346,21,30,1354.16,2382.04,0.00
2024-12-08 16:52:34,51,2347,21,30,1359.87,2383.00,0.00
2024-12-08 16:52:34,52,2347,22,30,1333.72,2383.02,0.00
2024-12-08 16:52:34,53,2346,22,31,1292.05,2383.38,0.00
2024-12-08 16:52:34,52,2346,21,31,1312.37,2383.92,0.00
2024-12-08 16:52:34,52,2347,21,31,1356.44,2384.00,0.00
2024-12-08 16:52:34,53,2347,21,32,1330.85,2384.02,0.00
2024-12-08 16:52:34,52,2347,21,31,1348.65,2384.04,0.00
2024-12-08 16:52:34,52,2348,21,31,1399.67,2385.00,0.00
2024-12-08 16:52:34,53,2348,22,31,1373.26,2385.02,0.00
2024-12-08 16:52:34,53,2349,22,31,1370.90,2386.00,0.00
2024-12-08 16:52:34,54,2349,22,32,1345.51,2386.02,0.00
2024-12-08 16:52:34,53,2349,21,32,1370.24,2386.04,0.00
2024-12-08 16:52:34,52,2349,21,31,1389.24,2386.04,0.00
2024-12-08 16:52:34,52,2350,21,31,1394.41,2387.00,0.00
2024-12-08 16:52:34,53,2350,21,32,1368.11,2387.02,0.00
2024-12-08 16:52:34,53,2351,21,32,1365.53,2388.00,0.00
2024-12-08 16:52:34,54,2351,22,32,1340.24,2388.02,0.00
2024-12-08 16:52:34,53,2351,22,31,1358.32,2388.04,0.00
2024-12-08 16:52:34,52,2351,21,31,1352.38,2388.96,0.00
2024-12-08 16:52:34,52,2352,21,31,1397.42,2389.00,0.00
2024-12-08 16:52:34,53,2352,21,32,1371.05,2389.02,0.00
2024-12-08 16:52:34,53,2353,21,32,1368.96,2390.00,0.00
2024-12-08 16:52:34,54,2353,21,33,1343.61,2390.02,0.00
2024-12-08 16:52:34,53,2353,21,32,1360.85,2390.06,0.00
2024-12-08 16:52:34,52,2353,20,32,1358.49,2390.89,0.00
2024-12-08 16:52:34,52,2354,20,32,1401.81,2391.00,0.00
2024-12-08 16:52:34,53,2354,20,33,1375.36,2391.02,0.00
2024-12-08 16:52:34,53,2355,20,33,1373.09,2392.00,0.00
2024-12-08 16:52:34,54,2355,21,33,1347.67,2392.02,0.00
2024-12-08 16:52:34,53,2355,21,32,1365.43,2392.06,0.00
2024-12-08 16:52:34,52,2355,20,32,1390.33,2392.12,0.00
2024-12-08 16:52:34,52,2356,20,32,1397.32,2393.00,0.00
2024-12-08 16:52:34,53,2356,20,33,1370.96,2393.02,0.00
2024-12-08 16:52:34,52,2356,19,33,1373.51,2393.31,0.00
2024-12-08 16:52:34,51,2356,18,33,1393.98,2393.59,0.00
2024-12-08 16:52:34,51,2357,18,33,1431.39,2394.00,0.00
2024-12-08 16:52:34,52,2357,18,34,1403.87,2394.02,0.00
2024-12-08 16:52:34,51,2357,18,33,1423.89,2394.06,0.00
2024-12-08 16:52:34,50,2357,17,33,1443.35,2394.22,0.00
2024-12-08 16:52:34,50,2358,17,33,1473.09,2395.00,0.00
2024-12-08 16:52:34,51,2358,17,34,1444.20,2395.02,0.00
2024-12-08 16:52:34,50,2358,16,34,1438.79,2395.48,0.00
2024-12-08 16:52:34,50,2359,16,34,1474.66,2396.00,0.00
2024-12-08 16:52:34,51,2359,17,34,1445.74,2396.02,0.00
2024-12-08 16:52:34,50,2359,16,34,1473.70,2396.02,0.00
2024-12-08 16:52:34,49,2359,16,33,1496.94,2396.04,0.00
2024-12-08 16:52:34,49,2360,16,33,1523.48,2397.00,0.00
2024-12-08 16:52:34,50,2360,16,34,1493.01,2397.02,0.00
2024-12-08 16:52:34,50,2361,16,34,1489.32,2398.00,0.00
2024-12-08 16:52:34,51,2361,17,34,1460.12,2398.02,0.00
2024-12-08 16:52:34,50,2361,17,33,1483.09,2398.04,0.00
2024-12-08 16:52:34,49,2361,16,33,1494.41,2398.37,0.00
2024-12-08 16:52:34,49,2362,16,33,1528.67,2399.00,0.00
2024-12-08 16:52:34,50,2362,17,33,1498.10,2399.02,0.00
2024-12-08 16:52:34,49,2362,16,33,1510.56,2399.04,0.00
2024-12-08 16:52:34,49,2363,16,33,1527.35,2400.00,0.00
2024-12-08 16:52:34,50,2363,17,33,1496.80,2400.02,0.00
2024-12-08 16:52:34,49,2363,17,32,1519.03,2400.04,0.00
2024-12-08 16:52:34,49,2364,17,32,1526.03,2401.00,0.00
2024-12-08 16:52:34,50,2364,17,33,1495.50,2401.02,0.00
2024-12-08 16:52:34,50,2365,17,33,1492.94,2402.00,0.00
2024-12-08 16:52:34,51,2365,18,33,1463.66,2402.02,0.00
2024-12-08 16:52:34,50,2365,18,32,1484.77,2402.04,0.00
2024-12-08 16:52:34,49,2365,17,32,1502.73,2402.55,0.00
2024-12-08 16:52:34,49,2366,17,32,1521.73,2403.00,0.00
2024-12-08 16:52:34,50,2366,17,33,1491.30,2403.02,0.00
2024-12-08 16:52:34,50,2367,17,33,1489.66,2404.00,0.00
2024-12-08 16:52:34,51,2367,17,34,1460.45,2404.02,0.00
2024-12-08 16:52:34,50,2367,17,33,1479.57,2404.06,0.00
2024-12-08 16:52:34,50,2368,17,33,1486.43,2405.00,0.00
2024-12-08 16:52:34,51,2368,17,34,1457.29,2405.02,0.00
2024-12-08 16:52:34,50,2368,16,34,1468.69,2405.18,0.00
2024-12-08 16:52:35,50,2369,16,34,1497.64,2406.00,0.00
2024-12-08 16:52:35,51,2369,16,35,1468.27,2406.02,0.00
2024-12-08 16:52:35,50,2369,15,35,1482.28,2406.14,0.00
2024-12-08 16:52:35,50,2370,15,35,1510.29,2407.00,0.00
2024-12-08 16:52:35,51,2370,15,36,1480.68,2407.02,0.00
2024-12-08 16:52:35,50,2370,14,36,1491.27,2407.18,0.00
2024-12-08 16:52:35,50,2371,14,36,1520.25,2408.00,0.00
2024-12-08 16:52:35,51,2371,14,37,1490.44,2408.02,0.00
2024-12-08 16:52:35,50,2371,14,36,1511.59,2408.06,0.00
2024-12-08 16:52:35,49,2371,13,36,1533.64,2408.18,0.00
2024-12-08 16:52:35,49,2372,13,36,1563.72,2409.00,0.00
2024-12-08 16:52:35,50,2372,13,37,1532.44,2409.02,0.00
2024-12-08 16:52:35,50,2373,13,37,1528.74,2410.00,0.00
2024-12-08 16:52:35,51,2373,14,37,1498.77,2410.02,0.00
2024-12-08 16:52:35,50,2373,14,36,1520.07,2410.06,0.00
2024-12-08 16:52:35,50,2374,14,36,1526.96,2411.00,0.00
2024-12-08 16:52:35,51,2374,14,37,1497.02,2411.02,0.00
2024-12-08 16:52:35,51,2375,14,37,1493.48,2412.00,0.00
2024-12-08 16:52:35,52,2375,14,38,1464.76,2412.02,0.00
2024-12-08 16:52:35,51,2375,14,37,1485.45,2412.06,0.00
2024-12-08 16:52:35,50,2375,13,37,1501.50,2412.62,0.00
2024-12-08 16:52:35,50,2376,13,37,1521.57,2413.00,0.00
2024-12-08 16:52:35,51,2376,14,37,1491.73,2413.02,0.00
2024-12-08 16:52:35,50,2376,13,37,1480.56,2413.96,0.00
2024-12-08 16:52:35,50,2377,13,37,1527.90,2414.00,0.00
2024-12-08 16:52:35,51,2377,13,38,1497.94,2414.02,0.00
2024-12-08 16:52:35,50,2377,13,37,1520.18,2414.06,0.00
2024-12-08 16:52:35,50,2378,13,37,1527.08,2415.00,0.00
2024-12-08 16:52:35,51,2378,13,38,1497.14,2415.02,0.00
2024-12-08 16:52:35,51,2379,13,38,1493.91,2416.00,0.00
2024-12-08 16:52:35,52,2379,13,39,1465.18,2416.02,0.00
2024-12-08 16:52:35,51,2379,13,38,1484.91,2416.06,0.00
2024-12-08 16:52:35,51,2380,13,38,1491.21,2417.00,0.00
2024-12-08 16:52:35,52,2380,13,39,1462.53,2417.02,0.00
2024-12-08 16:52:35,52,2381,13,39,1460.10,2418.00,0.00
2024-12-08 16:52:35,53,2381,13,40,1432.55,2418.02,0.00
2024-12-08 16:52:35,52,2381,13,39,1450.81,2418.06,0.00
2024-12-08 16:52:35,51,2381,12,39,1449.22,2418.92,0.00
2024-12-08 16:52:35,51,2382,12,39,1494.81,2419.00,0.00
2024-12-08 16:52:35,52,2382,13,39,1466.07,2419.02,0.00
2024-12-08 16:52:35,52,2383,13,39,1463.78,2420.00,0.00
2024-12-08 16:52:35,53,2383,13,40,1436.16,2420.02,0.00
2024-12-08 16:52:35,52,2383,13,39,1454.48,2420.06,0.00
2024-12-08 16:52:35,52,2384,13,39,1460.20,2421.00,0.00
2024-12-08 16:52:35,53,2384,13,40,1432.64,2421.02,0.00
2024-12-08 16:52:35,52,2384,12,40,1436.60,2421.62,0.00
2024-12-08 16:52:35,52,2385,12,40,1459.93,2422.00,0.00
2024-12-08 16:52:35,53,2385,12,41,1432.38,2422.02,0.00
2024-12-08 16:52:35,52,2385,11,41,1459.00,2422.06,0.00
2024-12-08 16:52:35,51,2385,10,41,1464.24,2422.63,0.00
2024-12-08 16:52:35,50,2385,9,41,1472.73,2422.96,0.00
2024-12-08 16:52:35,50,2386,9,41,1520.24,2423.00,0.00
2024-12-08 16:52:35,51,2386,10,41,1490.43,2423.02,0.00
2024-12-08 16:52:35,50,2386,10,40,1517.82,2423.08,0.00
2024-12-08 16:52:35,49,2386,9,40,1533.15,2423.65,0.00
2024-12-08 16:52:35,49,2387,9,40,1574.51,2424.00,0.00
2024-12-08 16:52:35,50,2387,10,40,1543.02,2424.02,0.00
2024-12-08 16:52:35,49,2387,9,40,1574.01,2424.02,0.00
2024-12-08 16:52:35,49,2388,9,40,1572.23,2425.00,0.00
2024-12-08 16:52:35,50,2388,9,41,1540.79,2425.02,0.00
2024-12-08 16:52:35,49,2388,9,40,1560.86,2425.06,0.00
2024-12-08 16:52:35,49,2389,9,40,1568.42,2426.00,0.00
2024-12-08 16:52:35,50,2389,10,40,1537.05,2426.02,0.00
2024-12-08 16:52:35,49,2389,9,40,1528.60,2426.57,0.00
2024-12-08 16:52:35,49,2390,9,40,1568.08,2427.00,0.00
2024-12-08 16:52:35,50,2390,9,41,1536.72,2427.02,0.00
2024-12-08 16:52:35,49,2390,9,40,1557.19,2427.06,0.00
2024-12-08 16:52:35,49,2391,9,40,1564.76,2428.00,0.00
2024-12-08 16:52:35,50,2391,10,40,1533.46,2428.02,0.00
2024-12-08 16:52:35,50,2392,10,40,1530.51,2429.00,0.00
2024-12-08 16:52:35,51,2392,10,41,1500.50,2429.02,0.00
2024-12-08 16:52:35,50,2392,10,40,1519.83,2429.06,0.00
2024-12-08 16:52:35,50,2393,10,40,1526.77,2430.00,0.00
2024-12-08 16:52:35,51,2393,10,41,1496.83,2430.02,0.00
2024-12-08 16:52:35,51,2394,10,41,1494.02,2431.00,0.00
2024-12-08 16:52:35,52,2394,10,42,1465.28,2431.02,0.00
2024-12-08 16:52:35,51,2394,10,41,1484.01,2431.06,0.00
2024-12-08 16:52:35,50,2394,9,41,1482.28,2431.96,0.00
2024-12-08 16:52:35,50,2395,9,41,1529.97,2432.00,0.00
2024-12-08 16:52:35,51,2395,9,42,1499.97,2432.02,0.00
2024-12-08 16:52:35,50,2395,8,42,1515.58,2432.12,0.00
2024-12-08 16:52:35,50,2396,8,42,1543.43,2433.00,0.00
2024-12-08 16:52:35,51,2396,9,42,1513.17,2433.02,0.00
2024-12-08 16:52:36,51,2397,9,42,1511.38,2434.00,0.00
2024-12-08 16:52:36,52,2397,10,42,1482.31,2434.02,0.00
2024-12-08 16:52:36,52,2398,10,42,1477.77,2435.00,0.00
2024-12-08 16:52:36,53,2398,10,43,1449.89,2435.02,0.00
2024-12-08 16:52:36,52,2398,10,42,1474.98,2435.12,0.00
2024-12-08 16:52:36,52,2399,10,42,1482.13,2436.00,0.00
2024-12-08 16:52:36,53,2399,10,43,1454.16,2436.02,0.00
2024-12-08 16:52:36,53,2400,10,43,1452.62,2437.00,0.00
2024-12-08 16:52:36,54,2400,11,43,1425.72,2437.02,0.00
2024-12-08 16:52:36,53,2400,10,43,1428.62,2437.26,0.00
2024-12-08 16:52:36,53,2401,10,43,1457.19,2438.00,0.00
2024-12-08 16:52:36,54,2401,10,44,1430.21,2438.02,0.00
2024-12-08 16:52:36,53,2401,9,44,1455.01,2438.09,0.00
2024-12-08 16:52:36,52,2401,9,43,1482.05,2438.10,0.00
2024-12-08 16:52:36,52,2402,9,43,1488.74,2439.00,0.00
2024-12-08 16:52:36,53,2402,10,43,1460.65,2439.02,0.00
2024-12-08 16:52:36,53,2403,10,43,1458.15,2440.00,0.00
2024-12-08 16:52:36,54,2403,11,43,1431.14,2440.02,0.00
2024-12-08 16:52:36,53,2403,10,43,1457.69,2440.02,0.00
2024-12-08 16:52:36,52,2403,10,42,1474.47,2440.08,0.00
2024-12-08 16:52:36,52,2404,10,42,1480.69,2441.00,0.00
2024-12-08 16:52:36,53,2404,11,42,1452.76,2441.02,0.00
2024-12-08 16:52:36,52,2404,10,42,1441.65,2441.89,0.00
2024-12-08 16:52:36,52,2405,10,42,1485.88,2442.00,0.00
2024-12-08 16:52:36,53,2405,11,42,1457.84,2442.02,0.00
2024-12-08 16:52:36,52,2405,11,41,1480.71,2442.04,0.00
2024-12-08 16:52:36,52,2406,11,41,1486.01,2443.00,0.00
2024-12-08 16:52:36,53,2406,12,41,1457.98,2443.02,0.00
2024-12-08 16:52:36,53,2407,12,41,1453.04,2444.00,0.00
2024-12-08 16:52:36,54,2407,12,42,1426.13,2444.02,0.00
2024-12-08 16:52:36,53,2407,12,41,1448.43,2444.04,0.00
2024-12-08 16:52:36,53,2408,12,41,1453.17,2445.00,0.00
2024-12-08 16:52:36,54,2408,13,41,1426.26,2445.02,0.00
2024-12-08 16:52:36,53,2408,13,40,1444.87,2445.04,0.00
2024-12-08 16:52:36,52,2408,12,40,1443.12,2445.94,0.00
2024-12-08 16:52:36,52,2409,12,40,1488.78,2446.00,0.00
2024-12-08 16:52:36,53,2409,12,41,1460.69,2446.02,0.00
2024-12-08 16:52:36,53,2410,12,41,1455.82,2447.00,0.00
2024-12-08 16:52:36,54,2410,12,42,1428.86,2447.02,0.00
2024-12-08 16:52:36,53,2410,12,41,1447.98,2447.04,0.00
2024-12-08 16:52:36,52,2410,11,41,1451.28,2447.85,0.00
2024-12-08 16:52:36,52,2411,11,41,1494.70,2448.00,0.00
2024-12-08 16:52:36,53,2411,11,42,1466.50,2448.02,0.00
2024-12-08 16:52:36,52,2411,10,42,1451.26,2448.67,0.00
2024-12-08 16:52:36,52,2412,10,42,1490.61,2449.00,0.00
2024-12-08 16:52:36,53,2412,10,43,1462.48,2449.02,0.00
2024-12-08 16:52:36,52,2412,10,42,1483.07,2449.04,0.00
2024-12-08 16:52:36,52,2413,10,42,1488.39,2450.00,0.00
2024-12-08 16:52:36,53,2413,11,42,1460.30,2450.02,0.00
2024-12-08 16:52:36,52,2413,10,42,1454.92,2450.83,0.00
2024-12-08 16:52:36,52,2414,10,42,1497.95,2451.00,0.00
2024-12-08 16:52:36,53,2414,11,42,1469.69,2451.02,0.00
2024-12-08 16:52:36,52,2414,11,41,1490.88,2451.04,0.00
2024-12-08 16:52:36,52,2415,11,41,1496.20,2452.00,0.00
2024-12-08 16:52:36,53,2415,11,42,1467.97,2452.02,0.00
2024-12-08 16:52:36,53,2416,11,42,1463.02,2453.00,0.00
2024-12-08 16:52:36,54,2416,12,42,1435.93,2453.02,0.00
2024-12-08 16:52:36,53,2416,12,41,1456.08,2453.04,0.00
2024-12-08 16:52:36,52,2416,11,41,1453.52,2453.96,0.00
2024-12-08 16:52:36,52,2417,11,41,1499.78,2454.00,0.00
2024-12-08 16:52:36,53,2417,11,42,1471.49,2454.02,0.00
2024-12-08 16:52:36,53,2418,11,42,1466.53,2455.00,0.00
2024-12-08 16:52:36,54,2418,12,42,1439.37,2455.02,0.00
2024-12-08 16:52:36,53,2418,12,41,1460.04,2455.04,0.00
2024-12-08 16:52:36,53,2419,12,41,1464.81,2456.00,0.00
2024-12-08 16:52:36,54,2419,12,42,1437.68,2456.02,0.00
2024-12-08 16:52:36,54,2420,12,42,1432.37,2457.00,0.00
2024-12-08 16:52:36,55,2420,12,43,1406.32,2457.02,0.00
2024-12-08 16:52:36,54,2420,12,42,1426.00,2457.04,0.00
2024-12-08 16:52:36,53,2420,11,42,1423.30,2457.94,0.00
2024-12-08 16:52:36,53,2421,11,42,1468.32,2458.00,0.00
2024-12-08 16:52:36,54,2421,12,42,1441.13,2458.02,0.00
2024-12-08 16:52:36,54,2422,12,42,1435.79,2459.00,0.00
2024-12-08 16:52:36,55,2422,12,43,1409.69,2459.02,0.00
2024-12-08 16:52:36,54,2422,12,42,1429.87,2459.04,0.00
2024-12-08 16:52:36,54,2423,12,42,1434.10,2460.00,0.00
2024-12-08 16:52:36,55,2423,12,43,1408.03,2460.02,0.00
2024-12-08 16:52:36,54,2423,11,43,1422.69,2460.11,0.00
2024-12-08 16:52:36,53,2423,10,43,1421.49,2460.62,0.00
2024-12-08 16:52:36,53,2424,10,43,1458.93,2461.00,0.00
2024-12-08 16:52:36,54,2424,11,43,1431.91,2461.02,0.00
2024-12-08 16:52:36,53,2424,11,42,1453.35,2461.04,0.00
2024-12-08 16:52:36,53,2425,11,42,1458.13,2462.00,0.00
2024-12-08 16:52:36,54,2425,12,42,1431.12,2462.02,0.00
2024-12-08 16:52:36,53,2425,11,42,1457.66,2462.02,0.00
2024-12-08 16:52:36,52,2425,10,42,1454.64,2462.46,0.00
2024-12-08 16:52:36,52,2426,10,42,1489.14,2463.00,0.00
2024-12-08 16:52:36,53,2426,10,43,1461.04,2463.02,0.00
2024-12-08 16:52:36,52,2426,10,42,1483.93,2463.02,0.00
2024-12-08 16:52:37,52,2427,10,42,1488.79,2464.00,0.00
2024-12-08 16:52:37,53,2427,11,42,1460.70,2464.02,0.00
2024-12-08 16:52:37,52,2427,10,42,1464.00,2464.65,0.00
2024-12-08 16:52:37,52,2428,10,42,1484.18,2465.00,0.00
2024-12-08 16:52:37,53,2428,10,43,1456.18,2465.02,0.00
2024-12-08 16:52:37,52,2428,10,42,1479.44,2465.02,0.00
2024-12-08 16:52:37,52,2429,10,42,1484.31,2466.00,0.00
2024-12-08 16:52:37,53,2429,10,43,1456.31,2466.02,0.00
2024-12-08 16:52:37,52,2429,9,43,1454.63,2466.40,0.00
2024-12-08 16:52:37,52,2430,9,43,1487.79,2467.00,0.00
2024-12-08 16:52:37,53,2430,10,43,1459.72,2467.02,0.00
2024-12-08 16:52:37,52,2430,10,42,1483.52,2467.02,0.00
2024-12-08 16:52:37,51,2430,9,42,1483.17,2467.92,0.00
2024-12-08 16:52:37,51,2431,9,42,1529.68,2468.00,0.00
2024-12-08 16:52:37,52,2431,9,43,1500.26,2468.02,0.00
2024-12-08 16:52:37,52,2432,9,43,1495.64,2469.00,0.00
2024-12-08 16:52:37,53,2432,10,43,1467.42,2469.02,0.00
2024-12-08 16:52:37,52,2432,10,42,1491.37,2469.02,0.00
2024-12-08 16:52:37,51,2432,9,42,1488.47,2469.61,0.00
2024-12-08 16:52:37,51,2433,9,42,1527.53,2470.00,0.00
2024-12-08 16:52:37,52,2433,10,42,1498.15,2470.02,0.00
2024-12-08 16:52:37,52,2434,10,42,1493.53,2471.00,0.00
2024-12-08 16:52:37,53,2434,10,43,1465.35,2471.02,0.00
2024-12-08 16:52:37,52,2434,10,42,1488.30,2471.02,0.00
2024-12-08 16:52:37,52,2435,10,42,1493.18,2472.00,0.00
2024-12-08 16:52:37,53,2435,11,42,1465.01,2472.02,0.00
2024-12-08 16:52:37,53,2436,11,42,1460.00,2473.00,0.00
2024-12-08 16:52:37,54,2436,12,42,1432.97,2473.02,0.00
2024-12-08 16:52:37,53,2436,12,41,1454.87,2473.02,0.00
2024-12-08 16:52:37,52,2436,11,41,1451.55,2473.96,0.00
2024-12-08 16:52:37,52,2437,11,41,1498.20,2474.00,0.00
2024-12-08 16:52:37,53,2437,12,41,1469.93,2474.02,0.00
2024-12-08 16:52:37,53,2438,12,41,1464.92,2475.00,0.00
2024-12-08 16:52:37,54,2438,12,42,1437.79,2475.02,0.00
2024-12-08 16:52:37,53,2438,12,41,1460.25,2475.02,0.00
2024-12-08 16:52:37,53,2439,12,41,1464.58,2476.00,0.00
2024-12-08 16:52:37,54,2439,13,41,1437.46,2476.02,0.00
2024-12-08 16:52:37,54,2440,13,41,1432.07,2477.00,0.00
2024-12-08 16:52:37,55,2440,14,41,1406.03,2477.02,0.00
2024-12-08 16:52:37,54,2440,14,40,1427.94,2477.02,0.00
2024-12-08 16:52:37,54,2441,14,40,1431.73,2478.00,0.00
2024-12-08 16:52:37,55,2441,14,41,1405.70,2478.02,0.00
2024-12-08 16:52:37,55,2442,14,41,1399.96,2479.00,0.00
2024-12-08 16:52:37,56,2442,15,41,1374.96,2479.02,0.00
2024-12-08 16:52:37,55,2442,15,40,1396.35,2479.02,0.00
2024-12-08 16:52:37,55,2443,15,40,1399.62,2480.00,0.00
2024-12-08 16:52:37,56,2443,16,40,1374.63,2480.02,0.00
2024-12-08 16:52:37,55,2443,15,40,1359.57,2480.96,0.00
2024-12-08 16:52:37,55,2444,15,40,1403.79,2481.00,0.00
2024-12-08 16:52:37,56,2444,16,40,1378.73,2481.02,0.00
2024-12-08 16:52:37,55,2444,16,39,1400.64,2481.02,0.00
2024-12-08 16:52:37,55,2445,16,39,1403.91,2482.00,0.00
2024-12-08 16:52:37,56,2445,17,39,1378.84,2482.02,0.00
2024-12-08 16:52:37,56,2446,17,39,1372.74,2483.00,0.00
2024-12-08 16:52:37,57,2446,18,39,1348.66,2483.02,0.00
2024-12-08 16:52:37,56,2446,18,38,1370.08,2483.02,0.00
2024-12-08 16:52:37,55,2446,17,38,1363.92,2483.96,0.00
2024-12-08 16:52:37,55,2447,17,38,1408.20,2484.00,0.00
2024-12-08 16:52:37,56,2447,18,38,1383.06,2484.02,0.00
2024-12-08 16:52:37,56,2448,18,38,1376.96,2485.00,0.00
2024-12-08 16:52:37,57,2448,19,38,1352.80,2485.02,0.00
2024-12-08 16:52:37,56,2448,19,37,1374.74,2485.02,0.00
2024-12-08 16:52:37,56,2449,19,37,1377.51,2486.00,0.00
2024-12-08 16:52:37,57,2449,19,38,1353.34,2486.02,0.00
2024-12-08 16:52:37,57,2450,19,38,1346.91,2487.00,0.00
2024-12-08 16:52:37,58,2450,20,38,1323.68,2487.02,0.00
2024-12-08 16:52:37,57,2450,20,37,1344.72,2487.02,0.00
2024-12-08 16:52:37,57,2451,20,37,1347.01,2488.00,0.00
2024-12-08 16:52:37,58,2451,21,37,1323.79,2488.02,0.00
2024-12-08 16:52:37,58,2452,21,37,1317.02,2489.00,0.00
2024-12-08 16:52:37,59,2452,21,38,1294.70,2489.02,0.00
2024-12-08 16:52:37,58,2452,21,37,1315.31,2489.02,0.00
2024-12-08 16:52:37,57,2452,20,37,1308.31,2489.95,0.00
2024-12-08 16:52:37,57,2453,20,37,1350.72,2490.00,0.00
2024-12-08 16:52:37,58,2453,21,37,1327.43,2490.02,0.00
2024-12-08 16:52:37,58,2454,21,37,1320.66,2491.00,0.00
2024-12-08 16:52:37,59,2454,22,37,1298.28,2491.02,0.00
2024-12-08 16:52:37,58,2454,22,36,1318.94,2491.02,0.00
2024-12-08 16:52:37,58,2455,22,36,1320.76,2492.00,0.00
2024-12-08 16:52:37,59,2455,23,36,1298.37,2492.02,0.00
2024-12-08 16:52:37,59,2456,23,36,1291.29,2493.00,0.00
2024-12-08 16:52:37,60,2456,23,37,1269.77,2493.02,0.00
2024-12-08 16:52:37,59,2456,23,36,1288.34,2493.05,0.00
2024-12-08 16:52:38,59,2457,23,36,1290.54,2494.00,0.00
2024-12-08 16:52:38,60,2457,23,37,1269.03,2494.02,0.00
2024-12-08 16:52:38,60,2458,23,37,1261.64,2495.00,0.00
2024-12-08 16:52:38,61,2458,24,37,1240.96,2495.02,0.00
2024-12-08 16:52:38,60,2458,24,36,1259.15,2495.05,0.00
2024-12-08 16:52:38,60,2459,24,36,1260.90,2496.00,0.00
2024-12-08 16:52:38,61,2459,24,37,1240.23,2496.02,0.00
2024-12-08 16:52:38,60,2459,23,37,1229.48,2496.52,0.00
2024-12-08 16:52:38,60,2460,23,37,1259.32,2497.00,0.00
2024-12-08 16:52:38,61,2460,23,38,1238.68,2497.02,0.00
2024-12-08 16:52:38,60,2460,23,37,1256.83,2497.05,0.00
2024-12-08 16:52:38,59,2460,22,37,1271.84,2497.24,0.00
2024-12-08 16:52:38,58,2460,21,37,1282.39,2497.71,0.00
2024-12-08 16:52:38,58,2461,21,37,1318.34,2498.00,0.00
2024-12-08 16:52:38,59,2461,21,38,1296.00,2498.02,0.00
2024-12-08 16:52:38,59,2462,21,38,1288.89,2499.00,0.00
2024-12-08 16:52:38,60,2462,21,39,1267.41,2499.02,0.00
2024-12-08 16:52:38,59,2462,21,38,1286.78,2499.05,0.00
2024-12-08 16:52:38,58,2462,20,38,1302.99,2499.22,0.00
2024-12-08 16:52:38,58,2463,20,38,1327.16,2500.00,0.00
2024-12-08 16:52:38,59,2463,20,39,1304.66,2500.02,0.00
2024-12-08 16:52:38,58,2463,19,39,1289.89,2500.60,0.00
2024-12-08 16:52:38,58,2464,19,39,1323.37,2501.00,0.00
2024-12-08 16:52:38,59,2464,19,40,1300.94,2501.02,0.00
2024-12-08 16:52:38,58,2464,19,39,1321.65,2501.05,0.00
2024-12-08 16:52:38,58,2465,19,39,1324.33,2502.00,0.00
2024-12-08 16:52:38,59,2465,20,39,1301.89,2502.02,0.00
2024-12-08 16:52:38,59,2466,20,39,1294.88,2503.00,0.00
2024-12-08 16:52:38,60,2466,20,40,1273.30,2503.02,0.00
2024-12-08 16:52:38,59,2466,20,39,1292.76,2503.05,0.00
2024-12-08 16:52:38,59,2467,20,39,1294.97,2504.00,0.00
2024-12-08 16:52:38,60,2467,21,39,1273.39,2504.02,0.00
2024-12-08 16:52:38,60,2468,21,39,1266.39,2505.00,0.00
2024-12-08 16:52:38,61,2468,22,39,1245.63,2505.02,0.00
2024-12-08 16:52:38,60,2468,22,38,1264.31,2505.05,0.00
2024-12-08 16:52:38,61,2467,23,38,1241.95,2505.15,0.00
2024-12-08 16:52:38,60,2467,22,38,1278.36,2505.68,0.00
2024-12-08 16:52:38,60,2468,22,38,1295.72,2506.00,0.00
2024-12-08 16:52:38,61,2468,23,38,1274.47,2506.02,0.00
2024-12-08 16:52:38,60,2468,23,37,1291.54,2506.02,0.00
2024-12-08 16:52:38,60,2469,23,37,1334.26,2507.00,0.00
2024-12-08 16:52:38,61,2469,23,38,1312.38,2507.02,0.00
2024-12-08 16:52:38,60,2469,22,38,1304.77,2507.48,0.00
2024-12-08 16:52:38,60,2470,22,38,1333.95,2508.00,0.00
2024-12-08 16:52:38,61,2470,22,39,1312.08,2508.02,0.00
2024-12-08 16:52:38,60,2470,22,38,1332.70,2508.03,0.00
2024-12-08 16:52:38,59,2470,21,38,1340.25,2508.64,0.00
2024-12-08 16:52:38,59,2471,21,38,1374.11,2509.00,0.00
2024-12-08 16:52:38,60,2471,21,39,1351.21,2509.02,0.00
2024-12-08 16:52:38,60,2472,21,39,1343.80,2510.00,0.00
2024-12-08 16:52:38,61,2472,21,40,1321.77,2510.02,0.00
2024-12-08 16:52:38,60,2472,21,39,1342.96,2510.03,0.00
2024-12-08 16:52:38,60,2473,21,39,1344.34,2511.00,0.00
2024-12-08 16:52:38,61,2473,21,40,1322.30,2511.02,0.00
2024-12-08 16:52:38,60,2473,21,39,1335.13,2511.03,0.00
2024-12-08 16:52:38,60,2474,21,39,1336.50,2512.00,0.00
2024-12-08 16:52:38,61,2474,21,40,1314.59,2512.02,0.00
2024-12-08 16:52:38,60,2474,20,40,1323.99,2512.18,0.00
2024-12-08 16:52:38,60,2475,20,40,1342.34,2513.00,0.00
2024-12-08 16:52:38,61,2475,21,40,1320.33,2513.02,0.00
2024-12-08 16:52:38,61,2476,21,40,1324.25,2514.00,0.00
2024-12-08 16:52:38,62,2476,21,41,1302.89,2514.02,0.00
2024-12-08 16:52:38,62,2477,21,41,1303.05,2515.00,0.00
2024-12-08 16:52:38,63,2477,21,42,1282.37,2515.02,0.00
2024-12-08 16:52:38,62,2477,20,42,1278.16,2515.68,0.00
2024-12-08 16:52:38,62,2478,20,42,1297.29,2516.00,0.00
2024-12-08 16:52:38,63,2478,20,43,1276.70,2516.02,0.00
2024-12-08 16:52:38,62,2478,20,42,1296.89,2516.02,0.00
2024-12-08 16:52:38,61,2478,20,41,1313.61,2516.03,0.00
2024-12-08 16:52:38,61,2479,20,41,1314.54,2517.00,0.00
2024-12-08 16:52:38,62,2479,20,42,1293.34,2517.02,0.00
2024-12-08 16:52:38,61,2479,20,41,1305.88,2517.03,0.00
2024-12-08 16:52:38,60,2479,19,41,1322.25,2517.22,0.00
2024-12-08 16:52:38,60,2480,19,41,1344.96,2518.00,0.00
2024-12-08 16:52:38,61,2480,20,41,1322.91,2518.02,0.00
2024-12-08 16:52:38,60,2480,20,40,1335.73,2518.03,0.00
2024-12-08 16:52:38,59,2480,19,40,1339.20,2518.15,0.00
2024-12-08 16:52:38,59,2481,19,40,1361.04,2519.00,0.00
2024-12-08 16:52:38,60,2481,20,40,1338.36,2519.02,0.00
2024-12-08 16:52:38,60,2482,20,40,1331.73,2520.00,0.00
2024-12-08 16:52:38,61,2482,20,41,1309.90,2520.02,0.00
2024-12-08 16:52:38,60,2482,20,40,1329.21,2520.03,0.00
2024-12-08 16:52:38,60,2483,20,40,1330.58,2521.00,0.00
2024-12-08 16:52:38,61,2483,21,40,1308.77,2521.02,0.00
2024-12-08 16:52:39,61,2484,21,40,1302.24,2522.00,0.00
2024-12-08 16:52:39,62,2484,22,40,1281.24,2522.02,0.00
2024-12-08 16:52:39,61,2484,22,39,1299.76,2522.03,0.00
2024-12-08 16:52:39,61,2485,22,39,1300.69,2523.00,0.00
2024-12-08 16:52:39,62,2485,22,40,1279.71,2523.02,0.00
2024-12-08 16:52:39,61,2485,21,40,1274.92,2523.69,0.00
2024-12-08 16:52:39,60,2485,20,40,1292.24,2523.85,0.00
2024-12-08 16:52:39,60,2486,20,40,1330.63,2524.00,0.00
2024-12-08 16:52:39,61,2486,21,40,1308.82,2524.02,0.00
2024-12-08 16:52:39,60,2486,21,39,1327.69,2524.05,0.00
2024-12-08 16:52:39,59,2486,20,39,1343.83,2524.24,0.00
2024-12-08 16:52:39,59,2487,20,39,1367.84,2525.00,0.00
2024-12-08 16:52:39,60,2487,20,40,1345.04,2525.02,0.00
2024-12-08 16:52:39,59,2487,19,40,1355.05,2525.19,0.00
2024-12-08 16:52:39,58,2487,18,40,1348.81,2525.69,0.00
2024-12-08 16:52:39,58,2488,18,40,1384.76,2526.00,0.00
2024-12-08 16:52:39,59,2488,19,40,1361.29,2526.02,0.00
2024-12-08 16:52:39,58,2488,19,39,1382.16,2526.05,0.00
2024-12-08 16:52:39,57,2488,18,39,1393.00,2526.32,0.00
2024-12-08 16:52:39,57,2489,18,39,1420.50,2527.00,0.00
2024-12-08 16:52:39,58,2489,18,40,1396.01,2527.02,0.00
2024-12-08 16:52:39,58,2490,18,40,1389.97,2528.00,0.00
2024-12-08 16:52:39,59,2490,19,40,1366.42,2528.02,0.00
2024-12-08 16:52:39,58,2490,19,39,1385.62,2528.07,0.00
2024-12-08 16:52:39,57,2490,18,39,1402.09,2528.37,0.00
2024-12-08 16:52:39,57,2491,18,39,1413.19,2529.00,0.00
2024-12-08 16:52:39,58,2491,19,39,1388.82,2529.02,0.00
2024-12-08 16:52:39,58,2492,19,39,1382.80,2530.00,0.00
2024-12-08 16:52:39,59,2492,20,39,1359.36,2530.02,0.00
2024-12-08 16:52:39,58,2492,20,38,1378.44,2530.07,0.00
2024-12-08 16:52:39,58,2493,20,38,1381.60,2531.00,0.00
2024-12-08 16:52:39,59,2493,20,39,1358.18,2531.02,0.00
2024-12-08 16:52:39,59,2494,20,39,1351.74,2532.00,0.00
2024-12-08 16:52:39,60,2494,21,39,1329.21,2532.02,0.00
2024-12-08 16:52:39,59,2494,21,38,1351.31,2532.02,0.00
2024-12-08 16:52:39,58,2494,21,37,1371.12,2532.05,0.00
2024-12-08 16:52:39,58,2495,21,37,1373.84,2533.00,0.00
2024-12-08 16:52:39,59,2495,21,38,1350.56,2533.02,0.00
2024-12-08 16:52:39,58,2495,20,38,1360.78,2533.17,0.00
2024-12-08 16:52:39,58,2496,20,38,1367.63,2534.00,0.00
2024-12-08 16:52:39,59,2496,20,39,1344.45,2534.02,0.00
2024-12-08 16:52:39,58,2496,20,38,1363.28,2534.07,0.00
2024-12-08 16:52:39,58,2497,20,38,1366.43,2535.00,0.00
2024-12-08 16:52:39,59,2497,20,39,1343.27,2535.02,0.00
2024-12-08 16:52:39,58,2497,19,39,1354.22,2535.16,0.00
2024-12-08 16:52:39,57,2497,18,39,1373.88,2535.19,0.00
2024-12-08 16:52:39,57,2498,18,39,1398.40,2536.00,0.00
2024-12-08 16:52:39,58,2498,18,40,1374.29,2536.02,0.00
2024-12-08 16:52:39,57,2498,18,39,1393.51,2536.07,0.00
2024-12-08 16:52:39,57,2499,18,39,1397.17,2537.00,0.00
2024-12-08 16:52:39,58,2499,19,39,1373.08,2537.02,0.00
2024-12-08 16:52:39,57,2499,18,39,1362.92,2537.82,0.00
2024-12-08 16:52:39,57,2500,18,39,1403.12,2538.00,0.00
2024-12-08 16:52:39,58,2500,18,40,1378.93,2538.02,0.00
2024-12-08 16:52:39,57,2500,18,39,1398.23,2538.07,0.00
2024-12-08 16:52:39,57,2501,18,39,1401.89,2539.00,0.00
2024-12-08 16:52:39,58,2501,19,39,1377.72,2539.02,0.00
2024-12-08 16:52:39,57,2501,18,39,1372.20,2539.42,0.00
2024-12-08 16:52:39,57,2502,18,39,1402.44,2540.00,0.00
2024-12-08 16:52:39,58,2502,18,40,1378.26,2540.02,0.00
2024-12-08 16:52:39,57,2502,18,39,1397.99,2540.07,0.00
2024-12-08 16:52:39,56,2502,17,39,1408.31,2540.64,0.00
2024-12-08 16:52:39,56,2503,17,39,1426.70,2541.00,0.00
2024-12-08 16:52:39,57,2503,18,39,1401.67,2541.02,0.00
2024-12-08 16:52:39,56,2503,17,39,1398.66,2541.70,0.00
2024-12-08 16:52:39,56,2504,17,39,1436.55,2542.00,0.00
2024-12-08 16:52:39,57,2504,18,39,1411.34,2542.02,0.00
2024-12-08 16:52:39,56,2504,18,38,1432.01,2542.07,0.00
2024-12-08 16:52:39,56,2505,18,38,1436.20,2543.00,0.00
2024-12-08 16:52:39,57,2505,19,38,1411.01,2543.02,0.00
2024-12-08 16:52:39,57,2506,19,38,1404.54,2544.00,0.00
2024-12-08 16:52:39,58,2506,20,38,1380.33,2544.02,0.00
2024-12-08 16:52:39,57,2506,20,37,1399.64,2544.07,0.00
2024-12-08 16:52:39,56,2506,19,37,1417.73,2544.20,0.00
2024-12-08 16:52:39,56,2507,19,37,1443.24,2545.00,0.00
2024-12-08 16:52:39,57,2507,20,37,1417.92,2545.02,0.00
2024-12-08 16:52:39,56,2507,19,37,1431.43,2545.13,0.00
2024-12-08 16:52:39,56,2508,19,37,1437.95,2546.00,0.00
2024-12-08 16:52:39,57,2508,19,38,1412.73,2546.02,0.00
2024-12-08 16:52:39,56,2508,19,37,1432.05,2546.07,0.00
2024-12-08 16:52:39,56,2509,19,37,1436.25,2547.00,0.00
2024-12-08 16:52:39,57,2509,19,38,1411.05,2547.02,0.00
2024-12-08 16:52:39,56,2509,19,37,1435.79,2547.02,0.00
2024-12-08 16:52:39,56,2510,19,37,1430.86,2548.00,0.00
2024-12-08 16:52:39,57,2510,20,37,1405.76,2548.02,0.00
2024-12-08 16:52:39,56,2510,20,36,1424.95,2548.05,0.00
2024-12-08 16:52:39,55,2510,19,36,1434.78,2548.31,0.00
2024-12-08 16:52:39,55,2511,19,36,1463.97,2549.00,0.00
2024-12-08 16:52:39,56,2511,20,36,1437.83,2549.02,0.00
2024-12-08 16:52:39,56,2512,20,36,1434.58,2550.00,0.00
2024-12-08 16:52:39,57,2512,20,37,1409.41,2550.02,0.00
2024-12-08 16:52:39,56,2512,20,36,1425.48,2550.07,0.00
2024-12-08 16:52:40,56,2513,20,36,1429.68,2551.00,0.00
2024-12-08 16:52:40,57,2513,20,37,1404.60,2551.02,0.00
2024-12-08 16:52:40,56,2513,19,37,1418.75,2551.09,0.00
2024-12-08 16:52:40,55,2513,18,37,1430.11,2551.64,0.00
2024-12-08 16:52:40,55,2514,18,37,1467.49,2552.00,0.00
2024-12-08 16:52:40,56,2514,18,38,1441.29,2552.02,0.00
2024-12-08 16:52:40,55,2514,18,37,1467.03,2552.02,0.00
2024-12-08 16:52:40,54,2514,18,36,1484.75,2552.06,0.00
2024-12-08 16:52:40,54,2515,18,36,1489.58,2553.00,0.00
2024-12-08 16:52:40,55,2515,19,36,1462.50,2553.02,0.00
2024-12-08 16:52:40,54,2515,18,36,1488.64,2553.06,0.00
2024-12-08 16:52:40,54,2516,18,36,1487.55,2554.00,0.00
2024-12-08 16:52:40,55,2516,19,36,1460.51,2554.02,0.00
2024-12-08 16:52:40,54,2516,19,35,1477.15,2554.06,0.00
2024-12-08 16:52:40,53,2516,18,35,1481.62,2554.45,0.00
2024-12-08 16:52:40,53,2517,18,35,1516.21,2555.00,0.00
2024-12-08 16:52:40,54,2517,18,36,1488.13,2555.02,0.00
2024-12-08 16:52:40,54,2518,18,36,1485.45,2556.00,0.00
2024-12-08 16:52:40,55,2518,19,36,1458.44,2556.02,0.00
2024-12-08 16:52:40,54,2518,19,35,1475.52,2556.06,0.00
2024-12-08 16:52:40,54,2519,19,35,1480.35,2557.00,0.00
2024-12-08 16:52:40,55,2519,19,36,1453.44,2557.02,0.00
2024-12-08 16:52:40,55,2520,19,36,1451.06,2558.00,0.00
2024-12-08 16:52:40,56,2520,19,37,1425.15,2558.02,0.00
2024-12-08 16:52:40,55,2520,19,36,1441.30,2558.05,0.00
2024-12-08 16:52:40,55,2521,19,36,1445.58,2559.00,0.00
2024-12-08 16:52:40,56,2521,20,36,1419.77,2559.02,0.00
2024-12-08 16:52:40,55,2521,20,35,1445.11,2559.02,0.00
2024-12-08 16:52:40,54,2521,19,35,1440.42,2559.70,0.00
2024-12-08 16:52:40,54,2522,19,35,1480.46,2560.00,0.00
2024-12-08 16:52:40,55,2522,19,36,1453.54,2560.02,0.00
2024-12-08 16:52:40,54,2522,19,35,1471.46,2560.04,0.00
2024-12-08 16:52:40,54,2523,19,35,1475.82,2561.00,0.00
2024-12-08 16:52:40,55,2523,19,36,1448.99,2561.02,0.00
2024-12-08 16:52:40,55,2524,19,36,1445.98,2562.00,0.00
2024-12-08 16:52:40,56,2524,20,36,1420.16,2562.02,0.00
2024-12-08 16:52:40,55,2524,20,35,1437.60,2562.04,0.00
2024-12-08 16:52:40,54,2524,19,35,1449.74,2562.61,0.00
2024-12-08 16:52:40,54,2525,19,35,1468.51,2563.00,0.00
2024-12-08 16:52:40,55,2525,19,36,1441.81,2563.02,0.00
2024-12-08 16:52:40,55,2526,19,36,1438.52,2564.00,0.00
2024-12-08 16:52:40,56,2526,19,37,1412.83,2564.02,0.00
2024-12-08 16:52:40,55,2526,19,36,1430.60,2564.04,0.00
2024-12-08 16:52:40,55,2527,19,36,1434.42,2565.00,0.00
2024-12-08 16:52:40,56,2527,19,37,1408.80,2565.02,0.00
2024-12-08 16:52:40,55,2527,18,37,1395.54,2565.85,0.00
2024-12-08 16:52:40,55,2528,18,37,1438.56,2566.00,0.00
2024-12-08 16:52:40,56,2528,19,37,1412.87,2566.02,0.00
2024-12-08 16:52:40,55,2528,19,36,1431.10,2566.04,0.00
2024-12-08 16:52:40,54,2528,18,36,1439.51,2566.63,0.00
2024-12-08 16:52:40,54,2529,18,36,1477.81,2567.00,0.00
2024-12-08 16:52:40,55,2529,19,36,1450.94,2567.02,0.00
2024-12-08 16:52:40,55,2530,19,36,1446.97,2568.00,0.00
2024-12-08 16:52:40,56,2530,20,36,1421.13,2568.02,0.00
2024-12-08 16:52:40,55,2530,20,35,1439.97,2568.04,0.00
2024-12-08 16:52:40,55,2531,20,35,1443.79,2569.00,0.00
2024-12-08 16:52:40,56,2531,21,35,1418.01,2569.02,0.00
2024-12-08 16:52:40,55,2531,20,35,1420.47,2569.56,0.00
2024-12-08 16:52:40,54,2531,19,35,1427.65,2569.67,0.00
2024-12-08 16:52:40,54,2532,19,35,1466.93,2570.00,0.00
2024-12-08 16:52:40,55,2532,19,36,1440.26,2570.02,0.00
2024-12-08 16:52:40,54,2532,19,35,1459.80,2570.04,0.00
2024-12-08 16:52:40,53,2532,18,35,1473.40,2570.59,0.00
2024-12-08 16:52:40,53,2533,18,35,1492.15,2571.00,0.00
2024-12-08 16:52:40,54,2533,19,35,1464.52,2571.02,0.00
2024-12-08 16:52:40,54,2534,19,35,1461.03,2572.00,0.00
2024-12-08 16:52:40,55,2534,20,35,1434.47,2572.02,0.00
2024-12-08 16:52:40,54,2534,20,34,1452.47,2572.06,0.00
2024-12-08 16:52:40,54,2535,20,34,1457.31,2573.00,0.00
2024-12-08 16:52:40,55,2535,21,34,1430.82,2573.02,0.00
2024-12-08 16:52:40,55,2536,21,34,1427.25,2574.00,0.00
2024-12-08 16:52:40,56,2536,21,35,1401.77,2574.02,0.00
2024-12-08 16:52:40,55,2536,21,34,1419.31,2574.05,0.00
2024-12-08 16:52:40,55,2537,21,34,1423.60,2575.00,0.00
2024-12-08 16:52:40,56,2537,22,34,1398.17,2575.02,0.00
2024-12-08 16:52:40,56,2538,22,34,1394.19,2576.00,0.00
2024-12-08 16:52:40,57,2538,22,35,1369.73,2576.02,0.00
2024-12-08 16:52:40,56,2538,22,34,1386.84,2576.05,0.00
2024-12-08 16:52:40,56,2539,22,34,1390.59,2577.00,0.00
2024-12-08 16:52:40,57,2539,23,34,1366.20,2577.02,0.00
2024-12-08 16:52:40,57,2540,23,34,1362.08,2578.00,0.00
2024-12-08 16:52:40,58,2540,24,34,1338.60,2578.02,0.00
2024-12-08 16:52:40,57,2540,24,33,1355.30,2578.05,0.00
2024-12-08 16:52:40,57,2541,24,33,1358.54,2579.00,0.00
2024-12-08 16:52:40,58,2541,24,34,1335.12,2579.02,0.00
2024-12-08 16:52:40,58,2542,24,34,1330.82,2580.00,0.00
2024-12-08 16:52:40,59,2542,24,35,1308.26,2580.02,0.00
2024-12-08 16:52:40,58,2542,24,34,1324.59,2580.05,0.00
2024-12-08 16:52:40,58,2543,24,34,1327.33,2581.00,0.00
2024-12-08 16:52:40,59,2543,24,35,1304.83,2581.02,0.00
2024-12-08 16:52:41,58,2543,23,35,1304.33,2581.57,0.00
2024-12-08 16:52:41,57,2543,22,35,1321.07,2581.68,0.00
2024-12-08 16:52:41,57,2544,22,35,1358.43,2582.00,0.00
2024-12-08 16:52:41,58,2544,22,36,1335.01,2582.02,0.00
2024-12-08 16:52:41,57,2544,21,36,1357.98,2582.02,0.00
2024-12-08 16:52:41,56,2544,21,35,1376.70,2582.04,0.00
2024-12-08 16:52:41,56,2545,21,35,1379.99,2583.00,0.00
2024-12-08 16:52:41,57,2545,21,36,1355.78,2583.02,0.00
2024-12-08 16:52:41,57,2546,21,36,1351.36,2584.00,0.00
2024-12-08 16:52:41,58,2546,22,36,1328.06,2584.02,0.00
2024-12-08 16:52:41,57,2546,22,35,1345.92,2584.04,0.00
2024-12-08 16:52:41,56,2546,21,35,1368.36,2584.09,0.00
2024-12-08 16:52:41,55,2546,20,35,1391.85,2584.13,0.00
2024-12-08 16:52:41,54,2546,19,35,1388.34,2584.91,0.00
2024-12-08 16:52:41,54,2547,19,35,1433.89,2585.00,0.00
2024-12-08 16:52:41,55,2547,20,35,1407.82,2585.02,0.00
2024-12-08 16:52:41,55,2548,20,35,1403.08,2586.00,0.00
2024-12-08 16:52:41,56,2548,21,35,1378.03,2586.02,0.00
2024-12-08 16:52:41,55,2548,21,34,1397.91,2586.04,0.00
2024-12-08 16:52:41,55,2549,21,34,1401.74,2587.00,0.00
2024-12-08 16:52:41,56,2549,22,34,1376.71,2587.02,0.00
2024-12-08 16:52:41,56,2550,22,34,1371.51,2588.00,0.00
2024-12-08 16:52:41,57,2550,23,34,1347.45,2588.02,0.00
2024-12-08 16:52:41,56,2550,23,33,1366.89,2588.04,0.00
2024-12-08 16:52:41,56,2551,23,33,1370.19,2589.00,0.00
2024-12-08 16:52:41,57,2551,23,34,1346.15,2589.02,0.00
2024-12-08 16:52:41,56,2551,22,34,1357.31,2589.13,0.00
2024-12-08 16:52:41,56,2552,22,34,1381.39,2590.00,0.00
2024-12-08 16:52:41,57,2552,23,34,1357.16,2590.02,0.00
2024-12-08 16:52:41,56,2552,23,33,1377.23,2590.04,0.00
2024-12-08 16:52:41,55,2552,22,33,1400.41,2590.11,0.00
2024-12-08 16:52:41,55,2553,22,33,1424.95,2591.00,0.00
2024-12-08 16:52:41,56,2553,22,34,1399.51,2591.02,0.00
2024-12-08 16:52:41,56,2554,22,34,1393.69,2592.00,0.00
2024-12-08 16:52:41,57,2554,22,35,1369.23,2592.02,0.00
2024-12-08 16:52:41,56,2554,22,34,1389.06,2592.04,0.00
2024-12-08 16:52:41,55,2554,21,34,1411.39,2592.11,0.00
2024-12-08 16:52:41,55,2555,21,34,1435.95,2593.00,0.00
2024-12-08 16:52:41,56,2555,21,35,1410.31,2593.02,0.00
2024-12-08 16:52:41,55,2555,20,35,1409.31,2593.29,0.00
2024-12-08 16:52:41,54,2555,19,35,1428.77,2593.56,0.00
2024-12-08 16:52:41,54,2556,19,35,1465.57,2594.00,0.00
2024-12-08 16:52:41,55,2556,20,35,1438.93,2594.02,0.00
2024-12-08 16:52:41,54,2556,20,34,1460.29,2594.04,0.00
2024-12-08 16:52:41,53,2556,19,34,1482.51,2594.17,0.00
2024-12-08 16:52:41,53,2557,19,34,1510.45,2595.00,0.00
2024-12-08 16:52:41,54,2557,19,35,1482.48,2595.02,0.00
2024-12-08 16:52:41,54,2558,19,35,1476.80,2596.00,0.00
2024-12-08 16:52:41,55,2558,19,36,1449.95,2596.02,0.00
2024-12-08 16:52:41,54,2558,19,35,1471.51,2596.04,0.00
2024-12-08 16:52:41,53,2558,18,35,1471.10,2596.51,0.00
2024-12-08 16:52:41,53,2559,18,35,1507.69,2597.00,0.00
2024-12-08 16:52:41,54,2559,19,35,1479.77,2597.02,0.00
2024-12-08 16:52:41,54,2560,19,35,1474.21,2598.00,0.00
2024-12-08 16:52:41,55,2560,19,36,1447.41,2598.02,0.00
2024-12-08 16:52:41,54,2560,19,35,1468.92,2598.04,0.00
2024-12-08 16:52:41,54,2561,19,35,1473.33,2599.00,0.00
2024-12-08 16:52:41,55,2561,19,36,1446.55,2599.02,0.00
2024-12-08 16:52:41,55,2562,19,36,1441.62,2600.00,0.00
2024-12-08 16:52:41,56,2562,19,37,1415.87,2600.02,0.00
2024-12-08 16:52:41,55,2562,19,36,1435.47,2600.04,0.00
2024-12-08 16:52:41,55,2563,19,36,1439.33,2601.00,0.00
2024-12-08 16:52:41,56,2563,19,37,1413.63,2601.02,0.00
2024-12-08 16:52:41,55,2563,18,37,1415.58,2601.56,0.00
2024-12-08 16:52:41,55,2564,18,37,1434.81,2602.00,0.00
2024-12-08 16:52:41,56,2564,19,37,1409.19,2602.02,0.00
2024-12-08 16:52:41,55,2564,19,36,1428.66,2602.04,0.00
2024-12-08 16:52:41,55,2565,19,36,1432.52,2603.00,0.00
2024-12-08 16:52:41,56,2565,19,37,1406.94,2603.02,0.00
2024-12-08 16:52:41,55,2565,18,37,1399.74,2603.75,0.00
2024-12-08 16:52:41,55,2566,18,37,1440.65,2604.00,0.00
2024-12-08 16:52:41,56,2566,18,38,1414.92,2604.02,0.00
2024-12-08 16:52:41,55,2566,18,37,1434.97,2604.04,0.00
2024-12-08 16:52:41,55,2567,18,37,1438.83,2605.00,0.00
2024-12-08 16:52:41,56,2567,18,38,1413.14,2605.02,0.00
2024-12-08 16:52:41,55,2567,17,38,1407.26,2605.42,0.00
2024-12-08 16:52:41,55,2568,17,38,1439.86,2606.00,0.00
2024-12-08 16:52:41,56,2568,18,38,1414.15,2606.02,0.00
2024-12-08 16:52:41,55,2568,17,38,1439.38,2606.02,0.00
2024-12-08 16:52:41,55,2569,17,38,1434.75,2607.00,0.00
2024-12-08 16:52:41,56,2569,17,39,1409.13,2607.02,0.00
2024-12-08 16:52:41,55,2569,17,38,1430.49,2607.02,0.00
2024-12-08 16:52:41,55,2570,17,38,1433.88,2608.00,0.00
2024-12-08 16:52:41,56,2570,17,39,1408.28,2608.02,0.00
2024-12-08 16:52:41,55,2570,17,38,1429.61,2608.02,0.00
2024-12-08 16:52:41,55,2571,17,38,1433.01,2609.00,0.00
2024-12-08 16:52:41,56,2571,18,38,1407.42,2609.02,0.00
2024-12-08 16:52:41,55,2571,17,38,1408.57,2609.60,0.00
2024-12-08 16:52:41,55,2572,17,38,1428.25,2610.00,0.00
2024-12-08 16:52:41,56,2572,17,39,1402.74,2610.02,0.00
2024-12-08 16:52:41,55,2572,17,38,1423.98,2610.02,0.00
2024-12-08 16:52:41,54,2572,16,38,1449.57,2610.04,0.00
2024-12-08 16:52:41,54,2573,16,38,1453.98,2611.00,0.00
2024-12-08 16:52:41,55,2573,17,38,1427.55,2611.02,0.00
2024-12-08 16:52:41,54,2573,16,38,1413.38,2611.93,0.00
2024-12-08 16:52:42,54,2574,16,38,1459.86,2612.00,0.00
2024-12-08 16:52:42,55,2574,16,39,1433.32,2612.02,0.00
2024-12-08 16:52:42,54,2574,16,38,1455.51,2612.02,0.00
2024-12-08 16:52:42,54,2575,16,38,1459.45,2613.00,0.00
2024-12-08 16:52:42,55,2575,16,39,1432.92,2613.02,0.00
2024-12-08 16:52:42,54,2575,15,39,1417.22,2613.61,0.00
2024-12-08 16:52:42,54,2576,15,39,1455.74,2614.00,0.00
2024-12-08 16:52:42,55,2576,15,40,1429.28,2614.02,0.00
2024-12-08 16:52:42,54,2576,15,39,1449.45,2614.02,0.00
2024-12-08 16:52:42,53,2576,14,39,1454.76,2614.42,0.00
2024-12-08 16:52:42,53,2577,14,39,1489.21,2615.00,0.00
2024-12-08 16:52:42,54,2577,15,39,1461.63,2615.02,0.00
2024-12-08 16:52:42,54,2578,15,39,1457.47,2616.00,0.00
2024-12-08 16:52:42,55,2578,16,39,1430.97,2616.02,0.00
2024-12-08 16:52:42,54,2578,16,38,1451.66,2616.02,0.00
2024-12-08 16:52:42,54,2579,16,38,1455.61,2617.00,0.00
2024-12-08 16:52:42,55,2579,17,38,1429.14,2617.02,0.00
2024-12-08 16:52:42,55,2580,17,38,1425.50,2618.00,0.00
2024-12-08 16:52:42,56,2580,17,39,1400.05,2618.02,0.00
2024-12-08 16:52:42,55,2580,17,38,1419.31,2618.02,0.00
2024-12-08 16:52:42,54,2580,16,38,1430.75,2618.59,0.00
2024-12-08 16:52:42,54,2581,16,38,1449.48,2619.00,0.00
2024-12-08 16:52:42,55,2581,17,38,1423.12,2619.02,0.00
2024-12-08 16:52:42,55,2582,17,38,1419.23,2620.00,0.00
2024-12-08 16:52:42,56,2582,18,38,1393.89,2620.02,0.00
2024-12-08 16:52:42,55,2582,18,37,1413.51,2620.02,0.00
2024-12-08 16:52:42,54,2582,17,37,1437.30,2620.11,0.00
2024-12-08 16:52:42,54,2583,17,37,1443.64,2621.00,0.00
2024-12-08 16:52:42,55,2583,18,37,1417.39,2621.02,0.00
2024-12-08 16:52:42,55,2584,18,37,1413.16,2622.00,0.00
2024-12-08 16:52:42,56,2584,18,38,1387.93,2622.02,0.00
2024-12-08 16:52:42,55,2584,18,37,1407.92,2622.02,0.00
2024-12-08 16:52:42,55,2585,18,37,1411.32,2623.00,0.00
2024-12-08 16:52:42,56,2585,18,38,1386.11,2623.02,0.00
2024-12-08 16:52:42,55,2585,17,38,1382.90,2623.66,0.00
2024-12-08 16:52:42,55,2586,17,38,1421.78,2624.00,0.00
2024-12-08 16:52:42,56,2586,17,39,1396.39,2624.02,0.00
2024-12-08 16:52:42,55,2586,17,38,1415.58,2624.04,0.00
2024-12-08 16:52:42,54,2586,16,38,1419.78,2624.41,0.00
2024-12-08 16:52:42,54,2587,16,38,1453.23,2625.00,0.00
2024-12-08 16:52:42,55,2587,17,38,1426.81,2625.02,0.00
2024-12-08 16:52:42,54,2587,16,38,1436.47,2625.17,0.00
2024-12-08 16:52:42,54,2588,16,38,1463.71,2626.00,0.00
2024-12-08 16:52:42,55,2588,17,38,1437.10,2626.02,0.00
2024-12-08 16:52:42,54,2588,17,37,1457.40,2626.04,0.00
2024-12-08 16:52:42,54,2589,17,37,1461.84,2627.00,0.00
2024-12-08 16:52:42,55,2589,17,38,1435.26,2627.02,0.00
2024-12-08 16:52:42,54,2589,16,38,1433.37,2627.35,0.00
2024-12-08 16:52:42,54,2590,16,38,1465.43,2628.00,0.00
2024-12-08 16:52:42,55,2590,16,39,1438.79,2628.02,0.00
2024-12-08 16:52:42,54,2590,16,38,1459.59,2628.04,0.00
2024-12-08 16:52:42,54,2591,16,38,1464.04,2629.00,0.00
2024-12-08 16:52:42,55,2591,16,39,1437.42,2629.02,0.00
2024-12-08 16:52:42,54,2591,15,39,1436.88,2629.33,0.00
2024-12-08 16:52:42,54,2592,15,39,1468.49,2630.00,0.00
2024-12-08 16:52:42,55,2592,15,40,1441.79,2630.02,0.00
2024-12-08 16:52:42,54,2592,14,40,1456.80,2630.02,0.00
2024-12-08 16:52:42,53,2592,14,39,1478.83,2630.02,0.00
2024-12-08 16:52:42,53,2593,14,39,1503.22,2631.00,0.00
2024-12-08 16:52:42,54,2593,14,40,1475.39,2631.02,0.00
2024-12-08 16:52:42,54,2594,14,40,1470.74,2632.00,0.00
2024-12-08 16:52:42,55,2594,15,40,1444.00,2632.02,0.00
2024-12-08 16:52:42,54,2594,15,39,1465.87,2632.02,0.00
2024-12-08 16:52:42,53,2594,14,39,1491.56,2632.09,0.00
2024-12-08 16:52:42,53,2595,14,39,1498.07,2633.00,0.00
2024-12-08 16:52:42,54,2595,14,40,1470.33,2633.02,0.00
2024-12-08 16:52:42,53,2595,13,40,1483.58,2633.09,0.00
2024-12-08 16:52:42,53,2596,13,40,1509.97,2634.00,0.00
2024-12-08 16:52:42,54,2596,13,41,1482.01,2634.02,0.00
2024-12-08 16:52:42,53,2596,13,40,1505.00,2634.02,0.00
2024-12-08 16:52:42,52,2596,12,40,1532.44,2634.08,0.00
2024-12-08 16:52:42,52,2597,12,40,1559.35,2635.00,0.00
2024-12-08 16:52:42,53,2597,13,40,1529.93,2635.02,0.00
2024-12-08 16:52:42,52,2597,12,40,1535.18,2635.56,0.00
2024-12-08 16:52:42,52,2598,12,40,1554.41,2636.00,0.00
2024-12-08 16:52:42,53,2598,13,40,1525.09,2636.02,0.00
2024-12-08 16:52:42,52,2598,13,39,1549.85,2636.02,0.00
2024-12-08 16:52:42,52,2599,13,39,1555.00,2637.00,0.00
2024-12-08 16:52:42,53,2599,13,40,1525.66,2637.02,0.00
2024-12-08 16:52:42,53,2600,13,40,1520.27,2638.00,0.00
2024-12-08 16:52:42,54,2600,14,40,1492.12,2638.02,0.00
2024-12-08 16:52:42,53,2600,14,39,1516.29,2638.02,0.00
2024-12-08 16:52:42,52,2600,13,39,1512.01,2638.96,0.00
2024-12-08 16:52:42,52,2601,13,39,1561.77,2639.00,0.00
2024-12-08 16:52:42,53,2601,13,40,1532.30,2639.02,0.00
2024-12-08 16:52:42,52,2601,12,40,1518.42,2639.58,0.00
2024-12-08 16:52:42,52,2602,12,40,1558.30,2640.00,0.00
2024-12-08 16:52:42,53,2602,12,41,1528.89,2640.02,0.00
2024-12-08 16:52:42,52,2602,12,40,1552.71,2640.02,0.00
2024-12-08 16:52:43,52,2603,12,40,1557.87,2641.00,0.00
2024-12-08 16:52:43,53,2603,13,40,1528.48,2641.02,0.00
2024-12-08 16:52:43,53,2604,13,40,1525.36,2642.00,0.00
2024-12-08 16:52:43,54,2604,14,40,1497.11,2642.02,0.00
2024-12-08 16:52:43,53,2604,13,40,1500.86,2642.57,0.00
2024-12-08 16:52:43,52,2604,12,40,1529.06,2642.60,0.00
2024-12-08 16:52:43,52,2605,12,40,1550.90,2643.00,0.00
2024-12-08 16:52:43,53,2605,13,40,1521.64,2643.02,0.00
2024-12-08 16:52:43,52,2605,13,39,1544.80,2643.02,0.00
2024-12-08 16:52:43,52,2606,13,39,1549.96,2644.00,0.00
2024-12-08 16:52:43,53,2606,13,40,1520.72,2644.02,0.00
2024-12-08 16:52:43,52,2606,13,39,1543.35,2644.02,0.00
2024-12-08 16:52:43,51,2606,12,39,1558.86,2644.57,0.00
2024-12-08 16:52:43,51,2607,12,39,1578.88,2645.00,0.00
2024-12-08 16:52:43,52,2607,12,40,1548.51,2645.02,0.00
2024-12-08 16:52:43,51,2607,11,40,1551.71,2645.65,0.00
2024-12-08 16:52:43,51,2608,11,40,1574.15,2646.00,0.00
2024-12-08 16:52:43,52,2608,12,40,1543.88,2646.02,0.00
2024-12-08 16:52:43,51,2608,12,39,1566.89,2646.02,0.00
2024-12-08 16:52:43,51,2609,12,39,1572.67,2647.00,0.00
2024-12-08 16:52:43,52,2609,13,39,1542.43,2647.02,0.00
2024-12-08 16:52:43,51,2609,12,39,1531.66,2647.90,0.00
2024-12-08 16:52:43,51,2610,12,39,1581.06,2648.00,0.00
2024-12-08 16:52:43,52,2610,13,39,1550.65,2648.02,0.00
2024-12-08 16:52:43,51,2610,13,38,1574.31,2648.02,0.00
2024-12-08 16:52:43,51,2611,13,38,1580.09,2649.00,0.00
2024-12-08 16:52:43,52,2611,14,38,1549.71,2649.02,0.00
2024-12-08 16:52:43,52,2612,14,38,1544.69,2650.00,0.00
2024-12-08 16:52:43,53,2612,15,38,1515.54,2650.02,0.00
2024-12-08 16:52:43,52,2612,15,37,1538.57,2650.02,0.00
2024-12-08 16:52:43,51,2612,14,37,1535.01,2650.96,0.00
2024-12-08 16:52:43,51,2613,14,37,1585.97,2651.00,0.00
2024-12-08 16:52:43,52,2613,14,38,1555.47,2651.02,0.00
2024-12-08 16:52:43,52,2614,14,38,1550.44,2652.00,0.00
2024-12-08 16:52:43,53,2614,14,39,1521.19,2652.02,0.00
2024-12-08 16:52:43,52,2614,14,38,1544.83,2652.02,0.00
2024-12-08 16:52:43,52,2615,14,38,1550.01,2653.00,0.00
2024-12-08 16:52:43,53,2615,15,38,1520.76,2653.02,0.00
2024-12-08 16:52:43,53,2616,15,38,1515.46,2654.00,0.00
2024-12-08 16:52:43,54,2616,15,39,1487.39,2654.02,0.00
2024-12-08 16:52:43,53,2616,15,38,1510.45,2654.02,0.00
2024-12-08 16:52:43,52,2616,14,38,1522.92,2654.65,0.00
2024-12-08 16:52:43,52,2617,14,38,1544.61,2655.00,0.00
2024-12-08 16:52:43,53,2617,15,38,1515.47,2655.02,0.00
2024-12-08 16:52:43,52,2617,14,38,1509.06,2655.46,0.00
2024-12-08 16:52:43,52,2618,14,38,1546.22,2656.00,0.00
2024-12-08 16:52:43,53,2618,14,39,1517.04,2656.02,0.00
2024-12-08 16:52:43,52,2618,14,38,1539.07,2656.02,0.00
2024-12-08 16:52:43,52,2619,14,38,1544.24,2657.00,0.00
2024-12-08 16:52:43,53,2619,15,38,1515.11,2657.02,0.00
2024-12-08 16:52:43,53,2620,15,38,1510.87,2658.00,0.00
2024-12-08 16:52:43,54,2620,15,39,1482.89,2658.02,0.00
2024-12-08 16:52:43,53,2620,15,38,1503.85,2658.02,0.00
2024-12-08 16:52:43,52,2620,14,38,1530.75,2658.10,0.00
2024-12-08 16:52:43,52,2621,14,38,1537.94,2659.00,0.00
2024-12-08 16:52:43,53,2621,15,38,1508.93,2659.02,0.00
2024-12-08 16:52:43,53,2622,15,38,1504.29,2660.00,0.00
2024-12-08 16:52:43,54,2622,16,38,1476.43,2660.02,0.00
2024-12-08 16:52:43,53,2622,16,37,1497.76,2660.02,0.00
2024-12-08 16:52:43,53,2623,16,37,1502.34,2661.00,0.00
2024-12-08 16:52:43,54,2623,16,38,1474.52,2661.02,0.00
2024-12-08 16:52:43,53,2623,15,38,1470.09,2661.76,0.00
2024-12-08 16:52:43,53,2624,15,38,1513.95,2662.00,0.00
2024-12-08 16:52:43,54,2624,16,38,1485.92,2662.02,0.00
2024-12-08 16:52:43,53,2624,16,37,1507.93,2662.02,0.00
2024-12-08 16:52:43,53,2625,16,37,1512.51,2663.00,0.00
2024-12-08 16:52:43,54,2625,16,38,1484.50,2663.02,0.00
2024-12-08 16:52:43,54,2626,16,38,1479.68,2664.00,0.00
2024-12-08 16:52:43,55,2626,16,39,1452.78,2664.02,0.00
2024-12-08 16:52:43,54,2626,16,38,1473.76,2664.02,0.00
2024-12-08 16:52:43,54,2627,16,38,1477.77,2665.00,0.00
2024-12-08 16:52:43,55,2627,17,38,1450.90,2665.02,0.00
2024-12-08 16:52:43,55,2628,17,38,1445.97,2666.00,0.00
2024-12-08 16:52:43,56,2628,18,38,1420.15,2666.02,0.00
2024-12-08 16:52:43,55,2628,18,37,1440.64,2666.02,0.00
2024-12-08 16:52:43,54,2628,17,37,1440.23,2666.82,0.00
2024-12-08 16:52:43,54,2629,17,37,1484.81,2667.00,0.00
2024-12-08 16:52:43,55,2629,18,37,1457.81,2667.02,0.00
2024-12-08 16:52:43,55,2630,18,37,1453.13,2668.00,0.00
2024-12-08 16:52:43,56,2630,19,37,1427.18,2668.02,0.00
2024-12-08 16:52:43,55,2630,19,36,1447.79,2668.02,0.00
2024-12-08 16:52:43,55,2631,19,36,1451.24,2669.00,0.00
2024-12-08 16:52:43,56,2631,20,36,1425.33,2669.02,0.00
2024-12-08 16:52:43,56,2632,20,36,1420.18,2670.00,0.00
2024-12-08 16:52:43,57,2632,20,37,1395.27,2670.02,0.00
2024-12-08 16:52:43,56,2632,20,36,1415.42,2670.02,0.00
2024-12-08 16:52:43,55,2632,19,36,1437.80,2670.15,0.00
2024-12-08 16:52:44,55,2633,19,36,1444.60,2671.00,0.00
2024-12-08 16:52:44,56,2633,20,36,1418.81,2671.02,0.00
2024-12-08 16:52:44,56,2634,20,36,1413.33,2672.00,0.00
2024-12-08 16:52:44,57,2634,20,37,1388.53,2672.02,0.00
2024-12-08 16:52:44,56,2634,20,36,1409.03,2672.02,0.00
2024-12-08 16:52:44,56,2635,20,36,1411.95,2673.00,0.00
2024-12-08 16:52:44,57,2635,20,37,1387.18,2673.02,0.00
2024-12-08 16:52:44,56,2635,19,37,1368.42,2673.63,0.00
2024-12-08 16:52:44,56,2636,19,37,1406.38,2674.00,0.00
2024-12-08 16:52:44,57,2636,20,37,1381.71,2674.02,0.00
2024-12-08 16:52:44,56,2636,20,36,1402.56,2674.02,0.00
2024-12-08 16:52:44,55,2636,19,36,1394.82,2674.58,0.00
2024-12-08 16:52:44,54,2636,18,36,1419.20,2674.65,0.00
2024-12-08 16:52:44,54,2637,18,36,1459.56,2675.00,0.00
2024-12-08 16:52:44,55,2637,19,36,1433.02,2675.02,0.00
2024-12-08 16:52:44,55,2638,19,36,1427.40,2676.00,0.00
2024-12-08 16:52:44,56,2638,20,36,1401.91,2676.02,0.00
2024-12-08 16:52:44,55,2638,20,35,1423.51,2676.02,0.00
2024-12-08 16:52:44,54,2638,19,35,1445.46,2676.17,0.00
2024-12-08 16:52:44,54,2639,19,35,1453.38,2677.00,0.00
2024-12-08 16:52:44,55,2639,20,35,1426.96,2677.02,0.00
2024-12-08 16:52:44,55,2640,20,35,1420.71,2678.00,0.00
2024-12-08 16:52:44,56,2640,20,36,1395.34,2678.02,0.00
2024-12-08 16:52:44,55,2640,20,35,1417.31,2678.02,0.00
2024-12-08 16:52:44,55,2641,20,35,1420.76,2679.00,0.00
2024-12-08 16:52:44,56,2641,20,36,1395.39,2679.02,0.00
2024-12-08 16:52:44,55,2641,19,36,1389.87,2679.71,0.00
2024-12-08 16:52:44,55,2642,19,36,1430.99,2680.00,0.00
2024-12-08 16:52:44,56,2642,19,37,1405.43,2680.02,0.00
2024-12-08 16:52:44,55,2642,19,36,1428.06,2680.02,0.00
2024-12-08 16:52:44,55,2643,19,36,1431.52,2681.00,0.00
2024-12-08 16:52:44,56,2643,20,36,1405.96,2681.02,0.00
2024-12-08 16:52:44,56,2644,20,36,1399.48,2682.00,0.00
2024-12-08 16:52:44,57,2644,21,36,1374.93,2682.02,0.00
2024-12-08 16:52:44,56,2644,21,35,1396.60,2682.02,0.00
2024-12-08 16:52:44,55,2644,20,35,1398.77,2682.76,0.00
2024-12-08 16:52:44,55,2645,20,35,1441.37,2683.00,0.00
2024-12-08 16:52:44,56,2645,20,36,1415.63,2683.02,0.00
2024-12-08 16:52:44,56,2646,20,36,1409.06,2684.00,0.00
2024-12-08 16:52:44,57,2646,20,37,1384.34,2684.02,0.00
2024-12-08 16:52:44,56,2646,20,36,1406.66,2684.02,0.00
2024-12-08 16:52:44,56,2647,20,36,1409.59,2685.00,0.00
2024-12-08 16:52:44,57,2647,21,36,1384.86,2685.02,0.00
2024-12-08 16:52:44,57,2648,21,36,1378.49,2686.00,0.00
2024-12-08 16:52:44,58,2648,21,37,1354.73,2686.02,0.00
2024-12-08 16:52:44,57,2648,21,36,1376.14,2686.02,0.00
2024-12-08 16:52:44,57,2649,21,36,1378.53,2687.00,0.00
2024-12-08 16:52:44,58,2649,21,37,1354.77,2687.02,0.00
2024-12-08 16:52:44,57,2649,20,37,1337.41,2687.93,0.00
2024-12-08 16:52:44,57,2650,20,37,1382.73,2688.00,0.00
2024-12-08 16:52:44,58,2650,21,37,1358.89,2688.02,0.00
2024-12-08 16:52:44,57,2650,21,36,1380.37,2688.02,0.00
2024-12-08 16:52:44,57,2651,21,36,1382.77,2689.00,0.00
2024-12-08 16:52:44,58,2651,21,37,1358.93,2689.02,0.00
2024-12-08 16:52:44,57,2651,20,37,1352.61,2689.12,0.00
2024-12-08 16:52:44,57,2652,20,37,1376.68,2690.00,0.00
2024-12-08 16:52:44,58,2652,20,38,1352.94,2690.02,0.00
2024-12-08 16:52:44,57,2652,20,37,1374.79,2690.02,0.00
2024-12-08 16:52:44,57,2653,20,37,1377.19,2691.00,0.00
2024-12-08 16:52:44,58,2653,21,37,1353.44,2691.02,0.00
2024-12-08 16:52:44,57,2653,20,37,1355.28,2691.26,0.00
2024-12-08 16:52:44,56,2653,19,37,1370.01,2691.63,0.00
2024-12-08 16:52:44,56,2654,19,37,1408.23,2692.00,0.00
2024-12-08 16:52:44,57,2654,19,38,1383.53,2692.02,0.00
2024-12-08 16:52:44,56,2654,19,37,1406.79,2692.02,0.00
2024-12-08 16:52:44,55,2654,18,37,1416.28,2692.62,0.00
2024-12-08 16:52:44,55,2655,18,37,1435.64,2693.00,0.00
2024-12-08 16:52:44,56,2655,19,37,1410.01,2693.02,0.00
2024-12-08 16:52:44,56,2656,19,37,1403.73,2694.00,0.00
2024-12-08 16:52:44,57,2656,19,38,1379.11,2694.02,0.00
2024-12-08 16:52:44,56,2656,19,37,1401.33,2694.02,0.00
2024-12-08 16:52:44,55,2656,18,37,1409.83,2694.35,0.00
2024-12-08 16:52:44,55,2657,18,37,1441.61,2695.00,0.00
2024-12-08 16:52:44,56,2657,19,37,1415.86,2695.02,0.00
2024-12-08 16:52:44,55,2657,18,37,1401.04,2695.55,0.00
2024-12-08 16:52:44,55,2658,18,37,1438.12,2696.00,0.00
2024-12-08 16:52:44,56,2658,19,37,1412.44,2696.02,0.00
2024-12-08 16:52:44,55,2658,19,36,1434.69,2696.02,0.00
2024-12-08 16:52:44,54,2658,18,36,1444.51,2696.65,0.00
2024-12-08 16:52:44,54,2659,18,36,1465.25,2697.00,0.00
2024-12-08 16:52:44,55,2659,19,36,1438.61,2697.02,0.00
2024-12-08 16:52:44,54,2659,18,36,1449.12,2697.19,0.00
2024-12-08 16:52:44,54,2660,18,36,1477.59,2698.00,0.00
2024-12-08 16:52:44,55,2660,18,37,1450.72,2698.02,0.00
2024-12-08 16:52:44,54,2660,18,36,1474.59,2698.02,0.00
2024-12-08 16:52:44,54,2661,18,36,1478.63,2699.00,0.00
2024-12-08 16:52:44,55,2661,19,36,1451.75,2699.02,0.00
2024-12-08 16:52:45,54,2661,18,36,1449.77,2699.37,0.00
2024-12-08 16:52:45,54,2662,18,36,1483.18,2700.00,0.00
2024-12-08 16:52:45,55,2662,19,36,1456.22,2700.02,0.00
2024-12-08 16:52:45,54,2662,19,35,1480.68,2700.02,0.00
2024-12-08 16:52:45,54,2663,19,35,1484.73,2701.00,0.00
2024-12-08 16:52:45,55,2663,20,35,1457.74,2701.02,0.00
2024-12-08 16:52:45,55,2664,20,35,1451.58,2702.00,0.00
2024-12-08 16:52:45,56,2664,20,36,1425.66,2702.02,0.00
2024-12-08 16:52:45,55,2664,20,35,1448.63,2702.02,0.00
2024-12-08 16:52:45,55,2665,20,35,1452.12,2703.00,0.00
2024-12-08 16:52:45,56,2665,20,36,1426.19,2703.02,0.00
2024-12-08 16:52:45,55,2665,19,36,1437.91,2703.18,0.00
2024-12-08 16:52:45,55,2666,19,36,1446.25,2704.00,0.00
2024-12-08 16:52:45,56,2666,20,36,1420.42,2704.02,0.00
2024-12-08 16:52:45,55,2666,20,35,1443.79,2704.02,0.00
2024-12-08 16:52:45,54,2666,19,35,1436.00,2704.96,0.00
2024-12-08 16:52:45,54,2667,19,35,1485.11,2705.00,0.00
2024-12-08 16:52:45,55,2667,19,36,1458.11,2705.02,0.00
2024-12-08 16:52:45,54,2667,18,36,1470.81,2705.17,0.00
2024-12-08 16:52:45,53,2667,17,36,1485.04,2705.66,0.00
2024-12-08 16:52:45,53,2668,17,36,1506.74,2706.00,0.00
2024-12-08 16:52:45,54,2668,18,36,1478.83,2706.02,0.00
2024-12-08 16:52:45,53,2668,18,35,1504.69,2706.02,0.00
2024-12-08 16:52:45,53,2669,18,35,1509.34,2707.00,0.00
2024-12-08 16:52:45,54,2669,19,35,1481.39,2707.02,0.00
2024-12-08 16:52:45,54,2670,19,35,1475.41,2708.00,0.00
2024-12-08 16:52:45,55,2670,19,36,1448.59,2708.02,0.00
2024-12-08 16:52:45,54,2670,19,35,1473.91,2708.02,0.00
2024-12-08 16:52:45,54,2671,19,35,1477.97,2709.00,0.00
2024-12-08 16:52:45,55,2671,20,35,1451.09,2709.02,0.00
2024-12-08 16:52:45,54,2671,19,35,1443.51,2709.44,0.00
2024-12-08 16:52:45,54,2672,19,35,1479.01,2710.00,0.00
2024-12-08 16:52:45,55,2672,20,35,1452.12,2710.02,0.00
2024-12-08 16:52:45,54,2672,20,34,1478.01,2710.02,0.00
2024-12-08 16:52:45,54,2673,20,34,1482.07,2711.00,0.00
2024-12-08 16:52:45,55,2673,21,34,1455.12,2711.02,0.00
2024-12-08 16:52:45,54,2673,20,34,1459.88,2711.26,0.00
2024-12-08 16:52:45,54,2674,20,34,1490.48,2712.00,0.00
2024-12-08 16:52:45,55,2674,20,35,1463.38,2712.02,0.00
2024-12-08 16:52:45,54,2674,20,34,1489.47,2712.02,0.00
2024-12-08 16:52:45,53,2674,19,34,1500.81,2712.64,0.00
2024-12-08 16:52:45,53,2675,19,34,1522.04,2713.00,0.00
2024-12-08 16:52:45,54,2675,19,35,1493.86,2713.02,0.00
2024-12-08 16:52:45,54,2676,19,35,1487.88,2714.00,0.00
2024-12-08 16:52:45,55,2676,20,35,1460.82,2714.02,0.00
2024-12-08 16:52:45,54,2676,20,34,1487.37,2714.02,0.00
2024-12-08 16:52:45,53,2676,19,34,1481.14,2714.96,0.00
2024-12-08 16:52:45,53,2677,19,34,1531.36,2715.00,0.00
2024-12-08 16:52:45,54,2677,19,35,1503.00,2715.02,0.00
2024-12-08 16:52:45,54,2678,19,35,1497.02,2716.00,0.00
2024-12-08 16:52:45,55,2678,20,35,1469.80,2716.02,0.00
2024-12-08 16:52:45,54,2678,20,34,1496.01,2716.02,0.00
2024-12-08 16:52:45,53,2678,19,34,1495.48,2716.87,0.00
2024-12-08 16:52:45,53,2679,19,34,1543.26,2717.00,0.00
2024-12-08 16:52:45,54,2679,20,34,1514.68,2717.02,0.00
2024-12-08 16:52:45,54,2680,20,34,1508.69,2718.00,0.00
2024-12-08 16:52:45,55,2680,21,34,1481.26,2718.02,0.00
2024-12-08 16:52:45,54,2680,21,33,1507.69,2718.02,0.00
2024-12-08 16:52:45,54,2681,21,33,1511.76,2719.00,0.00
2024-12-08 16:52:45,55,2681,21,34,1484.28,2719.02,0.00
2024-12-08 16:52:45,54,2681,20,34,1473.20,2719.52,0.00
2024-12-08 16:52:45,54,2682,20,34,1510.81,2720.00,0.00
2024-12-08 16:52:45,55,2682,20,35,1483.34,2720.02,0.00
2024-12-08 16:52:45,54,2682,20,34,1510.31,2720.02,0.00
2024-12-08 16:52:45,53,2682,19,34,1535.25,2720.15,0.00
2024-12-08 16:52:45,52,2682,18,34,1549.89,2720.69,0.00
2024-12-08 16:52:45,52,2683,18,34,1573.16,2721.00,0.00
2024-12-08 16:52:45,53,2683,18,35,1543.47,2721.02,0.00
2024-12-08 16:52:45,53,2684,18,35,1537.88,2722.00,0.00
2024-12-08 16:52:45,54,2684,19,35,1509.40,2722.02,0.00
2024-12-08 16:52:45,53,2684,19,34,1536.34,2722.02,0.00
2024-12-08 16:52:45,53,2685,19,34,1541.01,2723.00,0.00
2024-12-08 16:52:45,54,2685,19,35,1512.48,2723.02,0.00
2024-12-08 16:52:45,53,2685,18,35,1499.13,2723.57,0.00
2024-12-08 16:52:45,53,2686,18,35,1539.01,2724.00,0.00
2024-12-08 16:52:45,54,2686,18,36,1510.51,2724.02,0.00
2024-12-08 16:52:45,53,2686,18,35,1537.98,2724.02,0.00
2024-12-08 16:52:45,52,2686,17,35,1528.58,2724.67,0.00
2024-12-08 16:52:45,52,2687,17,35,1572.33,2725.00,0.00
2024-12-08 16:52:45,53,2687,17,36,1542.66,2725.02,0.00
2024-12-08 16:52:45,53,2688,17,36,1537.05,2726.00,0.00
2024-12-08 16:52:45,54,2688,18,36,1508.59,2726.02,0.00
2024-12-08 16:52:45,53,2688,18,35,1533.97,2726.02,0.00
2024-12-08 16:52:45,53,2689,18,35,1538.65,2727.00,0.00
2024-12-08 16:52:45,54,2689,18,36,1510.15,2727.02,0.00
2024-12-08 16:52:45,54,2690,18,36,1504.14,2728.00,0.00
2024-12-08 16:52:45,55,2690,19,36,1476.79,2728.02,0.00
2024-12-08 16:52:45,54,2690,19,35,1501.61,2728.02,0.00
2024-12-08 16:52:45,54,2691,19,35,1505.70,2729.00,0.00
2024-12-08 16:52:45,55,2691,20,35,1478.32,2729.02,0.00
2024-12-08 16:52:46,55,2692,20,35,1472.21,2730.00,0.00
2024-12-08 16:52:46,56,2692,20,36,1445.92,2730.02,0.00
2024-12-08 16:52:46,55,2692,20,35,1469.73,2730.02,0.00
2024-12-08 16:52:46,55,2693,20,35,1473.25,2731.00,0.00
2024-12-08 16:52:46,56,2693,20,36,1446.94,2731.02,0.00
2024-12-08 16:52:46,55,2693,19,36,1459.38,2731.15,0.00
2024-12-08 16:52:46,55,2694,19,36,1486.21,2732.00,0.00
2024-12-08 16:52:46,56,2694,19,37,1459.67,2732.02,0.00
2024-12-08 16:52:46,55,2694,19,36,1483.72,2732.02,0.00
2024-12-08 16:52:46,54,2694,18,36,1491.49,2732.09,0.00
2024-12-08 16:52:46,54,2695,18,36,1517.83,2733.00,0.00
2024-12-08 16:52:46,55,2695,19,36,1490.23,2733.02,0.00
2024-12-08 16:52:46,54,2695,18,36,1502.18,2733.15,0.00
2024-12-08 16:52:46,54,2696,18,36,1530.03,2734.00,0.00
2024-12-08 16:52:46,55,2696,18,37,1502.21,2734.02,0.00
2024-12-08 16:52:46,54,2696,18,36,1527.49,2734.02,0.00
2024-12-08 16:52:46,53,2696,17,36,1531.22,2734.45,0.00
2024-12-08 16:52:46,53,2697,17,36,1568.24,2735.00,0.00
2024-12-08 16:52:46,54,2697,18,36,1539.20,2735.02,0.00
2024-12-08 16:52:46,54,2698,18,36,1533.17,2736.00,0.00
2024-12-08 16:52:46,55,2698,18,37,1505.30,2736.02,0.00
2024-12-08 16:52:46,54,2698,18,36,1530.13,2736.02,0.00
2024-12-08 16:52:46,53,2698,17,36,1541.76,2736.64,0.00
2024-12-08 16:52:46,53,2699,17,36,1563.19,2737.00,0.00
2024-12-08 16:52:46,54,2699,17,37,1534.24,2737.02,0.00
2024-12-08 16:52:46,53,2699,16,37,1544.96,2737.19,0.00
2024-12-08 16:52:46,52,2699,15,37,1562.29,2737.64,0.00
2024-12-08 16:52:46,52,2700,15,37,1605.20,2738.00,0.00
2024-12-08 16:52:46,53,2700,16,37,1574.92,2738.02,0.00
2024-12-08 16:52:46,52,2700,16,36,1602.04,2738.02,0.00
2024-12-08 16:52:46,52,2701,16,36,1607.37,2739.00,0.00
2024-12-08 16:52:46,53,2701,16,37,1577.04,2739.02,0.00
2024-12-08 16:52:46,53,2702,16,37,1571.41,2740.00,0.00
2024-12-08 16:52:46,54,2702,17,37,1542.31,2740.02,0.00
2024-12-08 16:52:46,53,2702,17,36,1568.83,2740.02,0.00
2024-12-08 16:52:46,53,2703,17,36,1573.54,2741.00,0.00
2024-12-08 16:52:46,54,2703,17,37,1544.40,2741.02,0.00
2024-12-08 16:52:46,53,2703,16,37,1546.76,2741.32,0.00
2024-12-08 16:52:46,53,2704,16,37,1580.32,2742.00,0.00
2024-12-08 16:52:46,54,2704,17,37,1551.06,2742.02,0.00
2024-12-08 16:52:46,53,2704,17,36,1575.67,2742.02,0.00
2024-12-08 16:52:46,52,2704,16,36,1567.78,2742.64,0.00
2024-12-08 16:52:46,52,2705,16,36,1610.77,2743.00,0.00
2024-12-08 16:52:46,53,2705,16,37,1580.38,2743.02,0.00
2024-12-08 16:52:46,52,2705,15,37,1573.50,2743.46,0.00
2024-12-08 16:52:46,52,2706,15,37,1611.89,2744.00,0.00
2024-12-08 16:52:46,53,2706,15,38,1581.47,2744.02,0.00
2024-12-08 16:52:46,52,2706,15,37,1607.14,2744.02,0.00
2024-12-08 16:52:46,52,2707,15,37,1612.47,2745.00,0.00
2024-12-08 16:52:46,53,2707,16,37,1582.05,2745.02,0.00
2024-12-08 16:52:46,53,2708,16,37,1576.41,2746.00,0.00
2024-12-08 16:52:46,54,2708,17,37,1547.22,2746.02,0.00
2024-12-08 16:52:46,53,2708,17,36,1572.26,2746.02,0.00
2024-12-08 16:52:46,53,2709,17,36,1576.98,2747.00,0.00
2024-12-08 16:52:46,54,2709,18,36,1547.78,2747.02,0.00
2024-12-08 16:52:46,53,2709,17,36,1560.92,2747.02,0.00
2024-12-08 16:52:46,53,2710,17,36,1576.00,2748.00,0.00
2024-12-08 16:52:46,54,2710,18,36,1546.82,2748.02,0.00
2024-12-08 16:52:46,53,2710,18,35,1570.30,2748.02,0.00
2024-12-08 16:52:46,53,2711,18,35,1575.02,2749.00,0.00
2024-12-08 16:52:46,54,2711,18,36,1545.85,2749.02,0.00
2024-12-08 16:52:46,54,2712,18,36,1540.92,2750.00,0.00
2024-12-08 16:52:46,55,2712,18,37,1512.90,2750.02,0.00
2024-12-08 16:52:46,54,2712,18,36,1535.83,2750.02,0.00
2024-12-08 16:52:46,53,2712,17,36,1548.50,2750.62,0.00
2024-12-08 16:52:46,53,2713,17,36,1569.53,2751.00,0.00
2024-12-08 16:52:46,54,2713,18,36,1540.46,2751.02,0.00
2024-12-08 16:52:46,53,2713,17,36,1531.43,2751.81,0.00
2024-12-08 16:52:46,53,2714,17,36,1578.30,2752.00,0.00
2024-12-08 16:52:46,54,2714,17,37,1549.07,2752.02,0.00
2024-12-08 16:52:46,53,2714,17,36,1573.62,2752.02,0.00
2024-12-08 16:52:46,53,2715,17,36,1578.35,2753.00,0.00
2024-12-08 16:52:46,54,2715,17,37,1549.12,2753.02,0.00
2024-12-08 16:52:46,53,2715,16,37,1563.85,2753.15,0.00
2024-12-08 16:52:46,53,2716,16,37,1573.17,2754.00,0.00
2024-12-08 16:52:46,54,2716,17,37,1544.03,2754.02,0.00
2024-12-08 16:52:46,53,2716,17,36,1567.97,2754.02,0.00
2024-12-08 16:52:46,52,2716,16,36,1562.17,2754.96,0.00
2024-12-08 16:52:46,52,2717,16,36,1614.11,2755.00,0.00
2024-12-08 16:52:46,53,2717,16,37,1583.66,2755.02,0.00
2024-12-08 16:52:46,53,2718,16,37,1578.17,2756.00,0.00
2024-12-08 16:52:46,54,2718,17,37,1548.94,2756.02,0.00
2024-12-08 16:52:46,53,2718,17,36,1573.49,2756.02,0.00
2024-12-08 16:52:46,52,2718,16,36,1586.58,2756.65,0.00
2024-12-08 16:52:46,52,2719,16,36,1609.10,2757.00,0.00
2024-12-08 16:52:46,53,2719,16,37,1578.74,2757.02,0.00
2024-12-08 16:52:46,52,2719,15,37,1563.34,2757.96,0.00
2024-12-08 16:52:46,52,2720,15,37,1615.34,2758.00,0.00
2024-12-08 16:52:46,53,2720,15,38,1584.86,2758.02,0.00
2024-12-08 16:52:46,52,2720,15,37,1610.56,2758.02,0.00
2024-12-08 16:52:46,51,2720,14,37,1639.47,2758.12,0.00
2024-12-08 16:52:46,50,2720,13,37,1656.59,2758.68,0.00
2024-12-08 16:52:46,50,2721,13,37,1681.11,2759.00,0.00
2024-12-08 16:52:46,51,2721,13,38,1648.15,2759.02,0.00
2024-12-08 16:52:47,51,2722,13,38,1643.33,2760.00,0.00
2024-12-08 16:52:47,52,2722,14,38,1611.73,2760.02,0.00
2024-12-08 16:52:47,51,2722,14,37,1639.01,2760.02,0.00
2024-12-08 16:52:47,50,2722,13,37,1637.56,2760.94,0.00
2024-12-08 16:52:47,50,2723,13,37,1691.17,2761.00,0.00
2024-12-08 16:52:47,51,2723,13,38,1658.01,2761.02,0.00
2024-12-08 16:52:47,51,2724,13,38,1653.19,2762.00,0.00
2024-12-08 16:52:47,52,2724,13,39,1621.40,2762.02,0.00
2024-12-08 16:52:47,51,2724,13,38,1648.86,2762.02,0.00
2024-12-08 16:52:47,50,2724,12,38,1654.42,2762.48,0.00
2024-12-08 16:52:47,50,2725,12,38,1695.71,2763.00,0.00
2024-12-08 16:52:47,51,2725,12,39,1662.46,2763.02,0.00
2024-12-08 16:52:47,50,2725,11,39,1675.87,2763.20,0.00
2024-12-08 16:52:47,50,2726,11,39,1709.59,2764.00,0.00
2024-12-08 16:52:47,51,2726,12,39,1676.07,2764.02,0.00
2024-12-08 16:52:47,50,2726,12,38,1705.72,2764.02,0.00
2024-12-08 16:52:47,49,2726,11,38,1716.67,2764.41,0.00
2024-12-08 16:52:47,49,2727,11,38,1757.19,2765.00,0.00
2024-12-08 16:52:47,50,2727,12,38,1722.04,2765.02,0.00
2024-12-08 16:52:47,50,2728,12,38,1717.69,2766.00,0.00
2024-12-08 16:52:47,51,2728,12,39,1684.01,2766.02,0.00
2024-12-08 16:52:47,50,2728,12,38,1713.81,2766.02,0.00
2024-12-08 16:52:47,50,2729,12,38,1720.52,2767.00,0.00
2024-12-08 16:52:47,51,2729,12,39,1686.78,2767.02,0.00
2024-12-08 16:52:47,50,2729,11,39,1706.71,2767.12,0.00
2024-12-08 16:52:47,50,2730,11,39,1716.16,2768.00,0.00
2024-12-08 16:52:47,51,2730,12,39,1682.51,2768.02,0.00
2024-12-08 16:52:47,50,2730,12,38,1712.28,2768.02,0.00
2024-12-08 16:52:47,49,2730,11,38,1708.58,2768.63,0.00
2024-12-08 16:52:47,49,2731,11,38,1755.21,2769.00,0.00
2024-12-08 16:52:47,50,2731,11,39,1720.10,2769.02,0.00
2024-12-08 16:52:47,49,2731,10,39,1706.92,2769.61,0.00
2024-12-08 16:52:47,49,2732,10,39,1753.01,2770.00,0.00
2024-12-08 16:52:47,50,2732,11,39,1717.95,2770.02,0.00
2024-12-08 16:52:47,49,2732,11,38,1747.93,2770.02,0.00
2024-12-08 16:52:47,49,2733,11,38,1755.34,2771.00,0.00
2024-12-08 16:52:47,50,2733,12,38,1720.24,2771.02,0.00
2024-12-08 16:52:47,49,2733,11,38,1712.88,2771.88,0.00
2024-12-08 16:52:47,49,2734,11,38,1766.16,2772.00,0.00
2024-12-08 16:52:47,50,2734,11,39,1730.84,2772.02,0.00
2024-12-08 16:52:47,49,2734,11,38,1759.94,2772.02,0.00
2024-12-08 16:52:47,49,2735,11,38,1767.36,2773.00,0.00
2024-12-08 16:52:47,50,2735,12,38,1732.02,2773.02,0.00
2024-12-08 16:52:47,50,2736,12,38,1727.65,2774.00,0.00
2024-12-08 16:52:47,51,2736,12,39,1693.77,2774.02,0.00
2024-12-08 16:52:47,50,2736,12,38,1722.10,2774.02,0.00
2024-12-08 16:52:47,49,2736,11,38,1721.61,2774.96,0.00
2024-12-08 16:52:47,49,2737,11,38,1777.13,2775.00,0.00
2024-12-08 16:52:47,50,2737,12,38,1741.59,2775.02,0.00
2024-12-08 16:52:47,49,2737,11,38,1737.14,2775.49,0.00
2024-12-08 16:52:47,49,2738,11,38,1780.04,2776.00,0.00
2024-12-08 16:52:47,50,2738,11,39,1744.44,2776.02,0.00
2024-12-08 16:52:47,49,2738,11,38,1774.37,2776.02,0.00
2024-12-08 16:52:47,49,2739,11,38,1781.81,2777.00,0.00
2024-12-08 16:52:47,50,2739,11,39,1746.18,2777.02,0.00
2024-12-08 16:52:47,50,2740,11,39,1741.81,2778.00,0.00
2024-12-08 16:52:47,51,2740,12,39,1707.65,2778.02,0.00
2024-12-08 16:52:47,50,2740,12,38,1735.69,2778.02,0.00
2024-12-08 16:52:47,50,2741,12,38,1742.43,2779.00,0.00
2024-12-08 16:52:47,51,2741,12,39,1708.27,2779.02,0.00
2024-12-08 16:52:47,50,2741,11,39,1710.21,2779.06,0.00
2024-12-08 16:52:47,50,2742,11,39,1740.28,2780.00,0.00
2024-12-08 16:52:47,51,2742,11,40,1706.16,2780.02,0.00
2024-12-08 16:52:47,50,2742,11,39,1733.05,2780.02,0.00
2024-12-08 16:52:47,50,2743,11,39,1739.79,2781.00,0.00
2024-12-08 16:52:47,51,2743,11,40,1705.68,2781.02,0.00
2024-12-08 16:52:47,51,2744,11,40,1700.84,2782.00,0.00
2024-12-08 16:52:47,52,2744,12,40,1668.13,2782.02,0.00
2024-12-08 16:52:47,51,2744,12,39,1694.29,2782.02,0.00
2024-12-08 16:52:47,50,2744,11,39,1701.94,2782.80,0.00
2024-12-08 16:52:47,50,2745,11,39,1752.18,2783.00,0.00
2024-12-08 16:52:47,51,2745,12,39,1717.82,2783.02,0.00
2024-12-08 16:52:47,51,2746,12,39,1712.98,2784.00,0.00
2024-12-08 16:52:47,52,2746,13,39,1680.04,2784.02,0.00
2024-12-08 16:52:47,51,2746,13,38,1706.43,2784.02,0.00
2024-12-08 16:52:47,51,2747,13,38,1712.50,2785.00,0.00
2024-12-08 16:52:47,52,2747,14,38,1679.57,2785.02,0.00
2024-12-08 16:52:47,52,2748,14,38,1674.28,2786.00,0.00
2024-12-08 16:52:47,53,2748,15,38,1642.69,2786.02,0.00
2024-12-08 16:52:47,52,2748,15,37,1666.25,2786.04,0.00
2024-12-08 16:52:47,52,2749,15,37,1672.20,2787.00,0.00
2024-12-08 16:52:47,53,2749,16,37,1640.65,2787.02,0.00
2024-12-08 16:52:47,53,2750,16,37,1634.94,2788.00,0.00
2024-12-08 16:52:47,54,2750,17,37,1604.66,2788.02,0.00
2024-12-08 16:52:47,53,2750,17,36,1627.58,2788.04,0.00
2024-12-08 16:52:47,52,2750,16,36,1627.48,2788.54,0.00
2024-12-08 16:52:47,52,2751,16,36,1668.57,2789.00,0.00
2024-12-08 16:52:47,53,2751,17,36,1637.09,2789.02,0.00
2024-12-08 16:52:47,53,2752,17,36,1631.36,2790.00,0.00
2024-12-08 16:52:47,54,2752,18,36,1601.15,2790.02,0.00
2024-12-08 16:52:47,53,2752,18,35,1624.52,2790.04,0.00
2024-12-08 16:52:48,53,2753,18,35,1629.84,2791.00,0.00
2024-12-08 16:52:48,54,2753,19,35,1599.66,2791.02,0.00
2024-12-08 16:52:48,53,2753,18,35,1585.87,2791.57,0.00
2024-12-08 16:52:48,53,2754,18,35,1626.73,2792.00,0.00
2024-12-08 16:52:48,54,2754,19,35,1596.61,2792.02,0.00
2024-12-08 16:52:48,53,2754,19,34,1619.89,2792.04,0.00
2024-12-08 16:52:48,53,2755,19,34,1625.21,2793.00,0.00
2024-12-08 16:52:48,54,2755,19,35,1595.11,2793.02,0.00
2024-12-08 16:52:48,53,2755,18,35,1610.49,2793.15,0.00
2024-12-08 16:52:48,52,2755,17,35,1627.78,2793.64,0.00
2024-12-08 16:52:48,52,2756,17,35,1650.07,2794.00,0.00
2024-12-08 16:52:48,53,2756,18,35,1618.94,2794.02,0.00
2024-12-08 16:52:48,52,2756,18,34,1643.63,2794.04,0.00
2024-12-08 16:52:48,52,2757,18,34,1649.59,2795.00,0.00
2024-12-08 16:52:48,53,2757,18,35,1618.46,2795.02,0.00
2024-12-08 16:52:48,53,2758,18,35,1612.71,2796.00,0.00
2024-12-08 16:52:48,54,2758,18,36,1582.85,2796.02,0.00
2024-12-08 16:52:48,53,2758,18,35,1606.91,2796.04,0.00
2024-12-08 16:52:48,52,2758,17,35,1621.99,2796.62,0.00
2024-12-08 16:52:48,52,2759,17,35,1643.78,2797.00,0.00
2024-12-08 16:52:48,53,2759,18,35,1612.76,2797.02,0.00
2024-12-08 16:52:48,53,2760,18,35,1607.00,2798.00,0.00
2024-12-08 16:52:48,54,2760,19,35,1577.24,2798.02,0.00
2024-12-08 16:52:48,53,2760,19,34,1601.20,2798.04,0.00
2024-12-08 16:52:48,53,2761,19,34,1606.52,2799.00,0.00
2024-12-08 16:52:48,54,2761,19,35,1576.77,2799.02,0.00
2024-12-08 16:52:48,54,2762,19,35,1570.84,2800.00,0.00
2024-12-08 16:52:48,55,2762,19,36,1542.28,2800.02,0.00
2024-12-08 16:52:48,54,2762,19,35,1564.62,2800.04,0.00
2024-12-08 16:52:48,53,2762,18,35,1557.98,2800.60,0.00
2024-12-08 16:52:48,53,2763,18,35,1599.99,2801.00,0.00
2024-12-08 16:52:48,54,2763,19,35,1570.36,2801.02,0.00
2024-12-08 16:52:48,54,2764,19,35,1564.79,2802.00,0.00
2024-12-08 16:52:48,55,2764,19,36,1536.34,2802.02,0.00
2024-12-08 16:52:48,54,2764,19,35,1559.09,2802.04,0.00
2024-12-08 16:52:48,54,2765,19,35,1563.79,2803.00,0.00
2024-12-08 16:52:48,55,2765,20,35,1535.36,2803.02,0.00
2024-12-08 16:52:48,54,2765,19,35,1546.20,2803.19,0.00
2024-12-08 16:52:48,54,2766,19,35,1575.78,2804.00,0.00
2024-12-08 16:52:48,55,2766,20,35,1547.13,2804.02,0.00
2024-12-08 16:52:48,54,2766,20,34,1570.59,2804.04,0.00
2024-12-08 16:52:48,53,2766,19,34,1584.13,2804.62,0.00
2024-12-08 16:52:48,53,2767,19,34,1605.55,2805.00,0.00
2024-12-08 16:52:48,54,2767,19,35,1575.82,2805.02,0.00
2024-12-08 16:52:48,53,2767,18,35,1578.09,2805.62,0.00
2024-12-08 16:52:48,53,2768,18,35,1599.52,2806.00,0.00
2024-12-08 16:52:48,54,2768,19,35,1569.90,2806.02,0.00
2024-12-08 16:52:48,53,2768,19,34,1594.23,2806.04,0.00
2024-12-08 16:52:48,52,2768,18,34,1591.95,2806.92,0.00
2024-12-08 16:52:48,52,2769,18,34,1643.82,2807.00,0.00
2024-12-08 16:52:48,53,2769,19,34,1612.80,2807.02,0.00
2024-12-08 16:52:48,53,2770,19,34,1607.02,2808.00,0.00
2024-12-08 16:52:48,54,2770,20,34,1577.26,2808.02,0.00
2024-12-08 16:52:48,53,2770,20,33,1601.72,2808.04,0.00
2024-12-08 16:52:48,53,2771,20,33,1607.06,2809.00,0.00
2024-12-08 16:52:48,54,2771,21,33,1577.30,2809.02,0.00
2024-12-08 16:52:48,53,2771,20,33,1561.22,2809.59,0.00
2024-12-08 16:52:48,53,2772,20,33,1602.86,2810.00,0.00
2024-12-08 16:52:48,54,2772,20,34,1573.18,2810.02,0.00
2024-12-08 16:52:48,53,2772,20,33,1598.09,2810.04,0.00
2024-12-08 16:52:48,53,2773,20,33,1603.43,2811.00,0.00
2024-12-08 16:52:48,54,2773,20,34,1573.74,2811.02,0.00
2024-12-08 16:52:48,54,2774,20,34,1567.53,2812.00,0.00
2024-12-08 16:52:48,55,2774,20,35,1539.03,2812.02,0.00
2024-12-08 16:52:48,54,2774,20,34,1562.84,2812.04,0.00
2024-12-08 16:52:48,53,2774,19,34,1555.47,2812.62,0.00
2024-12-08 16:52:48,52,2774,18,34,1584.31,2812.65,0.00
2024-12-08 16:52:48,52,2775,18,34,1628.94,2813.00,0.00
2024-12-08 16:52:48,53,2775,18,35,1598.20,2813.02,0.00
2024-12-08 16:52:48,53,2776,18,35,1592.40,2814.00,0.00
2024-12-08 16:52:48,54,2776,19,35,1562.91,2814.02,0.00
2024-12-08 16:52:48,53,2776,19,34,1587.62,2814.04,0.00
2024-12-08 16:52:48,52,2776,18,34,1591.51,2814.81,0.00
2024-12-08 16:52:48,52,2777,18,34,1640.38,2815.00,0.00
2024-12-08 16:52:48,53,2777,18,35,1609.43,2815.02,0.00
2024-12-08 16:52:48,53,2778,18,35,1603.63,2816.00,0.00
2024-12-08 16:52:48,54,2778,19,35,1573.93,2816.02,0.00
2024-12-08 16:52:48,53,2778,19,34,1598.85,2816.04,0.00
2024-12-08 16:52:48,53,2779,19,34,1604.20,2817.00,0.00
2024-12-08 16:52:48,54,2779,19,35,1574.49,2817.02,0.00
2024-12-08 16:52:49,54,2780,19,35,1568.26,2818.00,0.00
2024-12-08 16:52:49,55,2780,20,35,1539.75,2818.02,0.00
2024-12-08 16:52:49,54,2780,19,35,1567.74,2818.02,0.00
2024-12-08 16:52:49,53,2780,19,34,1593.60,2818.02,0.00
2024-12-08 16:52:49,52,2780,18,34,1588.20,2818.60,0.00
2024-12-08 16:52:49,52,2781,18,34,1631.33,2819.00,0.00
2024-12-08 16:52:49,53,2781,19,34,1600.55,2819.02,0.00
2024-12-08 16:52:49,53,2782,19,34,1594.94,2820.00,0.00
2024-12-08 16:52:49,54,2782,19,35,1565.40,2820.02,0.00
2024-12-08 16:52:49,53,2782,19,34,1589.09,2820.04,0.00
2024-12-08 16:52:49,53,2783,19,34,1594.44,2821.00,0.00
2024-12-08 16:52:49,54,2783,19,35,1564.91,2821.02,0.00
2024-12-08 16:52:49,53,2783,18,35,1555.57,2821.49,0.00
2024-12-08 16:52:49,53,2784,18,35,1594.80,2822.00,0.00
2024-12-08 16:52:49,54,2784,18,36,1565.26,2822.02,0.00
2024-12-08 16:52:49,53,2784,18,35,1589.48,2822.04,0.00
2024-12-08 16:52:49,53,2785,18,35,1594.83,2823.00,0.00
2024-12-08 16:52:49,54,2785,19,35,1565.30,2823.02,0.00
2024-12-08 16:52:49,53,2785,18,35,1560.02,2823.76,0.00
2024-12-08 16:52:49,53,2786,18,35,1606.58,2824.00,0.00
2024-12-08 16:52:49,54,2786,18,36,1576.83,2824.02,0.00
2024-12-08 16:52:49,53,2786,18,35,1601.26,2824.04,0.00
2024-12-08 16:52:49,53,2787,18,35,1606.62,2825.00,0.00
2024-12-08 16:52:49,54,2787,18,36,1576.87,2825.02,0.00
2024-12-08 16:52:49,54,2788,18,36,1570.82,2826.00,0.00
2024-12-08 16:52:49,55,2788,18,37,1542.26,2826.02,0.00
2024-12-08 16:52:49,54,2788,18,36,1566.11,2826.04,0.00
2024-12-08 16:52:49,53,2788,17,36,1564.47,2826.89,0.00
2024-12-08 16:52:49,53,2789,17,36,1614.69,2827.00,0.00
2024-12-08 16:52:49,54,2789,17,37,1584.79,2827.02,0.00
2024-12-08 16:52:49,53,2789,16,37,1581.77,2827.42,0.00
2024-12-08 16:52:49,53,2790,16,37,1619.00,2828.00,0.00
2024-12-08 16:52:49,54,2790,16,38,1589.02,2828.02,0.00
2024-12-08 16:52:49,53,2790,16,37,1614.20,2828.04,0.00
2024-12-08 16:52:49,52,2790,15,37,1628.13,2828.65,0.00
2024-12-08 16:52:49,52,2791,15,37,1651.26,2829.00,0.00
2024-12-08 16:52:49,53,2791,15,38,1620.10,2829.02,0.00
2024-12-08 16:52:49,52,2791,14,38,1607.69,2829.90,0.00
2024-12-08 16:52:49,52,2792,14,38,1659.46,2830.00,0.00
2024-12-08 16:52:49,53,2792,15,38,1628.15,2830.02,0.00
2024-12-08 16:52:49,52,2792,15,37,1654.57,2830.04,0.00
2024-12-08 16:52:49,51,2792,14,37,1668.27,2830.37,0.00
2024-12-08 16:52:49,51,2793,14,37,1706.48,2831.00,0.00
2024-12-08 16:52:49,52,2793,14,38,1673.66,2831.02,0.00
2024-12-08 16:52:49,52,2794,14,38,1668.26,2832.00,0.00
2024-12-08 16:52:49,53,2794,15,38,1636.78,2832.02,0.00
2024-12-08 16:52:49,52,2794,15,37,1663.91,2832.04,0.00
2024-12-08 16:52:49,52,2795,15,37,1669.94,2833.00,0.00
2024-12-08 16:52:49,53,2795,15,38,1638.43,2833.02,0.00
2024-12-08 16:52:49,53,2796,15,38,1632.59,2834.00,0.00
2024-12-08 16:52:49,54,2796,15,39,1602.36,2834.02,0.00
2024-12-08 16:52:49,53,2796,15,38,1628.85,2834.04,0.00
2024-12-08 16:52:49,53,2797,15,38,1634.24,2835.00,0.00
2024-12-08 16:52:49,54,2797,15,39,1603.97,2835.02,0.00
2024-12-08 16:52:49,53,2797,14,39,1600.14,2835.42,0.00
2024-12-08 16:52:49,53,2798,14,39,1637.49,2836.00,0.00
2024-12-08 16:52:49,54,2798,14,40,1607.17,2836.02,0.00
2024-12-08 16:52:49,53,2798,14,39,1633.75,2836.04,0.00
2024-12-08 16:52:49,53,2799,14,39,1639.14,2837.00,0.00
2024-12-08 16:52:49,54,2799,14,40,1608.78,2837.02,0.00
2024-12-08 16:52:49,53,2799,13,40,1606.07,2837.40,0.00
2024-12-08 16:52:49,53,2800,13,40,1642.93,2838.00,0.00
2024-12-08 16:52:49,54,2800,14,40,1612.50,2838.02,0.00
2024-12-08 16:52:49,53,2800,14,39,1639.72,2838.04,0.00
2024-12-08 16:52:49,52,2800,13,39,1641.43,2838.50,0.00
2024-12-08 16:52:49,52,2801,13,39,1682.21,2839.00,0.00
2024-12-08 16:52:49,53,2801,14,39,1650.47,2839.02,0.00
2024-12-08 16:52:49,53,2802,14,39,1644.62,2840.00,0.00
2024-12-08 16:52:49,54,2802,14,40,1614.17,2840.02,0.00
2024-12-08 16:52:49,53,2802,14,39,1641.94,2840.04,0.00
2024-12-08 16:52:49,53,2803,14,39,1647.35,2841.00,0.00
2024-12-08 16:52:49,54,2803,15,39,1616.84,2841.02,0.00
2024-12-08 16:52:49,54,2804,15,39,1610.57,2842.00,0.00
2024-12-08 16:52:49,55,2804,15,40,1581.28,2842.02,0.00
2024-12-08 16:52:49,54,2804,15,39,1607.41,2842.04,0.00
2024-12-08 16:52:49,54,2805,15,39,1612.19,2843.00,0.00
2024-12-08 16:52:49,55,2805,15,40,1582.87,2843.02,0.00
2024-12-08 16:52:49,54,2805,14,40,1576.27,2843.78,0.00
2024-12-08 16:52:49,54,2806,14,40,1622.76,2844.00,0.00
2024-12-08 16:52:49,55,2806,15,40,1593.26,2844.02,0.00
2024-12-08 16:52:49,54,2806,15,39,1620.13,2844.04,0.00
2024-12-08 16:52:49,53,2806,14,39,1637.28,2844.04,0.00
2024-12-08 16:52:49,52,2806,13,39,1664.34,2844.19,0.00
2024-12-08 16:52:49,52,2807,13,39,1696.60,2845.00,0.00
2024-12-08 16:52:49,53,2807,14,39,1664.59,2845.02,0.00
2024-12-08 16:52:49,52,2807,13,39,1653.89,2845.89,0.00
2024-12-08 16:52:49,52,2808,13,39,1705.41,2846.00,0.00
2024-12-08 16:52:49,53,2808,14,39,1673.23,2846.02,0.00
2024-12-08 16:52:49,52,2808,14,38,1702.67,2846.04,0.00
2024-12-08 16:52:49,52,2809,14,38,1708.75,2847.00,0.00
2024-12-08 16:52:49,53,2809,15,38,1676.51,2847.02,0.00
2024-12-08 16:52:50,53,2810,15,38,1670.65,2848.00,0.00
2024-12-08 16:52:50,54,2810,16,38,1639.71,2848.02,0.00
2024-12-08 16:52:50,53,2810,15,38,1670.11,2848.02,0.00
2024-12-08 16:52:50,52,2810,15,37,1699.49,2848.02,0.00
2024-12-08 16:52:50,52,2811,15,37,1705.02,2849.00,0.00
2024-12-08 16:52:50,53,2811,15,38,1672.85,2849.02,0.00
2024-12-08 16:52:50,53,2812,15,38,1666.98,2850.00,0.00
2024-12-08 16:52:50,54,2812,16,38,1636.11,2850.02,0.00
2024-12-08 16:52:50,53,2812,16,37,1664.29,2850.02,0.00
2024-12-08 16:52:50,52,2812,15,37,1693.59,2850.12,0.00
2024-12-08 16:52:50,52,2813,15,37,1701.83,2851.00,0.00
2024-12-08 16:52:50,53,2813,16,37,1669.72,2851.02,0.00
2024-12-08 16:52:50,53,2814,16,37,1663.85,2852.00,0.00
2024-12-08 16:52:50,54,2814,16,38,1633.03,2852.02,0.00
2024-12-08 16:52:50,53,2814,16,37,1661.16,2852.02,0.00
2024-12-08 16:52:50,52,2814,15,37,1690.93,2852.10,0.00
2024-12-08 16:52:50,51,2814,14,37,1708.20,2852.65,0.00
2024-12-08 16:52:50,51,2815,14,37,1731.94,2853.00,0.00
2024-12-08 16:52:50,52,2815,15,37,1698.63,2853.02,0.00
2024-12-08 16:52:50,51,2815,14,37,1694.35,2853.78,0.00
2024-12-08 16:52:50,51,2816,14,37,1744.30,2854.00,0.00
2024-12-08 16:52:50,52,2816,14,38,1710.75,2854.02,0.00
2024-12-08 16:52:50,51,2816,14,37,1742.06,2854.02,0.00
2024-12-08 16:52:50,51,2817,14,37,1748.27,2855.00,0.00
2024-12-08 16:52:50,52,2817,14,38,1714.65,2855.02,0.00
2024-12-08 16:52:50,52,2818,14,38,1709.21,2856.00,0.00
2024-12-08 16:52:50,53,2818,15,38,1676.96,2856.02,0.00
2024-12-08 16:52:50,52,2818,15,37,1707.01,2856.02,0.00
2024-12-08 16:52:50,51,2818,14,37,1728.80,2856.22,0.00
2024-12-08 16:52:50,51,2819,14,37,1762.94,2857.00,0.00
2024-12-08 16:52:50,52,2819,14,38,1729.03,2857.02,0.00
2024-12-08 16:52:50,52,2820,14,38,1723.59,2858.00,0.00
2024-12-08 16:52:50,53,2820,15,38,1691.07,2858.02,0.00
2024-12-08 16:52:50,52,2820,15,37,1721.94,2858.02,0.00
2024-12-08 16:52:50,52,2821,15,37,1727.50,2859.00,0.00
2024-12-08 16:52:50,53,2821,15,38,1694.90,2859.02,0.00
2024-12-08 16:52:50,53,2822,15,38,1689.02,2860.00,0.00
2024-12-08 16:52:50,54,2822,15,39,1657.74,2860.02,0.00
2024-12-08 16:52:50,53,2822,15,38,1687.94,2860.02,0.00
2024-12-08 16:52:50,52,2822,14,38,1703.15,2860.64,0.00
2024-12-08 16:52:50,51,2822,13,38,1718.80,2860.94,0.00
2024-12-08 16:52:50,51,2823,13,38,1773.26,2861.00,0.00
2024-12-08 16:52:50,52,2823,13,39,1739.16,2861.02,0.00
2024-12-08 16:52:50,52,2824,13,39,1733.71,2862.00,0.00
2024-12-08 16:52:50,53,2824,14,39,1701.00,2862.02,0.00
2024-12-08 16:52:50,52,2824,14,38,1727.11,2862.02,0.00
2024-12-08 16:52:50,51,2824,13,38,1743.15,2862.31,0.00
2024-12-08 16:52:50,51,2825,13,38,1780.11,2863.00,0.00
2024-12-08 16:52:50,52,2825,13,39,1745.88,2863.02,0.00
2024-12-08 16:52:50,52,2826,13,39,1740.43,2864.00,0.00
2024-12-08 16:52:50,53,2826,13,40,1707.59,2864.02,0.00
2024-12-08 16:52:50,52,2826,13,39,1733.82,2864.02,0.00
2024-12-08 16:52:50,51,2826,12,39,1739.64,2864.82,0.00
2024-12-08 16:52:50,51,2827,12,39,1790.91,2865.00,0.00
2024-12-08 16:52:50,52,2827,13,39,1756.46,2865.02,0.00
2024-12-08 16:52:50,51,2827,12,39,1757.59,2865.73,0.00
2024-12-08 16:52:50,51,2828,12,39,1806.14,2866.00,0.00
2024-12-08 16:52:50,52,2828,13,39,1771.41,2866.02,0.00
2024-12-08 16:52:50,51,2828,13,38,1799.96,2866.02,0.00
2024-12-08 16:52:50,50,2828,12,38,1817.98,2866.66,0.00
2024-12-08 16:52:50,50,2829,12,38,1842.91,2867.00,0.00
2024-12-08 16:52:50,51,2829,13,38,1806.77,2867.02,0.00
2024-12-08 16:52:50,51,2830,13,38,1801.78,2868.00,0.00
2024-12-08 16:52:50,52,2830,13,39,1767.13,2868.02,0.00
2024-12-08 16:52:50,51,2830,13,38,1795.03,2868.02,0.00
2024-12-08 16:52:50,51,2831,13,38,1801.28,2869.00,0.00
2024-12-08 16:52:50,52,2831,13,39,1766.64,2869.02,0.00
2024-12-08 16:52:50,51,2831,12,39,1750.43,2869.65,0.00
2024-12-08 16:52:50,51,2832,12,39,1796.84,2870.00,0.00
2024-12-08 16:52:50,52,2832,13,39,1762.29,2870.02,0.00
2024-12-08 16:52:50,51,2832,13,38,1790.65,2870.02,0.00
2024-12-08 16:52:50,51,2833,13,38,1796.90,2871.00,0.00
2024-12-08 16:52:50,52,2833,14,38,1762.35,2871.02,0.00
2024-12-08 16:52:50,52,2834,14,38,1756.80,2872.00,0.00
2024-12-08 16:52:50,53,2834,15,38,1723.65,2872.02,0.00
2024-12-08 16:52:50,52,2834,15,37,1750.72,2872.02,0.00
2024-12-08 16:52:50,51,2834,14,37,1767.32,2872.65,0.00
2024-12-08 16:52:50,51,2835,14,37,1791.26,2873.00,0.00
2024-12-08 16:52:50,52,2835,15,37,1756.82,2873.02,0.00
2024-12-08 16:52:50,52,2836,15,37,1751.33,2874.00,0.00
2024-12-08 16:52:50,53,2836,15,38,1718.29,2874.02,0.00
2024-12-08 16:52:50,52,2836,15,37,1740.55,2874.06,0.00
2024-12-08 16:52:50,52,2837,15,37,1747.23,2875.00,0.00
2024-12-08 16:52:50,53,2837,16,37,1714.26,2875.02,0.00
2024-12-08 16:52:50,52,2837,15,37,1705.37,2875.85,0.00
2024-12-08 16:52:50,52,2838,15,37,1756.36,2876.00,0.00
2024-12-08 16:52:50,53,2838,16,37,1723.22,2876.02,0.00
2024-12-08 16:52:50,52,2838,16,36,1745.55,2876.06,0.00
2024-12-08 16:52:50,52,2839,16,36,1752.24,2877.00,0.00
2024-12-08 16:52:50,53,2839,16,37,1719.18,2877.02,0.00
2024-12-08 16:52:51,53,2840,16,37,1712.32,2878.00,0.00
2024-12-08 16:52:51,54,2840,17,37,1680.61,2878.02,0.00
2024-12-08 16:52:51,53,2840,17,36,1702.14,2878.06,0.00
2024-12-08 16:52:51,52,2840,16,36,1701.62,2878.92,0.00
2024-12-08 16:52:51,52,2841,16,36,1754.82,2879.00,0.00
2024-12-08 16:52:51,53,2841,16,37,1721.71,2879.02,0.00
2024-12-08 16:52:51,54,2840,16,38,1689.83,2879.06,0.00
2024-12-08 16:52:51,53,2840,15,38,1729.33,2879.09,0.00
2024-12-08 16:52:51,53,2841,15,38,1758.16,2880.00,0.00
2024-12-08 16:52:51,54,2841,16,38,1725.60,2880.02,0.00
2024-12-08 16:52:51,53,2841,16,37,1726.67,2880.06,0.00
2024-12-08 16:52:51,53,2842,16,37,1808.80,2881.00,0.00
2024-12-08 16:52:51,54,2842,16,38,1775.30,2881.02,0.00
2024-12-08 16:52:51,54,2843,16,38,1767.86,2882.00,0.00
2024-12-08 16:52:51,55,2843,17,38,1735.71,2882.02,0.00
2024-12-08 16:52:51,54,2843,17,37,1758.21,2882.06,0.00
2024-12-08 16:52:51,53,2843,16,37,1752.02,2882.66,0.00
2024-12-08 16:52:51,53,2844,16,37,1796.88,2883.00,0.00
2024-12-08 16:52:51,54,2844,16,38,1763.61,2883.02,0.00
2024-12-08 16:52:51,54,2845,16,38,1756.04,2884.00,0.00
2024-12-08 16:52:51,55,2845,16,39,1724.11,2884.02,0.00
2024-12-08 16:52:51,54,2845,16,38,1745.45,2884.07,0.00
2024-12-08 16:52:51,54,2846,16,38,1751.38,2885.00,0.00
2024-12-08 16:52:51,55,2846,16,39,1719.54,2885.02,0.00
2024-12-08 16:52:51,54,2846,16,38,1750.78,2885.04,0.00
2024-12-08 16:52:51,53,2846,15,38,1754.75,2885.66,0.00
2024-12-08 16:52:51,53,2847,15,38,1779.06,2886.00,0.00
2024-12-08 16:52:51,54,2847,15,39,1746.11,2886.02,0.00
2024-12-08 16:52:51,53,2847,15,38,1769.82,2886.06,0.00
2024-12-08 16:52:51,53,2848,15,38,1775.86,2887.00,0.00
2024-12-08 16:52:51,54,2848,15,39,1742.97,2887.02,0.00
2024-12-08 16:52:51,53,2848,14,39,1736.45,2887.79,0.00
2024-12-08 16:52:51,53,2849,14,39,1785.11,2888.00,0.00
2024-12-08 16:52:51,54,2849,15,39,1752.05,2888.02,0.00
2024-12-08 16:52:51,53,2849,15,38,1776.41,2888.06,0.00
2024-12-08 16:52:51,53,2850,15,38,1782.46,2889.00,0.00
2024-12-08 16:52:51,54,2850,16,38,1749.45,2889.02,0.00
2024-12-08 16:52:51,54,2851,16,38,1743.10,2890.00,0.00
2024-12-08 16:52:51,55,2851,17,38,1711.41,2890.02,0.00
2024-12-08 16:52:51,54,2851,17,37,1735.08,2890.06,0.00
2024-12-08 16:52:51,54,2852,17,37,1740.49,2891.00,0.00
2024-12-08 16:52:51,55,2852,17,38,1708.84,2891.02,0.00
2024-12-08 16:52:51,55,2853,17,38,1702.24,2892.00,0.00
2024-12-08 16:52:51,56,2853,18,38,1671.85,2892.02,0.00
2024-12-08 16:52:51,55,2853,18,37,1694.37,2892.05,0.00
2024-12-08 16:52:51,55,2854,18,37,1699.15,2893.00,0.00
2024-12-08 16:52:51,56,2854,18,38,1668.81,2893.02,0.00
2024-12-08 16:52:51,56,2855,18,38,1662.21,2894.00,0.00
2024-12-08 16:52:51,57,2855,18,39,1633.05,2894.02,0.00
2024-12-08 16:52:51,56,2855,18,38,1654.99,2894.05,0.00
2024-12-08 16:52:51,56,2856,18,38,1659.17,2895.00,0.00
2024-12-08 16:52:51,57,2856,18,39,1630.06,2895.02,0.00
2024-12-08 16:52:51,56,2856,17,39,1614.12,2895.93,0.00
2024-12-08 16:52:51,56,2857,17,39,1663.82,2896.00,0.00
2024-12-08 16:52:51,57,2857,17,40,1634.63,2896.02,0.00
2024-12-08 16:52:51,56,2857,17,39,1657.10,2896.05,0.00
2024-12-08 16:52:51,56,2858,17,39,1661.29,2897.00,0.00
2024-12-08 16:52:51,57,2858,18,39,1632.14,2897.02,0.00
2024-12-08 16:52:51,56,2858,17,39,1619.34,2897.89,0.00
2024-12-08 16:52:51,56,2859,17,39,1668.07,2898.00,0.00
2024-12-08 16:52:51,57,2859,18,39,1638.81,2898.02,0.00
2024-12-08 16:52:51,56,2859,18,38,1661.87,2898.05,0.00
2024-12-08 16:52:51,55,2859,17,38,1673.96,2898.67,0.00
2024-12-08 16:52:51,55,2860,17,38,1717.43,2899.00,0.00
2024-12-08 16:52:51,56,2860,17,39,1686.76,2899.02,0.00
2024-12-08 16:52:51,56,2861,17,39,1679.58,2900.00,0.00
2024-12-08 16:52:51,57,2861,17,40,1650.11,2900.02,0.00
2024-12-08 16:52:51,56,2861,17,39,1673.89,2900.05,0.00
2024-12-08 16:52:51,56,2862,17,39,1678.09,2901.00,0.00
2024-12-08 16:52:51,57,2862,18,39,1648.65,2901.02,0.00
2024-12-08 16:52:51,57,2863,18,39,1641.07,2902.00,0.00
2024-12-08 16:52:51,58,2863,18,40,1612.77,2902.02,0.00
2024-12-08 16:52:51,57,2863,18,39,1635.99,2902.05,0.00
2024-12-08 16:52:51,56,2863,17,39,1646.36,2902.70,0.00
2024-12-08 16:52:51,56,2864,17,39,1668.87,2903.00,0.00
2024-12-08 16:52:51,57,2864,18,39,1639.60,2903.02,0.00
2024-12-08 16:52:51,57,2865,18,39,1632.01,2904.00,0.00
2024-12-08 16:52:51,58,2865,19,39,1603.87,2904.02,0.00
2024-12-08 16:52:51,57,2865,19,38,1626.92,2904.05,0.00
2024-12-08 16:52:51,57,2866,19,38,1630.53,2905.00,0.00
2024-12-08 16:52:51,58,2866,19,39,1602.42,2905.02,0.00
2024-12-08 16:52:51,58,2867,19,39,1594.65,2906.00,0.00
2024-12-08 16:52:51,59,2867,19,40,1567.62,2906.02,0.00
2024-12-08 16:52:51,58,2867,19,39,1589.64,2906.05,0.00
2024-12-08 16:52:51,58,2868,19,39,1592.69,2907.00,0.00
2024-12-08 16:52:51,59,2868,19,40,1565.69,2907.02,0.00
2024-12-08 16:52:51,58,2868,18,40,1553.53,2907.85,0.00
2024-12-08 16:52:51,58,2869,18,40,1599.25,2908.00,0.00
2024-12-08 16:52:51,59,2869,19,40,1572.15,2908.02,0.00
2024-12-08 16:52:51,58,2869,19,39,1594.75,2908.05,0.00
2024-12-08 16:52:52,58,2870,19,39,1597.80,2909.00,0.00
2024-12-08 16:52:52,59,2870,19,40,1570.71,2909.02,0.00
2024-12-08 16:52:52,58,2870,18,40,1567.88,2909.71,0.00
2024-12-08 16:52:52,58,2871,18,40,1589.67,2910.00,0.00
2024-12-08 16:52:52,59,2871,18,41,1562.72,2910.02,0.00
2024-12-08 16:52:52,58,2871,18,40,1585.66,2910.05,0.00
2024-12-08 16:52:52,57,2871,17,40,1608.93,2910.19,0.00
2024-12-08 16:52:52,56,2871,16,40,1615.67,2910.80,0.00
2024-12-08 16:52:52,56,2872,16,40,1662.07,2911.00,0.00
2024-12-08 16:52:52,57,2872,17,40,1632.91,2911.02,0.00
2024-12-08 16:52:52,56,2872,16,40,1628.45,2911.45,0.00
2024-12-08 16:52:52,56,2873,16,40,1664.72,2912.00,0.00
2024-12-08 16:52:52,57,2873,16,41,1635.51,2912.02,0.00
2024-12-08 16:52:52,56,2873,16,40,1661.08,2912.05,0.00
2024-12-08 16:52:52,56,2874,16,40,1665.29,2913.00,0.00
2024-12-08 16:52:52,57,2874,16,41,1636.07,2913.02,0.00
2024-12-08 16:52:52,57,2875,16,41,1628.46,2914.00,0.00
2024-12-08 16:52:52,58,2875,17,41,1600.38,2914.02,0.00
2024-12-08 16:52:52,57,2875,17,40,1625.39,2914.05,0.00
2024-12-08 16:52:52,56,2875,16,40,1634.27,2914.41,0.00
2024-12-08 16:52:52,56,2876,16,40,1669.56,2915.00,0.00
2024-12-08 16:52:52,57,2876,16,41,1640.27,2915.02,0.00
2024-12-08 16:52:52,57,2877,16,41,1632.64,2916.00,0.00
2024-12-08 16:52:52,58,2877,17,41,1604.49,2916.02,0.00
2024-12-08 16:52:52,57,2877,16,41,1631.62,2916.04,0.00
2024-12-08 16:52:52,56,2877,16,40,1658.16,2916.04,0.00
2024-12-08 16:52:52,55,2877,15,40,1670.94,2916.36,0.00
2024-12-08 16:52:52,55,2878,15,40,1705.85,2917.00,0.00
2024-12-08 16:52:52,56,2878,15,41,1675.39,2917.02,0.00
2024-12-08 16:52:52,55,2878,14,41,1674.70,2917.38,0.00
2024-12-08 16:52:52,55,2879,14,41,1710.15,2918.00,0.00
2024-12-08 16:52:52,56,2879,14,42,1679.61,2918.02,0.00
2024-12-08 16:52:52,55,2879,14,41,1706.97,2918.04,0.00
2024-12-08 16:52:52,55,2880,14,41,1711.27,2919.00,0.00
2024-12-08 16:52:52,56,2880,15,41,1680.71,2919.02,0.00
2024-12-08 16:52:52,55,2880,14,41,1685.80,2919.05,0.00
2024-12-08 16:52:52,55,2881,14,41,1711.85,2920.00,0.00
2024-12-08 16:52:52,56,2881,15,41,1681.28,2920.02,0.00
2024-12-08 16:52:52,55,2881,15,40,1709.20,2920.04,0.00
2024-12-08 16:52:52,55,2882,15,40,1713.50,2921.00,0.00
2024-12-08 16:52:52,56,2882,16,40,1682.90,2921.02,0.00
2024-12-08 16:52:52,55,2882,15,40,1692.33,2921.26,0.00
2024-12-08 16:52:52,54,2882,14,40,1712.02,2921.65,0.00
2024-12-08 16:52:52,54,2883,14,40,1756.11,2922.00,0.00
2024-12-08 16:52:52,55,2883,14,41,1724.18,2922.02,0.00
2024-12-08 16:52:52,54,2883,14,40,1750.71,2922.06,0.00
2024-12-08 16:52:52,54,2884,14,40,1756.17,2923.00,0.00
2024-12-08 16:52:52,55,2884,14,41,1724.24,2923.02,0.00
2024-12-08 16:52:52,54,2884,13,41,1715.25,2923.50,0.00
2024-12-08 16:52:52,54,2885,13,41,1755.15,2924.00,0.00
2024-12-08 16:52:52,55,2885,13,42,1723.24,2924.02,0.00
2024-12-08 16:52:52,54,2885,13,41,1749.20,2924.06,0.00
2024-12-08 16:52:52,54,2886,13,41,1754.66,2925.00,0.00
2024-12-08 16:52:52,55,2886,13,42,1722.76,2925.02,0.00
2024-12-08 16:52:52,54,2886,12,42,1726.05,2925.63,0.00
2024-12-08 16:52:52,54,2887,12,42,1748.01,2926.00,0.00
2024-12-08 16:52:52,55,2887,12,43,1716.23,2926.02,0.00
2024-12-08 16:52:52,54,2887,12,42,1742.06,2926.06,0.00
2024-12-08 16:52:52,54,2888,12,42,1747.53,2927.00,0.00
2024-12-08 16:52:52,55,2888,13,42,1715.75,2927.02,0.00
2024-12-08 16:52:52,54,2888,12,42,1717.19,2927.09,0.00
2024-12-08 16:52:52,54,2889,12,42,1745.41,2928.00,0.00
2024-12-08 16:52:52,55,2889,12,43,1713.68,2928.02,0.00
2024-12-08 16:52:52,54,2889,12,42,1740.00,2928.06,0.00
2024-12-08 16:52:52,54,2890,12,42,1745.47,2929.00,0.00
2024-12-08 16:52:52,55,2890,12,43,1713.73,2929.02,0.00
2024-12-08 16:52:52,55,2891,12,43,1706.86,2930.00,0.00
2024-12-08 16:52:52,56,2891,13,43,1676.38,2930.02,0.00
2024-12-08 16:52:52,55,2891,13,42,1701.53,2930.05,0.00
2024-12-08 16:52:52,54,2891,12,42,1697.25,2930.96,0.00
2024-12-08 16:52:52,54,2892,12,42,1750.46,2931.00,0.00
2024-12-08 16:52:52,55,2892,12,43,1718.63,2931.02,0.00
2024-12-08 16:52:52,55,2893,12,43,1711.75,2932.00,0.00
2024-12-08 16:52:52,56,2893,12,44,1681.19,2932.02,0.00
2024-12-08 16:52:52,55,2893,12,43,1706.43,2932.05,0.00
2024-12-08 16:52:52,55,2894,12,43,1711.27,2933.00,0.00
2024-12-08 16:52:52,56,2894,13,43,1680.71,2933.02,0.00
2024-12-08 16:52:52,55,2894,12,43,1663.83,2933.96,0.00
2024-12-08 16:52:52,55,2895,12,43,1716.12,2934.00,0.00
2024-12-08 16:52:52,56,2895,13,43,1685.48,2934.02,0.00
2024-12-08 16:52:52,55,2895,13,42,1711.32,2934.05,0.00
2024-12-08 16:52:52,55,2896,13,42,1716.17,2935.00,0.00
2024-12-08 16:52:52,56,2896,13,43,1685.53,2935.02,0.00
2024-12-08 16:52:52,55,2896,12,43,1684.51,2935.71,0.00
2024-12-08 16:52:52,55,2897,12,43,1729.57,2936.00,0.00
2024-12-08 16:52:52,56,2897,13,43,1698.69,2936.02,0.00
2024-12-08 16:52:52,55,2897,13,42,1725.30,2936.05,0.00
2024-12-08 16:52:52,55,2898,13,42,1730.16,2937.00,0.00
2024-12-08 16:52:52,56,2898,14,42,1699.26,2937.02,0.00
2024-12-08 16:52:52,56,2899,14,42,1691.97,2938.00,0.00
2024-12-08 16:52:53,57,2899,14,43,1662.29,2938.02,0.00
2024-12-08 16:52:53,56,2899,14,42,1687.78,2938.05,0.00
2024-12-08 16:52:53,56,2900,14,42,1692.02,2939.00,0.00
2024-12-08 16:52:53,57,2900,14,43,1662.34,2939.02,0.00
2024-12-08 16:52:53,57,2901,14,43,1654.65,2940.00,0.00
2024-12-08 16:52:53,58,2901,14,44,1626.12,2940.02,0.00
2024-12-08 16:52:53,57,2901,13,44,1654.65,2940.02,0.00
2024-12-08 16:52:53,56,2901,13,43,1681.05,2940.04,0.00
2024-12-08 16:52:53,55,2901,12,43,1693.25,2940.67,0.00
2024-12-08 16:52:53,54,2901,11,43,1706.85,2940.96,0.00
2024-12-08 16:52:53,54,2902,11,43,1760.24,2941.00,0.00
2024-12-08 16:52:53,55,2902,12,43,1728.24,2941.02,0.00
2024-12-08 16:52:53,55,2903,12,43,1721.34,2942.00,0.00
2024-12-08 16:52:53,56,2903,13,43,1690.60,2942.02,0.00
2024-12-08 16:52:53,55,2903,13,42,1717.06,2942.04,0.00
2024-12-08 16:52:53,54,2903,12,42,1730.12,2942.69,0.00
2024-12-08 16:52:53,54,2904,12,42,1753.81,2943.00,0.00
2024-12-08 16:52:53,55,2904,12,43,1721.92,2943.02,0.00
2024-12-08 16:52:53,55,2905,12,43,1715.01,2944.00,0.00
2024-12-08 16:52:53,56,2905,12,44,1684.39,2944.02,0.00
2024-12-08 16:52:53,55,2905,12,43,1711.27,2944.04,0.00
2024-12-08 16:52:53,54,2905,11,43,1706.44,2944.96,0.00
2024-12-08 16:52:53,54,2906,11,43,1759.91,2945.00,0.00
2024-12-08 16:52:53,55,2906,12,43,1727.91,2945.02,0.00
2024-12-08 16:52:53,55,2907,12,43,1721.00,2946.00,0.00
2024-12-08 16:52:53,56,2907,12,44,1690.27,2946.02,0.00
2024-12-08 16:52:53,55,2907,11,44,1720.46,2946.02,0.00
2024-12-08 16:52:53,54,2907,11,43,1747.41,2946.02,0.00
2024-12-08 16:52:53,54,2908,11,43,1751.83,2947.00,0.00
2024-12-08 16:52:53,55,2908,11,44,1719.98,2947.02,0.00
2024-12-08 16:52:53,55,2909,11,44,1713.06,2948.00,0.00
2024-12-08 16:52:53,56,2909,12,44,1682.47,2948.02,0.00
2024-12-08 16:52:53,55,2909,12,43,1707.70,2948.02,0.00
2024-12-08 16:52:53,54,2909,11,43,1702.21,2948.96,0.00
2024-12-08 16:52:53,54,2910,11,43,1755.75,2949.00,0.00
2024-12-08 16:52:53,55,2910,12,43,1723.82,2949.02,0.00
2024-12-08 16:52:53,54,2910,11,43,1710.68,2949.59,0.00
2024-12-08 16:52:53,54,2911,11,43,1753.61,2950.00,0.00
2024-12-08 16:52:53,55,2911,11,44,1721.73,2950.02,0.00
2024-12-08 16:52:53,54,2911,11,43,1748.15,2950.02,0.00
2024-12-08 16:52:53,54,2912,11,43,1752.57,2951.00,0.00
2024-12-08 16:52:53,55,2912,11,44,1720.70,2951.02,0.00
2024-12-08 16:52:53,54,2912,10,44,1724.70,2951.04,0.00
2024-12-08 16:52:53,54,2913,10,44,1751.52,2952.00,0.00
2024-12-08 16:52:53,55,2913,10,45,1719.67,2952.02,0.00
2024-12-08 16:52:53,54,2913,10,44,1747.15,2952.02,0.00
2024-12-08 16:52:53,54,2914,10,44,1751.57,2953.00,0.00
2024-12-08 16:52:53,55,2914,11,44,1719.72,2953.02,0.00
2024-12-08 16:52:53,54,2914,10,44,1704.53,2953.94,0.00
2024-12-08 16:52:53,54,2915,10,44,1757.63,2954.00,0.00
2024-12-08 16:52:53,55,2915,10,45,1725.67,2954.02,0.00
2024-12-08 16:52:53,54,2915,10,44,1753.25,2954.02,0.00
2024-12-08 16:52:53,54,2916,10,44,1757.68,2955.00,0.00
2024-12-08 16:52:53,55,2916,11,44,1725.72,2955.02,0.00
2024-12-08 16:52:53,56,2915,12,44,1665.67,2955.70,0.00
2024-12-08 16:52:53,56,2916,12,44,1720.81,2956.00,0.00
2024-12-08 16:52:53,57,2916,12,45,1690.62,2956.02,0.00
2024-12-08 16:52:53,56,2916,12,44,1716.59,2956.02,0.00
2024-12-08 16:52:53,56,2917,12,44,1772.61,2957.00,0.00
2024-12-08 16:52:53,57,2917,12,45,1741.52,2957.02,0.00
2024-12-08 16:52:53,57,2918,12,45,1733.80,2958.00,0.00
2024-12-08 16:52:53,58,2918,13,45,1703.91,2958.02,0.00
2024-12-08 16:52:53,57,2918,13,44,1730.17,2958.02,0.00
2024-12-08 16:52:53,56,2918,12,44,1721.26,2958.68,0.00
2024-12-08 16:52:53,56,2919,12,44,1764.83,2959.00,0.00
2024-12-08 16:52:53,57,2919,13,44,1733.87,2959.02,0.00
2024-12-08 16:52:53,57,2920,13,44,1726.15,2960.00,0.00
2024-12-08 16:52:53,58,2920,14,44,1696.39,2960.02,0.00
2024-12-08 16:52:53,57,2920,14,43,1723.03,2960.02,0.00
2024-12-08 16:52:53,57,2921,14,43,1725.69,2961.00,0.00
2024-12-08 16:52:53,58,2921,15,43,1695.94,2961.02,0.00
2024-12-08 16:52:53,58,2922,15,43,1687.83,2962.00,0.00
2024-12-08 16:52:53,59,2922,16,43,1659.22,2962.02,0.00
2024-12-08 16:52:53,58,2922,16,42,1685.28,2962.02,0.00
2024-12-08 16:52:53,58,2923,16,42,1687.38,2963.00,0.00
2024-12-08 16:52:53,59,2923,17,42,1658.78,2963.02,0.00
2024-12-08 16:52:53,58,2923,16,42,1667.52,2963.24,0.00
2024-12-08 16:52:53,58,2924,16,42,1696.63,2964.00,0.00
2024-12-08 16:52:53,59,2924,17,42,1667.88,2964.02,0.00
2024-12-08 16:52:53,58,2924,17,41,1694.59,2964.02,0.00
2024-12-08 16:52:53,57,2924,16,41,1720.20,2964.16,0.00
2024-12-08 16:52:53,57,2925,16,41,1726.98,2965.00,0.00
2024-12-08 16:52:53,58,2925,17,41,1697.21,2965.02,0.00
2024-12-08 16:52:53,58,2926,17,41,1689.09,2966.00,0.00
2024-12-08 16:52:53,59,2926,18,41,1660.46,2966.02,0.00
2024-12-08 16:52:53,58,2926,18,40,1686.02,2966.02,0.00
2024-12-08 16:52:53,58,2927,18,40,1688.12,2967.00,0.00
2024-12-08 16:52:53,59,2927,19,40,1659.51,2967.02,0.00
2024-12-08 16:52:53,58,2927,18,40,1642.37,2967.60,0.00
2024-12-08 16:52:53,58,2928,18,40,1682.04,2968.00,0.00
2024-12-08 16:52:53,59,2928,18,41,1653.53,2968.02,0.00
2024-12-08 16:52:54,58,2928,18,40,1678.97,2968.02,0.00
2024-12-08 16:52:54,58,2929,18,40,1681.07,2969.00,0.00
2024-12-08 16:52:54,59,2929,18,41,1652.58,2969.02,0.00
2024-12-08 16:52:54,59,2930,18,41,1644.07,2970.00,0.00
2024-12-08 16:52:54,60,2930,18,42,1616.67,2970.02,0.00
2024-12-08 16:52:54,59,2930,18,41,1641.55,2970.02,0.00
2024-12-08 16:52:54,59,2931,18,41,1643.11,2971.00,0.00
2024-12-08 16:52:54,60,2931,19,41,1615.73,2971.02,0.00
2024-12-08 16:52:54,59,2931,18,41,1600.28,2971.90,0.00
2024-12-08 16:52:54,59,2932,18,41,1647.70,2972.00,0.00
2024-12-08 16:52:54,60,2932,19,41,1620.24,2972.02,0.00
2024-12-08 16:52:54,59,2932,19,40,1645.68,2972.02,0.00
2024-12-08 16:52:54,58,2932,18,40,1669.49,2972.17,0.00
2024-12-08 16:52:54,58,2933,18,40,1676.16,2973.00,0.00
2024-12-08 16:52:54,59,2933,18,41,1647.75,2973.02,0.00
2024-12-08 16:52:54,58,2933,17,41,1646.26,2973.67,0.00
2024-12-08 16:52:54,58,2934,17,41,1667.49,2974.00,0.00
2024-12-08 16:52:54,59,2934,17,42,1639.23,2974.02,0.00
2024-12-08 16:52:54,58,2934,17,41,1665.95,2974.02,0.00
2024-12-08 16:52:54,57,2934,16,41,1658.15,2974.97,0.00
2024-12-08 16:52:54,57,2935,16,41,1709.32,2975.00,0.00
2024-12-08 16:52:54,58,2935,16,42,1679.85,2975.02,0.00
2024-12-08 16:52:54,57,2935,15,42,1678.87,2975.68,0.00
2024-12-08 16:52:54,57,2936,15,42,1701.02,2976.00,0.00
2024-12-08 16:52:54,58,2936,15,43,1671.69,2976.02,0.00
2024-12-08 16:52:54,57,2936,15,42,1698.93,2976.02,0.00
2024-12-08 16:52:54,57,2937,15,42,1701.59,2977.00,0.00
2024-12-08 16:52:54,58,2937,15,43,1672.25,2977.02,0.00
2024-12-08 16:52:54,57,2937,14,43,1656.13,2977.93,0.00
2024-12-08 16:52:54,57,2938,14,43,1706.34,2978.00,0.00
2024-12-08 16:52:54,58,2938,15,43,1676.92,2978.02,0.00
2024-12-08 16:52:54,57,2938,15,42,1704.77,2978.02,0.00
2024-12-08 16:52:54,57,2939,15,42,1707.44,2979.00,0.00
2024-12-08 16:52:54,58,2939,16,42,1678.00,2979.02,0.00
2024-12-08 16:52:54,58,2940,16,42,1669.83,2980.00,0.00
2024-12-08 16:52:54,59,2940,17,42,1641.52,2980.02,0.00
2024-12-08 16:52:54,58,2940,17,41,1668.29,2980.02,0.00
2024-12-08 16:52:54,57,2940,16,41,1675.45,2980.74,0.00
2024-12-08 16:52:54,57,2941,16,41,1720.09,2981.00,0.00
2024-12-08 16:52:54,58,2941,17,41,1690.43,2981.02,0.00
2024-12-08 16:52:54,58,2942,17,41,1682.26,2982.00,0.00
2024-12-08 16:52:54,59,2942,17,42,1653.75,2982.02,0.00
2024-12-08 16:52:54,58,2942,17,41,1680.20,2982.02,0.00
2024-12-08 16:52:54,58,2943,17,41,1682.31,2983.00,0.00
2024-12-08 16:52:54,59,2943,18,41,1653.79,2983.02,0.00
2024-12-08 16:52:54,58,2943,17,41,1651.79,2983.71,0.00
2024-12-08 16:52:54,58,2944,17,41,1674.13,2984.00,0.00
2024-12-08 16:52:54,59,2944,17,42,1645.75,2984.02,0.00
2024-12-08 16:52:54,58,2944,17,41,1672.58,2984.02,0.00
2024-12-08 16:52:54,57,2944,16,41,1664.77,2984.97,0.00
2024-12-08 16:52:54,57,2945,16,41,1716.11,2985.00,0.00
2024-12-08 16:52:54,58,2945,17,41,1686.52,2985.02,0.00
2024-12-08 16:52:54,58,2946,17,41,1678.34,2986.00,0.00
2024-12-08 16:52:54,59,2946,18,41,1649.89,2986.02,0.00
2024-12-08 16:52:54,58,2946,18,40,1677.31,2986.02,0.00
2024-12-08 16:52:54,58,2947,18,40,1679.41,2987.00,0.00
2024-12-08 16:52:54,59,2947,18,41,1650.95,2987.02,0.00
2024-12-08 16:52:54,58,2947,17,41,1630.79,2987.67,0.00
2024-12-08 16:52:54,58,2948,17,41,1672.76,2988.00,0.00
2024-12-08 16:52:54,59,2948,17,42,1644.41,2988.02,0.00
2024-12-08 16:52:54,58,2948,17,41,1671.73,2988.02,0.00
2024-12-08 16:52:54,58,2949,17,41,1673.84,2989.00,0.00
2024-12-08 16:52:54,59,2949,17,42,1645.47,2989.02,0.00
2024-12-08 16:52:54,59,2950,17,42,1636.90,2990.00,0.00
2024-12-08 16:52:54,60,2950,18,42,1609.62,2990.02,0.00
2024-12-08 16:52:54,59,2950,18,41,1636.39,2990.02,0.00
2024-12-08 16:52:54,58,2950,17,41,1636.16,2990.83,0.00
2024-12-08 16:52:54,58,2951,17,41,1682.69,2991.00,0.00
2024-12-08 16:52:54,59,2951,18,41,1654.17,2991.02,0.00
2024-12-08 16:52:54,59,2952,18,41,1645.60,2992.00,0.00
2024-12-08 16:52:54,60,2952,19,41,1618.17,2992.02,0.00
2024-12-08 16:52:54,59,2952,19,40,1645.09,2992.02,0.00
2024-12-08 16:52:54,59,2953,19,40,1646.66,2993.00,0.00
2024-12-08 16:52:54,60,2953,20,40,1619.21,2993.02,0.00
2024-12-08 16:52:54,59,2953,20,39,1636.00,2993.02,0.00
2024-12-08 16:52:54,58,2953,19,39,1652.86,2993.02,0.00
2024-12-08 16:52:54,58,2954,19,39,1675.61,2994.00,0.00
2024-12-08 16:52:54,59,2954,19,40,1647.21,2994.02,0.00
2024-12-08 16:52:54,59,2955,19,40,1638.62,2995.00,0.00
2024-12-08 16:52:54,60,2955,20,40,1611.31,2995.02,0.00
2024-12-08 16:52:54,59,2955,20,39,1638.11,2995.02,0.00
2024-12-08 16:52:54,58,2955,19,39,1639.21,2995.52,0.00
2024-12-08 16:52:54,58,2956,19,39,1676.73,2996.00,0.00
2024-12-08 16:52:54,59,2956,19,40,1648.31,2996.02,0.00
2024-12-08 16:52:54,59,2957,19,40,1639.71,2997.00,0.00
2024-12-08 16:52:54,60,2957,19,41,1612.39,2997.02,0.00
2024-12-08 16:52:54,59,2957,19,40,1639.21,2997.02,0.00
2024-12-08 16:52:55,59,2958,19,40,1640.77,2998.00,0.00
2024-12-08 16:52:55,60,2958,20,40,1613.42,2998.02,0.00
2024-12-08 16:52:55,59,2958,20,39,1630.10,2998.02,0.00
2024-12-08 16:52:55,58,2958,19,39,1624.05,2998.91,0.00
2024-12-08 16:52:55,58,2959,19,39,1673.23,2999.00,0.00
2024-12-08 16:52:55,59,2959,20,39,1644.87,2999.02,0.00
2024-12-08 16:52:55,59,2960,20,39,1636.27,3000.00,0.00
2024-12-08 16:52:55,60,2960,21,39,1609.00,3000.02,0.00
2024-12-08 16:52:55,59,2960,21,38,1634.75,3000.02,0.00
2024-12-08 16:52:55,59,2961,21,38,1636.31,3001.00,0.00
2024-12-08 16:52:55,60,2961,21,39,1609.04,3001.02,0.00
2024-12-08 16:52:55,59,2961,20,39,1599.36,3001.49,0.00
2024-12-08 16:52:55,59,2962,20,39,1635.33,3002.00,0.00
2024-12-08 16:52:55,60,2962,20,40,1608.07,3002.02,0.00
2024-12-08 16:52:55,59,2962,20,39,1634.31,3002.02,0.00
2024-12-08 16:52:55,59,2963,20,39,1635.87,3003.00,0.00
2024-12-08 16:52:55,60,2963,20,40,1608.61,3003.02,0.00
2024-12-08 16:52:55,60,2964,20,40,1599.63,3004.00,0.00
2024-12-08 16:52:55,61,2964,21,40,1573.41,3004.02,0.00
2024-12-08 16:52:55,60,2964,21,39,1599.13,3004.02,0.00
2024-12-08 16:52:55,59,2964,20,39,1598.62,3004.81,0.00
2024-12-08 16:52:55,59,2965,20,39,1644.09,3005.00,0.00
2024-12-08 16:52:55,60,2965,21,39,1616.69,3005.02,0.00
2024-12-08 16:52:55,59,2965,21,38,1633.40,3005.02,0.00
2024-12-08 16:52:55,59,2966,21,38,1634.96,3006.00,0.00
2024-12-08 16:52:55,60,2966,22,38,1607.71,3006.02,0.00
2024-12-08 16:52:55,59,2966,22,37,1624.26,3006.02,0.00
2024-12-08 16:52:55,59,2967,22,37,1625.82,3007.00,0.00
2024-12-08 16:52:55,60,2967,23,37,1598.72,3007.02,0.00
2024-12-08 16:52:55,59,2967,22,37,1598.83,3007.10,0.00
2024-12-08 16:52:55,59,2968,22,37,1623.30,3008.00,0.00
2024-12-08 16:52:55,60,2968,22,38,1596.24,3008.02,0.00
2024-12-08 16:52:55,59,2968,22,37,1622.79,3008.02,0.00
2024-12-08 16:52:55,58,2968,21,37,1644.09,3008.22,0.00
2024-12-08 16:52:55,58,2969,21,37,1652.36,3009.00,0.00
2024-12-08 16:52:55,59,2969,22,37,1624.35,3009.02,0.00
2024-12-08 16:52:55,58,2969,22,36,1641.46,3009.02,0.00
2024-12-08 16:52:55,58,2970,22,36,1643.56,3010.00,0.00
2024-12-08 16:52:55,59,2970,22,37,1615.71,3010.02,0.00
2024-12-08 16:52:55,59,2971,22,37,1607.06,3011.00,0.00
2024-12-08 16:52:55,60,2971,23,37,1580.27,3011.02,0.00
2024-12-08 16:52:55,59,2971,23,36,1606.55,3011.02,0.00
2024-12-08 16:52:55,59,2972,23,36,1608.10,3012.00,0.00
2024-12-08 16:52:55,60,2972,23,37,1581.30,3012.02,0.00
2024-12-08 16:52:55,59,2972,23,36,1597.38,3012.02,0.00
2024-12-08 16:52:55,59,2973,23,36,1598.93,3013.00,0.00
2024-12-08 16:52:55,60,2973,23,37,1572.28,3013.02,0.00
2024-12-08 16:52:55,59,2973,22,37,1572.47,3013.32,0.00
2024-12-08 16:52:55,59,2974,22,37,1603.55,3014.00,0.00
2024-12-08 16:52:55,60,2974,23,37,1576.82,3014.02,0.00
2024-12-08 16:52:55,59,2974,23,36,1602.02,3014.03,0.00
2024-12-08 16:52:55,59,2975,23,36,1604.08,3015.00,0.00
2024-12-08 16:52:55,60,2975,24,36,1577.35,3015.02,0.00
2024-12-08 16:52:55,60,2976,24,36,1568.32,3016.00,0.00
2024-12-08 16:52:55,61,2976,25,36,1542.61,3016.02,0.00
2024-12-08 16:52:55,60,2976,25,35,1566.32,3016.03,0.00
2024-12-08 16:52:55,60,2977,25,35,1567.83,3017.00,0.00
2024-12-08 16:52:55,61,2977,25,36,1542.13,3017.02,0.00
2024-12-08 16:52:55,61,2978,25,36,1532.75,3018.00,0.00
2024-12-08 16:52:55,62,2978,26,36,1508.03,3018.02,0.00
2024-12-08 16:52:55,61,2978,26,35,1531.27,3018.03,0.00
2024-12-08 16:52:55,61,2979,26,35,1532.27,3019.00,0.00
2024-12-08 16:52:55,62,2979,26,36,1507.55,3019.02,0.00
2024-12-08 16:52:55,61,2979,25,36,1494.04,3019.82,0.00
2024-12-08 16:52:55,61,2980,25,36,1538.22,3020.00,0.00
2024-12-08 16:52:55,62,2980,26,36,1513.41,3020.02,0.00
2024-12-08 16:52:55,61,2980,26,35,1537.23,3020.03,0.00
2024-12-08 16:52:55,60,2980,25,35,1557.37,3020.22,0.00
2024-12-08 16:52:55,59,2980,24,35,1560.56,3020.83,0.00
2024-12-08 16:52:55,59,2981,24,35,1606.76,3021.00,0.00
2024-12-08 16:52:55,60,2981,25,35,1579.98,3021.02,0.00
2024-12-08 16:52:55,59,2981,24,35,1590.43,3021.22,0.00
2024-12-08 16:52:55,58,2981,23,35,1588.36,3021.60,0.00
2024-12-08 16:52:55,58,2982,23,35,1628.75,3022.00,0.00
2024-12-08 16:52:55,59,2982,24,35,1601.15,3022.02,0.00
2024-12-08 16:52:55,58,2982,24,34,1627.20,3022.03,0.00
2024-12-08 16:52:55,58,2983,24,34,1629.81,3023.00,0.00
2024-12-08 16:52:55,59,2983,24,35,1602.19,3023.02,0.00
2024-12-08 16:52:55,58,2983,23,35,1582.65,3023.62,0.00
2024-12-08 16:52:55,58,2984,23,35,1623.57,3024.00,0.00
2024-12-08 16:52:55,59,2984,24,35,1596.06,3024.02,0.00
2024-12-08 16:52:55,58,2984,24,34,1622.54,3024.03,0.00
2024-12-08 16:52:55,58,2985,24,34,1625.16,3025.00,0.00
2024-12-08 16:52:55,59,2985,24,35,1597.61,3025.02,0.00
2024-12-08 16:52:55,58,2985,23,35,1597.10,3025.35,0.00
2024-12-08 16:52:55,58,2986,23,35,1629.87,3026.00,0.00
2024-12-08 16:52:55,59,2986,23,36,1602.24,3026.02,0.00
2024-12-08 16:52:55,58,2986,23,35,1628.83,3026.03,0.00
2024-12-08 16:52:55,57,2986,22,35,1640.52,3026.33,0.00
2024-12-08 16:52:55,56,2986,21,35,1658.68,3026.70,0.00
2024-12-08 16:52:56,56,2987,21,35,1703.77,3027.00,0.00
2024-12-08 16:52:56,57,2987,21,36,1673.88,3027.02,0.00
2024-12-08 16:52:56,56,2987,21,35,1691.88,3027.04,0.00
2024-12-08 16:52:56,56,2988,21,35,1695.68,3028.00,0.00
2024-12-08 16:52:56,57,2988,22,35,1665.93,3028.02,0.00
2024-12-08 16:52:56,56,2988,21,35,1680.57,3028.16,0.00
2024-12-08 16:52:56,56,2989,21,35,1688.13,3029.00,0.00
2024-12-08 16:52:56,57,2989,22,35,1658.51,3029.02,0.00
2024-12-08 16:52:56,56,2989,22,34,1684.35,3029.07,0.00
2024-12-08 16:52:56,55,2989,21,34,1689.46,3029.78,0.00
2024-12-08 16:52:56,55,2990,21,34,1738.12,3030.00,0.00
2024-12-08 16:52:56,56,2990,21,35,1707.08,3030.02,0.00
2024-12-08 16:52:56,55,2990,21,34,1726.00,3030.04,0.00
2024-12-08 16:52:56,55,2991,21,34,1730.43,3031.00,0.00
2024-12-08 16:52:56,56,2991,22,34,1699.52,3031.02,0.00
2024-12-08 16:52:56,56,2992,22,34,1691.96,3032.00,0.00
2024-12-08 16:52:56,57,2992,23,34,1662.28,3032.02,0.00
2024-12-08 16:52:56,56,2992,23,33,1689.26,3032.05,0.00
2024-12-08 16:52:56,55,2992,22,33,1683.02,3032.96,0.00
2024-12-08 16:52:56,55,2993,22,33,1737.08,3033.00,0.00
2024-12-08 16:52:56,56,2993,23,33,1706.06,3033.02,0.00
2024-12-08 16:52:56,56,2994,23,33,1698.50,3034.00,0.00
2024-12-08 16:52:56,57,2994,23,34,1668.70,3034.02,0.00
2024-12-08 16:52:56,56,2994,23,33,1695.26,3034.07,0.00
2024-12-08 16:52:56,56,2995,23,33,1700.14,3035.00,0.00
2024-12-08 16:52:56,57,2995,23,34,1670.31,3035.02,0.00
2024-12-08 16:52:56,56,2995,22,34,1668.48,3035.70,0.00
2024-12-08 16:52:56,56,2996,22,34,1692.03,3036.00,0.00
2024-12-08 16:52:56,57,2996,23,34,1662.34,3036.02,0.00
2024-12-08 16:52:56,56,2996,23,33,1689.33,3036.07,0.00
2024-12-08 16:52:56,56,2997,23,33,1694.21,3037.00,0.00
2024-12-08 16:52:56,57,2997,24,33,1664.49,3037.02,0.00
2024-12-08 16:52:56,57,2998,24,33,1658.24,3038.00,0.00
2024-12-08 16:52:56,58,2998,25,33,1629.65,3038.02,0.00
2024-12-08 16:52:56,57,2998,25,32,1650.78,3038.07,0.00
2024-12-08 16:52:56,56,2998,24,32,1670.56,3038.25,0.00
2024-12-08 16:52:56,56,2999,24,32,1702.51,3039.00,0.00
2024-12-08 16:52:56,57,2999,25,32,1672.65,3039.02,0.00
2024-12-08 16:52:56,56,2999,24,32,1674.26,3039.32,0.00
2024-12-08 16:52:56,56,3000,24,32,1708.37,3040.00,0.00
2024-12-08 16:52:56,57,3000,24,33,1678.40,3040.02,0.00
2024-12-08 16:52:56,56,3000,24,32,1701.32,3040.07,0.00
2024-12-08 16:52:56,56,3001,24,32,1706.22,3041.00,0.00
2024-12-08 16:52:56,57,3001,25,32,1676.28,3041.02,0.00
2024-12-08 16:52:56,57,3002,25,32,1669.29,3042.00,0.00
2024-12-08 16:52:56,58,3002,26,32,1640.51,3042.02,0.00
2024-12-08 16:52:56,57,3002,26,31,1662.89,3042.07,0.00
2024-12-08 16:52:56,57,3003,26,31,1667.17,3043.00,0.00
2024-12-08 16:52:56,58,3003,27,31,1638.42,3043.02,0.00
2024-12-08 16:52:56,57,3003,26,31,1651.19,3043.18,0.00
2024-12-08 16:52:56,57,3004,26,31,1660.73,3044.00,0.00
2024-12-08 16:52:56,58,3004,27,31,1632.10,3044.02,0.00
2024-12-08 16:52:56,57,3004,27,30,1653.79,3044.07,0.00
2024-12-08 16:52:56,56,3004,26,30,1677.46,3044.18,0.00
2024-12-08 16:52:56,56,3005,26,30,1707.33,3045.00,0.00
2024-12-08 16:52:56,57,3005,26,31,1677.38,3045.02,0.00
2024-12-08 16:52:56,57,3006,26,31,1670.29,3046.00,0.00
2024-12-08 16:52:56,58,3006,26,32,1641.49,3046.02,0.00
2024-12-08 16:52:56,57,3006,26,31,1663.88,3046.07,0.00
2024-12-08 16:52:56,57,3007,26,31,1668.16,3047.00,0.00
2024-12-08 16:52:56,58,3007,26,32,1639.40,3047.02,0.00
2024-12-08 16:52:56,58,3008,26,32,1632.16,3048.00,0.00
2024-12-08 16:52:56,59,3008,26,33,1604.49,3048.02,0.00
2024-12-08 16:52:56,58,3008,26,32,1626.38,3048.07,0.00
2024-12-08 16:52:56,58,3009,26,32,1630.07,3049.00,0.00
2024-12-08 16:52:56,59,3009,27,32,1602.44,3049.02,0.00
2024-12-08 16:52:56,58,3009,26,32,1583.65,3049.91,0.00
2024-12-08 16:52:56,58,3010,26,32,1633.66,3050.00,0.00
2024-12-08 16:52:56,59,3010,26,33,1605.97,3050.02,0.00
2024-12-08 16:52:56,58,3010,26,32,1628.40,3050.07,0.00
2024-12-08 16:52:56,58,3011,26,32,1632.09,3051.00,0.00
2024-12-08 16:52:56,59,3011,26,33,1604.42,3051.02,0.00
2024-12-08 16:52:56,58,3011,26,32,1631.04,3051.03,0.00
2024-12-08 16:52:56,58,3012,26,32,1624.18,3052.00,0.00
2024-12-08 16:52:56,59,3012,27,32,1596.65,3052.02,0.00
2024-12-08 16:52:56,58,3012,27,31,1619.97,3052.05,0.00
2024-12-08 16:52:56,57,3012,26,31,1628.90,3052.68,0.00
2024-12-08 16:52:56,56,3012,25,31,1649.37,3052.80,0.00
2024-12-08 16:52:56,56,3013,25,31,1698.03,3053.00,0.00
2024-12-08 16:52:56,57,3013,26,31,1668.24,3053.02,0.00
2024-12-08 16:52:56,56,3013,25,31,1682.79,3053.14,0.00
2024-12-08 16:52:56,56,3014,25,31,1691.17,3054.00,0.00
2024-12-08 16:52:56,57,3014,26,31,1661.50,3054.02,0.00
2024-12-08 16:52:56,56,3014,26,30,1685.18,3054.05,0.00
2024-12-08 16:52:56,56,3015,26,30,1689.55,3055.00,0.00
2024-12-08 16:52:56,57,3015,26,31,1659.90,3055.02,0.00
2024-12-08 16:52:56,56,3015,25,31,1689.00,3055.02,0.00
2024-12-08 16:52:56,55,3015,24,31,1719.15,3055.02,0.00
2024-12-08 16:52:57,55,3016,24,31,1713.47,3056.00,0.00
2024-12-08 16:52:57,56,3016,24,32,1682.88,3056.02,0.00
2024-12-08 16:52:57,55,3016,24,31,1708.47,3056.02,0.00
2024-12-08 16:52:57,55,3017,24,31,1712.37,3057.00,0.00
2024-12-08 16:52:57,56,3017,25,31,1681.79,3057.02,0.00
2024-12-08 16:52:57,56,3018,25,31,1675.44,3058.00,0.00
2024-12-08 16:52:57,57,3018,25,32,1646.04,3058.02,0.00
2024-12-08 16:52:57,56,3018,25,31,1669.98,3058.02,0.00
2024-12-08 16:52:57,56,3019,25,31,1673.25,3059.00,0.00
2024-12-08 16:52:57,57,3019,25,32,1643.90,3059.02,0.00
2024-12-08 16:52:57,56,3019,24,32,1630.32,3059.84,0.00
2024-12-08 16:52:57,56,3020,24,32,1680.16,3060.00,0.00
2024-12-08 16:52:57,57,3020,25,32,1650.68,3060.02,0.00
2024-12-08 16:52:57,56,3020,25,31,1675.24,3060.02,0.00
2024-12-08 16:52:57,55,3020,24,31,1703.50,3060.09,0.00
2024-12-08 16:52:57,55,3021,24,31,1709.60,3061.00,0.00
2024-12-08 16:52:57,56,3021,25,31,1679.07,3061.02,0.00
2024-12-08 16:52:57,56,3022,25,31,1672.23,3062.00,0.00
2024-12-08 16:52:57,57,3022,25,32,1642.90,3062.02,0.00
2024-12-08 16:52:57,56,3022,25,31,1667.86,3062.02,0.00
2024-12-08 16:52:57,56,3023,25,31,1671.14,3063.00,0.00
2024-12-08 16:52:57,57,3023,25,32,1641.82,3063.02,0.00
2024-12-08 16:52:57,58,3022,26,32,1566.94,3063.62,0.00
2024-12-08 16:52:57,58,3023,26,32,1640.67,3064.00,0.00
2024-12-08 16:52:57,59,3023,27,32,1612.86,3064.02,0.00
2024-12-08 16:52:57,58,3023,27,31,1634.85,3064.02,0.00
2024-12-08 16:52:57,57,3023,26,31,1640.92,3064.35,0.00
2024-12-08 16:52:57,57,3024,26,31,1728.97,3065.00,0.00
2024-12-08 16:52:57,58,3024,27,31,1699.16,3065.02,0.00
2024-12-08 16:52:57,57,3024,26,31,1699.46,3065.63,0.00
2024-12-08 16:52:57,56,3024,25,31,1716.28,3065.86,0.00
2024-12-08 16:52:57,56,3025,25,31,1766.76,3066.00,0.00
2024-12-08 16:52:57,57,3025,25,32,1735.77,3066.02,0.00
2024-12-08 16:52:57,56,3025,25,31,1760.74,3066.02,0.00
2024-12-08 16:52:57,55,3025,24,31,1789.45,3066.13,0.00
2024-12-08 16:52:57,54,3025,23,31,1807.12,3066.63,0.00
2024-12-08 16:52:57,54,3026,23,31,1830.12,3067.00,0.00
2024-12-08 16:52:57,55,3026,23,32,1796.85,3067.02,0.00
2024-12-08 16:52:57,56,3025,24,32,1744.61,3067.36,0.00
2024-12-08 16:52:57,56,3026,24,32,1781.77,3068.00,0.00
2024-12-08 16:52:57,57,3026,25,32,1750.51,3068.02,0.00
2024-12-08 16:52:57,56,3026,25,31,1776.29,3068.02,0.00
2024-12-08 16:52:57,55,3026,24,31,1770.66,3068.95,0.00
2024-12-08 16:52:57,55,3027,24,31,1880.60,3069.00,0.00
2024-12-08 16:52:57,56,3027,24,32,1847.02,3069.02,0.00
2024-12-08 16:52:57,55,3027,23,32,1842.62,3069.75,0.00
2024-12-08 16:52:57,55,3028,23,32,1890.84,3070.00,0.00
2024-12-08 16:52:57,56,3028,24,32,1857.07,3070.02,0.00
2024-12-08 16:52:57,55,3028,24,31,1883.59,3070.04,0.00
2024-12-08 16:52:57,55,3029,24,31,1888.10,3071.00,0.00
2024-12-08 16:52:57,56,3029,25,31,1854.39,3071.02,0.00
2024-12-08 16:52:57,56,3030,25,31,1846.76,3072.00,0.00
2024-12-08 16:52:57,57,3030,25,32,1814.36,3072.02,0.00
2024-12-08 16:52:57,56,3030,25,31,1840.18,3072.04,0.00
2024-12-08 16:52:57,55,3030,24,31,1871.43,3072.11,0.00
2024-12-08 16:52:57,55,3031,24,31,1878.16,3073.00,0.00
2024-12-08 16:52:57,56,3031,25,31,1844.62,3073.02,0.00
2024-12-08 16:52:57,56,3032,25,31,1836.98,3074.00,0.00
2024-12-08 16:52:57,57,3032,26,31,1804.76,3074.02,0.00
2024-12-08 16:52:57,56,3032,26,30,1830.95,3074.04,0.00
2024-12-08 16:52:57,55,3032,25,30,1829.56,3074.91,0.00
2024-12-08 16:52:57,55,3033,25,30,1882.73,3075.00,0.00
2024-12-08 16:52:57,56,3033,26,30,1849.11,3075.02,0.00
2024-12-08 16:52:57,56,3034,26,30,1841.86,3076.00,0.00
2024-12-08 16:52:57,57,3034,27,30,1809.55,3076.02,0.00
2024-12-08 16:52:57,56,3034,27,29,1833.63,3076.05,0.00
2024-12-08 16:52:57,56,3035,27,29,1838.06,3077.00,0.00
2024-12-08 16:52:57,57,3035,27,30,1805.82,3077.02,0.00
2024-12-08 16:52:57,57,3036,27,30,1798.58,3078.00,0.00
2024-12-08 16:52:57,58,3036,28,30,1767.57,3078.02,0.00
2024-12-08 16:52:57,57,3036,28,29,1790.49,3078.05,0.00
2024-12-08 16:52:58,57,3037,28,29,1794.31,3079.00,0.00
2024-12-08 16:52:58,58,3037,28,30,1763.37,3079.02,0.00
2024-12-08 16:52:58,58,3038,28,30,1756.43,3080.00,0.00
2024-12-08 16:52:58,59,3038,29,30,1726.66,3080.02,0.00
2024-12-08 16:52:58,58,3038,29,29,1748.48,3080.05,0.00
2024-12-08 16:52:58,58,3039,29,29,1751.69,3081.00,0.00
2024-12-08 16:52:58,59,3039,30,29,1722.00,3081.02,0.00
2024-12-08 16:52:58,58,3039,29,29,1721.42,3081.07,0.00
2024-12-08 16:52:58,58,3040,29,29,1746.41,3082.00,0.00
2024-12-08 16:52:58,59,3040,30,29,1716.81,3082.02,0.00
2024-12-08 16:52:58,58,3040,30,28,1738.98,3082.05,0.00
2024-12-08 16:52:58,57,3040,29,28,1767.35,3082.12,0.00
2024-12-08 16:52:58,57,3041,29,28,1773.30,3083.00,0.00
2024-12-08 16:52:58,58,3041,30,28,1742.73,3083.02,0.00
2024-12-08 16:52:58,58,3042,30,28,1736.38,3084.00,0.00
2024-12-08 16:52:58,59,3042,30,29,1706.95,3084.02,0.00
2024-12-08 16:52:58,58,3042,30,28,1727.88,3084.05,0.00
2024-12-08 16:52:58,58,3043,30,28,1731.09,3085.00,0.00
2024-12-08 16:52:58,59,3043,30,29,1701.75,3085.02,0.00
2024-12-08 16:52:58,58,3043,29,29,1684.83,3085.90,0.00
2024-12-08 16:52:58,58,3044,29,29,1734.92,3086.00,0.00
2024-12-08 16:52:58,59,3044,30,29,1705.51,3086.02,0.00
2024-12-08 16:52:58,58,3044,30,28,1725.88,3086.07,0.00
2024-12-08 16:52:58,58,3045,30,28,1729.63,3087.00,0.00
2024-12-08 16:52:58,59,3045,30,29,1700.31,3087.02,0.00
2024-12-08 16:52:58,59,3046,30,29,1706.97,3088.00,0.00
2024-12-08 16:52:58,60,3046,30,30,1678.52,3088.02,0.00
2024-12-08 16:52:58,60,3047,30,30,1681.31,3089.00,0.00
2024-12-08 16:52:58,61,3047,31,30,1653.75,3089.02,0.00
2024-12-08 16:52:58,60,3047,30,30,1663.81,3089.10,0.00
2024-12-08 16:52:58,59,3047,29,30,1690.45,3089.15,0.00
2024-12-08 16:52:58,58,3047,28,30,1705.09,3089.62,0.00
2024-12-08 16:52:58,58,3048,28,30,1746.92,3090.00,0.00
2024-12-08 16:52:58,59,3048,28,31,1717.31,3090.02,0.00
2024-12-08 16:52:58,58,3048,28,30,1735.21,3090.09,0.00
2024-12-08 16:52:58,58,3049,28,30,1739.49,3091.00,0.00
2024-12-08 16:52:58,59,3049,29,30,1710.01,3091.02,0.00
2024-12-08 16:52:58,58,3049,28,30,1717.19,3091.26,0.00
2024-12-08 16:52:58,58,3050,28,30,1748.05,3092.00,0.00
2024-12-08 16:52:58,59,3050,28,31,1718.42,3092.02,0.00
2024-12-08 16:52:58,58,3050,28,30,1738.47,3092.09,0.00
2024-12-08 16:52:58,58,3051,28,30,1742.75,3093.00,0.00
2024-12-08 16:52:58,59,3051,28,31,1713.21,3093.02,0.00
2024-12-08 16:52:58,59,3052,28,31,1706.39,3094.00,0.00
2024-12-08 16:52:58,60,3052,29,31,1677.95,3094.02,0.00
2024-12-08 16:52:58,59,3052,29,30,1697.48,3094.09,0.00
2024-12-08 16:52:58,58,3052,28,30,1725.17,3094.14,0.00
2024-12-08 16:52:58,57,3052,27,30,1735.49,3094.37,0.00
2024-12-08 16:52:58,57,3053,27,30,1770.67,3095.00,0.00
2024-12-08 16:52:58,58,3053,27,31,1740.14,3095.02,0.00
2024-12-08 16:52:58,58,3054,27,31,1733.04,3096.00,0.00
2024-12-08 16:52:58,59,3054,28,31,1703.67,3096.02,0.00
2024-12-08 16:52:58,58,3054,28,30,1724.51,3096.09,0.00
2024-12-08 16:52:58,58,3055,28,30,1728.79,3097.00,0.00
2024-12-08 16:52:58,59,3055,29,30,1699.49,3097.02,0.00
2024-12-08 16:52:58,58,3055,28,30,1696.77,3097.10,0.00
2024-12-08 16:52:58,58,3056,28,30,1722.94,3098.00,0.00
2024-12-08 16:52:58,59,3056,29,30,1693.74,3098.02,0.00
2024-12-08 16:52:58,58,3056,29,29,1713.87,3098.09,0.00
2024-12-08 16:52:58,57,3056,28,29,1726.55,3098.65,0.00
2024-12-08 16:52:58,57,3057,28,29,1748.56,3099.00,0.00
2024-12-08 16:52:58,58,3057,29,29,1718.41,3099.02,0.00
2024-12-08 16:52:58,58,3058,29,29,1712.64,3100.00,0.00
2024-12-08 16:52:58,59,3058,29,30,1683.61,3100.02,0.00
2024-12-08 16:52:58,58,3058,28,30,1712.10,3100.02,0.00
2024-12-08 16:52:58,57,3058,28,29,1732.36,3100.07,0.00
2024-12-08 16:52:58,57,3059,28,29,1736.72,3101.00,0.00
2024-12-08 16:52:58,58,3059,28,30,1706.77,3101.02,0.00
2024-12-08 16:52:58,59,3058,29,30,1642.52,3101.87,0.00
2024-12-08 16:52:58,59,3059,29,30,1676.72,3102.00,0.00
2024-12-08 16:52:58,60,3059,30,30,1648.77,3102.02,0.00
2024-12-08 16:52:58,59,3059,30,29,1667.78,3102.07,0.00
2024-12-08 16:52:58,58,3059,29,29,1696.46,3102.07,0.00
2024-12-08 16:52:58,57,3059,28,29,1725.15,3102.11,0.00
2024-12-08 16:52:58,56,3059,27,29,1717.79,3102.95,0.00
2024-12-08 16:52:58,56,3060,27,29,1826.96,3103.00,0.00
2024-12-08 16:52:58,57,3060,28,29,1794.91,3103.02,0.00
2024-12-08 16:52:58,57,3061,28,29,1789.45,3104.00,0.00
2024-12-08 16:52:58,58,3061,28,30,1758.60,3104.02,0.00
2024-12-08 16:52:58,57,3061,27,30,1788.91,3104.02,0.00
2024-12-08 16:52:58,56,3061,27,29,1809.79,3104.07,0.00
2024-12-08 16:52:58,56,3062,27,29,1814.79,3105.00,0.00
2024-12-08 16:52:58,57,3062,27,30,1782.95,3105.02,0.00
2024-12-08 16:52:58,57,3063,27,30,1778.83,3106.00,0.00
2024-12-08 16:52:58,58,3063,27,31,1748.16,3106.02,0.00
2024-12-08 16:52:58,57,3063,27,30,1766.31,3106.07,0.00
2024-12-08 16:52:58,56,3063,26,30,1756.57,3106.96,0.00
2024-12-08 16:52:59,56,3064,26,30,1810.96,3107.00,0.00
2024-12-08 16:52:59,57,3064,26,31,1779.19,3107.02,0.00
2024-12-08 16:52:59,56,3064,25,31,1791.32,3107.16,0.00
2024-12-08 16:52:59,56,3065,25,31,1821.26,3108.00,0.00
2024-12-08 16:52:59,57,3065,25,32,1789.31,3108.02,0.00
2024-12-08 16:52:59,56,3065,25,31,1809.07,3108.07,0.00
2024-12-08 16:52:59,55,3065,24,31,1829.04,3108.24,0.00
2024-12-08 16:52:59,55,3066,24,31,1862.32,3109.00,0.00
2024-12-08 16:52:59,56,3066,25,31,1829.07,3109.02,0.00
2024-12-08 16:52:59,56,3067,25,31,1824.13,3110.00,0.00
2024-12-08 16:52:59,57,3067,25,32,1792.13,3110.02,0.00
2024-12-08 16:52:59,56,3067,25,31,1812.48,3110.07,0.00
2024-12-08 16:52:59,56,3068,25,31,1817.49,3111.00,0.00
2024-12-08 16:52:59,57,3068,26,31,1785.61,3111.02,0.00
2024-12-08 16:52:59,57,3069,26,31,1780.56,3112.00,0.00
2024-12-08 16:52:59,58,3069,26,32,1749.86,3112.02,0.00
2024-12-08 16:52:59,57,3069,26,31,1769.65,3112.07,0.00
2024-12-08 16:52:59,57,3070,26,31,1774.03,3113.00,0.00
2024-12-08 16:52:59,58,3070,27,31,1743.44,3113.02,0.00
2024-12-08 16:52:59,58,3071,27,31,1738.59,3114.00,0.00
2024-12-08 16:52:59,59,3071,27,32,1709.12,3114.02,0.00
2024-12-08 16:52:59,58,3071,27,31,1727.86,3114.07,0.00
2024-12-08 16:52:59,58,3072,27,31,1731.63,3115.00,0.00
2024-12-08 16:52:59,59,3072,27,32,1702.28,3115.02,0.00
2024-12-08 16:52:59,58,3072,26,32,1696.73,3115.67,0.00
2024-12-08 16:52:59,58,3073,26,32,1740.48,3116.00,0.00
2024-12-08 16:52:59,59,3073,26,33,1710.98,3116.02,0.00
2024-12-08 16:52:59,58,3073,26,32,1730.29,3116.07,0.00
2024-12-08 16:52:59,58,3074,26,32,1734.06,3117.00,0.00
2024-12-08 16:52:59,59,3074,26,33,1704.66,3117.02,0.00
2024-12-08 16:52:59,58,3074,25,33,1706.75,3117.29,0.00
2024-12-08 16:52:59,58,3075,25,33,1738.91,3118.00,0.00
2024-12-08 16:52:59,59,3075,26,33,1709.44,3118.02,0.00
2024-12-08 16:52:59,58,3075,25,33,1738.38,3118.02,0.00
2024-12-08 16:52:59,57,3075,25,32,1757.94,3118.05,0.00
2024-12-08 16:52:59,57,3076,25,32,1761.78,3119.00,0.00
2024-12-08 16:52:59,58,3076,26,32,1731.40,3119.02,0.00
2024-12-08 16:52:59,57,3076,25,32,1744.27,3119.11,0.00
2024-12-08 16:52:59,57,3077,25,32,1771.62,3120.00,0.00
2024-12-08 16:52:59,58,3077,25,33,1741.08,3120.02,0.00
2024-12-08 16:52:59,57,3077,24,33,1771.08,3120.02,0.00
2024-12-08 16:52:59,56,3077,24,32,1792.68,3120.04,0.00
2024-12-08 16:52:59,56,3078,24,32,1796.59,3121.00,0.00
2024-12-08 16:52:59,57,3078,24,33,1765.07,3121.02,0.00
2024-12-08 16:52:59,57,3079,24,33,1760.14,3122.00,0.00
2024-12-08 16:52:59,58,3079,25,33,1729.80,3122.02,0.00
2024-12-08 16:52:59,57,3079,25,32,1750.29,3122.04,0.00
2024-12-08 16:52:59,56,3079,24,32,1739.73,3122.96,0.00
2024-12-08 16:52:59,56,3080,24,32,1794.40,3123.00,0.00
2024-12-08 16:52:59,57,3080,24,33,1762.92,3123.02,0.00
2024-12-08 16:52:59,56,3080,23,33,1749.68,3123.82,0.00
2024-12-08 16:52:59,56,3081,23,33,1800.04,3124.00,0.00
2024-12-08 16:52:59,57,3081,24,33,1768.46,3124.02,0.00
2024-12-08 16:52:59,56,3081,24,32,1790.56,3124.04,0.00
2024-12-08 16:52:59,56,3082,24,32,1794.47,3125.00,0.00
2024-12-08 16:52:59,57,3082,24,33,1762.99,3125.02,0.00
2024-12-08 16:52:59,57,3083,24,33,1758.65,3126.00,0.00
2024-12-08 16:52:59,58,3083,25,33,1728.33,3126.02,0.00
2024-12-08 16:52:59,57,3083,25,32,1748.79,3126.04,0.00
2024-12-08 16:52:59,56,3083,24,32,1770.03,3126.20,0.00
2024-12-08 16:52:59,56,3084,24,32,1801.24,3127.00,0.00
2024-12-08 16:52:59,57,3084,25,32,1769.64,3127.02,0.00
2024-12-08 16:52:59,57,3085,25,32,1764.76,3128.00,0.00
2024-12-08 16:52:59,58,3085,26,32,1734.33,3128.02,0.00
2024-12-08 16:52:59,57,3085,26,31,1755.43,3128.04,0.00
2024-12-08 16:52:59,57,3086,26,31,1758.73,3129.00,0.00
2024-12-08 16:52:59,58,3086,27,31,1728.41,3129.02,0.00
2024-12-08 16:52:59,57,3086,26,31,1733.55,3129.25,0.00
2024-12-08 16:52:59,57,3087,26,31,1765.34,3130.00,0.00
2024-12-08 16:52:59,58,3087,26,32,1734.90,3130.02,0.00
2024-12-08 16:52:59,57,3087,26,31,1754.92,3130.05,0.00
2024-12-08 16:52:59,56,3087,25,31,1784.04,3130.11,0.00
2024-12-08 16:52:59,56,3088,25,31,1790.17,3131.00,0.00
2024-12-08 16:52:59,57,3088,25,32,1758.76,3131.02,0.00
2024-12-08 16:52:59,57,3089,25,32,1753.90,3132.00,0.00
2024-12-08 16:52:59,58,3089,25,33,1723.66,3132.02,0.00
2024-12-08 16:52:59,57,3089,25,32,1744.02,3132.05,0.00
2024-12-08 16:52:59,56,3089,24,32,1768.96,3132.11,0.00
2024-12-08 16:52:59,56,3090,24,32,1797.46,3133.00,0.00
2024-12-08 16:52:59,57,3090,24,33,1765.93,3133.02,0.00
2024-12-08 16:52:59,56,3090,23,33,1760.69,3133.41,0.00
2024-12-08 16:53:00,56,3091,23,33,1798.60,3134.00,0.00
2024-12-08 16:53:00,57,3091,23,34,1767.04,3134.02,0.00
2024-12-08 16:53:00,56,3091,23,33,1787.98,3134.07,0.00
2024-12-08 16:53:00,55,3091,22,33,1779.74,3134.66,0.00
2024-12-08 16:53:00,55,3092,22,33,1826.18,3135.00,0.00
2024-12-08 16:53:00,56,3092,22,34,1793.57,3135.02,0.00
2024-12-08 16:53:00,55,3092,21,34,1796.40,3135.60,0.00
2024-12-08 16:53:00,55,3093,21,34,1822.27,3136.00,0.00
2024-12-08 16:53:00,56,3093,22,34,1789.73,3136.02,0.00
2024-12-08 16:53:00,55,3093,22,33,1810.88,3136.07,0.00
2024-12-08 16:53:00,54,3093,21,33,1844.42,3136.07,0.00
2024-12-08 16:53:00,53,3093,20,33,1841.94,3136.89,0.00
2024-12-08 16:53:00,53,3094,20,33,1897.67,3137.00,0.00
2024-12-08 16:53:00,54,3094,21,33,1862.53,3137.02,0.00
2024-12-08 16:53:00,54,3095,21,33,1859.40,3138.00,0.00
2024-12-08 16:53:00,55,3095,21,34,1825.59,3138.02,0.00
2024-12-08 16:53:00,54,3095,21,33,1846.05,3138.07,0.00
2024-12-08 16:53:00,53,3095,20,33,1846.35,3138.83,0.00
2024-12-08 16:53:00,53,3096,20,33,1900.39,3139.00,0.00
2024-12-08 16:53:00,54,3096,21,33,1865.20,3139.02,0.00
2024-12-08 16:53:00,53,3096,20,33,1885.01,3139.09,0.00
2024-12-08 16:53:00,53,3097,20,33,1914.50,3140.00,0.00
2024-12-08 16:53:00,54,3097,21,33,1879.04,3140.02,0.00
2024-12-08 16:53:00,53,3097,21,32,1900.88,3140.08,0.00
2024-12-08 16:53:00,53,3098,21,32,1905.45,3141.00,0.00
2024-12-08 16:53:00,54,3098,22,32,1870.17,3141.02,0.00
2024-12-08 16:53:00,54,3099,22,32,1865.38,3142.00,0.00
2024-12-08 16:53:00,55,3099,23,32,1831.46,3142.02,0.00
2024-12-08 16:53:00,55,3100,23,32,1820.55,3143.00,0.00
2024-12-08 16:53:00,56,3100,24,32,1788.04,3143.02,0.00
2024-12-08 16:53:00,55,3100,24,31,1816.56,3143.11,0.00
2024-12-08 16:53:00,55,3101,24,31,1819.60,3144.00,0.00
2024-12-08 16:53:00,56,3101,24,32,1787.11,3144.02,0.00
2024-12-08 16:53:00,55,3101,23,32,1817.33,3144.09,0.00
2024-12-08 16:53:00,55,3102,23,32,1813.47,3145.00,0.00
2024-12-08 16:53:00,56,3102,24,32,1781.09,3145.02,0.00
2024-12-08 16:53:00,55,3102,24,31,1799.19,3145.09,0.00
2024-12-08 16:53:00,54,3102,23,31,1828.47,3145.09,0.00
2024-12-08 16:53:00,54,3103,23,31,1835.45,3146.00,0.00
2024-12-08 16:53:00,55,3103,23,32,1802.08,3146.02,0.00
2024-12-08 16:53:00,55,3104,23,32,1799.66,3147.00,0.00
2024-12-08 16:53:00,56,3104,23,33,1767.53,3147.02,0.00
2024-12-08 16:53:00,55,3104,23,32,1785.37,3147.09,0.00
2024-12-08 16:53:00,55,3105,23,32,1791.65,3148.00,0.00
2024-12-08 16:53:00,56,3105,23,33,1759.66,3148.02,0.00
2024-12-08 16:53:00,56,3106,23,33,1757.13,3149.00,0.00
2024-12-08 16:53:00,57,3106,24,33,1726.30,3149.02,0.00
2024-12-08 16:53:00,56,3106,23,33,1755.41,3149.07,0.00
2024-12-08 16:53:00,55,3106,23,32,1775.88,3149.07,0.00
2024-12-08 16:53:00,54,3106,22,32,1785.37,3149.59,0.00
2024-12-08 16:53:00,54,3107,22,32,1831.16,3150.00,0.00
2024-12-08 16:53:00,55,3107,23,32,1797.87,3150.02,0.00
2024-12-08 16:53:00,54,3107,22,32,1829.42,3150.07,0.00
2024-12-08 16:53:00,53,3107,21,32,1830.49,3150.62,0.00
2024-12-08 16:53:00,53,3108,21,32,1878.33,3151.00,0.00
2024-12-08 16:53:00,54,3108,21,33,1843.54,3151.02,0.00
2024-12-08 16:53:00,53,3108,21,32,1864.66,3151.08,0.00
2024-12-08 16:53:00,53,3109,21,32,1871.79,3152.00,0.00
2024-12-08 16:53:00,54,3109,22,32,1837.13,3152.02,0.00
2024-12-08 16:53:00,53,3109,21,32,1870.01,3152.08,0.00
2024-12-08 16:53:00,52,3109,20,32,1883.59,3152.21,0.00
2024-12-08 16:53:00,52,3110,20,32,1919.91,3153.00,0.00
2024-12-08 16:53:00,53,3110,21,32,1883.68,3153.02,0.00
2024-12-08 16:53:00,53,3111,21,32,1877.14,3154.00,0.00
2024-12-08 16:53:00,54,3111,21,33,1842.38,3154.02,0.00
2024-12-08 16:53:00,53,3111,21,32,1870.60,3154.08,0.00
2024-12-08 16:53:00,53,3112,21,32,1877.74,3155.00,0.00
2024-12-08 16:53:00,54,3112,21,33,1842.96,3155.02,0.00
2024-12-08 16:53:00,54,3113,21,33,1838.66,3156.00,0.00
2024-12-08 16:53:00,55,3113,22,33,1805.23,3156.02,0.00
2024-12-08 16:53:00,54,3113,22,32,1826.39,3156.07,0.00
2024-12-08 16:53:00,54,3114,22,32,1832.81,3157.00,0.00
2024-12-08 16:53:00,55,3114,22,33,1799.49,3157.02,0.00
2024-12-08 16:53:00,55,3115,22,33,1795.77,3158.00,0.00
2024-12-08 16:53:00,56,3115,22,34,1763.70,3158.02,0.00
2024-12-08 16:53:00,55,3115,22,33,1783.71,3158.07,0.00
2024-12-08 16:53:00,54,3115,21,33,1816.74,3158.07,0.00
2024-12-08 16:53:00,54,3116,21,33,1823.17,3159.00,0.00
2024-12-08 16:53:00,55,3116,22,33,1790.02,3159.02,0.00
2024-12-08 16:53:00,54,3116,21,33,1792.09,3159.59,0.00
2024-12-08 16:53:00,54,3117,21,33,1838.00,3160.00,0.00
2024-12-08 16:53:00,55,3117,22,33,1804.58,3160.02,0.00
2024-12-08 16:53:00,54,3117,22,32,1823.38,3160.09,0.00
2024-12-08 16:53:00,54,3118,22,32,1830.39,3161.00,0.00
2024-12-08 16:53:00,55,3118,23,32,1797.11,3161.02,0.00
2024-12-08 16:53:00,55,3119,23,32,1794.02,3162.00,0.00
2024-12-08 16:53:00,56,3119,24,32,1761.98,3162.02,0.00
2024-12-08 16:53:00,57,3118,24,33,1730.51,3162.07,0.00
2024-12-08 16:53:00,56,3118,24,32,1804.35,3162.11,0.00
2024-12-08 16:53:01,56,3119,24,32,1810.55,3163.00,0.00
2024-12-08 16:53:01,57,3119,24,33,1778.78,3163.02,0.00
2024-12-08 16:53:01,56,3119,23,33,1809.98,3163.02,0.00
2024-12-08 16:53:01,56,3120,23,33,1881.18,3164.00,0.00
2024-12-08 16:53:01,57,3120,24,33,1848.18,3164.02,0.00
2024-12-08 16:53:01,57,3121,24,33,1843.96,3165.00,0.00
2024-12-08 16:53:01,58,3121,25,33,1812.17,3165.02,0.00
2024-12-08 16:53:01,57,3121,25,32,1830.67,3165.09,0.00
2024-12-08 16:53:01,57,3122,25,32,1835.66,3166.00,0.00
2024-12-08 16:53:01,58,3122,26,32,1804.01,3166.02,0.00
2024-12-08 16:53:01,57,3122,26,31,1822.36,3166.09,0.00
2024-12-08 16:53:01,57,3123,26,31,1827.35,3167.00,0.00
2024-12-08 16:53:01,58,3123,27,31,1795.84,3167.02,0.00
2024-12-08 16:53:01,57,3123,26,31,1826.26,3167.04,0.00
2024-12-08 16:53:01,56,3123,25,31,1830.47,3167.23,0.00
2024-12-08 16:53:01,56,3124,25,31,1863.19,3168.00,0.00
2024-12-08 16:53:01,57,3124,25,32,1830.51,3168.02,0.00
2024-12-08 16:53:01,56,3124,25,31,1850.78,3168.07,0.00
2024-12-08 16:53:01,56,3125,25,31,1855.86,3169.00,0.00
2024-12-08 16:53:01,57,3125,26,31,1823.30,3169.02,0.00
2024-12-08 16:53:01,57,3126,26,31,1817.81,3170.00,0.00
2024-12-08 16:53:01,58,3126,26,32,1786.47,3170.02,0.00
2024-12-08 16:53:01,57,3126,26,31,1806.16,3170.07,0.00
2024-12-08 16:53:01,56,3126,25,31,1819.21,3170.29,0.00
2024-12-08 16:53:01,55,3126,24,31,1846.98,3170.46,0.00
2024-12-08 16:53:01,55,3127,24,31,1887.70,3171.00,0.00
2024-12-08 16:53:01,56,3127,25,31,1853.99,3171.02,0.00
2024-12-08 16:53:01,56,3128,25,31,1848.07,3172.00,0.00
2024-12-08 16:53:01,57,3128,26,31,1815.65,3172.02,0.00
2024-12-08 16:53:01,56,3128,26,30,1836.77,3172.07,0.00
2024-12-08 16:53:01,56,3129,26,30,1841.85,3173.00,0.00
2024-12-08 16:53:01,57,3129,26,31,1809.54,3173.02,0.00
2024-12-08 16:53:01,57,3130,26,31,1803.63,3174.00,0.00
2024-12-08 16:53:01,58,3130,27,31,1772.53,3174.02,0.00
2024-12-08 16:53:01,57,3130,27,30,1792.51,3174.07,0.00
2024-12-08 16:53:01,57,3131,27,30,1796.95,3175.00,0.00
2024-12-08 16:53:01,58,3131,28,30,1765.97,3175.02,0.00
2024-12-08 16:53:01,58,3132,28,30,1760.51,3176.00,0.00
2024-12-08 16:53:01,59,3132,29,30,1730.67,3176.02,0.00
2024-12-08 16:53:01,58,3132,29,29,1749.58,3176.07,0.00
2024-12-08 16:53:01,59,3131,30,29,1698.23,3176.80,0.00
2024-12-08 16:53:01,59,3132,30,29,1730.68,3177.00,0.00
2024-12-08 16:53:01,60,3132,30,30,1701.83,3177.02,0.00
2024-12-08 16:53:01,60,3133,30,30,1749.70,3178.00,0.00
2024-12-08 16:53:01,61,3133,31,30,1721.01,3178.02,0.00
2024-12-08 16:53:01,60,3133,31,29,1739.13,3178.07,0.00
2024-12-08 16:53:01,59,3133,30,29,1727.73,3178.90,0.00
2024-12-08 16:53:01,59,3134,30,29,1778.45,3179.00,0.00
2024-12-08 16:53:01,60,3134,31,29,1748.81,3179.02,0.00
2024-12-08 16:53:01,60,3135,31,29,1742.93,3180.00,0.00
2024-12-08 16:53:01,61,3135,32,29,1714.36,3180.02,0.00
2024-12-08 16:53:01,60,3135,32,28,1732.89,3180.07,0.00
2024-12-08 16:53:01,60,3136,32,28,1735.53,3181.00,0.00
2024-12-08 16:53:01,61,3136,33,28,1707.08,3181.02,0.00
2024-12-08 16:53:01,60,3136,32,28,1708.39,3181.53,0.00
2024-12-08 16:53:01,60,3137,32,28,1729.60,3182.00,0.00
2024-12-08 16:53:01,61,3137,33,28,1701.25,3182.02,0.00
2024-12-08 16:53:01,60,3137,33,27,1720.08,3182.07,0.00
2024-12-08 16:53:01,60,3138,33,27,1722.72,3183.00,0.00
2024-12-08 16:53:01,61,3138,34,27,1694.48,3183.02,0.00
2024-12-08 16:53:01,60,3138,33,27,1695.09,3183.55,0.00
2024-12-08 16:53:01,60,3139,33,27,1716.39,3184.00,0.00
2024-12-08 16:53:01,61,3139,33,28,1688.25,3184.02,0.00
2024-12-08 16:53:01,60,3139,33,27,1707.39,3184.07,0.00
2024-12-08 16:53:01,60,3140,33,27,1710.03,3185.00,0.00
2024-12-08 16:53:01,61,3140,34,27,1682.00,3185.02,0.00
2024-12-08 16:53:01,61,3141,34,27,1676.08,3186.00,0.00
2024-12-08 16:53:01,62,3141,35,27,1649.05,3186.02,0.00
2024-12-08 16:53:01,61,3141,35,26,1666.70,3186.07,0.00
2024-12-08 16:53:01,60,3141,34,26,1675.65,3186.67,0.00
2024-12-08 16:53:01,60,3142,34,26,1697.12,3187.00,0.00
2024-12-08 16:53:01,61,3142,35,26,1669.30,3187.02,0.00
2024-12-08 16:53:01,60,3142,34,26,1660.63,3187.43,0.00
2024-12-08 16:53:01,60,3143,34,26,1696.06,3188.00,0.00
2024-12-08 16:53:01,61,3143,35,26,1668.25,3188.02,0.00
2024-12-08 16:53:01,60,3143,35,25,1687.04,3188.07,0.00
2024-12-08 16:53:01,60,3144,35,25,1689.68,3189.00,0.00
2024-12-08 16:53:01,61,3144,35,26,1661.98,3189.02,0.00
2024-12-08 16:53:01,61,3145,35,26,1656.03,3190.00,0.00
2024-12-08 16:53:01,62,3145,36,26,1629.32,3190.02,0.00
2024-12-08 16:53:01,61,3145,35,26,1654.13,3190.07,0.00
2024-12-08 16:53:01,60,3145,35,25,1674.26,3190.07,0.00
2024-12-08 16:53:01,60,3146,35,25,1676.89,3191.00,0.00
2024-12-08 16:53:01,61,3146,36,25,1649.40,3191.02,0.00
2024-12-08 16:53:02,60,3146,35,25,1647.96,3191.58,0.00
2024-12-08 16:53:02,60,3147,35,25,1671.14,3192.00,0.00
2024-12-08 16:53:02,61,3147,36,25,1643.74,3192.02,0.00
2024-12-08 16:53:02,60,3147,36,24,1662.11,3192.07,0.00
2024-12-08 16:53:02,60,3148,36,24,1664.75,3193.00,0.00
2024-12-08 16:53:02,61,3148,36,25,1637.45,3193.02,0.00
2024-12-08 16:53:02,60,3148,35,25,1642.99,3193.22,0.00
2024-12-08 16:53:02,60,3149,35,25,1671.65,3194.00,0.00
2024-12-08 16:53:02,61,3149,35,26,1644.25,3194.02,0.00
2024-12-08 16:53:02,60,3149,35,25,1661.02,3194.07,0.00
2024-12-08 16:53:02,59,3149,34,25,1679.46,3194.15,0.00
2024-12-08 16:53:02,58,3149,33,25,1695.63,3194.55,0.00
2024-12-08 16:53:02,58,3150,33,25,1736.68,3195.00,0.00
2024-12-08 16:53:02,59,3150,34,25,1707.24,3195.02,0.00
2024-12-08 16:53:02,58,3150,33,25,1697.00,3195.72,0.00
2024-12-08 16:53:02,58,3151,33,25,1743.48,3196.00,0.00
2024-12-08 16:53:02,59,3151,34,25,1713.93,3196.02,0.00
2024-12-08 16:53:02,58,3151,34,24,1733.03,3196.07,0.00
2024-12-08 16:53:02,58,3152,34,24,1736.86,3197.00,0.00
2024-12-08 16:53:02,59,3152,35,24,1707.43,3197.02,0.00
2024-12-08 16:53:02,59,3153,35,24,1702.26,3198.00,0.00
2024-12-08 16:53:02,60,3153,36,24,1673.89,3198.02,0.00
2024-12-08 16:53:02,59,3153,35,24,1701.19,3198.03,0.00
2024-12-08 16:53:02,58,3153,35,23,1721.70,3198.05,0.00
2024-12-08 16:53:02,58,3154,35,23,1724.98,3199.00,0.00
2024-12-08 16:53:02,59,3154,36,23,1695.74,3199.02,0.00
2024-12-08 16:53:02,58,3154,35,23,1679.75,3199.52,0.00
2024-12-08 16:53:02,58,3155,35,23,1719.79,3200.00,0.00
2024-12-08 16:53:02,59,3155,36,23,1690.64,3200.02,0.00
2024-12-08 16:53:02,58,3155,36,22,1710.97,3200.05,0.00
2024-12-08 16:53:02,57,3155,35,22,1739.32,3200.11,0.00
2024-12-08 16:53:02,56,3155,34,22,1757.39,3200.52,0.00
2024-12-08 16:53:02,56,3156,34,22,1776.58,3201.00,0.00
2024-12-08 16:53:02,57,3156,34,23,1745.41,3201.02,0.00
2024-12-08 16:53:02,57,3157,34,23,1739.41,3202.00,0.00
2024-12-08 16:53:02,58,3157,34,24,1709.43,3202.02,0.00
2024-12-08 16:53:02,57,3157,33,24,1738.30,3202.04,0.00
2024-12-08 16:53:02,56,3157,33,23,1761.91,3202.04,0.00
2024-12-08 16:53:02,56,3158,33,23,1765.88,3203.00,0.00
2024-12-08 16:53:02,57,3158,34,23,1734.90,3203.02,0.00
2024-12-08 16:53:02,56,3158,33,23,1752.75,3203.07,0.00
2024-12-08 16:53:02,56,3159,33,23,1759.98,3204.00,0.00
2024-12-08 16:53:02,57,3159,33,24,1729.10,3204.02,0.00
2024-12-08 16:53:02,56,3159,33,23,1752.55,3204.04,0.00
2024-12-08 16:53:02,56,3160,33,23,1756.52,3205.00,0.00
2024-12-08 16:53:02,57,3160,33,24,1725.71,3205.02,0.00
2024-12-08 16:53:02,57,3161,33,24,1719.93,3206.00,0.00
2024-12-08 16:53:02,58,3161,34,24,1690.28,3206.02,0.00
2024-12-08 16:53:02,57,3161,34,23,1712.07,3206.04,0.00
2024-12-08 16:53:02,56,3161,33,23,1734.23,3206.14,0.00
2024-12-08 16:53:02,56,3162,33,23,1764.49,3207.00,0.00
2024-12-08 16:53:02,57,3162,34,23,1733.54,3207.02,0.00
2024-12-08 16:53:02,56,3162,33,23,1735.96,3207.29,0.00
2024-12-08 16:53:02,56,3163,33,23,1770.77,3208.00,0.00
2024-12-08 16:53:02,57,3163,33,24,1739.71,3208.02,0.00
2024-12-08 16:53:02,56,3163,33,23,1759.90,3208.05,0.00
2024-12-08 16:53:02,56,3164,33,23,1764.45,3209.00,0.00
2024-12-08 16:53:02,57,3164,33,24,1733.49,3209.02,0.00
2024-12-08 16:53:02,56,3164,32,24,1732.22,3209.63,0.00
2024-12-08 16:53:02,56,3165,32,24,1777.77,3210.00,0.00
2024-12-08 16:53:02,57,3165,32,25,1746.58,3210.02,0.00
2024-12-08 16:53:02,56,3165,32,24,1766.32,3210.07,0.00
2024-12-08 16:53:02,56,3166,32,24,1771.44,3211.00,0.00
2024-12-08 16:53:02,57,3166,33,24,1740.36,3211.02,0.00
2024-12-08 16:53:02,57,3167,33,24,1735.94,3212.00,0.00
2024-12-08 16:53:02,58,3167,34,24,1706.01,3212.02,0.00
2024-12-08 16:53:02,57,3167,34,23,1725.26,3212.07,0.00
2024-12-08 16:53:02,57,3168,34,23,1729.72,3213.00,0.00
2024-12-08 16:53:02,58,3168,35,23,1699.90,3213.02,0.00
2024-12-08 16:53:02,57,3168,34,23,1715.66,3213.11,0.00
2024-12-08 16:53:02,57,3169,34,23,1725.38,3214.00,0.00
2024-12-08 16:53:02,58,3169,35,23,1695.63,3214.02,0.00
2024-12-08 16:53:02,57,3169,35,22,1715.25,3214.07,0.00
2024-12-08 16:53:02,57,3170,35,22,1719.71,3215.00,0.00
2024-12-08 16:53:02,58,3170,36,22,1690.06,3215.02,0.00
2024-12-08 16:53:02,58,3171,36,22,1685.77,3216.00,0.00
2024-12-08 16:53:02,59,3171,36,23,1657.19,3216.02,0.00
2024-12-08 16:53:02,58,3171,36,22,1675.25,3216.07,0.00
2024-12-08 16:53:02,57,3171,35,22,1689.90,3216.53,0.00
2024-12-08 16:53:02,57,3172,35,22,1708.83,3217.00,0.00
2024-12-08 16:53:02,58,3172,36,22,1679.37,3217.02,0.00
2024-12-08 16:53:02,57,3172,35,22,1668.37,3217.46,0.00
2024-12-08 16:53:02,57,3173,35,22,1707.67,3218.00,0.00
2024-12-08 16:53:02,58,3173,35,23,1678.22,3218.02,0.00
2024-12-08 16:53:02,57,3173,35,22,1696.39,3218.07,0.00
2024-12-08 16:53:03,57,3174,35,22,1700.86,3219.00,0.00
2024-12-08 16:53:03,58,3174,35,23,1671.53,3219.02,0.00
2024-12-08 16:53:03,58,3175,35,23,1667.41,3220.00,0.00
2024-12-08 16:53:03,59,3175,35,24,1639.15,3220.02,0.00
2024-12-08 16:53:03,58,3175,35,23,1656.88,3220.07,0.00
2024-12-08 16:53:03,57,3175,34,23,1684.83,3220.11,0.00
2024-12-08 16:53:03,56,3175,33,23,1683.64,3220.45,0.00
2024-12-08 16:53:03,56,3176,33,23,1723.68,3221.00,0.00
2024-12-08 16:53:03,57,3176,33,24,1693.44,3221.02,0.00
2024-12-08 16:53:03,56,3176,32,24,1684.72,3221.43,0.00
2024-12-08 16:53:03,56,3177,32,24,1724.21,3222.00,0.00
2024-12-08 16:53:03,57,3177,33,24,1693.96,3222.02,0.00
2024-12-08 16:53:03,56,3177,33,23,1713.29,3222.07,0.00
2024-12-08 16:53:03,56,3178,33,23,1718.41,3223.00,0.00
2024-12-08 16:53:03,57,3178,34,23,1688.27,3223.02,0.00
2024-12-08 16:53:03,56,3178,33,23,1686.80,3223.61,0.00
2024-12-08 16:53:03,56,3179,33,23,1731.98,3224.00,0.00
2024-12-08 16:53:03,57,3179,33,24,1701.60,3224.02,0.00
2024-12-08 16:53:03,56,3179,33,23,1721.64,3224.07,0.00
2024-12-08 16:53:03,55,3179,32,23,1735.02,3224.64,0.00
2024-12-08 16:53:03,55,3180,32,23,1758.75,3225.00,0.00
2024-12-08 16:53:03,56,3180,32,24,1727.34,3225.02,0.00
2024-12-08 16:53:03,56,3181,32,24,1724.23,3226.00,0.00
2024-12-08 16:53:03,57,3181,32,25,1693.98,3226.02,0.00
2024-12-08 16:53:03,56,3181,31,25,1720.96,3226.02,0.00
2024-12-08 16:53:03,55,3181,31,24,1739.95,3226.09,0.00
2024-12-08 16:53:03,55,3182,31,24,1769.81,3227.00,0.00
2024-12-08 16:53:03,56,3182,31,25,1738.21,3227.02,0.00
2024-12-08 16:53:03,56,3183,31,25,1740.06,3228.00,0.00
2024-12-08 16:53:03,57,3183,31,26,1709.54,3228.02,0.00
2024-12-08 16:53:03,56,3183,30,26,1706.52,3228.23,0.00
2024-12-08 16:53:03,56,3184,30,26,1739.86,3229.00,0.00
2024-12-08 16:53:03,57,3184,31,26,1709.34,3229.02,0.00
2024-12-08 16:53:03,56,3184,30,26,1715.43,3229.18,0.00
2024-12-08 16:53:03,56,3185,30,26,1747.07,3230.00,0.00
2024-12-08 16:53:03,57,3185,31,26,1716.42,3230.02,0.00
2024-12-08 16:53:03,56,3185,30,26,1745.28,3230.07,0.00
2024-12-08 16:53:03,55,3185,30,25,1764.68,3230.11,0.00
2024-12-08 16:53:03,55,3186,30,25,1771.68,3231.00,0.00
2024-12-08 16:53:03,56,3186,31,25,1740.04,3231.02,0.00
2024-12-08 16:53:03,55,3186,30,25,1746.47,3231.24,0.00
2024-12-08 16:53:03,55,3187,30,25,1781.04,3232.00,0.00
2024-12-08 16:53:03,56,3187,30,26,1749.23,3232.02,0.00
2024-12-08 16:53:03,55,3187,30,25,1776.35,3232.07,0.00
2024-12-08 16:53:03,55,3188,30,25,1782.18,3233.00,0.00
2024-12-08 16:53:03,56,3188,31,25,1750.35,3233.02,0.00
2024-12-08 16:53:03,55,3188,31,24,1769.26,3233.09,0.00
2024-12-08 16:53:03,54,3188,30,24,1791.64,3233.41,0.00
2024-12-08 16:53:03,54,3189,30,24,1808.83,3234.00,0.00
2024-12-08 16:53:03,55,3189,30,25,1775.94,3234.02,0.00
2024-12-08 16:53:03,54,3189,29,25,1766.84,3234.37,0.00
2024-12-08 16:53:03,54,3190,29,25,1806.81,3235.00,0.00
2024-12-08 16:53:03,55,3190,29,26,1773.96,3235.02,0.00
2024-12-08 16:53:03,54,3190,29,25,1793.04,3235.09,0.00
2024-12-08 16:53:03,54,3191,29,25,1800.17,3236.00,0.00
2024-12-08 16:53:03,55,3191,29,26,1767.44,3236.02,0.00
2024-12-08 16:53:03,54,3191,28,26,1797.79,3236.09,0.00
2024-12-08 16:53:03,54,3192,28,26,1799.74,3237.00,0.00
2024-12-08 16:53:03,55,3192,28,27,1767.02,3237.02,0.00
2024-12-08 16:53:03,54,3192,28,26,1784.18,3237.11,0.00
2024-12-08 16:53:03,53,3192,27,26,1796.91,3237.25,0.00
2024-12-08 16:53:03,53,3193,27,26,1834.05,3238.00,0.00
2024-12-08 16:53:03,54,3193,28,26,1800.09,3238.02,0.00
2024-12-08 16:53:03,54,3194,28,26,1801.35,3239.00,0.00
2024-12-08 16:53:03,55,3194,29,26,1768.60,3239.02,0.00
2024-12-08 16:53:03,54,3194,28,26,1748.27,3239.83,0.00
2024-12-08 16:53:03,54,3195,28,26,1803.00,3240.00,0.00
2024-12-08 16:53:03,55,3195,28,27,1770.22,3240.02,0.00
2024-12-08 16:53:03,54,3195,27,27,1800.02,3240.11,0.00
2024-12-08 16:53:03,53,3195,27,26,1829.71,3240.15,0.00
2024-12-08 16:53:03,53,3196,27,26,1839.42,3241.00,0.00
2024-12-08 16:53:03,54,3196,27,27,1805.36,3241.02,0.00
2024-12-08 16:53:03,54,3197,27,27,1807.39,3242.00,0.00
2024-12-08 16:53:03,55,3197,28,27,1774.53,3242.02,0.00
2024-12-08 16:53:03,54,3197,27,27,1763.58,3242.69,0.00
2024-12-08 16:53:03,54,3198,27,27,1813.68,3243.00,0.00
2024-12-08 16:53:03,55,3198,27,28,1780.70,3243.02,0.00
2024-12-08 16:53:03,54,3198,26,28,1813.08,3243.02,0.00
2024-12-08 16:53:03,53,3198,26,27,1839.36,3243.13,0.00
2024-12-08 16:53:03,53,3199,26,27,1848.47,3244.00,0.00
2024-12-08 16:53:03,54,3199,26,28,1814.24,3244.02,0.00
2024-12-08 16:53:03,54,3200,26,28,1816.58,3245.00,0.00
2024-12-08 16:53:03,55,3200,27,28,1783.55,3245.02,0.00
2024-12-08 16:53:03,54,3200,26,28,1815.98,3245.02,0.00
2024-12-08 16:53:03,54,3201,26,28,1810.31,3246.00,0.00
2024-12-08 16:53:03,55,3201,27,28,1777.39,3246.02,0.00
2024-12-08 16:53:03,54,3201,27,27,1801.32,3246.15,0.00
2024-12-08 16:53:03,54,3202,27,27,1810.26,3247.00,0.00
2024-12-08 16:53:04,55,3202,28,27,1777.35,3247.02,0.00
2024-12-08 16:53:04,55,3203,28,27,1778.78,3248.00,0.00
2024-12-08 16:53:04,56,3203,29,27,1747.02,3248.02,0.00
2024-12-08 16:53:04,57,3202,29,28,1686.40,3248.63,0.00
2024-12-08 16:53:04,57,3203,29,28,1722.65,3249.00,0.00
2024-12-08 16:53:04,58,3203,29,29,1692.94,3249.02,0.00
2024-12-08 16:53:04,57,3203,29,28,1715.26,3249.14,0.00
2024-12-08 16:53:04,57,3204,29,28,1779.05,3250.00,0.00
2024-12-08 16:53:04,58,3204,29,29,1748.38,3250.02,0.00
2024-12-08 16:53:04,57,3204,28,29,1772.78,3250.02,0.00
2024-12-08 16:53:04,57,3205,28,29,1787.01,3251.00,0.00
2024-12-08 16:53:04,58,3205,28,30,1756.20,3251.02,0.00
2024-12-08 16:53:04,57,3205,27,30,1777.34,3251.16,0.00
2024-12-08 16:53:04,56,3205,26,30,1791.40,3251.34,0.00
2024-12-08 16:53:04,55,3205,25,30,1814.10,3251.64,0.00
2024-12-08 16:53:04,55,3206,25,30,1861.67,3252.00,0.00
2024-12-08 16:53:04,56,3206,25,31,1828.43,3252.02,0.00
2024-12-08 16:53:04,55,3206,24,31,1858.74,3252.11,0.00
2024-12-08 16:53:04,54,3206,24,30,1885.94,3252.15,0.00
2024-12-08 16:53:04,54,3207,24,30,1894.92,3253.00,0.00
2024-12-08 16:53:04,55,3207,25,30,1860.47,3253.02,0.00
2024-12-08 16:53:04,55,3208,25,30,1861.76,3254.00,0.00
2024-12-08 16:53:04,56,3208,25,31,1828.51,3254.02,0.00
2024-12-08 16:53:04,56,3209,25,31,1821.70,3255.00,0.00
2024-12-08 16:53:04,57,3209,26,31,1789.75,3255.02,0.00
2024-12-08 16:53:04,56,3209,26,30,1813.01,3255.14,0.00
2024-12-08 16:53:04,55,3209,25,30,1812.47,3255.76,0.00
2024-12-08 16:53:04,55,3210,25,30,1864.15,3256.00,0.00
2024-12-08 16:53:04,56,3210,26,30,1830.86,3256.02,0.00
2024-12-08 16:53:04,55,3210,25,30,1861.21,3256.11,0.00
2024-12-08 16:53:04,54,3210,24,30,1869.20,3256.26,0.00
2024-12-08 16:53:04,54,3211,24,30,1905.89,3257.00,0.00
2024-12-08 16:53:04,55,3211,25,30,1871.24,3257.02,0.00
2024-12-08 16:53:04,54,3211,24,30,1902.29,3257.11,0.00
2024-12-08 16:53:04,54,3212,24,30,1898.30,3258.00,0.00
2024-12-08 16:53:04,55,3212,25,30,1863.78,3258.02,0.00
2024-12-08 16:53:04,54,3212,25,29,1891.07,3258.11,0.00
2024-12-08 16:53:04,54,3213,25,29,1898.88,3259.00,0.00
2024-12-08 16:53:04,55,3213,25,30,1864.35,3259.02,0.00
2024-12-08 16:53:04,54,3213,24,30,1871.18,3259.22,0.00
2024-12-08 16:53:04,54,3214,24,30,1906.71,3260.00,0.00
2024-12-08 16:53:04,55,3214,24,31,1872.04,3260.02,0.00
2024-12-08 16:53:04,54,3214,23,31,1850.86,3260.63,0.00
2024-12-08 16:53:04,54,3215,23,31,1899.44,3261.00,0.00
2024-12-08 16:53:04,55,3215,23,32,1864.90,3261.02,0.00
2024-12-08 16:53:04,54,3215,23,31,1893.42,3261.11,0.00
2024-12-08 16:53:04,53,3215,22,31,1925.45,3261.11,0.00
2024-12-08 16:53:04,53,3216,22,31,1958.64,3262.00,0.00
2024-12-08 16:53:04,54,3216,23,31,1922.37,3262.02,0.00
2024-12-08 16:53:04,53,3216,22,31,1929.16,3262.25,0.00
2024-12-08 16:53:04,54,3215,22,32,1886.92,3262.48,0.00
2024-12-08 16:53:04,54,3216,22,32,1948.34,3263.00,0.00
2024-12-08 16:53:04,55,3216,23,32,1912.92,3263.02,0.00
2024-12-08 16:53:04,55,3217,23,32,1964.54,3264.00,0.00
2024-12-08 16:53:04,56,3217,24,32,1929.46,3264.02,0.00
2024-12-08 16:53:04,55,3217,24,31,1958.03,3264.13,0.00
2024-12-08 16:53:04,55,3218,24,31,1965.74,3265.00,0.00
2024-12-08 16:53:04,56,3218,24,32,1930.63,3265.02,0.00
2024-12-08 16:53:04,56,3219,24,32,1928.38,3266.00,0.00
2024-12-08 16:53:04,57,3219,25,32,1894.55,3266.02,0.00
2024-12-08 16:53:04,56,3219,24,32,1927.80,3266.02,0.00
2024-12-08 16:53:04,55,3219,23,32,1912.49,3266.82,0.00
2024-12-08 16:53:04,55,3220,23,32,1966.08,3267.00,0.00
2024-12-08 16:53:04,56,3220,23,33,1930.97,3267.02,0.00
2024-12-08 16:53:04,55,3220,23,32,1961.34,3267.11,0.00
2024-12-08 16:53:04,55,3221,23,32,1968.47,3268.00,0.00
2024-12-08 16:53:04,56,3221,23,33,1933.31,3268.02,0.00
2024-12-08 16:53:04,55,3221,22,33,1966.10,3268.09,0.00
2024-12-08 16:53:04,55,3222,22,33,1965.83,3269.00,0.00
2024-12-08 16:53:04,56,3222,23,33,1930.72,3269.02,0.00
2024-12-08 16:53:04,55,3222,22,33,1922.70,3269.58,0.00
2024-12-08 16:53:04,55,3223,22,33,1968.78,3270.00,0.00
2024-12-08 16:53:04,56,3223,23,33,1933.62,3270.02,0.00
2024-12-08 16:53:04,55,3223,23,32,1965.82,3270.09,0.00
2024-12-08 16:53:04,54,3223,22,32,1986.70,3270.57,0.00
2024-12-08 16:53:04,54,3224,22,32,2009.43,3271.00,0.00
2024-12-08 16:53:04,55,3224,23,32,1972.90,3271.02,0.00
2024-12-08 16:53:04,54,3224,22,32,2003.39,3271.11,0.00
2024-12-08 16:53:04,54,3225,22,32,2023.38,3272.00,0.00
2024-12-08 16:53:04,55,3225,22,33,1986.59,3272.02,0.00
2024-12-08 16:53:04,55,3226,22,33,1978.87,3273.00,0.00
2024-12-08 16:53:04,56,3226,23,33,1943.53,3273.02,0.00
2024-12-08 16:53:04,55,3226,23,32,1973.52,3273.11,0.00
2024-12-08 16:53:04,55,3227,23,32,1980.66,3274.00,0.00
2024-12-08 16:53:04,56,3227,23,33,1945.29,3274.02,0.00
2024-12-08 16:53:04,56,3228,23,33,1942.50,3275.00,0.00
2024-12-08 16:53:04,57,3228,24,33,1908.42,3275.02,0.00
2024-12-08 16:53:04,56,3228,23,33,1894.86,3275.80,0.00
2024-12-08 16:53:04,56,3229,23,33,1947.06,3276.00,0.00
2024-12-08 16:53:04,57,3229,24,33,1912.91,3276.02,0.00
2024-12-08 16:53:04,56,3229,23,33,1946.48,3276.02,0.00
2024-12-08 16:53:04,55,3229,23,32,1977.71,3276.09,0.00
2024-12-08 16:53:05,55,3230,23,32,1984.26,3277.00,0.00
2024-12-08 16:53:05,56,3230,24,32,1948.83,3277.02,0.00
2024-12-08 16:53:05,56,3231,24,32,1945.01,3278.00,0.00
2024-12-08 16:53:05,57,3231,25,32,1910.89,3278.02,0.00
2024-12-08 16:53:05,57,3232,25,32,1902.27,3279.00,0.00
2024-12-08 16:53:05,58,3232,26,32,1869.47,3279.02,0.00
2024-12-08 16:53:05,57,3232,26,31,1899.40,3279.09,0.00
2024-12-08 16:53:05,57,3233,26,31,1904.57,3280.00,0.00
2024-12-08 16:53:05,58,3233,26,32,1871.74,3280.02,0.00
2024-12-08 16:53:05,57,3233,25,32,1904.00,3280.02,0.00
2024-12-08 16:53:05,56,3233,24,32,1921.62,3280.11,0.00
2024-12-08 16:53:05,56,3234,24,32,1951.48,3281.00,0.00
2024-12-08 16:53:05,57,3234,25,32,1917.24,3281.02,0.00
2024-12-08 16:53:05,56,3234,25,31,1938.01,3281.07,0.00
2024-12-08 16:53:05,55,3234,24,31,1934.76,3281.58,0.00
2024-12-08 16:53:05,55,3235,24,31,1981.00,3282.00,0.00
2024-12-08 16:53:05,56,3235,25,31,1945.63,3282.02,0.00
2024-12-08 16:53:05,55,3235,24,31,1980.40,3282.02,0.00
2024-12-08 16:53:05,55,3236,24,31,1975.67,3283.00,0.00
2024-12-08 16:53:05,56,3236,24,32,1940.39,3283.02,0.00
2024-12-08 16:53:05,55,3236,24,31,1963.14,3283.05,0.00
2024-12-08 16:53:05,54,3236,23,31,1984.68,3283.50,0.00
2024-12-08 16:53:05,54,3237,23,31,2005.10,3284.00,0.00
2024-12-08 16:53:05,55,3237,23,32,1968.64,3284.02,0.00
2024-12-08 16:53:05,54,3237,22,32,2000.84,3284.02,0.00
2024-12-08 16:53:05,54,3238,22,32,2017.76,3285.00,0.00
2024-12-08 16:53:05,55,3238,22,33,1981.08,3285.02,0.00
2024-12-08 16:53:05,54,3238,22,32,2004.99,3285.04,0.00
2024-12-08 16:53:05,54,3239,22,32,2010.47,3286.00,0.00
2024-12-08 16:53:05,55,3239,22,33,1973.91,3286.02,0.00
2024-12-08 16:53:05,55,3240,22,33,1968.58,3287.00,0.00
2024-12-08 16:53:05,56,3240,22,34,1933.43,3287.02,0.00
2024-12-08 16:53:05,55,3240,22,33,1954.54,3287.07,0.00
2024-12-08 16:53:05,54,3240,21,33,1981.64,3287.13,0.00
2024-12-08 16:53:05,54,3241,21,33,2014.46,3288.00,0.00
2024-12-08 16:53:05,55,3241,21,34,1977.84,3288.02,0.00
2024-12-08 16:53:05,55,3242,21,34,1986.11,3289.00,0.00
2024-12-08 16:53:05,56,3242,22,34,1950.65,3289.02,0.00
2024-12-08 16:53:05,55,3242,21,34,1978.08,3289.02,0.00
2024-12-08 16:53:05,56,3241,21,35,1942.18,3289.07,0.00
2024-12-08 16:53:05,56,3242,21,35,1994.95,3290.00,0.00
2024-12-08 16:53:05,57,3242,21,36,1959.95,3290.02,0.00
2024-12-08 16:53:05,57,3243,21,36,2009.00,3291.00,0.00
2024-12-08 16:53:05,58,3243,22,36,1974.36,3291.02,0.00
2024-12-08 16:53:05,57,3243,22,35,1999.80,3291.09,0.00
2024-12-08 16:53:05,56,3243,21,35,2017.01,3291.64,0.00
2024-12-08 16:53:05,56,3244,21,35,2040.79,3292.00,0.00
2024-12-08 16:53:05,57,3244,21,36,2004.99,3292.02,0.00
2024-12-08 16:53:05,58,3243,22,36,1937.87,3292.71,0.00
2024-12-08 16:53:05,58,3244,22,36,1997.71,3293.00,0.00
2024-12-08 16:53:05,59,3244,22,37,1963.85,3293.02,0.00
2024-12-08 16:53:05,58,3244,21,37,1956.65,3293.72,0.00
2024-12-08 16:53:05,58,3245,21,37,2061.35,3294.00,0.00
2024-12-08 16:53:05,59,3245,21,38,2026.41,3294.02,0.00
2024-12-08 16:53:05,58,3245,21,37,2058.55,3294.09,0.00
2024-12-08 16:53:05,58,3246,21,37,2063.11,3295.00,0.00
2024-12-08 16:53:05,59,3246,21,38,2028.14,3295.02,0.00
2024-12-08 16:53:05,59,3247,21,38,2021.63,3296.00,0.00
2024-12-08 16:53:05,60,3247,22,38,1987.94,3296.02,0.00
2024-12-08 16:53:05,59,3247,22,37,2008.26,3296.09,0.00
2024-12-08 16:53:05,58,3247,21,37,2020.14,3296.35,0.00
2024-12-08 16:53:05,58,3248,21,37,2055.84,3297.00,0.00
2024-12-08 16:53:05,59,3248,21,38,2020.99,3297.02,0.00
2024-12-08 16:53:05,60,3247,21,39,1928.49,3297.93,0.00
2024-12-08 16:53:05,60,3248,21,39,1983.53,3298.00,0.00
2024-12-08 16:53:05,61,3248,21,40,1951.01,3298.02,0.00
2024-12-08 16:53:05,60,3248,21,39,1970.92,3298.08,0.00
2024-12-08 16:53:05,60,3249,21,39,2029.21,3299.00,0.00
2024-12-08 16:53:05,61,3249,21,40,1995.95,3299.02,0.00
2024-12-08 16:53:05,60,3249,20,40,1997.63,3299.63,0.00
2024-12-08 16:53:05,60,3250,20,40,2021.75,3300.00,0.00
2024-12-08 16:53:05,61,3250,20,41,1988.61,3300.02,0.00
2024-12-08 16:53:05,60,3250,20,40,2009.68,3300.08,0.00
2024-12-08 16:53:05,60,3251,20,40,2013.01,3301.00,0.00
2024-12-08 16:53:05,61,3251,20,41,1980.01,3301.02,0.00
2024-12-08 16:53:05,60,3251,19,41,1994.88,3301.07,0.00
2024-12-08 16:53:05,60,3252,19,41,2008.67,3302.00,0.00
2024-12-08 16:53:05,61,3252,19,42,1975.74,3302.02,0.00
2024-12-08 16:53:05,60,3252,18,42,1986.68,3302.07,0.00
2024-12-08 16:53:05,59,3252,18,41,2009.72,3302.07,0.00
2024-12-08 16:53:05,59,3253,18,41,2035.49,3303.00,0.00
2024-12-08 16:53:05,60,3253,19,41,2001.57,3303.02,0.00
2024-12-08 16:53:05,59,3253,18,41,2006.62,3303.56,0.00
2024-12-08 16:53:05,59,3254,18,41,2028.93,3304.00,0.00
2024-12-08 16:53:05,60,3254,18,42,1995.12,3304.02,0.00
2024-12-08 16:53:05,59,3254,18,41,2017.20,3304.07,0.00
2024-12-08 16:53:05,60,3253,18,42,1965.70,3304.65,0.00
2024-12-08 16:53:05,60,3254,18,42,1997.37,3305.00,0.00
2024-12-08 16:53:05,61,3254,18,43,1964.63,3305.02,0.00
2024-12-08 16:53:05,60,3254,17,43,1950.30,3305.83,0.00
2024-12-08 16:53:06,60,3255,17,43,2055.11,3306.00,0.00
2024-12-08 16:53:06,61,3255,18,43,2021.42,3306.02,0.00
2024-12-08 16:53:06,60,3255,18,42,2043.56,3306.07,0.00
2024-12-08 16:53:06,59,3255,17,42,2077.65,3306.09,0.00
2024-12-08 16:53:06,59,3256,17,42,2081.61,3307.00,0.00
2024-12-08 16:53:06,60,3256,17,43,2046.91,3307.02,0.00
2024-12-08 16:53:06,59,3256,16,43,2048.68,3307.34,0.00
2024-12-08 16:53:06,58,3256,15,43,2078.26,3307.52,0.00
2024-12-08 16:53:06,58,3257,15,43,2119.71,3308.00,0.00
2024-12-08 16:53:06,59,3257,16,43,2083.78,3308.02,0.00
2024-12-08 16:53:06,58,3257,16,42,2108.32,3308.07,0.00
2024-12-08 16:53:06,58,3258,16,42,2112.36,3309.00,0.00
2024-12-08 16:53:06,59,3258,17,42,2076.56,3309.02,0.00
2024-12-08 16:53:06,59,3259,17,42,2069.61,3310.00,0.00
2024-12-08 16:53:06,60,3259,17,43,2035.12,3310.02,0.00
2024-12-08 16:53:06,59,3259,17,42,2055.62,3310.10,0.00
2024-12-08 16:53:06,58,3259,16,42,2074.65,3310.60,0.00
2024-12-08 16:53:06,58,3260,16,42,2096.09,3311.00,0.00
2024-12-08 16:53:06,59,3260,17,42,2060.57,3311.02,0.00
2024-12-08 16:53:06,59,3261,17,42,2053.20,3312.00,0.00
2024-12-08 16:53:06,60,3261,18,42,2018.98,3312.02,0.00
2024-12-08 16:53:06,59,3261,18,41,2039.76,3312.10,0.00
2024-12-08 16:53:06,59,3262,18,41,2044.28,3313.00,0.00
2024-12-08 16:53:06,60,3262,19,41,2010.21,3313.02,0.00
2024-12-08 16:53:06,59,3262,18,41,2001.79,3313.46,0.00
2024-12-08 16:53:06,59,3263,18,41,2040.40,3314.00,0.00
2024-12-08 16:53:06,60,3263,18,42,2006.39,3314.02,0.00
2024-12-08 16:53:06,59,3263,18,41,2027.51,3314.10,0.00
2024-12-08 16:53:06,59,3264,18,41,2032.03,3315.00,0.00
2024-12-08 16:53:06,60,3264,18,42,1998.16,3315.02,0.00
2024-12-08 16:53:06,60,3265,18,42,1990.43,3316.00,0.00
2024-12-08 16:53:06,61,3265,19,42,1957.80,3316.02,0.00
2024-12-08 16:53:06,60,3265,19,41,1978.30,3316.10,0.00
2024-12-08 16:53:06,59,3265,18,41,2000.67,3316.22,0.00
2024-12-08 16:53:06,59,3266,18,41,2031.57,3317.00,0.00
2024-12-08 16:53:06,60,3266,19,41,1997.71,3317.02,0.00
2024-12-08 16:53:06,59,3266,18,41,2003.13,3317.54,0.00
2024-12-08 16:53:06,59,3267,18,41,2024.46,3318.00,0.00
2024-12-08 16:53:06,60,3267,18,42,1990.72,3318.02,0.00
2024-12-08 16:53:06,59,3267,18,41,2012.11,3318.10,0.00
2024-12-08 16:53:06,58,3267,17,41,2046.23,3318.10,0.00
2024-12-08 16:53:06,58,3268,17,41,2051.40,3319.00,0.00
2024-12-08 16:53:06,59,3268,18,41,2016.63,3319.02,0.00
2024-12-08 16:53:06,59,3269,18,41,2010.10,3320.00,0.00
2024-12-08 16:53:06,60,3269,19,41,1976.60,3320.02,0.00
2024-12-08 16:53:06,59,3269,19,40,1996.06,3320.10,0.00
2024-12-08 16:53:06,59,3270,19,40,2000.57,3321.00,0.00
2024-12-08 16:53:06,60,3270,20,40,1967.23,3321.02,0.00
2024-12-08 16:53:06,60,3271,20,40,1960.60,3322.00,0.00
2024-12-08 16:53:06,61,3271,21,40,1928.46,3322.02,0.00
2024-12-08 16:53:06,60,3271,21,39,1947.34,3322.10,0.00
2024-12-08 16:53:06,60,3272,21,39,1951.22,3323.00,0.00
2024-12-08 16:53:06,61,3272,21,40,1919.23,3323.02,0.00
2024-12-08 16:53:06,60,3272,20,40,1936.85,3323.12,0.00
2024-12-08 16:53:06,60,3273,20,40,1944.73,3324.00,0.00
2024-12-08 16:53:06,61,3273,21,40,1912.85,3324.02,0.00
2024-12-08 16:53:06,60,3273,21,39,1932.01,3324.10,0.00
2024-12-08 16:53:06,59,3273,20,39,1952.22,3324.22,0.00
2024-12-08 16:53:06,59,3274,20,39,1983.18,3325.00,0.00
2024-12-08 16:53:06,60,3274,21,39,1950.12,3325.02,0.00
2024-12-08 16:53:06,59,3274,20,39,1944.25,3325.73,0.00
2024-12-08 16:53:06,59,3275,20,39,1991.79,3326.00,0.00
2024-12-08 16:53:06,60,3275,21,39,1958.60,3326.02,0.00
2024-12-08 16:53:06,59,3275,21,38,1977.16,3326.12,0.00
2024-12-08 16:53:06,59,3276,21,38,1982.24,3327.00,0.00
2024-12-08 16:53:06,60,3276,21,39,1949.20,3327.02,0.00
2024-12-08 16:53:06,59,3276,20,39,1968.16,3327.07,0.00
2024-12-08 16:53:06,59,3277,20,39,1982.84,3328.00,0.00
2024-12-08 16:53:06,60,3277,21,39,1949.79,3328.02,0.00
2024-12-08 16:53:06,59,3277,21,38,1981.51,3328.05,0.00
2024-12-08 16:53:06,58,3277,21,37,2003.06,3328.09,0.00
2024-12-08 16:53:06,58,3278,21,37,2007.66,3329.00,0.00
2024-12-08 16:53:06,59,3278,21,38,1973.63,3329.02,0.00
2024-12-08 16:53:06,58,3278,20,38,1989.03,3329.12,0.00
2024-12-08 16:53:06,58,3279,20,38,2017.74,3330.00,0.00
2024-12-08 16:53:06,59,3279,21,38,1983.54,3330.02,0.00
2024-12-08 16:53:06,58,3279,21,37,2004.55,3330.09,0.00
2024-12-08 16:53:06,57,3279,20,37,2039.72,3330.09,0.00
2024-12-08 16:53:06,57,3280,20,37,2068.36,3331.00,0.00
2024-12-08 16:53:06,58,3280,21,37,2032.70,3331.02,0.00
2024-12-08 16:53:06,58,3281,21,37,2026.03,3332.00,0.00
2024-12-08 16:53:06,59,3281,21,38,1991.69,3332.02,0.00
2024-12-08 16:53:06,58,3281,21,37,2011.69,3332.09,0.00
2024-12-08 16:53:06,58,3282,21,37,2016.29,3333.00,0.00
2024-12-08 16:53:06,59,3282,21,38,1982.12,3333.02,0.00
2024-12-08 16:53:06,59,3283,21,38,1975.61,3334.00,0.00
2024-12-08 16:53:06,60,3283,22,38,1942.68,3334.02,0.00
2024-12-08 16:53:06,59,3283,22,37,1961.50,3334.09,0.00
2024-12-08 16:53:06,58,3283,21,37,1971.62,3334.29,0.00
2024-12-08 16:53:07,58,3284,21,37,2006.00,3335.00,0.00
2024-12-08 16:53:07,59,3284,21,38,1972.00,3335.02,0.00
2024-12-08 16:53:07,58,3284,20,38,1972.25,3335.64,0.00
2024-12-08 16:53:07,58,3285,20,38,2017.94,3336.00,0.00
2024-12-08 16:53:07,59,3285,21,38,1983.74,3336.02,0.00
2024-12-08 16:53:07,60,3284,21,39,1931.87,3336.28,0.00
2024-12-08 16:53:07,60,3285,21,39,1966.84,3337.00,0.00
2024-12-08 16:53:07,61,3285,21,40,1934.59,3337.02,0.00
2024-12-08 16:53:07,60,3285,21,39,1961.31,3337.12,0.00
2024-12-08 16:53:07,59,3285,20,39,1961.43,3337.51,0.00
2024-12-08 16:53:07,59,3286,20,39,2058.50,3338.00,0.00
2024-12-08 16:53:07,60,3286,21,39,2024.20,3338.02,0.00
2024-12-08 16:53:07,59,3286,20,39,2026.60,3338.64,0.00
2024-12-08 16:53:07,59,3287,20,39,2054.02,3339.00,0.00
2024-12-08 16:53:07,60,3287,20,40,2019.79,3339.02,0.00
2024-12-08 16:53:07,60,3288,20,40,2009.82,3340.00,0.00
2024-12-08 16:53:07,61,3288,20,41,1976.87,3340.02,0.00
2024-12-08 16:53:07,60,3288,20,40,2004.28,3340.12,0.00
2024-12-08 16:53:07,60,3289,20,40,2008.75,3341.00,0.00
2024-12-08 16:53:07,61,3289,21,40,1975.82,3341.02,0.00
2024-12-08 16:53:07,60,3289,20,40,1975.68,3341.67,0.00
2024-12-08 16:53:07,60,3290,20,40,2020.49,3342.00,0.00
2024-12-08 16:53:07,61,3290,20,41,1987.37,3342.02,0.00
2024-12-08 16:53:07,61,3291,20,41,1977.00,3343.00,0.00
2024-12-08 16:53:07,62,3291,20,42,1945.11,3343.02,0.00
2024-12-08 16:53:07,61,3291,20,41,1972.64,3343.12,0.00
2024-12-08 16:53:07,61,3292,20,41,1976.50,3344.00,0.00
2024-12-08 16:53:07,62,3292,21,41,1944.62,3344.02,0.00
2024-12-08 16:53:07,62,3293,21,41,1945.73,3345.00,0.00
2024-12-08 16:53:07,63,3293,22,41,1914.84,3345.02,0.00
2024-12-08 16:53:07,63,3294,22,41,1907.35,3346.00,0.00
2024-12-08 16:53:07,64,3294,23,41,1877.55,3346.02,0.00
2024-12-08 16:53:07,63,3294,23,40,1894.10,3346.11,0.00
2024-12-08 16:53:07,63,3295,23,40,1896.77,3347.00,0.00
2024-12-08 16:53:07,64,3295,24,40,1867.13,3347.02,0.00
2024-12-08 16:53:07,64,3296,24,40,1860.75,3348.00,0.00
2024-12-08 16:53:07,65,3296,25,40,1832.13,3348.02,0.00
2024-12-08 16:53:07,64,3296,25,39,1860.23,3348.02,0.00
2024-12-08 16:53:07,63,3296,25,38,1888.70,3348.03,0.00
2024-12-08 16:53:07,62,3296,25,37,1905.15,3348.11,0.00
2024-12-08 16:53:07,62,3297,25,37,1908.39,3349.00,0.00
2024-12-08 16:53:07,63,3297,26,37,1878.10,3349.02,0.00
2024-12-08 16:53:07,62,3297,25,37,1891.66,3349.06,0.00
2024-12-08 16:53:07,62,3298,25,37,1904.10,3350.00,0.00
2024-12-08 16:53:07,63,3298,25,38,1873.87,3350.02,0.00
2024-12-08 16:53:07,63,3299,25,38,1867.02,3351.00,0.00
2024-12-08 16:53:07,64,3299,25,39,1837.85,3351.02,0.00
2024-12-08 16:53:07,63,3299,25,38,1856.91,3351.02,0.00
2024-12-08 16:53:07,63,3300,25,38,1856.40,3352.00,0.00
2024-12-08 16:53:07,64,3300,26,38,1827.40,3352.02,0.00
2024-12-08 16:53:07,63,3300,26,37,1844.71,3352.08,0.00
2024-12-08 16:53:07,62,3300,25,37,1831.15,3352.97,0.00
2024-12-08 16:53:07,62,3301,25,37,1884.17,3353.00,0.00
2024-12-08 16:53:07,63,3301,26,37,1854.26,3353.02,0.00
2024-12-08 16:53:07,62,3301,25,37,1841.33,3353.84,0.00
2024-12-08 16:53:07,62,3302,25,37,1890.14,3354.00,0.00
2024-12-08 16:53:07,63,3302,25,38,1860.14,3354.02,0.00
2024-12-08 16:53:07,62,3302,25,37,1877.19,3354.10,0.00
2024-12-08 16:53:07,62,3303,25,37,1879.88,3355.00,0.00
2024-12-08 16:53:07,63,3303,26,37,1850.04,3355.02,0.00
2024-12-08 16:53:07,62,3303,25,37,1835.53,3355.50,0.00
2024-12-08 16:53:07,62,3304,25,37,1873.23,3356.00,0.00
2024-12-08 16:53:07,63,3304,25,38,1843.49,3356.02,0.00
2024-12-08 16:53:07,62,3304,25,37,1860.81,3356.10,0.00
2024-12-08 16:53:07,63,3303,25,38,1804.56,3356.94,0.00
2024-12-08 16:53:07,63,3304,25,38,1836.58,3357.00,0.00
2024-12-08 16:53:07,64,3304,26,38,1807.89,3357.02,0.00
2024-12-08 16:53:08,64,3305,26,38,1853.34,3358.00,0.00
2024-12-08 16:53:08,65,3305,27,38,1824.83,3358.02,0.00
2024-12-08 16:53:08,64,3305,27,37,1841.83,3358.09,0.00
2024-12-08 16:53:08,63,3305,26,37,1860.54,3358.40,0.00
2024-12-08 16:53:08,62,3305,25,37,1879.90,3358.71,0.00
2024-12-08 16:53:08,61,3305,24,37,1888.55,3358.95,0.00
2024-12-08 16:53:08,61,3306,24,37,1941.99,3359.00,0.00
2024-12-08 16:53:08,62,3306,24,38,1910.67,3359.02,0.00
2024-12-08 16:53:08,62,3307,24,38,1899.86,3360.00,0.00
2024-12-08 16:53:08,63,3307,25,38,1869.70,3360.02,0.00
2024-12-08 16:53:08,62,3307,25,37,1894.99,3360.05,0.00
2024-12-08 16:53:08,61,3307,24,37,1896.17,3360.82,0.00
2024-12-08 16:53:08,61,3308,24,37,1945.35,3361.00,0.00
2024-12-08 16:53:08,62,3308,24,38,1913.98,3361.02,0.00
2024-12-08 16:53:08,61,3308,24,37,1944.25,3361.02,0.00
2024-12-08 16:53:08,60,3308,23,37,1958.00,3361.57,0.00
2024-12-08 16:53:08,60,3309,23,37,1977.39,3362.00,0.00
2024-12-08 16:53:08,61,3309,23,38,1944.97,3362.02,0.00
2024-12-08 16:53:08,61,3310,23,38,1935.42,3363.00,0.00
2024-12-08 16:53:08,62,3310,24,38,1904.20,3363.02,0.00
2024-12-08 16:53:08,61,3310,24,37,1926.62,3363.07,0.00
2024-12-08 16:53:08,60,3310,23,37,1925.74,3363.85,0.00
2024-12-08 16:53:08,60,3311,23,37,1976.88,3364.00,0.00
2024-12-08 16:53:08,61,3311,24,37,1944.47,3364.02,0.00
2024-12-08 16:53:08,60,3311,23,37,1960.12,3364.18,0.00
2024-12-08 16:53:08,60,3312,23,37,1968.03,3365.00,0.00
2024-12-08 16:53:08,61,3312,23,38,1935.76,3365.02,0.00
2024-12-08 16:53:08,60,3312,23,37,1959.07,3365.07,0.00
2024-12-08 16:53:08,60,3313,23,37,1961.88,3366.00,0.00
2024-12-08 16:53:08,61,3313,24,37,1929.72,3366.02,0.00
2024-12-08 16:53:08,62,3312,24,38,1840.92,3366.81,0.00
2024-12-08 16:53:08,62,3313,24,38,1895.93,3367.00,0.00
2024-12-08 16:53:08,63,3313,25,38,1865.84,3367.02,0.00
2024-12-08 16:53:08,62,3313,25,37,1888.35,3367.06,0.00
2024-12-08 16:53:08,62,3314,25,37,1944.30,3368.00,0.00
2024-12-08 16:53:08,63,3314,25,38,1913.44,3368.02,0.00
2024-12-08 16:53:08,63,3315,25,38,1902.44,3369.00,0.00
2024-12-08 16:53:08,64,3315,25,39,1872.71,3369.02,0.00
2024-12-08 16:53:08,63,3315,25,38,1895.50,3369.06,0.00
2024-12-08 16:53:08,62,3315,24,38,1888.87,3369.92,0.00
2024-12-08 16:53:08,62,3316,24,38,1940.56,3370.00,0.00
2024-12-08 16:53:08,63,3316,25,38,1909.76,3370.02,0.00
2024-12-08 16:53:08,62,3316,24,38,1923.77,3370.19,0.00
2024-12-08 16:53:08,62,3317,24,38,1929.87,3371.00,0.00
2024-12-08 16:53:08,63,3317,24,39,1899.23,3371.02,0.00
2024-12-08 16:53:08,62,3317,24,38,1923.36,3371.06,0.00
2024-12-08 16:53:08,61,3317,23,38,1924.65,3371.80,0.00
2024-12-08 16:53:08,61,3318,23,38,1973.45,3372.00,0.00
2024-12-08 16:53:08,62,3318,24,38,1941.62,3372.02,0.00
2024-12-08 16:53:08,62,3319,24,38,1930.77,3373.00,0.00
2024-12-08 16:53:08,63,3319,25,38,1900.13,3373.02,0.00
2024-12-08 16:53:08,62,3319,25,37,1924.80,3373.06,0.00
2024-12-08 16:53:08,62,3320,25,37,1926.45,3374.00,0.00
2024-12-08 16:53:08,63,3320,26,37,1895.87,3374.02,0.00
2024-12-08 16:53:08,62,3320,25,37,1882.55,3374.48,0.00
2024-12-08 16:53:08,62,3321,25,37,1919.95,3375.00,0.00
2024-12-08 16:53:08,63,3321,26,37,1889.47,3375.02,0.00
2024-12-08 16:53:08,62,3321,26,36,1914.52,3375.06,0.00
2024-12-08 16:53:08,62,3322,26,36,1916.16,3376.00,0.00
2024-12-08 16:53:08,63,3322,27,36,1885.74,3376.02,0.00
2024-12-08 16:53:08,63,3323,27,36,1874.51,3377.00,0.00
2024-12-08 16:53:08,64,3323,27,37,1845.22,3377.02,0.00
2024-12-08 16:53:08,63,3323,27,36,1869.70,3377.06,0.00
2024-12-08 16:53:08,63,3324,27,36,1870.78,3378.00,0.00
2024-12-08 16:53:08,64,3324,28,36,1841.54,3378.02,0.00
2024-12-08 16:53:08,64,3325,28,36,1829.95,3379.00,0.00
2024-12-08 16:53:08,65,3325,29,36,1801.79,3379.02,0.00
2024-12-08 16:53:08,64,3325,29,35,1825.21,3379.06,0.00
2024-12-08 16:53:08,64,3326,29,35,1825.73,3380.00,0.00
2024-12-08 16:53:08,65,3326,30,35,1797.65,3380.02,0.00
2024-12-08 16:53:08,64,3326,29,35,1808.89,3380.20,0.00
2024-12-08 16:53:08,63,3326,28,35,1832.78,3380.25,0.00
2024-12-08 16:53:08,63,3327,28,35,1861.70,3381.00,0.00
2024-12-08 16:53:08,64,3327,28,36,1832.61,3381.02,0.00
2024-12-08 16:53:08,63,3327,28,35,1857.96,3381.06,0.00
2024-12-08 16:53:08,63,3328,28,35,1859.03,3382.00,0.00
2024-12-08 16:53:08,64,3328,28,36,1829.99,3382.02,0.00
2024-12-08 16:53:08,64,3329,28,36,1818.37,3383.00,0.00
2024-12-08 16:53:08,65,3329,29,36,1790.39,3383.02,0.00
2024-12-08 16:53:08,64,3329,29,35,1815.21,3383.06,0.00
2024-12-08 16:53:09,64,3330,29,35,1815.73,3384.00,0.00
2024-12-08 16:53:09,65,3330,30,35,1787.80,3384.02,0.00
2024-12-08 16:53:09,65,3331,30,35,1775.83,3385.00,0.00
2024-12-08 16:53:09,66,3331,31,35,1748.92,3385.02,0.00
2024-12-08 16:53:09,65,3331,31,34,1774.83,3385.03,0.00
2024-12-08 16:53:09,64,3331,31,33,1800.45,3385.05,0.00
2024-12-08 16:53:09,64,3332,31,33,1800.45,3386.00,0.00
2024-12-08 16:53:09,65,3332,31,34,1772.75,3386.02,0.00
2024-12-08 16:53:09,65,3333,31,34,1760.77,3387.00,0.00
2024-12-08 16:53:09,66,3333,31,35,1734.09,3387.02,0.00
2024-12-08 16:53:09,67,3332,32,35,1708.21,3387.05,0.00
2024-12-08 16:53:09,66,3332,32,34,1779.78,3387.06,0.00
2024-12-08 16:53:09,65,3332,31,34,1804.47,3387.14,0.00
2024-12-08 16:53:09,64,3332,30,34,1829.51,3387.20,0.00
2024-12-08 16:53:09,64,3333,30,34,1855.92,3388.00,0.00
2024-12-08 16:53:09,65,3333,31,34,1827.37,3388.02,0.00
2024-12-08 16:53:09,65,3334,31,34,1867.68,3389.00,0.00
2024-12-08 16:53:09,66,3334,31,35,1839.38,3389.02,0.00
2024-12-08 16:53:09,65,3334,31,34,1862.49,3389.08,0.00
2024-12-08 16:53:09,65,3335,31,34,1863.01,3390.00,0.00
2024-12-08 16:53:09,66,3335,32,34,1834.79,3390.02,0.00
2024-12-08 16:53:09,65,3335,31,34,1829.86,3390.35,0.00
2024-12-08 16:53:09,65,3336,31,34,1860.53,3391.00,0.00
2024-12-08 16:53:09,66,3336,31,35,1832.34,3391.02,0.00
2024-12-08 16:53:09,67,3335,31,36,1804.50,3391.06,0.00
2024-12-08 16:53:09,66,3335,31,35,1856.01,3391.09,0.00
2024-12-08 16:53:09,66,3336,31,35,1856.52,3392.00,0.00
2024-12-08 16:53:09,67,3336,32,35,1828.81,3392.02,0.00
2024-12-08 16:53:09,67,3337,32,35,1867.08,3393.00,0.00
2024-12-08 16:53:09,68,3337,32,36,1839.63,3393.02,0.00
2024-12-08 16:53:09,69,3336,33,36,1812.97,3393.04,0.00
2024-12-08 16:53:09,68,3336,33,35,1837.67,3393.09,0.00
2024-12-08 16:53:09,67,3336,32,35,1844.63,3393.69,0.00
2024-12-08 16:53:09,67,3337,32,35,1864.60,3394.00,0.00
2024-12-08 16:53:09,68,3337,32,36,1837.17,3394.02,0.00
2024-12-08 16:53:09,67,3337,31,36,1836.26,3394.09,0.00
2024-12-08 16:53:09,66,3337,30,36,1844.32,3394.67,0.00
2024-12-08 16:53:09,66,3338,30,36,1936.10,3395.00,0.00
2024-12-08 16:53:09,67,3338,31,36,1907.20,3395.02,0.00
2024-12-08 16:53:09,66,3338,31,35,1929.45,3395.08,0.00
2024-12-08 16:53:09,65,3338,30,35,1956.00,3395.17,0.00
2024-12-08 16:53:09,65,3339,30,35,1959.64,3396.00,0.00
2024-12-08 16:53:09,66,3339,30,36,1929.95,3396.02,0.00
2024-12-08 16:53:09,66,3340,30,36,1918.59,3397.00,0.00
2024-12-08 16:53:09,67,3340,30,37,1889.95,3397.02,0.00
2024-12-08 16:53:09,66,3340,30,36,1910.39,3397.09,0.00
2024-12-08 16:53:09,66,3341,30,36,1910.92,3398.00,0.00
2024-12-08 16:53:09,67,3341,31,36,1882.39,3398.02,0.00
2024-12-08 16:53:09,66,3341,30,36,1880.58,3398.11,0.00
2024-12-08 16:53:09,66,3342,30,36,1902.21,3399.00,0.00
2024-12-08 16:53:09,67,3342,30,37,1873.82,3399.02,0.00
2024-12-08 16:53:09,66,3342,30,36,1894.00,3399.09,0.00
2024-12-08 16:53:09,65,3342,29,36,1904.59,3399.65,0.00
2024-12-08 16:53:09,65,3343,29,36,1924.20,3400.00,0.00
2024-12-08 16:53:09,66,3343,30,36,1895.04,3400.02,0.00
2024-12-08 16:53:09,66,3344,30,36,1884.78,3401.00,0.00
2024-12-08 16:53:09,67,3344,30,37,1856.65,3401.02,0.00
2024-12-08 16:53:09,66,3344,30,36,1876.06,3401.09,0.00
2024-12-08 16:53:09,66,3345,30,36,1876.57,3402.00,0.00
2024-12-08 16:53:09,67,3345,30,37,1848.57,3402.02,0.00
2024-12-08 16:53:09,68,3344,31,37,1821.38,3402.04,0.00
2024-12-08 16:53:09,68,3345,31,37,1815.65,3403.00,0.00
2024-12-08 16:53:09,69,3345,31,38,1789.34,3403.01,0.00
2024-12-08 16:53:09,68,3345,31,37,1807.68,3403.09,0.00
2024-12-08 16:53:09,68,3346,31,37,1857.23,3404.00,0.00
2024-12-08 16:53:09,69,3346,32,37,1830.32,3404.01,0.00
2024-12-08 16:53:09,68,3346,31,37,1820.26,3404.74,0.00
2024-12-08 16:53:09,68,3347,31,37,1861.53,3405.00,0.00
2024-12-08 16:53:09,69,3347,32,37,1834.55,3405.01,0.00
2024-12-08 16:53:09,68,3347,32,36,1853.55,3405.09,0.00
2024-12-08 16:53:09,68,3348,32,36,1853.06,3406.00,0.00
2024-12-08 16:53:09,69,3348,32,37,1826.20,3406.01,0.00
2024-12-08 16:53:09,68,3348,31,37,1836.59,3406.19,0.00
2024-12-08 16:53:09,67,3348,30,37,1851.86,3406.33,0.00
2024-12-08 16:53:09,66,3348,29,37,1869.34,3406.64,0.00
2024-12-08 16:53:09,65,3348,28,37,1897.96,3406.65,0.00
2024-12-08 16:53:09,65,3349,28,37,1938.58,3407.00,0.00
2024-12-08 16:53:09,66,3349,29,37,1909.21,3407.02,0.00
2024-12-08 16:53:09,66,3350,29,37,1898.13,3408.00,0.00
2024-12-08 16:53:09,67,3350,29,38,1869.80,3408.02,0.00
2024-12-08 16:53:09,66,3350,29,37,1889.90,3408.11,0.00
2024-12-08 16:53:09,65,3350,28,37,1915.86,3408.19,0.00
2024-12-08 16:53:09,65,3351,28,37,1920.04,3409.00,0.00
2024-12-08 16:53:09,66,3351,29,37,1890.94,3409.02,0.00
2024-12-08 16:53:09,66,3352,29,37,1880.00,3410.00,0.00
2024-12-08 16:53:09,67,3352,29,38,1851.94,3410.02,0.00
2024-12-08 16:53:09,66,3352,29,37,1871.76,3410.11,0.00
2024-12-08 16:53:09,66,3353,29,37,1872.80,3411.00,0.00
2024-12-08 16:53:09,67,3353,30,37,1844.84,3411.02,0.00
2024-12-08 16:53:09,66,3353,29,37,1860.93,3411.05,0.00
2024-12-08 16:53:09,67,3352,29,38,1809.82,3411.61,0.00
2024-12-08 16:53:10,67,3353,29,38,1859.51,3412.00,0.00
2024-12-08 16:53:10,68,3353,30,38,1832.16,3412.02,0.00
2024-12-08 16:53:10,67,3353,29,38,1847.82,3412.05,0.00
2024-12-08 16:53:10,66,3353,28,38,1857.19,3412.59,0.00
2024-12-08 16:53:10,66,3354,28,38,1938.45,3413.00,0.00
2024-12-08 16:53:10,67,3354,28,39,1909.52,3413.02,0.00
2024-12-08 16:53:10,67,3355,28,39,1900.74,3414.00,0.00
2024-12-08 16:53:10,68,3355,29,39,1872.78,3414.02,0.00
2024-12-08 16:53:10,67,3355,29,38,1891.07,3414.03,0.00
2024-12-08 16:53:10,67,3356,29,38,1889.06,3415.00,0.00
2024-12-08 16:53:10,68,3356,30,38,1861.28,3415.02,0.00
2024-12-08 16:53:10,67,3356,29,38,1845.55,3415.52,0.00
2024-12-08 16:53:10,67,3357,29,38,1880.57,3416.00,0.00
2024-12-08 16:53:10,68,3357,30,38,1852.91,3416.02,0.00
2024-12-08 16:53:10,67,3357,30,37,1879.05,3416.05,0.00
2024-12-08 16:53:10,66,3357,30,36,1904.94,3416.05,0.00
2024-12-08 16:53:10,66,3358,30,36,1903.93,3417.00,0.00
2024-12-08 16:53:10,67,3358,30,37,1875.51,3417.02,0.00
2024-12-08 16:53:10,67,3359,30,37,1862.79,3418.00,0.00
2024-12-08 16:53:10,68,3359,31,37,1835.40,3418.02,0.00
2024-12-08 16:53:10,67,3359,31,36,1859.24,3418.05,0.00
2024-12-08 16:53:10,67,3360,31,36,1857.73,3419.00,0.00
2024-12-08 16:53:10,68,3360,31,37,1830.41,3419.02,0.00
2024-12-08 16:53:10,68,3361,31,37,1817.36,3420.00,0.00
2024-12-08 16:53:10,69,3361,31,38,1791.02,3420.01,0.00
2024-12-08 16:53:10,68,3361,31,37,1814.36,3420.04,0.00
2024-12-08 16:53:10,68,3362,31,37,1812.36,3421.00,0.00
2024-12-08 16:53:10,69,3362,32,37,1786.09,3421.01,0.00
2024-12-08 16:53:10,68,3362,31,37,1781.83,3421.09,0.00
2024-12-08 16:53:10,68,3363,31,37,1801.45,3422.00,0.00
2024-12-08 16:53:10,69,3363,31,38,1775.34,3422.01,0.00
2024-12-08 16:53:10,68,3363,31,37,1795.43,3422.06,0.00
2024-12-08 16:53:10,67,3363,30,37,1820.19,3422.12,0.00
2024-12-08 16:53:10,67,3364,30,37,1821.20,3423.00,0.00
2024-12-08 16:53:10,68,3364,30,38,1794.42,3423.02,0.00
2024-12-08 16:53:10,68,3365,30,38,1784.84,3424.00,0.00
2024-12-08 16:53:10,69,3365,30,39,1758.97,3424.01,0.00
2024-12-08 16:53:10,68,3365,30,38,1776.80,3424.06,0.00
2024-12-08 16:53:10,67,3365,29,38,1759.88,3424.97,0.00
2024-12-08 16:53:10,67,3366,29,38,1810.00,3425.00,0.00
2024-12-08 16:53:10,68,3366,30,38,1783.38,3425.02,0.00
2024-12-08 16:53:10,67,3366,29,38,1775.56,3425.72,0.00
2024-12-08 16:53:10,66,3366,28,38,1788.58,3425.92,0.00
2024-12-08 16:53:10,66,3367,28,38,1837.96,3426.00,0.00
2024-12-08 16:53:10,67,3367,28,39,1810.52,3426.02,0.00
2024-12-08 16:53:10,66,3367,27,39,1836.93,3426.03,0.00
2024-12-08 16:53:10,65,3367,27,38,1859.92,3426.05,0.00
2024-12-08 16:53:10,64,3367,26,38,1886.08,3426.13,0.00
2024-12-08 16:53:10,64,3368,26,38,1888.73,3427.00,0.00
2024-12-08 16:53:10,65,3368,26,39,1859.67,3427.02,0.00
2024-12-08 16:53:10,64,3368,25,39,1873.78,3427.14,0.00
2024-12-08 16:53:10,64,3369,25,39,1878.20,3428.00,0.00
2024-12-08 16:53:10,65,3369,26,39,1849.31,3428.02,0.00
2024-12-08 16:53:10,64,3369,26,38,1872.33,3428.05,0.00
2024-12-08 16:53:10,63,3369,25,38,1878.79,3428.70,0.00
2024-12-08 16:53:10,63,3370,25,38,1923.10,3429.00,0.00
2024-12-08 16:53:10,64,3370,26,38,1893.05,3429.02,0.00
2024-12-08 16:53:10,64,3371,26,38,1881.40,3430.00,0.00
2024-12-08 16:53:10,65,3371,27,38,1852.46,3430.02,0.00
2024-12-08 16:53:10,64,3371,27,37,1876.59,3430.05,0.00
2024-12-08 16:53:10,63,3371,26,37,1879.19,3430.46,0.00
2024-12-08 16:53:10,63,3372,26,37,1915.50,3431.00,0.00
2024-12-08 16:53:10,64,3372,27,37,1885.57,3431.02,0.00
2024-12-08 16:53:10,63,3372,26,37,1899.22,3431.18,0.00
2024-12-08 16:53:10,63,3373,26,37,1925.87,3432.00,0.00
2024-12-08 16:53:10,64,3373,26,38,1895.78,3432.02,0.00
2024-12-08 16:53:10,63,3373,26,37,1920.43,3432.05,0.00
2024-12-08 16:53:10,63,3374,26,37,1920.98,3433.00,0.00
2024-12-08 16:53:10,64,3374,27,37,1890.97,3433.02,0.00
2024-12-08 16:53:10,63,3374,26,37,1904.68,3433.18,0.00
2024-12-08 16:53:10,63,3375,26,37,1910.16,3434.00,0.00
2024-12-08 16:53:10,64,3375,27,37,1880.31,3434.02,0.00
2024-12-08 16:53:10,63,3375,27,36,1904.72,3434.05,0.00
2024-12-08 16:53:10,62,3375,26,36,1893.80,3434.97,0.00
2024-12-08 16:53:10,62,3376,26,36,1948.12,3435.00,0.00
2024-12-08 16:53:10,63,3376,27,36,1917.19,3435.02,0.00
2024-12-08 16:53:10,62,3376,26,36,1931.54,3435.16,0.00
2024-12-08 16:53:10,62,3377,26,36,1958.66,3436.00,0.00
2024-12-08 16:53:10,63,3377,26,37,1927.57,3436.02,0.00
2024-12-08 16:53:10,62,3377,26,36,1953.68,3436.05,0.00
2024-12-08 16:53:10,62,3378,26,36,1954.79,3437.00,0.00
2024-12-08 16:53:10,63,3378,27,36,1923.76,3437.02,0.00
2024-12-08 16:53:10,63,3379,27,36,1912.32,3438.00,0.00
2024-12-08 16:53:10,64,3379,28,36,1882.44,3438.02,0.00
2024-12-08 16:53:10,63,3379,28,35,1906.87,3438.05,0.00
2024-12-08 16:53:10,63,3380,28,35,1907.42,3439.00,0.00
2024-12-08 16:53:10,64,3380,28,36,1877.61,3439.02,0.00
2024-12-08 16:53:11,64,3381,28,36,1865.80,3440.00,0.00
2024-12-08 16:53:11,65,3381,29,36,1837.09,3440.02,0.00
2024-12-08 16:53:11,64,3381,29,35,1860.97,3440.05,0.00
2024-12-08 16:53:11,63,3381,28,35,1870.74,3440.62,0.00
2024-12-08 16:53:11,63,3382,28,35,1890.68,3441.00,0.00
2024-12-08 16:53:11,64,3382,28,36,1861.14,3441.02,0.00
2024-12-08 16:53:11,63,3382,27,36,1874.88,3441.16,0.00
2024-12-08 16:53:11,63,3383,27,36,1879.43,3442.00,0.00
2024-12-08 16:53:11,64,3383,27,37,1850.06,3442.02,0.00
2024-12-08 16:53:11,63,3383,27,36,1873.98,3442.06,0.00
2024-12-08 16:53:11,63,3384,27,36,1875.06,3443.00,0.00
2024-12-08 16:53:11,64,3384,28,36,1845.76,3443.02,0.00
2024-12-08 16:53:11,63,3384,27,36,1823.95,3443.94,0.00
2024-12-08 16:53:11,63,3385,27,36,1876.48,3444.00,0.00
2024-12-08 16:53:11,64,3385,28,36,1847.16,3444.02,0.00
2024-12-08 16:53:11,63,3385,28,35,1871.57,3444.06,0.00
2024-12-08 16:53:11,63,3386,28,35,1872.65,3445.00,0.00
2024-12-08 16:53:11,64,3386,29,35,1843.39,3445.02,0.00
2024-12-08 16:53:11,63,3386,28,35,1871.56,3445.03,0.00
2024-12-08 16:53:11,63,3387,28,35,1860.61,3446.00,0.00
2024-12-08 16:53:11,64,3387,29,35,1831.54,3446.02,0.00
2024-12-08 16:53:11,63,3387,29,34,1856.25,3446.05,0.00
2024-12-08 16:53:11,63,3388,29,34,1856.77,3447.00,0.00
2024-12-08 16:53:11,64,3388,30,34,1827.76,3447.02,0.00
2024-12-08 16:53:11,63,3388,29,34,1839.28,3447.05,0.00
2024-12-08 16:53:11,63,3389,29,34,1850.74,3448.00,0.00
2024-12-08 16:53:11,64,3389,30,34,1821.83,3448.02,0.00
2024-12-08 16:53:11,63,3389,30,33,1844.19,3448.05,0.00
2024-12-08 16:53:11,63,3390,30,33,1844.71,3449.00,0.00
2024-12-08 16:53:11,64,3390,30,34,1815.89,3449.02,0.00
2024-12-08 16:53:11,63,3390,29,34,1826.66,3449.05,0.00
2024-12-08 16:53:11,63,3391,29,34,1838.13,3450.00,0.00
2024-12-08 16:53:11,64,3391,29,35,1809.41,3450.02,0.00
2024-12-08 16:53:11,63,3391,29,34,1830.47,3450.05,0.00
2024-12-08 16:53:11,62,3391,28,34,1840.64,3450.37,0.00
2024-12-08 16:53:11,61,3391,27,34,1858.58,3450.72,0.00
2024-12-08 16:53:11,61,3392,27,34,1905.73,3451.00,0.00
2024-12-08 16:53:11,62,3392,27,35,1874.99,3451.02,0.00
2024-12-08 16:53:11,61,3392,26,35,1891.06,3451.12,0.00
2024-12-08 16:53:11,60,3392,25,35,1901.98,3451.40,0.00
2024-12-08 16:53:11,60,3393,25,35,1939.21,3452.00,0.00
2024-12-08 16:53:11,61,3393,26,35,1907.42,3452.02,0.00
2024-12-08 16:53:11,60,3393,26,34,1931.74,3452.05,0.00
2024-12-08 16:53:11,60,3394,26,34,1934.01,3453.00,0.00
2024-12-08 16:53:11,61,3394,27,34,1902.31,3453.02,0.00
2024-12-08 16:53:11,60,3394,26,34,1918.51,3453.13,0.00
2024-12-08 16:53:11,59,3394,25,34,1912.66,3453.64,0.00
2024-12-08 16:53:11,59,3395,25,34,1959.17,3454.00,0.00
2024-12-08 16:53:11,60,3395,25,35,1926.51,3454.02,0.00
2024-12-08 16:53:11,59,3395,25,34,1950.39,3454.05,0.00
2024-12-08 16:53:11,59,3396,25,34,1953.29,3455.00,0.00
2024-12-08 16:53:11,60,3396,26,34,1920.74,3455.02,0.00
2024-12-08 16:53:11,59,3396,25,34,1932.86,3455.20,0.00
2024-12-08 16:53:11,59,3397,25,34,1964.40,3456.00,0.00
2024-12-08 16:53:11,60,3397,25,35,1931.66,3456.02,0.00
2024-12-08 16:53:11,60,3398,25,35,1923.24,3457.00,0.00
2024-12-08 16:53:11,61,3398,26,35,1891.71,3457.02,0.00
2024-12-08 16:53:11,60,3398,26,34,1913.46,3457.05,0.00
2024-12-08 16:53:11,60,3399,26,34,1915.73,3458.00,0.00
2024-12-08 16:53:11,61,3399,27,34,1884.32,3458.02,0.00
2024-12-08 16:53:11,61,3400,27,34,1874.48,3459.00,0.00
2024-12-08 16:53:11,62,3400,27,35,1844.25,3459.02,0.00
2024-12-08 16:53:11,61,3400,27,34,1867.12,3459.05,0.00
2024-12-08 16:53:11,61,3401,27,34,1868.78,3460.00,0.00
2024-12-08 16:53:11,62,3401,28,34,1838.64,3460.02,0.00
2024-12-08 16:53:11,62,3402,28,34,1829.21,3461.00,0.00
2024-12-08 16:53:11,63,3402,29,34,1800.18,3461.02,0.00
2024-12-08 16:53:11,62,3402,29,33,1821.96,3461.05,0.00
2024-12-08 16:53:11,61,3402,28,33,1847.90,3461.16,0.00
2024-12-08 16:53:11,61,3403,28,33,1853.49,3462.00,0.00
2024-12-08 16:53:11,62,3403,28,34,1823.60,3462.02,0.00
2024-12-08 16:53:11,62,3404,28,34,1813.51,3463.00,0.00
2024-12-08 16:53:11,63,3404,29,34,1784.72,3463.02,0.00
2024-12-08 16:53:11,62,3404,29,33,1807.37,3463.05,0.00
2024-12-08 16:53:11,61,3404,28,33,1801.45,3463.54,0.00
2024-12-08 16:53:11,61,3405,28,33,1842.64,3464.00,0.00
2024-12-08 16:53:11,62,3405,28,34,1812.92,3464.02,0.00
2024-12-08 16:53:11,61,3405,27,34,1811.70,3464.34,0.00
2024-12-08 16:53:11,61,3406,27,34,1846.19,3465.00,0.00
2024-12-08 16:53:11,62,3406,28,34,1816.41,3465.02,0.00
2024-12-08 16:53:11,61,3406,28,33,1839.95,3465.05,0.00
2024-12-08 16:53:11,61,3407,28,33,1841.61,3466.00,0.00
2024-12-08 16:53:11,62,3407,28,34,1811.91,3466.02,0.00
2024-12-08 16:53:11,61,3407,27,34,1811.50,3466.07,0.00
2024-12-08 16:53:11,61,3408,27,34,1836.46,3467.00,0.00
2024-12-08 16:53:11,62,3408,27,35,1806.84,3467.02,0.00
2024-12-08 16:53:11,61,3408,26,35,1835.33,3467.03,0.00
2024-12-08 16:53:11,60,3408,26,34,1861.29,3467.03,0.00
2024-12-08 16:53:12,60,3409,26,34,1862.98,3468.00,0.00
2024-12-08 16:53:12,61,3409,26,35,1832.44,3468.02,0.00
2024-12-08 16:53:12,60,3409,25,35,1828.44,3468.38,0.00
2024-12-08 16:53:12,60,3410,25,35,1865.25,3469.00,0.00
2024-12-08 16:53:12,61,3410,25,36,1834.67,3469.02,0.00
2024-12-08 16:53:12,60,3410,25,35,1860.05,3469.03,0.00
2024-12-08 16:53:12,61,3409,26,35,1823.37,3469.25,0.00
2024-12-08 16:53:12,60,3409,25,35,1850.50,3469.63,0.00
2024-12-08 16:53:12,60,3410,25,35,1895.86,3470.00,0.00
2024-12-08 16:53:12,61,3410,26,35,1864.78,3470.02,0.00
2024-12-08 16:53:12,60,3410,25,35,1858.03,3470.72,0.00
2024-12-08 16:53:12,60,3411,25,35,1964.09,3471.00,0.00
2024-12-08 16:53:12,61,3411,25,36,1931.90,3471.02,0.00
2024-12-08 16:53:12,60,3411,25,35,1959.47,3471.03,0.00
2024-12-08 16:53:12,59,3411,24,35,1972.85,3471.61,0.00
2024-12-08 16:53:12,59,3412,24,35,1994.93,3472.00,0.00
2024-12-08 16:53:12,60,3412,25,35,1961.68,3472.02,0.00
2024-12-08 16:53:12,60,3413,25,35,1951.25,3473.00,0.00
2024-12-08 16:53:12,61,3413,25,36,1919.26,3473.02,0.00
2024-12-08 16:53:12,60,3413,25,35,1946.62,3473.03,0.00
2024-12-08 16:53:12,60,3414,25,35,1948.33,3474.00,0.00
2024-12-08 16:53:12,61,3414,25,36,1916.39,3474.02,0.00
2024-12-08 16:53:12,60,3414,24,36,1901.65,3474.53,0.00
2024-12-08 16:53:12,60,3415,24,36,1943.68,3475.00,0.00
2024-12-08 16:53:12,61,3415,25,36,1911.82,3475.02,0.00
2024-12-08 16:53:12,60,3415,25,35,1939.05,3475.03,0.00
2024-12-08 16:53:12,60,3416,25,35,1940.76,3476.00,0.00
2024-12-08 16:53:12,61,3416,25,36,1908.95,3476.02,0.00
2024-12-08 16:53:12,60,3416,24,36,1922.87,3476.20,0.00
2024-12-08 16:53:12,60,3417,24,36,1931.14,3477.00,0.00
2024-12-08 16:53:12,61,3417,25,36,1899.49,3477.02,0.00
2024-12-08 16:53:12,60,3417,25,35,1927.09,3477.03,0.00
2024-12-08 16:53:12,59,3417,24,35,1914.08,3477.66,0.00
2024-12-08 16:53:12,59,3418,24,35,1961.49,3478.00,0.00
2024-12-08 16:53:12,60,3418,25,35,1928.80,3478.02,0.00
2024-12-08 16:53:12,59,3418,24,35,1923.80,3478.70,0.00
2024-12-08 16:53:12,59,3419,24,35,1972.41,3479.00,0.00
2024-12-08 16:53:12,60,3419,25,35,1939.54,3479.02,0.00
2024-12-08 16:53:12,59,3419,25,34,1968.29,3479.05,0.00
2024-12-08 16:53:12,58,3419,24,34,1982.44,3479.62,0.00
2024-12-08 16:53:12,57,3419,23,34,2016.63,3479.65,0.00
2024-12-08 16:53:12,57,3420,23,34,2041.34,3480.00,0.00
2024-12-08 16:53:12,58,3420,24,34,2006.15,3480.02,0.00
2024-12-08 16:53:12,57,3420,23,34,2016.59,3480.11,0.00
2024-12-08 16:53:12,57,3421,23,34,2047.07,3481.00,0.00
2024-12-08 16:53:12,58,3421,23,35,2011.78,3481.02,0.00
2024-12-08 16:53:12,57,3421,23,34,2042.19,3481.05,0.00
2024-12-08 16:53:12,57,3422,23,34,2046.44,3482.00,0.00
2024-12-08 16:53:12,58,3422,23,35,2011.15,3482.02,0.00
2024-12-08 16:53:12,57,3422,22,35,2003.84,3482.47,0.00
2024-12-08 16:53:12,57,3423,22,35,2047.03,3483.00,0.00
2024-12-08 16:53:12,58,3423,22,36,2011.73,3483.02,0.00
2024-12-08 16:53:12,57,3423,22,35,2042.14,3483.05,0.00
2024-12-08 16:53:12,57,3424,22,35,2046.39,3484.00,0.00
2024-12-08 16:53:12,58,3424,23,35,2011.11,3484.02,0.00
2024-12-08 16:53:12,57,3424,22,35,1998.91,3484.53,0.00
2024-12-08 16:53:12,57,3425,22,35,2043.92,3485.00,0.00
2024-12-08 16:53:12,58,3425,23,35,2008.68,3485.02,0.00
2024-12-08 16:53:12,57,3425,23,34,2039.04,3485.05,0.00
2024-12-08 16:53:12,57,3426,23,34,2043.28,3486.00,0.00
2024-12-08 16:53:12,58,3426,24,34,2008.06,3486.02,0.00
2024-12-08 16:53:12,58,3427,24,34,1998.41,3487.00,0.00
2024-12-08 16:53:12,59,3427,24,35,1964.54,3487.02,0.00
2024-12-08 16:53:12,58,3427,24,34,1994.21,3487.05,0.00
2024-12-08 16:53:12,58,3428,24,34,1997.78,3488.00,0.00
2024-12-08 16:53:12,59,3428,25,34,1963.92,3488.02,0.00
2024-12-08 16:53:12,59,3429,25,34,1971.34,3489.00,0.00
2024-12-08 16:53:12,60,3429,25,35,1938.48,3489.02,0.00
2024-12-08 16:53:12,59,3429,24,35,1951.89,3489.22,0.00
2024-12-08 16:53:12,59,3430,24,35,1974.42,3490.00,0.00
2024-12-08 16:53:12,60,3430,25,35,1941.51,3490.02,0.00
2024-12-08 16:53:12,60,3431,25,35,1935.99,3491.00,0.00
2024-12-08 16:53:12,61,3431,26,35,1904.25,3491.02,0.00
2024-12-08 16:53:12,60,3431,26,34,1923.78,3491.05,0.00
2024-12-08 16:53:12,60,3432,26,34,1926.07,3492.00,0.00
2024-12-08 16:53:12,61,3432,26,35,1894.49,3492.02,0.00
2024-12-08 16:53:12,62,3431,27,35,1826.03,3492.82,0.00
2024-12-08 16:53:12,62,3432,27,35,1888.44,3493.00,0.00
2024-12-08 16:53:12,63,3432,27,36,1858.46,3493.02,0.00
2024-12-08 16:53:12,62,3432,27,35,1883.94,3493.06,0.00
2024-12-08 16:53:12,62,3433,27,35,1941.95,3494.00,0.00
2024-12-08 16:53:12,63,3433,28,35,1911.13,3494.02,0.00
2024-12-08 16:53:12,62,3433,27,35,1894.98,3494.86,0.00
2024-12-08 16:53:12,62,3434,27,35,1946.38,3495.00,0.00
2024-12-08 16:53:12,63,3434,28,35,1915.48,3495.02,0.00
2024-12-08 16:53:12,62,3434,28,34,1941.87,3495.06,0.00
2024-12-08 16:53:12,61,3434,27,34,1969.73,3495.18,0.00
2024-12-08 16:53:13,61,3435,27,34,1975.99,3496.00,0.00
2024-12-08 16:53:13,62,3435,28,34,1944.12,3496.02,0.00
2024-12-08 16:53:13,63,3434,28,35,1898.84,3496.14,0.00
2024-12-08 16:53:13,62,3434,27,35,1967.84,3496.19,0.00
2024-12-08 16:53:13,62,3435,27,35,1974.00,3497.00,0.00
2024-12-08 16:53:13,63,3435,27,36,1942.67,3497.02,0.00
2024-12-08 16:53:13,62,3435,27,35,1970.06,3497.06,0.00
2024-12-08 16:53:13,62,3436,27,35,2028.16,3498.00,0.00
2024-12-08 16:53:13,63,3436,27,36,1995.97,3498.02,0.00
2024-12-08 16:53:13,62,3436,26,36,2011.28,3498.18,0.00
2024-12-08 16:53:13,62,3437,26,36,2016.89,3499.00,0.00
2024-12-08 16:53:13,63,3437,27,36,1984.88,3499.02,0.00
2024-12-08 16:53:13,62,3437,26,36,2006.74,3499.05,0.00
2024-12-08 16:53:13,61,3437,26,35,2037.34,3499.05,0.00
2024-12-08 16:53:13,61,3438,26,35,2062.02,3500.00,0.00
2024-12-08 16:53:13,62,3438,27,35,2028.76,3500.02,0.00
2024-12-08 16:53:13,61,3438,26,35,2044.85,3500.16,0.00
2024-12-08 16:53:13,60,3438,25,35,2057.25,3500.78,0.00
2024-12-08 16:53:13,60,3439,25,35,2084.84,3501.00,0.00
2024-12-08 16:53:13,61,3439,26,35,2050.67,3501.02,0.00
2024-12-08 16:53:13,60,3439,26,34,2081.93,3501.05,0.00
2024-12-08 16:53:13,60,3440,26,34,2084.27,3502.00,0.00
2024-12-08 16:53:13,61,3440,27,34,2050.10,3502.02,0.00
2024-12-08 16:53:13,60,3440,26,34,2083.69,3502.02,0.00
2024-12-08 16:53:13,59,3440,25,34,2118.41,3502.02,0.00
2024-12-08 16:53:13,59,3441,25,34,2127.03,3503.00,0.00
2024-12-08 16:53:13,60,3441,25,35,2091.58,3503.02,0.00
2024-12-08 16:53:13,60,3442,25,35,2096.99,3504.00,0.00
2024-12-08 16:53:13,61,3442,25,36,2062.61,3504.02,0.00
2024-12-08 16:53:13,60,3442,24,36,2080.09,3504.15,0.00
2024-12-08 16:53:13,60,3443,24,36,2094.90,3505.00,0.00
2024-12-08 16:53:13,61,3443,24,37,2060.56,3505.02,0.00
2024-12-08 16:53:13,60,3443,23,37,2046.86,3505.92,0.00
2024-12-08 16:53:13,60,3444,23,37,2102.43,3506.00,0.00
2024-12-08 16:53:13,61,3444,24,37,2067.96,3506.02,0.00
2024-12-08 16:53:13,60,3444,24,36,2096.00,3506.02,0.00
2024-12-08 16:53:13,60,3445,24,36,2097.19,3507.00,0.00
2024-12-08 16:53:13,61,3445,24,37,2062.80,3507.02,0.00
2024-12-08 16:53:13,60,3445,24,36,2085.50,3507.02,0.00
2024-12-08 16:53:13,60,3446,24,36,2086.67,3508.00,0.00
2024-12-08 16:53:13,61,3446,24,37,2052.47,3508.02,0.00
2024-12-08 16:53:13,60,3446,24,36,2074.98,3508.02,0.00
2024-12-08 16:53:13,60,3447,24,36,2076.16,3509.00,0.00
2024-12-08 16:53:13,61,3447,24,37,2042.12,3509.02,0.00
2024-12-08 16:53:13,61,3448,24,37,2031.20,3510.00,0.00
2024-12-08 16:53:13,62,3448,24,38,1998.43,3510.02,0.00
2024-12-08 16:53:13,61,3448,24,37,2029.47,3510.02,0.00
2024-12-08 16:53:13,60,3448,23,37,2016.82,3510.67,0.00
2024-12-08 16:53:13,60,3449,23,37,2063.88,3511.00,0.00
2024-12-08 16:53:13,61,3449,23,38,2030.05,3511.02,0.00
2024-12-08 16:53:13,60,3449,22,38,2012.09,3511.60,0.00
2024-12-08 16:53:13,60,3450,22,38,2056.86,3512.00,0.00
2024-12-08 16:53:13,61,3450,23,38,2023.14,3512.02,0.00
2024-12-08 16:53:13,60,3450,23,37,2053.93,3512.02,0.00
2024-12-08 16:53:13,60,3451,23,37,2055.10,3513.00,0.00
2024-12-08 16:53:13,61,3451,24,37,2021.41,3513.02,0.00
2024-12-08 16:53:13,61,3452,24,37,2010.47,3514.00,0.00
2024-12-08 16:53:13,62,3452,24,38,1978.04,3514.02,0.00
2024-12-08 16:53:13,61,3452,24,37,2007.01,3514.02,0.00
2024-12-08 16:53:13,60,3452,23,37,2016.79,3514.68,0.00
2024-12-08 16:53:13,60,3453,23,37,2041.04,3515.00,0.00
2024-12-08 16:53:13,61,3453,24,37,2007.58,3515.02,0.00
2024-12-08 16:53:13,60,3453,23,37,2003.12,3515.42,0.00
2024-12-08 16:53:13,60,3454,23,37,2041.62,3516.00,0.00
2024-12-08 16:53:13,61,3454,23,38,2008.15,3516.02,0.00
2024-12-08 16:53:13,60,3454,23,37,2038.11,3516.02,0.00
2024-12-08 16:53:13,60,3455,23,37,2039.27,3517.00,0.00
2024-12-08 16:53:13,61,3455,24,37,2005.84,3517.02,0.00
2024-12-08 16:53:13,60,3455,23,37,2005.01,3517.67,0.00
2024-12-08 16:53:13,60,3456,23,37,2028.71,3518.00,0.00
2024-12-08 16:53:13,61,3456,24,37,1995.46,3518.02,0.00
2024-12-08 16:53:13,60,3456,24,36,2025.78,3518.02,0.00
2024-12-08 16:53:13,60,3457,24,36,2026.94,3519.00,0.00
2024-12-08 16:53:13,61,3457,24,37,1993.71,3519.02,0.00
2024-12-08 16:53:13,61,3458,24,37,1983.10,3520.00,0.00
2024-12-08 16:53:13,62,3458,24,38,1951.12,3520.02,0.00
2024-12-08 16:53:13,61,3458,24,37,1976.76,3520.03,0.00
2024-12-08 16:53:13,60,3458,23,37,1967.96,3520.62,0.00
2024-12-08 16:53:13,60,3459,23,37,2013.42,3521.00,0.00
2024-12-08 16:53:13,61,3459,24,37,1980.42,3521.02,0.00
2024-12-08 16:53:13,62,3458,24,38,1932.61,3521.18,0.00
2024-12-08 16:53:13,61,3458,23,38,1993.76,3521.20,0.00
2024-12-08 16:53:13,60,3458,22,38,2010.81,3521.67,0.00
2024-12-08 16:53:13,60,3459,22,38,2058.02,3522.00,0.00
2024-12-08 16:53:13,61,3459,23,38,2024.28,3522.02,0.00
2024-12-08 16:53:13,60,3459,23,37,2052.16,3522.03,0.00
2024-12-08 16:53:13,60,3460,23,37,2112.62,3523.00,0.00
2024-12-08 16:53:13,61,3460,23,38,2077.99,3523.02,0.00
2024-12-08 16:53:13,61,3461,23,38,2067.03,3524.00,0.00
2024-12-08 16:53:13,62,3461,24,38,2033.69,3524.02,0.00
2024-12-08 16:53:13,61,3461,24,37,2061.83,3524.03,0.00
2024-12-08 16:53:14,61,3462,24,37,2062.99,3525.00,0.00
2024-12-08 16:53:14,62,3462,25,37,2029.72,3525.02,0.00
2024-12-08 16:53:14,61,3462,24,37,2040.54,3525.23,0.00
2024-12-08 16:53:14,61,3463,24,37,2071.67,3526.00,0.00
2024-12-08 16:53:14,62,3463,25,37,2038.25,3526.02,0.00
2024-12-08 16:53:14,61,3463,25,36,2065.89,3526.03,0.00
2024-12-08 16:53:14,61,3464,25,36,2067.05,3527.00,0.00
2024-12-08 16:53:14,62,3464,25,37,2033.71,3527.02,0.00
2024-12-08 16:53:14,61,3464,24,37,2044.59,3527.23,0.00
2024-12-08 16:53:14,61,3465,24,37,2075.74,3528.00,0.00
2024-12-08 16:53:14,62,3465,25,37,2042.26,3528.02,0.00
2024-12-08 16:53:14,61,3465,25,36,2069.96,3528.03,0.00
2024-12-08 16:53:14,61,3466,25,36,2071.12,3529.00,0.00
2024-12-08 16:53:14,62,3466,26,36,2037.71,3529.02,0.00
2024-12-08 16:53:14,63,3465,27,36,1979.23,3529.48,0.00
2024-12-08 16:53:14,63,3466,27,36,2014.90,3530.00,0.00
2024-12-08 16:53:14,64,3466,28,36,1983.42,3530.02,0.00
2024-12-08 16:53:14,63,3466,28,35,2008.74,3530.03,0.00
2024-12-08 16:53:14,63,3467,28,35,2064.79,3531.00,0.00
2024-12-08 16:53:14,64,3467,29,35,2032.53,3531.02,0.00
2024-12-08 16:53:14,63,3467,28,35,2025.94,3531.73,0.00
2024-12-08 16:53:14,63,3468,28,35,2072.67,3532.00,0.00
2024-12-08 16:53:14,64,3468,28,36,2040.28,3532.02,0.00
2024-12-08 16:53:14,63,3468,28,35,2065.39,3532.05,0.00
2024-12-08 16:53:14,62,3468,27,35,2076.26,3532.68,0.00
2024-12-08 16:53:14,62,3469,27,35,2099.28,3533.00,0.00
2024-12-08 16:53:14,63,3469,28,35,2065.96,3533.02,0.00
2024-12-08 16:53:14,63,3470,28,35,2054.21,3534.00,0.00
2024-12-08 16:53:14,64,3470,28,36,2022.11,3534.02,0.00
2024-12-08 16:53:14,63,3470,28,35,2046.37,3534.06,0.00
2024-12-08 16:53:14,63,3471,28,35,2047.49,3535.00,0.00
2024-12-08 16:53:14,64,3471,29,35,2015.50,3535.02,0.00
2024-12-08 16:53:14,64,3472,29,35,2003.46,3536.00,0.00
2024-12-08 16:53:14,65,3472,29,36,1972.64,3536.02,0.00
2024-12-08 16:53:14,64,3472,29,35,1995.74,3536.06,0.00
2024-12-08 16:53:14,64,3473,29,35,1996.29,3537.00,0.00
2024-12-08 16:53:14,65,3473,29,36,1965.58,3537.02,0.00
2024-12-08 16:53:14,65,3474,29,36,1953.19,3538.00,0.00
2024-12-08 16:53:14,66,3474,29,37,1923.60,3538.02,0.00
2024-12-08 16:53:14,65,3474,29,36,1946.14,3538.06,0.00
2024-12-08 16:53:14,64,3474,28,36,1934.92,3538.97,0.00
2024-12-08 16:53:14,64,3475,28,36,1989.12,3539.00,0.00
2024-12-08 16:53:14,65,3475,29,36,1958.52,3539.02,0.00
2024-12-08 16:53:14,64,3475,28,36,1972.04,3539.19,0.00
2024-12-08 16:53:14,64,3476,28,36,1977.12,3540.00,0.00
2024-12-08 16:53:14,65,3476,28,37,1946.70,3540.02,0.00
2024-12-08 16:53:14,64,3476,28,36,1970.50,3540.06,0.00
2024-12-08 16:53:14,65,3475,28,37,1921.39,3540.63,0.00
2024-12-08 16:53:14,65,3476,28,37,1953.79,3541.00,0.00
2024-12-08 16:53:14,66,3476,28,38,1924.19,3541.02,0.00
2024-12-08 16:53:14,67,3475,28,39,1878.61,3541.22,0.00
2024-12-08 16:53:14,67,3476,28,39,1967.95,3542.00,0.00
2024-12-08 16:53:14,68,3476,29,39,1939.01,3542.02,0.00
2024-12-08 16:53:14,67,3476,29,38,1962.15,3542.06,0.00
2024-12-08 16:53:14,66,3476,28,38,1971.27,3542.65,0.00
2024-12-08 16:53:14,65,3476,27,38,1981.57,3542.94,0.00
2024-12-08 16:53:14,65,3477,27,38,2088.44,3543.00,0.00
2024-12-08 16:53:14,66,3477,28,38,2056.79,3543.02,0.00
2024-12-08 16:53:14,66,3478,28,38,2043.95,3544.00,0.00
2024-12-08 16:53:14,67,3478,29,38,2013.44,3544.02,0.00
2024-12-08 16:53:14,66,3478,29,37,2037.52,3544.08,0.00
2024-12-08 16:53:14,65,3478,28,37,2042.43,3544.75,0.00
2024-12-08 16:53:14,65,3479,28,37,2088.43,3545.00,0.00
2024-12-08 16:53:14,66,3479,28,38,2056.79,3545.02,0.00
2024-12-08 16:53:14,66,3480,28,38,2043.94,3546.00,0.00
2024-12-08 16:53:14,67,3480,28,39,2013.43,3546.02,0.00
2024-12-08 16:53:14,66,3480,28,38,2037.51,3546.08,0.00
2024-12-08 16:53:14,65,3480,27,38,2041.95,3546.77,0.00
2024-12-08 16:53:14,65,3481,27,38,2088.52,3547.00,0.00
2024-12-08 16:53:14,66,3481,28,38,2056.87,3547.02,0.00
2024-12-08 16:53:14,65,3481,27,38,2071.12,3547.20,0.00
2024-12-08 16:53:14,66,3480,28,38,2037.62,3547.29,0.00
2024-12-08 16:53:14,65,3480,27,38,2063.61,3547.71,0.00
2024-12-08 16:53:14,65,3481,27,38,2108.06,3548.00,0.00
2024-12-08 16:53:14,66,3481,27,39,2076.12,3548.02,0.00
2024-12-08 16:53:14,65,3481,26,39,2107.51,3548.02,0.00
2024-12-08 16:53:14,64,3481,26,38,2134.91,3548.06,0.00
2024-12-08 16:53:14,65,3480,27,38,2083.78,3548.62,0.00
2024-12-08 16:53:14,65,3481,27,38,2171.99,3549.00,0.00
2024-12-08 16:53:14,66,3481,27,39,2139.08,3549.02,0.00
2024-12-08 16:53:14,65,3481,26,39,2141.43,3549.09,0.00
2024-12-08 16:53:14,65,3482,26,39,2219.02,3550.00,0.00
2024-12-08 16:53:14,66,3482,27,39,2185.40,3550.02,0.00
2024-12-08 16:53:14,65,3482,27,38,2213.58,3550.06,0.00
2024-12-08 16:53:14,65,3483,27,38,2213.64,3551.00,0.00
2024-12-08 16:53:14,66,3483,27,39,2180.10,3551.02,0.00
2024-12-08 16:53:15,66,3484,27,39,2183.64,3552.00,0.00
2024-12-08 16:53:15,67,3484,27,40,2151.04,3552.02,0.00
2024-12-08 16:53:15,67,3485,27,40,2151.21,3553.00,0.00
2024-12-08 16:53:15,68,3485,28,40,2119.58,3553.02,0.00
2024-12-08 16:53:15,68,3486,28,40,2112.43,3554.00,0.00
2024-12-08 16:53:15,69,3486,28,41,2081.81,3554.01,0.00
2024-12-08 16:53:15,68,3486,27,41,2072.55,3554.57,0.00
2024-12-08 16:53:15,68,3487,27,41,2110.00,3555.00,0.00
2024-12-08 16:53:15,69,3487,27,42,2079.42,3555.01,0.00
2024-12-08 16:53:15,68,3487,27,41,2103.74,3555.09,0.00
2024-12-08 16:53:15,68,3488,27,41,2103.27,3556.00,0.00
2024-12-08 16:53:15,69,3488,28,41,2072.79,3556.01,0.00
2024-12-08 16:53:15,69,3489,28,41,2058.94,3557.00,0.00
2024-12-08 16:53:15,70,3489,29,41,2029.52,3557.01,0.00
2024-12-08 16:53:15,69,3489,29,40,2053.28,3557.09,0.00
2024-12-08 16:53:15,69,3490,29,40,2052.30,3558.00,0.00
2024-12-08 16:53:15,70,3490,30,40,2022.98,3558.01,0.00
2024-12-08 16:53:15,70,3491,30,40,2008.80,3559.00,0.00
2024-12-08 16:53:15,71,3491,30,41,1980.51,3559.01,0.00
2024-12-08 16:53:15,70,3491,30,40,2003.73,3559.09,0.00
2024-12-08 16:53:15,70,3492,30,40,2002.24,3560.00,0.00
2024-12-08 16:53:15,71,3492,31,40,1974.04,3560.01,0.00
2024-12-08 16:53:15,70,3492,30,40,1961.25,3560.51,0.00
2024-12-08 16:53:15,70,3493,30,40,1995.18,3561.00,0.00
2024-12-08 16:53:15,71,3493,30,41,1967.08,3561.01,0.00
2024-12-08 16:53:15,70,3493,29,41,1994.67,3561.01,0.00
2024-12-08 16:53:15,69,3493,29,40,2017.92,3561.07,0.00
2024-12-08 16:53:15,69,3494,29,40,2016.40,3562.00,0.00
2024-12-08 16:53:15,70,3494,29,41,1987.60,3562.01,0.00
2024-12-08 16:53:15,69,3494,28,41,2011.76,3562.03,0.00
2024-12-08 16:53:15,69,3495,28,41,2019.03,3563.00,0.00
2024-12-08 16:53:15,70,3495,28,42,1990.19,3563.01,0.00
2024-12-08 16:53:15,69,3495,27,42,2002.52,3563.04,0.00
2024-12-08 16:53:15,68,3495,27,41,2028.30,3563.04,0.00
2024-12-08 16:53:15,67,3495,26,41,2054.37,3563.16,0.00
2024-12-08 16:53:15,67,3496,26,41,2078.29,3564.00,0.00
2024-12-08 16:53:15,68,3496,26,42,2047.73,3564.02,0.00
2024-12-08 16:53:15,68,3497,26,42,2034.15,3565.00,0.00
2024-12-08 16:53:15,69,3497,26,43,2004.67,3565.01,0.00
2024-12-08 16:53:15,68,3497,26,42,2028.39,3565.06,0.00
2024-12-08 16:53:15,68,3498,26,42,2026.85,3566.00,0.00
2024-12-08 16:53:15,69,3498,26,43,1997.48,3566.01,0.00
2024-12-08 16:53:15,68,3498,25,43,1988.74,3566.44,0.00
2024-12-08 16:53:15,68,3499,25,43,2021.65,3567.00,0.00
2024-12-08 16:53:15,69,3499,26,43,1992.35,3567.01,0.00
2024-12-08 16:53:15,68,3499,26,42,2015.90,3567.07,0.00
2024-12-08 16:53:15,67,3499,25,42,2017.41,3567.48,0.00
2024-12-08 16:53:15,66,3499,24,42,2040.02,3567.70,0.00
2024-12-08 16:53:15,66,3500,24,42,2083.50,3568.00,0.00
2024-12-08 16:53:15,67,3500,25,42,2052.40,3568.02,0.00
2024-12-08 16:53:15,67,3501,25,42,2039.12,3569.00,0.00
2024-12-08 16:53:15,68,3501,26,42,2009.14,3569.02,0.00
2024-12-08 16:53:15,67,3501,25,42,2016.76,3569.06,0.00
2024-12-08 16:53:15,66,3501,25,41,2042.99,3569.06,0.00
2024-12-08 16:53:15,66,3502,25,41,2064.11,3570.00,0.00
2024-12-08 16:53:15,67,3502,26,41,2033.30,3570.02,0.00
2024-12-08 16:53:15,66,3502,25,41,2015.67,3570.58,0.00
2024-12-08 16:53:15,66,3503,25,41,2054.95,3571.00,0.00
2024-12-08 16:53:15,67,3503,25,42,2024.28,3571.02,0.00
2024-12-08 16:53:15,66,3503,25,41,2049.55,3571.06,0.00
2024-12-08 16:53:15,66,3504,25,41,2049.03,3572.00,0.00
2024-12-08 16:53:15,67,3504,26,41,2018.45,3572.02,0.00
2024-12-08 16:53:15,66,3504,25,41,2029.61,3572.23,0.00
2024-12-08 16:53:15,66,3505,25,41,2056.64,3573.00,0.00
2024-12-08 16:53:15,67,3505,26,41,2025.94,3573.02,0.00
2024-12-08 16:53:15,66,3505,26,40,2051.78,3573.06,0.00
2024-12-08 16:53:15,66,3506,26,40,2051.26,3574.00,0.00
2024-12-08 16:53:15,67,3506,26,41,2020.64,3574.02,0.00
2024-12-08 16:53:15,66,3506,25,41,2018.79,3574.12,0.00
2024-12-08 16:53:15,66,3507,25,41,2042.08,3575.00,0.00
2024-12-08 16:53:15,67,3507,25,42,2011.60,3575.02,0.00
2024-12-08 16:53:15,66,3507,25,41,2035.05,3575.08,0.00
2024-12-08 16:53:15,66,3508,25,41,2035.07,3576.00,0.00
2024-12-08 16:53:15,67,3508,26,41,2004.69,3576.02,0.00
2024-12-08 16:53:15,67,3509,26,41,1991.37,3577.00,0.00
2024-12-08 16:53:15,68,3509,26,42,1962.09,3577.02,0.00
2024-12-08 16:53:15,67,3509,25,42,1990.31,3577.03,0.00
2024-12-08 16:53:15,66,3509,25,41,2015.05,3577.06,0.00
2024-12-08 16:53:15,66,3510,25,41,2014.52,3578.00,0.00
2024-12-08 16:53:15,67,3510,26,41,1984.45,3578.02,0.00
2024-12-08 16:53:15,66,3510,25,41,1997.77,3578.18,0.00
2024-12-08 16:53:16,66,3511,25,41,2001.53,3579.00,0.00
2024-12-08 16:53:16,67,3511,26,41,1971.65,3579.02,0.00
2024-12-08 16:53:16,66,3511,26,40,1996.12,3579.06,0.00
2024-12-08 16:53:16,67,3510,27,40,1954.19,3579.43,0.00
2024-12-08 16:53:16,67,3511,27,40,1986.10,3580.00,0.00
2024-12-08 16:53:16,68,3511,27,41,1956.89,3580.02,0.00
2024-12-08 16:53:16,67,3511,26,41,1933.51,3580.64,0.00
2024-12-08 16:53:16,67,3512,26,41,2027.81,3581.00,0.00
2024-12-08 16:53:16,68,3512,26,42,1997.99,3581.02,0.00
2024-12-08 16:53:16,67,3512,26,41,2022.47,3581.06,0.00
2024-12-08 16:53:16,67,3513,26,41,2021.42,3582.00,0.00
2024-12-08 16:53:16,68,3513,27,41,1991.70,3582.02,0.00
2024-12-08 16:53:16,67,3513,26,41,2003.31,3582.21,0.00
2024-12-08 16:53:16,66,3513,25,41,2010.47,3582.47,0.00
2024-12-08 16:53:16,66,3514,25,41,2046.11,3583.00,0.00
2024-12-08 16:53:16,67,3514,25,42,2015.57,3583.02,0.00
2024-12-08 16:53:16,66,3514,25,41,2041.23,3583.06,0.00
2024-12-08 16:53:16,66,3515,25,41,2040.71,3584.00,0.00
2024-12-08 16:53:16,67,3515,25,42,2010.25,3584.02,0.00
2024-12-08 16:53:16,66,3515,24,42,2035.83,3584.03,0.00
2024-12-08 16:53:16,66,3516,24,42,2045.08,3585.00,0.00
2024-12-08 16:53:16,67,3516,24,43,2014.56,3585.02,0.00
2024-12-08 16:53:16,66,3516,24,42,2041.28,3585.05,0.00
2024-12-08 16:53:16,65,3516,23,42,2051.75,3585.11,0.00
2024-12-08 16:53:16,65,3517,23,42,2075.47,3586.00,0.00
2024-12-08 16:53:16,66,3517,23,43,2044.02,3586.02,0.00
2024-12-08 16:53:16,65,3517,22,43,2031.57,3586.51,0.00
2024-12-08 16:53:16,65,3518,22,43,2069.42,3587.00,0.00
2024-12-08 16:53:16,66,3518,23,43,2038.07,3587.02,0.00
2024-12-08 16:53:16,65,3518,23,42,2066.12,3587.05,0.00
2024-12-08 16:53:16,64,3518,22,42,2052.79,3587.69,0.00
2024-12-08 16:53:16,64,3519,22,42,2097.86,3588.00,0.00
2024-12-08 16:53:16,65,3519,22,43,2065.58,3588.02,0.00
2024-12-08 16:53:16,65,3520,22,43,2052.91,3589.00,0.00
2024-12-08 16:53:16,66,3520,23,43,2021.80,3589.02,0.00
2024-12-08 16:53:16,65,3520,23,42,2050.15,3589.05,0.00
2024-12-08 16:53:16,64,3520,22,42,2056.02,3589.44,0.00
2024-12-08 16:53:16,63,3520,21,42,2079.69,3589.68,0.00
2024-12-08 16:53:16,63,3521,21,42,2125.51,3590.00,0.00
2024-12-08 16:53:16,64,3521,22,42,2092.30,3590.02,0.00
2024-12-08 16:53:16,63,3521,21,42,2118.10,3590.03,0.00
2024-12-08 16:53:16,63,3522,21,42,2129.52,3591.00,0.00
2024-12-08 16:53:16,64,3522,22,42,2096.25,3591.02,0.00
2024-12-08 16:53:16,63,3522,22,41,2126.67,3591.03,0.00
2024-12-08 16:53:16,63,3523,22,41,2126.69,3592.00,0.00
2024-12-08 16:53:16,64,3523,22,42,2093.46,3592.02,0.00
2024-12-08 16:53:16,63,3523,21,42,2110.77,3592.14,0.00
2024-12-08 16:53:16,63,3524,21,42,2121.97,3593.00,0.00
2024-12-08 16:53:16,64,3524,22,42,2088.82,3593.02,0.00
2024-12-08 16:53:16,63,3524,21,42,2079.41,3593.48,0.00
2024-12-08 16:53:16,63,3525,21,42,2118.00,3594.00,0.00
2024-12-08 16:53:16,64,3525,21,43,2084.90,3594.02,0.00
2024-12-08 16:53:16,63,3525,21,42,2113.44,3594.03,0.00
2024-12-08 16:53:16,63,3526,21,42,2113.45,3595.00,0.00
2024-12-08 16:53:16,64,3526,21,43,2080.43,3595.02,0.00
2024-12-08 16:53:16,64,3527,21,43,2068.08,3596.00,0.00
2024-12-08 16:53:16,65,3527,21,44,2036.27,3596.02,0.00
2024-12-08 16:53:16,64,3527,21,43,2065.28,3596.03,0.00
2024-12-08 16:53:16,63,3527,20,43,2074.43,3596.68,0.00
2024-12-08 16:53:16,63,3528,20,43,2097.50,3597.00,0.00
2024-12-08 16:53:16,64,3528,20,44,2064.73,3597.02,0.00
2024-12-08 16:53:16,63,3528,19,44,2046.39,3597.59,0.00
2024-12-08 16:53:16,63,3529,19,44,2088.94,3598.00,0.00
2024-12-08 16:53:16,64,3529,20,44,2056.30,3598.02,0.00
2024-12-08 16:53:16,63,3529,20,43,2086.66,3598.03,0.00
2024-12-08 16:53:16,62,3529,19,43,2083.66,3598.87,0.00
2024-12-08 16:53:16,62,3530,19,43,2137.16,3599.00,0.00
2024-12-08 16:53:16,63,3530,19,44,2103.24,3599.02,0.00
2024-12-08 16:53:16,63,3531,19,44,2098.79,3600.00,0.00
2024-12-08 16:53:16,64,3531,19,45,2065.99,3600.02,0.00
2024-12-08 16:53:16,63,3531,18,45,2040.31,3600.91,0.00
2024-12-08 16:53:16,63,3532,18,45,2094.12,3601.00,0.00
2024-12-08 16:53:16,64,3532,19,45,2061.40,3601.02,0.00
2024-12-08 16:53:16,63,3532,19,44,2088.97,3601.03,0.00
2024-12-08 16:53:16,63,3533,19,44,2088.98,3602.00,0.00
2024-12-08 16:53:16,64,3533,20,44,2056.34,3602.02,0.00
2024-12-08 16:53:16,64,3534,20,44,2043.96,3603.00,0.00
2024-12-08 16:53:16,65,3534,21,44,2012.52,3603.02,0.00
2024-12-08 16:53:16,64,3534,21,43,2042.84,3603.03,0.00
2024-12-08 16:53:16,64,3535,21,43,2042.28,3604.00,0.00
2024-12-08 16:53:16,65,3535,22,43,2010.86,3604.02,0.00
2024-12-08 16:53:16,65,3536,22,43,1997.08,3605.00,0.00
2024-12-08 16:53:16,66,3536,23,43,1966.82,3605.02,0.00
2024-12-08 16:53:16,65,3536,23,42,1991.56,3605.03,0.00
2024-12-08 16:53:16,65,3537,23,42,1990.45,3606.00,0.00
2024-12-08 16:53:16,66,3537,23,43,1960.29,3606.02,0.00
2024-12-08 16:53:16,65,3537,22,43,1985.90,3606.02,0.00
2024-12-08 16:53:16,64,3537,21,43,1978.41,3606.75,0.00
2024-12-08 16:53:16,64,3538,21,43,2025.94,3607.00,0.00
2024-12-08 16:53:16,65,3538,22,43,1994.77,3607.02,0.00
2024-12-08 16:53:16,64,3538,22,42,2022.00,3607.03,0.00
2024-12-08 16:53:17,64,3539,22,42,2021.43,3608.00,0.00
2024-12-08 16:53:17,65,3539,22,43,1990.33,3608.02,0.00
2024-12-08 16:53:17,65,3540,22,43,1977.56,3609.00,0.00
2024-12-08 16:53:17,66,3540,22,44,1947.59,3609.02,0.00
2024-12-08 16:53:17,65,3540,22,43,1973.67,3609.03,0.00
2024-12-08 16:53:17,65,3541,22,43,1972.55,3610.00,0.00
2024-12-08 16:53:17,66,3541,22,44,1942.66,3610.02,0.00
2024-12-08 16:53:17,65,3541,21,44,1938.15,3610.14,0.00
2024-12-08 16:53:17,65,3542,21,44,1963.10,3611.00,0.00
2024-12-08 16:53:17,66,3542,22,44,1933.35,3611.02,0.00
2024-12-08 16:53:17,65,3542,22,43,1959.21,3611.03,0.00
2024-12-08 16:53:17,65,3543,22,43,1958.08,3612.00,0.00
2024-12-08 16:53:17,66,3543,22,44,1928.42,3612.02,0.00
2024-12-08 16:53:17,67,3542,22,45,1877.63,3612.36,0.00
2024-12-08 16:53:17,67,3543,22,45,1913.64,3613.00,0.00
2024-12-08 16:53:17,68,3543,23,45,1885.50,3613.02,0.00
2024-12-08 16:53:17,67,3543,23,44,1910.41,3613.03,0.00
2024-12-08 16:53:17,67,3544,23,44,1962.18,3614.00,0.00
2024-12-08 16:53:17,68,3544,24,44,1933.32,3614.02,0.00
2024-12-08 16:53:17,68,3545,24,44,1919.50,3615.00,0.00
2024-12-08 16:53:17,69,3545,24,45,1891.68,3615.01,0.00
2024-12-08 16:53:17,68,3545,24,44,1916.85,3615.03,0.00
2024-12-08 16:53:17,67,3545,23,44,1926.42,3615.55,0.00
2024-12-08 16:53:17,67,3546,23,44,1942.93,3616.00,0.00
2024-12-08 16:53:17,68,3546,24,44,1914.35,3616.02,0.00
2024-12-08 16:53:17,67,3546,23,44,1901.56,3616.51,0.00
2024-12-08 16:53:17,67,3547,23,44,1938.06,3617.00,0.00
2024-12-08 16:53:17,68,3547,23,45,1909.56,3617.02,0.00
2024-12-08 16:53:17,67,3547,23,44,1935.37,3617.03,0.00
2024-12-08 16:53:17,67,3548,23,44,1933.20,3618.00,0.00
2024-12-08 16:53:17,68,3548,23,45,1904.77,3618.02,0.00
2024-12-08 16:53:17,67,3548,22,45,1914.90,3618.22,0.00
2024-12-08 16:53:17,67,3549,22,45,1919.69,3619.00,0.00
2024-12-08 16:53:17,68,3549,23,45,1891.46,3619.02,0.00
2024-12-08 16:53:17,67,3549,23,44,1918.07,3619.03,0.00
2024-12-08 16:53:17,66,3549,22,44,1919.52,3619.74,0.00
2024-12-08 16:53:17,66,3550,22,44,1965.22,3620.00,0.00
2024-12-08 16:53:17,67,3550,22,45,1935.89,3620.02,0.00
2024-12-08 16:53:17,67,3551,22,45,1935.24,3621.00,0.00
2024-12-08 16:53:17,68,3551,22,46,1906.78,3621.02,0.00
2024-12-08 16:53:17,67,3551,21,46,1916.92,3621.22,0.00
2024-12-08 16:53:17,67,3552,21,46,1927.28,3622.00,0.00
2024-12-08 16:53:17,68,3552,22,46,1898.94,3622.02,0.00
2024-12-08 16:53:17,67,3552,22,45,1917.01,3622.03,0.00
2024-12-08 16:53:17,66,3552,21,45,1911.89,3622.83,0.00
2024-12-08 16:53:17,66,3553,21,45,1960.87,3623.00,0.00
2024-12-08 16:53:17,67,3553,22,45,1931.60,3623.02,0.00
2024-12-08 16:53:17,66,3553,22,44,1949.89,3623.03,0.00
2024-12-08 16:53:17,66,3554,22,44,1948.23,3624.00,0.00
2024-12-08 16:53:17,67,3554,23,44,1919.15,3624.02,0.00
2024-12-08 16:53:17,66,3554,22,44,1901.97,3624.85,0.00
2024-12-08 16:53:17,66,3555,22,44,1951.51,3625.00,0.00
2024-12-08 16:53:17,67,3555,23,44,1922.39,3625.02,0.00
2024-12-08 16:53:17,66,3555,23,43,1949.87,3625.05,0.00
2024-12-08 16:53:17,65,3555,22,43,1955.09,3625.72,0.00
2024-12-08 16:53:17,65,3556,22,43,1978.74,3626.00,0.00
2024-12-08 16:53:17,66,3556,22,44,1948.76,3626.02,0.00
2024-12-08 16:53:17,65,3556,22,43,1965.91,3626.05,0.00
2024-12-08 16:53:17,65,3557,22,43,1965.33,3627.00,0.00
2024-12-08 16:53:17,66,3557,23,43,1935.56,3627.02,0.00
2024-12-08 16:53:17,65,3557,22,43,1922.17,3627.85,0.00
2024-12-08 16:53:17,65,3558,22,43,1972.52,3628.00,0.00
2024-12-08 16:53:17,66,3558,22,44,1942.63,3628.02,0.00
2024-12-08 16:53:17,65,3558,22,43,1970.84,3628.05,0.00
2024-12-08 16:53:17,65,3559,22,43,1970.27,3629.00,0.00
2024-12-08 16:53:17,66,3559,22,44,1940.41,3629.02,0.00
2024-12-08 16:53:17,65,3559,21,44,1969.71,3629.02,0.00
2024-12-08 16:53:17,64,3559,21,43,1987.45,3629.05,0.00
2024-12-08 16:53:17,63,3559,20,43,1982.37,3629.59,0.00
2024-12-08 16:53:17,63,3560,20,43,2025.31,3630.00,0.00
2024-12-08 16:53:17,64,3560,21,43,1993.66,3630.02,0.00
2024-12-08 16:53:17,64,3561,21,43,1981.16,3631.00,0.00
2024-12-08 16:53:17,65,3561,21,44,1950.68,3631.02,0.00
2024-12-08 16:53:17,64,3561,21,43,1979.47,3631.05,0.00
2024-12-08 16:53:17,64,3562,21,43,1979.44,3632.00,0.00
2024-12-08 16:53:17,65,3562,21,44,1948.99,3632.02,0.00
2024-12-08 16:53:17,64,3562,21,43,1966.39,3632.05,0.00
2024-12-08 16:53:17,64,3563,21,43,1966.36,3633.00,0.00
2024-12-08 16:53:17,65,3563,22,43,1936.11,3633.02,0.00
2024-12-08 16:53:17,64,3563,21,43,1947.69,3633.22,0.00
2024-12-08 16:53:17,64,3564,21,43,1953.84,3634.00,0.00
2024-12-08 16:53:17,65,3564,22,43,1923.78,3634.02,0.00
2024-12-08 16:53:17,64,3564,22,42,1952.14,3634.05,0.00
2024-12-08 16:53:17,64,3565,22,42,1952.11,3635.00,0.00
2024-12-08 16:53:17,65,3565,23,42,1922.08,3635.02,0.00
2024-12-08 16:53:17,64,3565,23,41,1939.05,3635.05,0.00
2024-12-08 16:53:18,64,3566,23,41,1939.01,3636.00,0.00
2024-12-08 16:53:18,65,3566,23,42,1909.18,3636.02,0.00
2024-12-08 16:53:18,65,3567,23,42,1896.27,3637.00,0.00
2024-12-08 16:53:18,66,3567,23,43,1867.54,3637.02,0.00
2024-12-08 16:53:18,65,3567,23,42,1893.48,3637.05,0.00
2024-12-08 16:53:18,65,3568,23,42,1892.88,3638.00,0.00
2024-12-08 16:53:18,66,3568,24,42,1864.20,3638.02,0.00
2024-12-08 16:53:18,66,3569,24,42,1850.98,3639.00,0.00
2024-12-08 16:53:18,67,3569,25,42,1823.36,3639.02,0.00
2024-12-08 16:53:18,66,3569,25,41,1848.23,3639.05,0.00
2024-12-08 16:53:18,65,3569,24,41,1870.56,3639.22,0.00
2024-12-08 16:53:18,65,3570,24,41,1876.06,3640.00,0.00
2024-12-08 16:53:18,66,3570,24,42,1847.63,3640.02,0.00
2024-12-08 16:53:18,65,3570,23,42,1847.05,3640.34,0.00
2024-12-08 16:53:18,65,3571,23,42,1879.37,3641.00,0.00
2024-12-08 16:53:18,66,3571,23,43,1850.90,3641.02,0.00
2024-12-08 16:53:18,66,3572,23,43,1849.09,3642.00,0.00
2024-12-08 16:53:18,67,3572,23,44,1821.50,3642.02,0.00
2024-12-08 16:53:18,66,3572,22,44,1826.05,3642.15,0.00
2024-12-08 16:53:18,65,3572,21,44,1833.69,3642.71,0.00
2024-12-08 16:53:18,65,3573,21,44,1879.28,3643.00,0.00
2024-12-08 16:53:18,66,3573,21,45,1850.81,3643.02,0.00
2024-12-08 16:53:18,65,3573,21,44,1865.84,3643.06,0.00
2024-12-08 16:53:18,64,3573,20,44,1867.82,3643.47,0.00
2024-12-08 16:53:18,64,3574,20,44,1905.76,3644.00,0.00
2024-12-08 16:53:18,65,3574,20,45,1876.44,3644.02,0.00
2024-12-08 16:53:18,64,3574,19,45,1905.19,3644.02,0.00
2024-12-08 16:53:18,63,3574,19,44,1922.13,3644.05,0.00
2024-12-08 16:53:18,62,3574,18,44,1937.27,3644.08,0.00
2024-12-08 16:53:18,62,3575,18,44,1963.07,3645.00,0.00
2024-12-08 16:53:18,63,3575,19,44,1931.91,3645.02,0.00
2024-12-08 16:53:18,62,3575,19,43,1949.55,3645.05,0.00
2024-12-08 16:53:18,61,3575,18,43,1957.63,3645.13,0.00
2024-12-08 16:53:18,61,3576,18,43,1986.23,3646.00,0.00
2024-12-08 16:53:18,62,3576,19,43,1954.20,3646.02,0.00
2024-12-08 16:53:18,61,3576,19,42,1972.49,3646.05,0.00
2024-12-08 16:53:18,60,3576,18,42,1982.40,3646.38,0.00
2024-12-08 16:53:18,59,3576,17,42,2006.22,3646.66,0.00
2024-12-08 16:53:18,59,3577,17,42,2055.92,3647.00,0.00
2024-12-08 16:53:18,60,3577,17,43,2021.65,3647.02,0.00
2024-12-08 16:53:18,60,3578,17,43,2010.66,3648.00,0.00
2024-12-08 16:53:18,61,3578,18,43,1977.69,3648.02,0.00
2024-12-08 16:53:18,62,3577,19,43,1945.80,3648.05,0.00
2024-12-08 16:53:18,61,3577,19,42,2033.93,3648.07,0.00
2024-12-08 16:53:18,61,3578,19,42,2036.26,3649.00,0.00
2024-12-08 16:53:18,62,3578,20,42,2003.42,3649.02,0.00
2024-12-08 16:53:18,62,3579,20,42,2051.09,3650.00,0.00
2024-12-08 16:53:18,63,3579,21,42,2018.53,3650.02,0.00
2024-12-08 16:53:18,62,3579,20,42,2014.07,3650.68,0.00
2024-12-08 16:53:18,62,3580,20,42,2037.87,3651.00,0.00
2024-12-08 16:53:18,63,3580,20,43,2005.52,3651.02,0.00
2024-12-08 16:53:18,62,3580,20,42,2036.12,3651.03,0.00
2024-12-08 16:53:18,62,3581,20,42,2034.56,3652.00,0.00
2024-12-08 16:53:18,63,3581,21,42,2002.27,3652.02,0.00
2024-12-08 16:53:18,62,3581,21,41,2032.22,3652.03,0.00
2024-12-08 16:53:18,62,3582,21,41,2029.06,3653.00,0.00
2024-12-08 16:53:18,63,3582,21,42,1996.85,3653.02,0.00
2024-12-08 16:53:18,62,3582,21,41,2026.72,3653.03,0.00
2024-12-08 16:53:18,61,3582,20,41,2033.85,3653.67,0.00
2024-12-08 16:53:18,61,3583,20,41,2058.05,3654.00,0.00
2024-12-08 16:53:18,62,3583,20,42,2024.85,3654.02,0.00
2024-12-08 16:53:18,61,3583,19,42,2021.82,3654.67,0.00
2024-12-08 16:53:18,61,3584,19,42,2046.03,3655.00,0.00
2024-12-08 16:53:18,62,3584,20,42,2013.03,3655.02,0.00
2024-12-08 16:53:18,61,3584,20,41,2043.65,3655.03,0.00
2024-12-08 16:53:18,60,3584,19,41,2036.78,3655.92,0.00
2024-12-08 16:53:18,60,3585,19,41,2094.71,3656.00,0.00
2024-12-08 16:53:18,61,3585,19,42,2060.37,3656.02,0.00
2024-12-08 16:53:18,60,3585,18,42,2041.76,3656.58,0.00
2024-12-08 16:53:18,60,3586,18,42,2087.79,3657.00,0.00
2024-12-08 16:53:18,61,3586,19,42,2053.57,3657.02,0.00
2024-12-08 16:53:18,60,3586,19,41,2084.76,3657.03,0.00
2024-12-08 16:53:18,60,3587,19,41,2086.03,3658.00,0.00
2024-12-08 16:53:18,61,3587,20,41,2051.83,3658.02,0.00
2024-12-08 16:53:18,61,3588,20,41,2040.40,3659.00,0.00
2024-12-08 16:53:18,62,3588,20,42,2007.49,3659.02,0.00
2024-12-08 16:53:18,61,3588,20,41,2038.01,3659.03,0.00
2024-12-08 16:53:18,61,3588,20,41,2039.15,3660.00,0.00
2024-12-08 16:53:18,62,3588,20,42,2006.26,3660.02,0.00
2024-12-08 16:53:18,62,3589,20,42,1994.41,3661.00,0.00
2024-12-08 16:53:18,63,3589,21,42,1962.76,3661.02,0.00
2024-12-08 16:53:18,62,3589,21,41,1968.43,3661.03,0.00
2024-12-08 16:53:18,62,3590,21,41,1992.59,3662.00,0.00
2024-12-08 16:53:18,63,3590,21,42,1960.97,3662.02,0.00
2024-12-08 16:53:18,62,3590,20,42,1973.16,3662.23,0.00
2024-12-08 16:53:18,62,3591,20,42,2004.36,3663.00,0.00
2024-12-08 16:53:18,63,3591,20,43,1972.55,3663.02,0.00
2024-12-08 16:53:18,62,3591,20,42,2002.59,3663.03,0.00
2024-12-08 16:53:18,62,3592,20,42,2003.14,3664.00,0.00
2024-12-08 16:53:18,63,3592,21,42,1971.34,3664.02,0.00
2024-12-08 16:53:19,63,3593,21,42,1959.08,3665.00,0.00
2024-12-08 16:53:19,64,3593,22,42,1928.47,3665.02,0.00
2024-12-08 16:53:19,63,3593,22,41,1957.92,3665.03,0.00
2024-12-08 16:53:19,63,3594,22,41,1957.87,3666.00,0.00
2024-12-08 16:53:19,64,3594,22,42,1927.28,3666.02,0.00
2024-12-08 16:53:19,63,3594,22,41,1945.07,3666.03,0.00
2024-12-08 16:53:19,63,3595,22,41,1945.02,3667.00,0.00
2024-12-08 16:53:19,64,3595,22,42,1914.63,3667.02,0.00
2024-12-08 16:53:19,63,3595,21,42,1926.43,3667.19,0.00
2024-12-08 16:53:19,62,3595,20,42,1940.58,3667.66,0.00
2024-12-08 16:53:19,62,3596,20,42,1963.89,3668.00,0.00
2024-12-08 16:53:19,63,3596,20,43,1932.71,3668.02,0.00
2024-12-08 16:53:19,62,3596,19,43,1963.30,3668.02,0.00
2024-12-08 16:53:19,61,3596,19,42,1994.88,3668.02,0.00
2024-12-08 16:53:19,60,3596,18,42,1981.35,3668.65,0.00
2024-12-08 16:53:19,59,3596,17,42,2013.70,3668.68,0.00
2024-12-08 16:53:19,59,3597,17,42,2064.31,3669.00,0.00
2024-12-08 16:53:19,60,3597,17,43,2029.90,3669.02,0.00
2024-12-08 16:53:19,59,3597,16,43,2039.51,3669.25,0.00
2024-12-08 16:53:19,59,3598,16,43,2074.82,3670.00,0.00
2024-12-08 16:53:19,60,3598,16,44,2040.24,3670.02,0.00
2024-12-08 16:53:19,59,3598,16,43,2072.34,3670.03,0.00
2024-12-08 16:53:19,58,3598,15,43,2084.34,3670.67,0.00
2024-12-08 16:53:19,58,3599,15,43,2110.54,3671.00,0.00
2024-12-08 16:53:19,59,3599,15,44,2074.77,3671.02,0.00
2024-12-08 16:53:19,59,3600,15,44,2064.13,3672.00,0.00
2024-12-08 16:53:19,60,3600,16,44,2029.73,3672.02,0.00
2024-12-08 16:53:19,59,3600,16,43,2061.64,3672.03,0.00
2024-12-08 16:53:19,58,3600,15,43,2078.93,3672.33,0.00
2024-12-08 16:53:19,58,3601,15,43,2118.02,3673.00,0.00
2024-12-08 16:53:19,59,3601,15,44,2082.12,3673.02,0.00
2024-12-08 16:53:19,59,3602,15,44,2071.48,3674.00,0.00
2024-12-08 16:53:19,60,3602,16,44,2036.96,3674.02,0.00
2024-12-08 16:53:19,59,3602,16,43,2069.62,3674.03,0.00
2024-12-08 16:53:19,58,3602,15,43,2076.51,3674.74,0.00
2024-12-08 16:53:19,58,3603,15,43,2130.58,3675.00,0.00
2024-12-08 16:53:19,59,3603,16,43,2094.47,3675.02,0.00
2024-12-08 16:53:19,59,3604,16,43,2083.82,3676.00,0.00
2024-12-08 16:53:19,60,3604,16,44,2049.09,3676.02,0.00
2024-12-08 16:53:19,59,3604,16,43,2082.58,3676.03,0.00
2024-12-08 16:53:19,59,3605,16,43,2085.01,3677.00,0.00
2024-12-08 16:53:19,60,3605,17,43,2050.26,3677.02,0.00
2024-12-08 16:53:19,59,3605,17,42,2071.30,3677.03,0.00
2024-12-08 16:53:19,58,3605,16,42,2093.14,3677.28,0.00
2024-12-08 16:53:19,58,3606,16,42,2130.42,3678.00,0.00
2024-12-08 16:53:19,59,3606,16,43,2094.31,3678.02,0.00
2024-12-08 16:53:19,58,3606,15,43,2068.53,3678.67,0.00
2024-12-08 16:53:19,58,3607,15,43,2120.17,3679.00,0.00
2024-12-08 16:53:19,59,3607,16,43,2084.23,3679.02,0.00
2024-12-08 16:53:19,58,3607,16,42,2118.90,3679.03,0.00
2024-12-08 16:53:19,57,3607,15,42,2133.43,3679.35,0.00
2024-12-08 16:53:19,57,3608,15,42,2174.57,3680.00,0.00
2024-12-08 16:53:19,58,3608,16,42,2137.07,3680.02,0.00
2024-12-08 16:53:19,57,3608,15,42,2154.39,3680.21,0.00
2024-12-08 16:53:19,56,3608,14,42,2157.84,3680.91,0.00
2024-12-08 16:53:19,56,3609,14,42,2220.36,3681.00,0.00
2024-12-08 16:53:19,57,3609,15,42,2181.40,3681.02,0.00
2024-12-08 16:53:19,56,3609,15,41,2214.78,3681.05,0.00
2024-12-08 16:53:19,56,3610,15,41,2219.98,3682.00,0.00
2024-12-08 16:53:19,57,3610,15,42,2181.03,3682.02,0.00
2024-12-08 16:53:19,56,3610,15,41,2219.06,3682.04,0.00
2024-12-08 16:53:19,56,3611,15,41,2210.46,3683.00,0.00
2024-12-08 16:53:19,57,3611,16,41,2171.68,3683.02,0.00
2024-12-08 16:53:19,56,3611,16,40,2205.85,3683.04,0.00
2024-12-08 16:53:19,56,3612,16,40,2210.40,3684.00,0.00
2024-12-08 16:53:19,57,3612,16,41,2171.62,3684.02,0.00
2024-12-08 16:53:19,56,3612,15,41,2152.40,3684.95,0.00
2024-12-08 16:53:19,56,3613,15,41,2216.26,3685.00,0.00
2024-12-08 16:53:19,57,3613,16,41,2177.38,3685.02,0.00
2024-12-08 16:53:19,56,3613,16,40,2212.32,3685.04,0.00
2024-12-08 16:53:19,56,3614,16,40,2216.87,3686.00,0.00
2024-12-08 16:53:19,57,3614,17,40,2177.97,3686.02,0.00
2024-12-08 16:53:19,57,3615,17,40,2168.21,3687.00,0.00
2024-12-08 16:53:19,58,3615,18,40,2130.83,3687.02,0.00
2024-12-08 16:53:19,57,3615,18,39,2164.98,3687.04,0.00
2024-12-08 16:53:19,57,3616,18,39,2168.80,3688.00,0.00
2024-12-08 16:53:19,58,3616,19,39,2131.41,3688.02,0.00
2024-12-08 16:53:19,57,3616,18,39,2119.43,3688.84,0.00
2024-12-08 16:53:19,57,3617,18,39,2178.45,3689.00,0.00
2024-12-08 16:53:19,58,3617,19,39,2140.89,3689.02,0.00
2024-12-08 16:53:19,57,3617,19,38,2175.21,3689.04,0.00
2024-12-08 16:53:19,57,3618,19,38,2179.04,3690.00,0.00
2024-12-08 16:53:19,58,3618,20,38,2141.47,3690.02,0.00
2024-12-08 16:53:19,57,3618,19,38,2177.75,3690.02,0.00
2024-12-08 16:53:19,57,3619,19,38,2193.88,3691.00,0.00
2024-12-08 16:53:19,58,3619,20,38,2156.05,3691.02,0.00
2024-12-08 16:53:19,57,3619,20,37,2192.58,3691.02,0.00
2024-12-08 16:53:19,57,3620,20,37,2195.77,3692.00,0.00
2024-12-08 16:53:19,58,3620,20,38,2157.91,3692.02,0.00
2024-12-08 16:53:20,58,3621,20,38,2147.67,3693.00,0.00
2024-12-08 16:53:20,59,3621,21,38,2111.27,3693.02,0.00
2024-12-08 16:53:20,58,3621,21,37,2145.76,3693.02,0.00
2024-12-08 16:53:20,58,3622,21,37,2148.25,3694.00,0.00
2024-12-08 16:53:20,59,3622,21,38,2111.84,3694.02,0.00
2024-12-08 16:53:20,59,3623,21,38,2101.14,3695.00,0.00
2024-12-08 16:53:20,60,3623,22,38,2066.12,3695.02,0.00
2024-12-08 16:53:20,59,3623,22,37,2099.26,3695.02,0.00
2024-12-08 16:53:20,59,3624,22,37,2101.08,3696.00,0.00
2024-12-08 16:53:20,60,3624,23,37,2066.06,3696.02,0.00
2024-12-08 16:53:20,60,3625,23,37,2054.92,3697.00,0.00
2024-12-08 16:53:20,61,3625,24,37,2021.23,3697.02,0.00
2024-12-08 16:53:20,60,3625,24,36,2053.68,3697.02,0.00
2024-12-08 16:53:20,61,3624,25,36,2012.80,3697.25,0.00
2024-12-08 16:53:20,61,3625,25,36,2055.12,3698.00,0.00
2024-12-08 16:53:20,62,3625,26,36,2021.97,3698.02,0.00
2024-12-08 16:53:20,62,3626,26,36,2069.65,3699.00,0.00
2024-12-08 16:53:20,63,3626,26,37,2036.80,3699.02,0.00
2024-12-08 16:53:20,62,3626,26,36,2068.46,3699.02,0.00
2024-12-08 16:53:20,61,3626,25,36,2097.55,3699.15,0.00
2024-12-08 16:53:20,61,3627,25,36,2102.93,3700.00,0.00
2024-12-08 16:53:20,62,3627,26,36,2069.02,3700.02,0.00
2024-12-08 16:53:20,61,3627,25,36,2059.06,3700.77,0.00
2024-12-08 16:53:20,61,3628,25,36,2111.39,3701.00,0.00
2024-12-08 16:53:20,62,3628,26,36,2077.33,3701.02,0.00
2024-12-08 16:53:20,61,3628,26,35,2110.78,3701.02,0.00
2024-12-08 16:53:20,61,3629,26,35,2111.35,3702.00,0.00
2024-12-08 16:53:20,62,3629,26,36,2077.30,3702.02,0.00
2024-12-08 16:53:20,62,3630,26,36,2065.32,3703.00,0.00
2024-12-08 16:53:20,63,3630,27,36,2032.54,3703.02,0.00
2024-12-08 16:53:20,62,3630,27,35,2062.93,3703.02,0.00
2024-12-08 16:53:20,62,3631,27,35,2062.89,3704.00,0.00
2024-12-08 16:53:20,63,3631,28,35,2030.14,3704.02,0.00
2024-12-08 16:53:20,63,3632,28,35,2017.75,3705.00,0.00
2024-12-08 16:53:20,64,3632,28,36,1986.23,3705.02,0.00
2024-12-08 16:53:20,63,3632,28,35,2015.40,3705.02,0.00
2024-12-08 16:53:20,63,3633,28,35,2014.77,3706.00,0.00
2024-12-08 16:53:20,64,3633,29,35,1983.29,3706.02,0.00
2024-12-08 16:53:20,64,3634,29,35,1970.50,3707.00,0.00
2024-12-08 16:53:20,65,3634,29,36,1940.19,3707.02,0.00
2024-12-08 16:53:20,64,3634,29,35,1968.76,3707.02,0.00
2024-12-08 16:53:20,63,3634,28,35,1953.26,3707.67,0.00
2024-12-08 16:53:20,62,3634,27,35,1984.16,3707.68,0.00
2024-12-08 16:53:20,62,3635,27,35,2032.22,3708.00,0.00
2024-12-08 16:53:20,63,3635,28,35,1999.96,3708.02,0.00
2024-12-08 16:53:20,63,3636,28,35,1987.55,3709.00,0.00
2024-12-08 16:53:20,64,3636,28,36,1956.50,3709.02,0.00
2024-12-08 16:53:20,63,3636,28,35,1985.79,3709.02,0.00
2024-12-08 16:53:20,62,3636,27,35,1993.00,3709.68,0.00
2024-12-08 16:53:20,62,3637,27,35,2017.16,3710.00,0.00
2024-12-08 16:53:20,63,3637,27,36,1985.14,3710.02,0.00
2024-12-08 16:53:20,62,3637,26,36,1986.76,3710.32,0.00
2024-12-08 16:53:20,62,3638,26,36,2021.90,3711.00,0.00
2024-12-08 16:53:20,63,3638,26,37,1989.80,3711.02,0.00
2024-12-08 16:53:20,62,3638,26,36,2020.70,3711.02,0.00
2024-12-08 16:53:20,62,3639,26,36,2020.64,3712.00,0.00
2024-12-08 16:53:20,63,3639,27,36,1988.57,3712.02,0.00
2024-12-08 16:53:20,62,3639,26,36,1977.87,3712.76,0.00
2024-12-08 16:53:20,62,3640,26,36,2028.97,3713.00,0.00
2024-12-08 16:53:20,63,3640,26,37,1996.77,3713.02,0.00
2024-12-08 16:53:20,62,3640,26,36,2026.58,3713.02,0.00
2024-12-08 16:53:20,61,3640,25,36,2034.55,3713.69,0.00
2024-12-08 16:53:20,61,3641,25,36,2059.75,3714.00,0.00
2024-12-08 16:53:20,62,3641,25,37,2026.53,3714.02,0.00
2024-12-08 16:53:20,62,3642,25,37,2014.49,3715.00,0.00
2024-12-08 16:53:20,63,3642,25,38,1982.51,3715.02,0.00
2024-12-08 16:53:20,62,3642,25,37,2012.69,3715.02,0.00
2024-12-08 16:53:20,61,3642,24,37,2020.42,3715.69,0.00
2024-12-08 16:53:20,60,3642,23,37,2033.25,3715.97,0.00
2024-12-08 16:53:20,60,3643,23,37,2093.97,3716.00,0.00
2024-12-08 16:53:20,61,3643,23,38,2059.64,3716.02,0.00
2024-12-08 16:53:20,60,3643,22,38,2053.14,3716.17,0.00
2024-12-08 16:53:20,60,3644,22,38,2084.62,3717.00,0.00
2024-12-08 16:53:20,61,3644,22,39,2050.44,3717.02,0.00
2024-12-08 16:53:20,60,3644,22,38,2081.52,3717.03,0.00
2024-12-08 16:53:20,59,3644,21,38,2086.62,3717.19,0.00
2024-12-08 16:53:20,59,3645,21,38,2119.89,3718.00,0.00
2024-12-08 16:53:20,60,3645,21,39,2084.56,3718.02,0.00
2024-12-08 16:53:20,60,3646,21,39,2091.60,3719.00,0.00
2024-12-08 16:53:20,61,3646,21,40,2057.31,3719.02,0.00
2024-12-08 16:53:20,61,3647,21,40,2059.34,3720.00,0.00
2024-12-08 16:53:20,62,3647,22,40,2026.12,3720.02,0.00
2024-12-08 16:53:20,63,3646,23,40,1993.38,3720.06,0.00
2024-12-08 16:53:20,63,3647,23,40,2035.74,3721.00,0.00
2024-12-08 16:53:20,64,3647,23,41,2003.94,3721.02,0.00
2024-12-08 16:53:20,64,3648,23,41,2068.04,3722.00,0.00
2024-12-08 16:53:20,65,3648,24,41,2036.23,3722.02,0.00
2024-12-08 16:53:20,65,3649,24,41,2039.77,3723.00,0.00
2024-12-08 16:53:20,66,3649,25,41,2008.86,3723.02,0.00
2024-12-08 16:53:21,66,3650,25,41,2007.99,3724.00,0.00
2024-12-08 16:53:21,67,3650,26,41,1978.02,3724.02,0.00
2024-12-08 16:53:21,67,3651,26,41,1968.88,3725.00,0.00
2024-12-08 16:53:21,68,3651,26,42,1939.93,3725.02,0.00
2024-12-08 16:53:21,67,3651,26,41,1959.43,3725.03,0.00
2024-12-08 16:53:21,66,3651,25,41,1981.84,3725.23,0.00
2024-12-08 16:53:21,66,3652,25,41,1987.40,3726.00,0.00
2024-12-08 16:53:21,67,3652,25,42,1957.73,3726.02,0.00
2024-12-08 16:53:21,66,3652,25,41,1976.11,3726.05,0.00
2024-12-08 16:53:21,65,3652,24,41,1989.42,3726.35,0.00
2024-12-08 16:53:21,65,3653,24,41,2023.10,3727.00,0.00
2024-12-08 16:53:21,66,3653,24,42,1992.45,3727.02,0.00
2024-12-08 16:53:21,65,3653,24,41,2009.34,3727.06,0.00
2024-12-08 16:53:21,64,3653,23,41,2005.98,3727.53,0.00
2024-12-08 16:53:21,64,3654,23,41,2047.11,3728.00,0.00
2024-12-08 16:53:21,65,3654,24,41,2015.61,3728.02,0.00
2024-12-08 16:53:21,64,3654,23,41,2007.06,3728.45,0.00
2024-12-08 16:53:21,64,3655,23,41,2045.33,3729.00,0.00
2024-12-08 16:53:21,65,3655,24,41,2013.86,3729.02,0.00
2024-12-08 16:53:21,64,3655,24,40,2036.61,3729.13,0.00
2024-12-08 16:53:21,64,3656,24,40,2039.46,3730.00,0.00
2024-12-08 16:53:21,65,3656,25,40,2008.09,3730.02,0.00
2024-12-08 16:53:21,65,3657,25,40,1994.85,3731.00,0.00
2024-12-08 16:53:21,66,3657,26,40,1964.62,3731.02,0.00
2024-12-08 16:53:21,65,3657,26,39,1987.39,3731.03,0.00
2024-12-08 16:53:21,64,3657,26,38,2016.70,3731.06,0.00
2024-12-08 16:53:21,64,3658,26,38,2017.23,3732.00,0.00
2024-12-08 16:53:21,65,3658,26,39,1986.20,3732.02,0.00
2024-12-08 16:53:21,65,3659,26,39,1972.95,3733.00,0.00
2024-12-08 16:53:21,66,3659,26,40,1943.05,3733.02,0.00
2024-12-08 16:53:21,65,3659,26,39,1970.65,3733.06,0.00
2024-12-08 16:53:21,64,3659,25,39,1957.62,3733.97,0.00
2024-12-08 16:53:21,64,3660,25,39,2014.81,3734.00,0.00
2024-12-08 16:53:21,65,3660,26,39,1983.81,3734.02,0.00
2024-12-08 16:53:21,64,3660,25,39,1960.21,3734.63,0.00
2024-12-08 16:53:21,64,3661,25,39,2004.85,3735.00,0.00
2024-12-08 16:53:21,65,3661,26,39,1974.00,3735.02,0.00
2024-12-08 16:53:21,64,3661,26,38,1999.60,3735.08,0.00
2024-12-08 16:53:21,64,3662,26,38,2000.71,3736.00,0.00
2024-12-08 16:53:21,65,3662,26,39,1969.93,3736.02,0.00
2024-12-08 16:53:21,66,3661,26,40,1925.38,3736.14,0.00
2024-12-08 16:53:21,66,3662,26,40,1968.51,3737.00,0.00
2024-12-08 16:53:21,67,3662,26,41,1939.12,3737.02,0.00
2024-12-08 16:53:21,66,3662,26,40,1963.98,3737.08,0.00
2024-12-08 16:53:21,65,3662,25,40,1984.91,3737.28,0.00
2024-12-08 16:53:21,64,3662,24,40,2010.89,3737.41,0.00
2024-12-08 16:53:21,65,3661,24,41,1967.54,3737.77,0.00
2024-12-08 16:53:21,65,3662,24,41,2082.72,3738.00,0.00
2024-12-08 16:53:21,66,3662,25,41,2051.17,3738.02,0.00
2024-12-08 16:53:21,65,3662,24,41,2051.76,3738.34,0.00
2024-12-08 16:53:21,65,3663,24,41,2142.53,3739.00,0.00
2024-12-08 16:53:21,66,3663,25,41,2110.06,3739.02,0.00
2024-12-08 16:53:21,65,3663,24,41,2141.95,3739.02,0.00
2024-12-08 16:53:21,64,3663,24,40,2171.33,3739.06,0.00
2024-12-08 16:53:21,64,3664,24,40,2171.91,3740.00,0.00
2024-12-08 16:53:21,65,3664,24,41,2138.50,3740.02,0.00
2024-12-08 16:53:21,65,3665,24,41,2143.47,3741.00,0.00
2024-12-08 16:53:21,66,3665,25,41,2111.00,3741.02,0.00
2024-12-08 16:53:21,65,3665,24,41,2122.82,3741.25,0.00
2024-12-08 16:53:21,65,3666,24,41,2145.88,3742.00,0.00
2024-12-08 16:53:21,66,3666,24,42,2113.36,3742.02,0.00
2024-12-08 16:53:21,66,3667,24,42,2110.49,3743.00,0.00
2024-12-08 16:53:21,67,3667,25,42,2078.99,3743.02,0.00
2024-12-08 16:53:21,67,3668,25,42,2067.48,3744.00,0.00
2024-12-08 16:53:21,68,3668,26,42,2037.08,3744.02,0.00
2024-12-08 16:53:21,67,3668,26,41,2066.92,3744.02,0.00
2024-12-08 16:53:21,66,3668,26,40,2089.73,3744.05,0.00
2024-12-08 16:53:21,65,3668,25,40,2115.02,3744.23,0.00
2024-12-08 16:53:21,65,3669,25,40,2121.29,3745.00,0.00
2024-12-08 16:53:21,66,3669,26,40,2089.15,3745.02,0.00
2024-12-08 16:53:21,67,3668,27,40,2023.06,3745.69,0.00
2024-12-08 16:53:21,67,3669,27,40,2078.65,3746.00,0.00
2024-12-08 16:53:21,68,3669,28,40,2048.08,3746.02,0.00
2024-12-08 16:53:21,67,3669,28,39,2076.42,3746.06,0.00
2024-12-08 16:53:21,67,3670,28,39,2131.21,3747.00,0.00
2024-12-08 16:53:21,68,3670,28,40,2099.87,3747.02,0.00
2024-12-08 16:53:21,67,3670,28,39,2117.80,3747.06,0.00
2024-12-08 16:53:21,67,3671,28,39,2116.68,3748.00,0.00
2024-12-08 16:53:21,68,3671,29,39,2085.55,3748.02,0.00
2024-12-08 16:53:21,67,3671,28,39,2116.12,3748.02,0.00
2024-12-08 16:53:21,66,3671,28,38,2135.12,3748.05,0.00
2024-12-08 16:53:21,66,3672,28,38,2133.99,3749.00,0.00
2024-12-08 16:53:21,67,3672,28,39,2102.14,3749.02,0.00
2024-12-08 16:53:21,66,3672,28,38,2120.93,3749.05,0.00
2024-12-08 16:53:21,65,3672,27,38,2107.72,3749.66,0.00
2024-12-08 16:53:21,65,3673,27,38,2152.97,3750.00,0.00
2024-12-08 16:53:21,66,3673,27,39,2120.35,3750.02,0.00
2024-12-08 16:53:21,65,3673,27,38,2139.71,3750.05,0.00
2024-12-08 16:53:21,65,3674,27,38,2139.12,3751.00,0.00
2024-12-08 16:53:21,66,3674,27,39,2106.71,3751.02,0.00
2024-12-08 16:53:21,65,3674,27,38,2125.85,3751.05,0.00
2024-12-08 16:53:21,64,3674,26,38,2146.17,3751.05,0.00
2024-12-08 16:53:21,64,3675,26,38,2169.60,3752.00,0.00
2024-12-08 16:53:21,65,3675,27,38,2136.23,3752.02,0.00
2024-12-08 16:53:21,64,3675,26,38,2138.62,3752.30,0.00
2024-12-08 16:53:22,64,3676,26,38,2171.36,3753.00,0.00
2024-12-08 16:53:22,65,3676,26,39,2137.95,3753.02,0.00
2024-12-08 16:53:22,64,3676,26,38,2169.60,3753.05,0.00
2024-12-08 16:53:22,64,3677,26,38,2169.59,3754.00,0.00
2024-12-08 16:53:22,65,3677,26,39,2136.21,3754.02,0.00
2024-12-08 16:53:22,64,3677,26,38,2169.00,3754.02,0.00
2024-12-08 16:53:22,63,3677,25,38,2180.23,3754.19,0.00
2024-12-08 16:53:22,63,3678,25,38,2209.98,3755.00,0.00
2024-12-08 16:53:22,64,3678,26,38,2175.45,3755.02,0.00
2024-12-08 16:53:22,63,3678,26,37,2208.19,3755.03,0.00
2024-12-08 16:53:22,63,3679,26,37,2207.97,3756.00,0.00
2024-12-08 16:53:22,64,3679,27,37,2173.47,3756.02,0.00
2024-12-08 16:53:22,63,3679,26,37,2149.25,3756.64,0.00
2024-12-08 16:53:22,63,3680,26,37,2195.44,3757.00,0.00
2024-12-08 16:53:22,64,3680,27,37,2161.13,3757.02,0.00
2024-12-08 16:53:22,63,3680,27,36,2193.65,3757.03,0.00
2024-12-08 16:53:22,63,3681,27,36,2193.64,3758.00,0.00
2024-12-08 16:53:22,64,3681,27,37,2159.36,3758.02,0.00
2024-12-08 16:53:22,63,3681,26,37,2177.55,3758.11,0.00
2024-12-08 16:53:22,63,3682,26,37,2180.50,3759.00,0.00
2024-12-08 16:53:22,64,3682,27,37,2146.43,3759.02,0.00
2024-12-08 16:53:22,63,3682,27,36,2177.51,3759.03,0.00
2024-12-08 16:53:22,62,3682,26,36,2176.71,3759.84,0.00
2024-12-08 16:53:22,62,3683,26,36,2231.42,3760.00,0.00
2024-12-08 16:53:22,63,3683,27,36,2196.00,3760.02,0.00
2024-12-08 16:53:22,64,3682,27,37,2134.25,3760.47,0.00
2024-12-08 16:53:22,64,3683,27,37,2158.15,3761.00,0.00
2024-12-08 16:53:22,65,3683,27,38,2124.95,3761.02,0.00
2024-12-08 16:53:22,64,3683,27,37,2155.21,3761.03,0.00
2024-12-08 16:53:22,63,3683,26,37,2187.05,3761.10,0.00
2024-12-08 16:53:22,64,3682,26,38,2130.30,3761.73,0.00
2024-12-08 16:53:22,64,3683,26,38,2223.97,3762.00,0.00
2024-12-08 16:53:22,65,3683,26,39,2189.75,3762.02,0.00
2024-12-08 16:53:22,65,3684,26,39,2234.33,3763.00,0.00
2024-12-08 16:53:22,66,3684,26,40,2200.48,3763.02,0.00
2024-12-08 16:53:22,65,3684,26,39,2227.39,3763.05,0.00
2024-12-08 16:53:22,64,3684,25,39,2258.69,3763.11,0.00
2024-12-08 16:53:22,64,3685,25,39,2284.55,3764.00,0.00
2024-12-08 16:53:22,65,3685,25,40,2249.40,3764.02,0.00
2024-12-08 16:53:22,65,3686,25,40,2236.10,3765.00,0.00
2024-12-08 16:53:22,66,3686,25,41,2202.22,3765.02,0.00
2024-12-08 16:53:22,65,3686,24,41,2235.52,3765.02,0.00
2024-12-08 16:53:22,64,3686,24,40,2263.98,3765.03,0.00
2024-12-08 16:53:22,63,3686,23,40,2289.00,3765.32,0.00
2024-12-08 16:53:22,63,3687,23,40,2299.63,3766.00,0.00
2024-12-08 16:53:22,64,3687,23,41,2263.70,3766.02,0.00
2024-12-08 16:53:22,64,3687,23,41,2250.76,3767.00,0.00
2024-12-08 16:53:22,65,3687,23,42,2216.13,3767.02,0.00
2024-12-08 16:53:22,64,3687,23,41,2242.52,3767.03,0.00
2024-12-08 16:53:22,63,3687,22,41,2230.62,3767.67,0.00
2024-12-08 16:53:22,63,3688,22,41,2278.12,3768.00,0.00
2024-12-08 16:53:22,64,3688,23,41,2242.53,3768.02,0.00
2024-12-08 16:53:22,63,3688,22,41,2243.44,3768.05,0.00
2024-12-08 16:53:22,63,3689,22,41,2267.96,3769.00,0.00
2024-12-08 16:53:22,64,3689,23,41,2232.52,3769.02,0.00
2024-12-08 16:53:22,63,3689,23,40,2258.99,3769.03,0.00
2024-12-08 16:53:22,64,3688,24,40,2203.94,3769.59,0.00
2024-12-08 16:53:22,64,3689,24,40,2262.57,3770.00,0.00
2024-12-08 16:53:22,65,3689,25,40,2227.76,3770.02,0.00
2024-12-08 16:53:22,64,3689,24,40,2226.78,3770.34,0.00
2024-12-08 16:53:22,64,3690,24,40,2320.32,3771.00,0.00
2024-12-08 16:53:22,65,3690,25,40,2284.63,3771.02,0.00
2024-12-08 16:53:22,64,3690,25,39,2310.90,3771.03,0.00
2024-12-08 16:53:22,64,3691,25,39,2310.33,3772.00,0.00
2024-12-08 16:53:22,65,3691,25,40,2274.79,3772.02,0.00
2024-12-08 16:53:22,65,3692,25,40,2262.29,3773.00,0.00
2024-12-08 16:53:22,66,3692,25,41,2228.01,3773.02,0.00
2024-12-08 16:53:22,65,3692,25,40,2253.00,3773.03,0.00
2024-12-08 16:53:22,64,3692,24,40,2264.70,3773.64,0.00
2024-12-08 16:53:22,64,3693,24,40,2310.37,3774.00,0.00
2024-12-08 16:53:22,65,3693,25,40,2274.83,3774.02,0.00
2024-12-08 16:53:22,65,3694,25,40,2262.52,3775.00,0.00
2024-12-08 16:53:22,66,3694,26,40,2228.24,3775.02,0.00
2024-12-08 16:53:22,65,3694,26,39,2253.23,3775.03,0.00
2024-12-08 16:53:22,65,3695,26,39,2252.08,3776.00,0.00
2024-12-08 16:53:22,66,3695,26,40,2217.96,3776.02,0.00
2024-12-08 16:53:22,66,3696,26,40,2205.73,3777.00,0.00
2024-12-08 16:53:22,67,3696,26,41,2172.81,3777.02,0.00
2024-12-08 16:53:22,66,3696,26,40,2197.15,3777.03,0.00
2024-12-08 16:53:22,65,3696,25,40,2183.63,3777.66,0.00
2024-12-08 16:53:22,65,3697,25,40,2229.22,3778.00,0.00
2024-12-08 16:53:22,66,3697,26,40,2195.44,3778.02,0.00
2024-12-08 16:53:22,66,3698,26,40,2183.21,3779.00,0.00
2024-12-08 16:53:22,67,3698,26,41,2150.62,3779.02,0.00
2024-12-08 16:53:22,66,3698,26,40,2175.19,3779.03,0.00
2024-12-08 16:53:22,65,3698,25,40,2185.56,3779.63,0.00
2024-12-08 16:53:22,65,3699,25,40,2230.03,3780.00,0.00
2024-12-08 16:53:22,66,3699,26,40,2196.24,3780.02,0.00
2024-12-08 16:53:22,65,3699,25,40,2183.51,3780.49,0.00
2024-12-08 16:53:23,65,3700,25,40,2222.86,3781.00,0.00
2024-12-08 16:53:23,66,3700,25,41,2189.18,3781.02,0.00
2024-12-08 16:53:23,65,3700,25,40,2214.72,3781.03,0.00
2024-12-08 16:53:23,64,3700,24,40,2223.06,3781.63,0.00
2024-12-08 16:53:23,64,3701,24,40,2244.62,3782.00,0.00
2024-12-08 16:53:23,65,3701,25,40,2210.09,3782.02,0.00
2024-12-08 16:53:23,66,3700,26,40,2158.88,3782.21,0.00
2024-12-08 16:53:23,66,3701,26,40,2173.01,3783.00,0.00
2024-12-08 16:53:23,67,3701,27,40,2140.58,3783.02,0.00
2024-12-08 16:53:23,66,3701,27,39,2165.56,3783.03,0.00
2024-12-08 16:53:23,66,3702,27,39,2219.00,3784.00,0.00
2024-12-08 16:53:23,67,3702,27,40,2185.88,3784.02,0.00
2024-12-08 16:53:23,67,3703,27,40,2170.87,3785.00,0.00
2024-12-08 16:53:23,68,3703,28,40,2138.94,3785.02,0.00
2024-12-08 16:53:23,67,3703,28,39,2164.09,3785.03,0.00
2024-12-08 16:53:23,66,3703,27,39,2183.62,3785.38,0.00
2024-12-08 16:53:23,66,3704,27,39,2193.03,3786.00,0.00
2024-12-08 16:53:23,67,3704,28,39,2160.29,3786.02,0.00
2024-12-08 16:53:23,67,3705,28,39,2143.93,3787.00,0.00
2024-12-08 16:53:23,68,3705,28,40,2112.40,3787.02,0.00
2024-12-08 16:53:23,67,3705,28,39,2137.71,3787.03,0.00
2024-12-08 16:53:23,67,3706,28,39,2132.65,3788.00,0.00
2024-12-08 16:53:23,68,3706,29,39,2101.29,3788.02,0.00
2024-12-08 16:53:23,67,3706,28,39,2100.64,3788.08,0.00
2024-12-08 16:53:23,67,3707,28,39,2119.94,3789.00,0.00
2024-12-08 16:53:23,68,3707,29,39,2088.77,3789.02,0.00
2024-12-08 16:53:23,67,3707,29,38,2113.16,3789.05,0.00
2024-12-08 16:53:23,67,3708,29,38,2108.93,3790.00,0.00
2024-12-08 16:53:23,68,3708,29,39,2077.92,3790.02,0.00
2024-12-08 16:53:23,67,3708,28,39,2093.33,3790.09,0.00
2024-12-08 16:53:23,67,3709,28,39,2113.54,3791.00,0.00
2024-12-08 16:53:23,68,3709,28,40,2082.46,3791.02,0.00
2024-12-08 16:53:23,67,3709,27,40,2112.98,3791.02,0.00
2024-12-08 16:53:23,66,3709,27,39,2139.25,3791.03,0.00
2024-12-08 16:53:23,65,3709,26,39,2165.44,3791.03,0.00
2024-12-08 16:53:23,65,3710,26,39,2184.88,3792.00,0.00
2024-12-08 16:53:23,66,3710,27,39,2151.78,3792.02,0.00
2024-12-08 16:53:23,65,3710,26,39,2144.64,3792.31,0.00
2024-12-08 16:53:23,65,3711,26,39,2174.99,3793.00,0.00
2024-12-08 16:53:23,66,3711,27,39,2142.04,3793.02,0.00
2024-12-08 16:53:23,65,3711,27,38,2172.08,3793.02,0.00
2024-12-08 16:53:23,65,3712,27,38,2169.88,3794.00,0.00
2024-12-08 16:53:23,66,3712,27,39,2137.00,3794.02,0.00
2024-12-08 16:53:23,66,3713,27,39,2127.45,3795.00,0.00
2024-12-08 16:53:23,67,3713,27,40,2095.70,3795.02,0.00
2024-12-08 16:53:23,66,3713,26,40,2111.39,3795.14,0.00
2024-12-08 16:53:23,65,3713,25,40,2124.01,3795.28,0.00
2024-12-08 16:53:23,65,3714,25,40,2153.21,3796.00,0.00
2024-12-08 16:53:23,66,3714,26,40,2120.58,3796.02,0.00
2024-12-08 16:53:23,65,3714,26,39,2152.04,3796.02,0.00
2024-12-08 16:53:23,65,3715,26,39,2144.21,3797.00,0.00
2024-12-08 16:53:23,66,3715,26,40,2111.72,3797.02,0.00
2024-12-08 16:53:23,66,3716,26,40,2092.23,3798.00,0.00
2024-12-08 16:53:23,67,3716,26,41,2061.00,3798.02,0.00
2024-12-08 16:53:23,66,3716,26,40,2085.91,3798.05,0.00
2024-12-08 16:53:23,65,3716,25,40,2111.61,3798.19,0.00
2024-12-08 16:53:23,65,3717,25,40,2136.07,3799.00,0.00
2024-12-08 16:53:23,66,3717,26,40,2103.71,3799.02,0.00
2024-12-08 16:53:23,65,3717,25,40,2118.58,3799.17,0.00
2024-12-08 16:53:23,65,3718,25,40,2120.63,3800.00,0.00
2024-12-08 16:53:23,66,3718,25,41,2088.50,3800.02,0.00
2024-12-08 16:53:23,65,3718,25,40,2114.80,3800.05,0.00
2024-12-08 16:53:23,65,3719,25,40,2112.04,3801.00,0.00
2024-12-08 16:53:23,66,3719,25,41,2080.04,3801.02,0.00
2024-12-08 16:53:23,66,3720,25,41,2064.87,3802.00,0.00
2024-12-08 16:53:23,67,3720,25,42,2034.05,3802.02,0.00
2024-12-08 16:53:23,66,3720,25,41,2056.82,3802.06,0.00
2024-12-08 16:53:23,66,3721,25,41,2053.90,3803.00,0.00
2024-12-08 16:53:23,67,3721,25,42,2023.24,3803.02,0.00
2024-12-08 16:53:23,66,3721,24,42,2047.67,3803.05,0.00
2024-12-08 16:53:23,66,3722,24,42,2056.29,3804.00,0.00
2024-12-08 16:53:23,67,3722,24,43,2025.60,3804.02,0.00
2024-12-08 16:53:23,66,3722,24,42,2049.38,3804.05,0.00
2024-12-08 16:53:23,65,3722,23,42,2054.96,3804.69,0.00
2024-12-08 16:53:23,65,3723,23,42,2078.60,3805.00,0.00
2024-12-08 16:53:23,66,3723,24,42,2047.11,3805.02,0.00
2024-12-08 16:53:23,66,3724,24,42,2033.10,3806.00,0.00
2024-12-08 16:53:23,67,3724,25,42,2002.75,3806.02,0.00
2024-12-08 16:53:23,66,3724,25,41,2025.61,3806.05,0.00
2024-12-08 16:53:23,66,3725,25,41,2022.72,3807.00,0.00
2024-12-08 16:53:23,67,3725,25,42,1992.53,3807.02,0.00
2024-12-08 16:53:23,66,3725,25,41,2015.94,3807.05,0.00
2024-12-08 16:53:23,65,3725,24,41,2023.21,3807.11,0.00
2024-12-08 16:53:23,65,3726,24,41,2046.76,3808.00,0.00
2024-12-08 16:53:23,66,3726,24,42,2015.75,3808.02,0.00
2024-12-08 16:53:23,66,3727,24,42,2001.89,3809.00,0.00
2024-12-08 16:53:23,67,3727,24,43,1972.01,3809.02,0.00
2024-12-08 16:53:23,66,3727,24,42,1995.55,3809.05,0.00
2024-12-08 16:53:23,66,3728,24,42,1993.03,3810.00,0.00
2024-12-08 16:53:23,67,3728,24,43,1963.29,3810.02,0.00
2024-12-08 16:53:23,66,3728,23,43,1973.98,3810.02,0.00
2024-12-08 16:53:24,66,3729,23,43,1982.55,3811.00,0.00
2024-12-08 16:53:24,67,3729,24,43,1952.96,3811.02,0.00
2024-12-08 16:53:24,66,3729,24,42,1977.93,3811.03,0.00
2024-12-08 16:53:24,65,3729,23,42,1962.29,3811.66,0.00
2024-12-08 16:53:24,65,3730,23,42,2008.27,3812.00,0.00
2024-12-08 16:53:24,66,3730,23,43,1977.84,3812.02,0.00
2024-12-08 16:53:24,65,3730,23,42,2000.06,3812.02,0.00
2024-12-08 16:53:24,65,3731,23,42,1998.23,3813.00,0.00
2024-12-08 16:53:24,66,3731,23,43,1967.96,3813.02,0.00
2024-12-08 16:53:24,66,3732,23,43,1955.49,3814.00,0.00
2024-12-08 16:53:24,67,3732,23,44,1926.30,3814.02,0.00
2024-12-08 16:53:24,66,3732,23,43,1951.44,3814.02,0.00
2024-12-08 16:53:24,65,3732,22,43,1938.56,3814.60,0.00
2024-12-08 16:53:24,65,3733,22,43,1982.26,3815.00,0.00
2024-12-08 16:53:24,66,3733,23,43,1952.23,3815.02,0.00
2024-12-08 16:53:24,65,3733,22,43,1923.62,3815.68,0.00
2024-12-08 16:53:24,65,3734,22,43,1970.24,3816.00,0.00
2024-12-08 16:53:24,66,3734,22,44,1940.38,3816.02,0.00
2024-12-08 16:53:24,65,3734,22,43,1966.13,3816.02,0.00
2024-12-08 16:53:24,64,3734,21,43,1972.24,3816.66,0.00
2024-12-08 16:53:24,64,3735,21,43,1995.15,3817.00,0.00
2024-12-08 16:53:24,65,3735,21,44,1964.45,3817.02,0.00
2024-12-08 16:53:24,64,3735,20,44,1957.71,3817.41,0.00
2024-12-08 16:53:24,64,3736,20,44,1993.12,3818.00,0.00
2024-12-08 16:53:24,65,3736,21,44,1962.45,3818.02,0.00
2024-12-08 16:53:24,64,3736,21,43,1987.15,3818.02,0.00
2024-12-08 16:53:24,63,3736,20,43,1992.66,3818.10,0.00
2024-12-08 16:53:24,63,3737,20,43,2015.87,3819.00,0.00
2024-12-08 16:53:24,64,3737,20,44,1984.37,3819.02,0.00
2024-12-08 16:53:24,63,3737,19,44,1985.06,3819.32,0.00
2024-12-08 16:53:24,64,3736,20,44,1929.99,3819.91,0.00
2024-12-08 16:53:24,64,3737,20,44,1989.76,3820.00,0.00
2024-12-08 16:53:24,65,3737,21,44,1959.15,3820.02,0.00
2024-12-08 16:53:24,64,3737,21,43,1983.79,3820.02,0.00
2024-12-08 16:53:24,63,3737,20,43,1996.83,3820.30,0.00
2024-12-08 16:53:24,64,3736,20,44,1955.96,3820.56,0.00
2024-12-08 16:53:24,64,3737,20,44,2076.28,3821.00,0.00
2024-12-08 16:53:24,65,3737,21,44,2044.34,3821.02,0.00
2024-12-08 16:53:24,64,3737,20,44,2061.38,3821.09,0.00
2024-12-08 16:53:24,63,3737,19,44,2087.42,3821.27,0.00
2024-12-08 16:53:24,62,3737,18,44,2104.50,3821.39,0.00
2024-12-08 16:53:24,62,3738,18,44,2204.77,3822.00,0.00
2024-12-08 16:53:24,63,3738,18,45,2169.78,3822.02,0.00
2024-12-08 16:53:24,62,3738,18,44,2199.22,3822.02,0.00
2024-12-08 16:53:24,61,3738,17,44,2212.65,3822.61,0.00
2024-12-08 16:53:24,61,3739,17,44,2235.52,3823.00,0.00
2024-12-08 16:53:24,62,3739,18,44,2199.46,3823.02,0.00
2024-12-08 16:53:24,61,3739,17,44,2193.08,3823.71,0.00
2024-12-08 16:53:24,61,3740,17,44,2244.72,3824.00,0.00
2024-12-08 16:53:24,62,3740,18,44,2208.52,3824.02,0.00
2024-12-08 16:53:24,61,3740,18,43,2239.71,3824.02,0.00
2024-12-08 16:53:24,61,3741,18,43,2240.29,3825.00,0.00
2024-12-08 16:53:24,62,3741,18,44,2204.16,3825.02,0.00
2024-12-08 16:53:24,62,3742,18,44,2191.77,3826.00,0.00
2024-12-08 16:53:24,63,3742,18,45,2156.98,3826.02,0.00
2024-12-08 16:53:24,62,3742,18,44,2186.84,3826.02,0.00
2024-12-08 16:53:24,61,3742,17,44,2195.23,3826.41,0.00
2024-12-08 16:53:24,61,3743,17,44,2235.82,3827.00,0.00
2024-12-08 16:53:24,62,3743,17,45,2199.76,3827.02,0.00
2024-12-08 16:53:24,61,3743,16,45,2206.65,3827.26,0.00
2024-12-08 16:53:24,61,3744,16,45,2241.66,3828.00,0.00
2024-12-08 16:53:24,62,3744,16,46,2205.50,3828.02,0.00
2024-12-08 16:53:24,61,3744,16,45,2237.26,3828.02,0.00
2024-12-08 16:53:24,61,3745,16,45,2237.85,3829.00,0.00
2024-12-08 16:53:24,62,3745,17,45,2201.75,3829.02,0.00
2024-12-08 16:53:24,61,3745,16,45,2219.07,3829.18,0.00
2024-12-08 16:53:24,61,3746,16,45,2225.85,3830.00,0.00
2024-12-08 16:53:24,62,3746,16,46,2189.95,3830.02,0.00
2024-12-08 16:53:24,61,3746,16,45,2220.20,3830.02,0.00
2024-12-08 16:53:24,61,3747,16,45,2220.78,3831.00,0.00
2024-12-08 16:53:24,62,3747,17,45,2184.96,3831.02,0.00
2024-12-08 16:53:24,61,3747,16,45,2189.48,3831.31,0.00
2024-12-08 16:53:24,61,3748,16,45,2226.39,3832.00,0.00
2024-12-08 16:53:24,62,3748,17,45,2190.48,3832.02,0.00
2024-12-08 16:53:24,61,3748,17,44,2220.73,3832.02,0.00
2024-12-08 16:53:24,61,3749,17,44,2221.31,3833.00,0.00
2024-12-08 16:53:24,62,3749,18,44,2185.49,3833.02,0.00
2024-12-08 16:53:24,61,3749,17,44,2177.57,3833.74,0.00
2024-12-08 16:53:24,61,3750,17,44,2230.56,3834.00,0.00
2024-12-08 16:53:24,62,3750,17,45,2194.59,3834.02,0.00
2024-12-08 16:53:24,61,3750,17,44,2225.53,3834.02,0.00
2024-12-08 16:53:24,61,3751,17,44,2226.12,3835.00,0.00
2024-12-08 16:53:24,62,3751,18,44,2190.21,3835.02,0.00
2024-12-08 16:53:24,61,3751,17,44,2185.39,3835.39,0.00
2024-12-08 16:53:24,61,3752,17,44,2225.44,3836.00,0.00
2024-12-08 16:53:24,62,3752,18,44,2189.54,3836.02,0.00
2024-12-08 16:53:24,61,3752,18,43,2221.67,3836.02,0.00
2024-12-08 16:53:24,61,3753,18,43,2222.24,3837.00,0.00
2024-12-08 16:53:24,62,3753,18,44,2186.40,3837.02,0.00
2024-12-08 16:53:24,62,3754,18,44,2173.97,3838.00,0.00
2024-12-08 16:53:24,63,3754,18,45,2139.46,3838.02,0.00
2024-12-08 16:53:24,62,3754,18,44,2170.88,3838.02,0.00
2024-12-08 16:53:24,61,3754,17,44,2199.59,3838.18,0.00
2024-12-08 16:53:24,60,3754,16,44,2212.88,3838.73,0.00
2024-12-08 16:53:25,60,3755,16,44,2266.82,3839.00,0.00
2024-12-08 16:53:25,61,3755,16,45,2229.66,3839.02,0.00
2024-12-08 16:53:25,61,3756,16,45,2217.01,3840.00,0.00
2024-12-08 16:53:25,62,3756,16,46,2181.25,3840.02,0.00
2024-12-08 16:53:25,61,3756,16,45,2214.49,3840.02,0.00
2024-12-08 16:53:25,60,3756,15,45,2198.73,3840.68,0.00
2024-12-08 16:53:25,60,3757,15,45,2250.82,3841.00,0.00
2024-12-08 16:53:25,61,3757,15,46,2213.92,3841.02,0.00
2024-12-08 16:53:25,60,3757,14,46,2229.75,3841.20,0.00
2024-12-08 16:53:25,59,3757,13,46,2265.68,3841.24,0.00
2024-12-08 16:53:25,59,3758,13,46,2301.13,3842.00,0.00
2024-12-08 16:53:25,60,3758,14,46,2262.78,3842.02,0.00
2024-12-08 16:53:25,59,3758,14,45,2299.18,3842.02,0.00
2024-12-08 16:53:25,58,3758,13,45,2318.29,3842.07,0.00
2024-12-08 16:53:25,58,3759,13,45,2349.13,3843.00,0.00
2024-12-08 16:53:25,59,3759,13,46,2309.31,3843.02,0.00
2024-12-08 16:53:25,59,3760,13,46,2298.19,3844.00,0.00
2024-12-08 16:53:25,60,3760,14,46,2259.88,3844.02,0.00
2024-12-08 16:53:25,59,3760,14,45,2296.88,3844.02,0.00
2024-12-08 16:53:25,59,3761,14,45,2298.78,3845.00,0.00
2024-12-08 16:53:25,60,3761,15,45,2260.47,3845.02,0.00
2024-12-08 16:53:25,59,3761,14,45,2238.09,3845.97,0.00
2024-12-08 16:53:25,59,3762,14,45,2301.99,3846.00,0.00
2024-12-08 16:53:25,60,3762,15,45,2263.62,3846.02,0.00
2024-12-08 16:53:25,59,3762,15,44,2301.34,3846.02,0.00
2024-12-08 16:53:25,59,3763,15,44,2303.24,3847.00,0.00
2024-12-08 16:53:25,60,3763,15,45,2264.85,3847.02,0.00
2024-12-08 16:53:25,59,3763,15,44,2289.55,3847.02,0.00
2024-12-08 16:53:25,59,3764,15,44,2291.45,3848.00,0.00
2024-12-08 16:53:25,60,3764,16,44,2253.25,3848.02,0.00
2024-12-08 16:53:25,60,3765,16,44,2241.65,3849.00,0.00
2024-12-08 16:53:25,61,3765,16,45,2204.90,3849.02,0.00
2024-12-08 16:53:25,60,3765,16,44,2239.09,3849.02,0.00
2024-12-08 16:53:25,59,3765,15,44,2245.47,3849.76,0.00
2024-12-08 16:53:25,59,3766,15,44,2301.77,3850.00,0.00
2024-12-08 16:53:25,60,3766,16,44,2263.41,3850.02,0.00
2024-12-08 16:53:25,60,3767,16,44,2251.80,3851.00,0.00
2024-12-08 16:53:25,61,3767,16,45,2214.89,3851.02,0.00
2024-12-08 16:53:25,60,3767,16,44,2249.88,3851.02,0.00
2024-12-08 16:53:25,61,3766,17,44,2204.87,3851.26,0.00
2024-12-08 16:53:25,61,3767,17,44,2245.77,3852.00,0.00
2024-12-08 16:53:25,62,3767,17,45,2209.55,3852.02,0.00
2024-12-08 16:53:25,62,3768,17,45,2259.22,3853.00,0.00
2024-12-08 16:53:25,63,3768,17,46,2223.36,3853.02,0.00
2024-12-08 16:53:25,62,3768,17,45,2256.73,3853.02,0.00
2024-12-08 16:53:25,61,3768,16,45,2252.93,3853.56,0.00
2024-12-08 16:53:25,61,3769,16,45,2299.38,3854.00,0.00
2024-12-08 16:53:25,62,3769,17,45,2262.29,3854.02,0.00
2024-12-08 16:53:25,61,3769,16,45,2269.16,3854.28,0.00
2024-12-08 16:53:25,61,3770,16,45,2305.03,3855.00,0.00
2024-12-08 16:53:25,62,3770,17,45,2267.85,3855.02,0.00
2024-12-08 16:53:25,61,3770,17,44,2303.14,3855.02,0.00
2024-12-08 16:53:25,62,3769,17,45,2251.86,3855.42,0.00
2024-12-08 16:53:25,62,3770,17,45,2316.33,3856.00,0.00
2024-12-08 16:53:25,63,3770,17,46,2279.56,3856.02,0.00
2024-12-08 16:53:25,63,3771,17,46,2327.91,3857.00,0.00
2024-12-08 16:53:25,64,3771,17,47,2291.54,3857.02,0.00
2024-12-08 16:53:25,63,3771,17,46,2326.07,3857.02,0.00
2024-12-08 16:53:25,62,3771,16,46,2322.19,3857.56,0.00
2024-12-08 16:53:25,62,3772,16,46,2367.94,3858.00,0.00
2024-12-08 16:53:25,63,3772,16,47,2330.35,3858.02,0.00
2024-12-08 16:53:25,63,3773,16,47,2317.48,3859.00,0.00
2024-12-08 16:53:25,64,3773,16,48,2281.27,3859.02,0.00
2024-12-08 16:53:25,63,3773,16,47,2315.64,3859.02,0.00
2024-12-08 16:53:25,62,3773,15,47,2308.72,3859.92,0.00
2024-12-08 16:53:25,62,3774,15,47,2367.92,3860.00,0.00
2024-12-08 16:53:25,63,3774,16,47,2330.33,3860.02,0.00
2024-12-08 16:53:25,63,3775,16,47,2317.45,3861.00,0.00
2024-12-08 16:53:25,64,3775,17,47,2281.24,3861.02,0.00
2024-12-08 16:53:25,63,3775,17,46,2315.00,3861.02,0.00
2024-12-08 16:53:25,63,3776,17,46,2314.37,3862.00,0.00
2024-12-08 16:53:25,64,3776,17,47,2278.21,3862.02,0.00
2024-12-08 16:53:25,64,3777,17,47,2264.92,3863.00,0.00
2024-12-08 16:53:25,65,3777,18,47,2230.07,3863.02,0.00
2024-12-08 16:53:25,64,3777,18,46,2261.90,3863.02,0.00
2024-12-08 16:53:25,64,3778,18,46,2260.68,3864.00,0.00
2024-12-08 16:53:25,65,3778,18,47,2225.90,3864.02,0.00
2024-12-08 16:53:25,64,3778,17,47,2234.81,3864.25,0.00
2024-12-08 16:53:25,65,3777,18,47,2191.06,3864.52,0.00
2024-12-08 16:53:25,64,3777,17,47,2262.23,3864.69,0.00
2024-12-08 16:53:25,64,3778,17,47,2310.78,3865.00,0.00
2024-12-08 16:53:25,65,3778,18,47,2275.23,3865.02,0.00
2024-12-08 16:53:25,65,3779,18,47,2321.02,3866.00,0.00
2024-12-08 16:53:25,66,3779,19,47,2285.86,3866.02,0.00
2024-12-08 16:53:25,66,3780,19,47,2272.61,3867.00,0.00
2024-12-08 16:53:25,67,3780,19,48,2238.70,3867.02,0.00
2024-12-08 16:53:25,66,3780,19,47,2264.41,3867.02,0.00
2024-12-08 16:53:26,66,3781,19,47,2262.07,3868.00,0.00
2024-12-08 16:53:26,67,3781,20,47,2228.31,3868.02,0.00
2024-12-08 16:53:26,66,3781,20,46,2259.72,3868.02,0.00
2024-12-08 16:53:26,66,3782,20,46,2257.38,3869.00,0.00
2024-12-08 16:53:26,67,3782,21,46,2223.68,3869.02,0.00
2024-12-08 16:53:26,68,3781,21,47,2168.35,3869.34,0.00
2024-12-08 16:53:26,67,3781,20,47,2195.13,3869.96,0.00
2024-12-08 16:53:26,67,3782,20,47,2251.18,3870.00,0.00
2024-12-08 16:53:26,68,3782,21,47,2218.07,3870.02,0.00
2024-12-08 16:53:26,67,3782,21,46,2248.29,3870.02,0.00
2024-12-08 16:53:26,67,3783,21,46,2303.18,3871.00,0.00
2024-12-08 16:53:26,68,3783,21,47,2269.31,3871.02,0.00
2024-12-08 16:53:26,68,3784,21,47,2254.52,3872.00,0.00
2024-12-08 16:53:26,69,3784,21,48,2221.85,3872.01,0.00
2024-12-08 16:53:26,68,3784,21,47,2252.25,3872.02,0.00
2024-12-08 16:53:26,68,3785,21,47,2248.84,3873.00,0.00
2024-12-08 16:53:26,69,3785,22,47,2216.25,3873.01,0.00
2024-12-08 16:53:26,69,3786,22,47,2201.10,3874.00,0.00
2024-12-08 16:53:26,70,3786,23,47,2169.66,3874.01,0.00
2024-12-08 16:53:26,69,3786,23,46,2197.74,3874.03,0.00
2024-12-08 16:53:26,68,3786,22,46,2185.01,3874.96,0.00
2024-12-08 16:53:26,68,3787,22,46,2240.32,3875.00,0.00
2024-12-08 16:53:26,69,3787,23,46,2207.85,3875.01,0.00
2024-12-08 16:53:26,68,3787,22,46,2199.47,3875.46,0.00
2024-12-08 16:53:26,68,3788,22,46,2235.76,3876.00,0.00
2024-12-08 16:53:26,69,3788,23,46,2203.36,3876.01,0.00
2024-12-08 16:53:26,68,3788,23,45,2234.62,3876.02,0.00
2024-12-08 16:53:26,68,3789,23,45,2231.21,3877.00,0.00
2024-12-08 16:53:26,69,3789,23,46,2198.87,3877.01,0.00
2024-12-08 16:53:26,69,3790,23,46,2183.70,3878.00,0.00
2024-12-08 16:53:26,70,3790,24,46,2152.51,3878.01,0.00
2024-12-08 16:53:26,69,3790,24,45,2182.02,3878.01,0.00
2024-12-08 16:53:26,69,3790,24,45,2178.08,3879.00,0.00
2024-12-08 16:53:26,70,3790,24,46,2146.97,3879.01,0.00
2024-12-08 16:53:26,70,3791,24,46,2146.88,3880.00,0.00
2024-12-08 16:53:26,71,3791,24,47,2116.64,3880.01,0.00
2024-12-08 16:53:26,71,3792,24,47,2110.70,3881.00,0.00
2024-12-08 16:53:26,72,3792,25,47,2081.39,3881.01,0.00
2024-12-08 16:53:26,71,3792,24,47,2057.38,3881.59,0.00
2024-12-08 16:53:26,70,3792,23,47,2081.32,3881.73,0.00
2024-12-08 16:53:26,70,3793,23,47,2126.44,3882.00,0.00
2024-12-08 16:53:26,71,3793,23,48,2096.49,3882.01,0.00
2024-12-08 16:53:26,70,3793,23,47,2120.90,3882.01,0.00
2024-12-08 16:53:26,70,3794,23,47,2115.38,3883.00,0.00
2024-12-08 16:53:26,71,3794,24,47,2085.58,3883.01,0.00
2024-12-08 16:53:26,70,3794,24,46,2104.28,3883.01,0.00
2024-12-08 16:53:26,70,3795,24,46,2099.42,3884.00,0.00
2024-12-08 16:53:26,71,3795,25,46,2069.85,3884.01,0.00
2024-12-08 16:53:26,70,3795,25,45,2088.32,3884.01,0.00
2024-12-08 16:53:26,69,3795,24,45,2109.02,3884.23,0.00
2024-12-08 16:53:26,69,3796,24,45,2113.43,3885.00,0.00
2024-12-08 16:53:26,70,3796,24,46,2083.23,3885.01,0.00
2024-12-08 16:53:26,69,3796,24,45,2102.16,3885.01,0.00
2024-12-08 16:53:26,69,3797,24,45,2096.41,3886.00,0.00
2024-12-08 16:53:26,70,3797,24,46,2066.46,3886.01,0.00
2024-12-08 16:53:26,69,3797,24,45,2085.31,3886.01,0.00
2024-12-08 16:53:26,70,3796,25,45,2052.22,3886.13,0.00
2024-12-08 16:53:26,70,3797,25,45,2066.69,3887.00,0.00
2024-12-08 16:53:26,71,3797,26,45,2037.58,3887.01,0.00
2024-12-08 16:53:26,70,3797,25,45,2016.72,3887.54,0.00
2024-12-08 16:53:26,69,3797,24,45,2040.41,3887.70,0.00
2024-12-08 16:53:26,69,3798,24,45,2141.48,3888.00,0.00
2024-12-08 16:53:26,70,3798,24,46,2110.89,3888.01,0.00
2024-12-08 16:53:26,69,3798,24,45,2140.92,3888.01,0.00
2024-12-08 16:53:26,69,3799,24,45,2134.19,3889.00,0.00
2024-12-08 16:53:26,70,3799,24,46,2103.71,3889.01,0.00
2024-12-08 16:53:26,69,3799,24,45,2122.36,3889.01,0.00
2024-12-08 16:53:26,68,3799,24,44,2148.13,3889.09,0.00
2024-12-08 16:53:26,68,3800,24,44,2147.51,3890.00,0.00
2024-12-08 16:53:26,69,3800,25,44,2116.38,3890.01,0.00
2024-12-08 16:53:26,68,3800,25,43,2135.49,3890.02,0.00
2024-12-08 16:53:26,67,3800,24,43,2154.11,3890.27,0.00
2024-12-08 16:53:26,67,3801,24,43,2184.19,3891.00,0.00
2024-12-08 16:53:26,68,3801,25,43,2152.07,3891.02,0.00
2024-12-08 16:53:26,68,3802,25,43,2138.28,3892.00,0.00
2024-12-08 16:53:26,69,3802,26,43,2107.29,3892.01,0.00
2024-12-08 16:53:26,68,3802,26,42,2133.70,3892.02,0.00
2024-12-08 16:53:26,67,3802,25,42,2156.92,3892.22,0.00
2024-12-08 16:53:26,67,3803,25,42,2162.03,3893.00,0.00
2024-12-08 16:53:26,68,3803,26,42,2130.24,3893.02,0.00
2024-12-08 16:53:26,67,3803,26,41,2149.83,3893.02,0.00
2024-12-08 16:53:26,67,3804,26,41,2146.90,3894.00,0.00
2024-12-08 16:53:26,68,3804,26,42,2115.32,3894.02,0.00
2024-12-08 16:53:26,67,3804,26,41,2134.69,3894.02,0.00
2024-12-08 16:53:26,67,3805,26,41,2131.75,3895.00,0.00
2024-12-08 16:53:26,68,3805,26,42,2100.40,3895.02,0.00
2024-12-08 16:53:26,67,3805,25,42,2099.32,3895.34,0.00
2024-12-08 16:53:27,67,3806,25,42,2132.30,3896.00,0.00
2024-12-08 16:53:27,68,3806,26,42,2100.94,3896.02,0.00
2024-12-08 16:53:27,67,3806,26,41,2130.57,3896.03,0.00
2024-12-08 16:53:27,66,3806,25,41,2114.16,3896.68,0.00
2024-12-08 16:53:27,65,3806,24,41,2146.09,3896.69,0.00
2024-12-08 16:53:27,65,3807,24,41,2194.27,3897.00,0.00
2024-12-08 16:53:27,66,3807,25,41,2161.03,3897.02,0.00
2024-12-08 16:53:27,65,3807,24,41,2165.01,3897.31,0.00
2024-12-08 16:53:27,65,3808,24,41,2198.44,3898.00,0.00
2024-12-08 16:53:27,66,3808,24,42,2165.13,3898.02,0.00
2024-12-08 16:53:27,65,3808,24,41,2196.65,3898.03,0.00
2024-12-08 16:53:27,66,3807,25,41,2163.37,3898.06,0.00
2024-12-08 16:53:27,66,3808,25,41,2179.27,3899.00,0.00
2024-12-08 16:53:27,67,3808,25,42,2146.74,3899.02,0.00
2024-12-08 16:53:27,66,3808,24,42,2134.57,3899.49,0.00
2024-12-08 16:53:27,66,3809,24,42,2233.01,3900.00,0.00
2024-12-08 16:53:27,67,3809,24,43,2199.68,3900.02,0.00
2024-12-08 16:53:27,66,3809,24,42,2231.26,3900.05,0.00
2024-12-08 16:53:27,65,3809,23,42,2228.60,3900.54,0.00
2024-12-08 16:53:27,65,3810,23,42,2270.95,3901.00,0.00
2024-12-08 16:53:27,66,3810,24,42,2236.54,3901.02,0.00
2024-12-08 16:53:27,65,3810,23,42,2232.87,3901.68,0.00
2024-12-08 16:53:27,65,3811,23,42,2256.52,3902.00,0.00
2024-12-08 16:53:27,66,3811,24,42,2222.33,3902.02,0.00
2024-12-08 16:53:27,65,3811,24,41,2254.75,3902.05,0.00
2024-12-08 16:53:27,66,3810,24,42,2202.45,3902.55,0.00
2024-12-08 16:53:27,66,3811,24,42,2239.46,3903.00,0.00
2024-12-08 16:53:27,67,3811,25,42,2206.03,3903.02,0.00
2024-12-08 16:53:27,66,3811,24,42,2201.19,3903.42,0.00
2024-12-08 16:53:27,66,3812,24,42,2297.41,3904.00,0.00
2024-12-08 16:53:27,67,3812,24,43,2263.12,3904.02,0.00
2024-12-08 16:53:27,66,3812,24,42,2295.07,3904.05,0.00
2024-12-08 16:53:27,66,3813,24,42,2293.86,3905.00,0.00
2024-12-08 16:53:27,67,3813,25,42,2259.62,3905.02,0.00
2024-12-08 16:53:27,67,3814,25,42,2245.04,3906.00,0.00
2024-12-08 16:53:27,68,3814,26,42,2212.02,3906.02,0.00
2024-12-08 16:53:27,67,3814,26,41,2243.32,3906.05,0.00
2024-12-08 16:53:27,66,3814,25,41,2270.85,3906.21,0.00
2024-12-08 16:53:27,66,3815,25,41,2276.09,3907.00,0.00
2024-12-08 16:53:27,67,3815,25,42,2242.12,3907.02,0.00
2024-12-08 16:53:27,66,3815,25,41,2262.50,3907.05,0.00
2024-12-08 16:53:27,65,3815,24,41,2272.38,3907.68,0.00
2024-12-08 16:53:27,65,3816,24,41,2296.06,3908.00,0.00
2024-12-08 16:53:27,66,3816,25,41,2261.27,3908.02,0.00
2024-12-08 16:53:27,65,3816,25,40,2282.26,3908.05,0.00
2024-12-08 16:53:27,64,3816,24,40,2280.28,3908.53,0.00
2024-12-08 16:53:27,64,3817,24,40,2323.37,3909.00,0.00
2024-12-08 16:53:27,65,3817,24,41,2287.63,3909.02,0.00
2024-12-08 16:53:27,64,3817,23,41,2267.10,3909.92,0.00
2024-12-08 16:53:27,64,3818,23,41,2325.19,3910.00,0.00
2024-12-08 16:53:27,65,3818,24,41,2289.42,3910.02,0.00
2024-12-08 16:53:27,64,3818,24,40,2323.38,3910.05,0.00
2024-12-08 16:53:27,63,3818,23,40,2353.49,3910.21,0.00
2024-12-08 16:53:27,63,3819,23,40,2385.05,3911.00,0.00
2024-12-08 16:53:27,64,3819,23,41,2347.79,3911.02,0.00
2024-12-08 16:53:27,64,3820,23,41,2334.33,3912.00,0.00
2024-12-08 16:53:27,65,3820,24,41,2298.41,3912.02,0.00
2024-12-08 16:53:27,64,3820,24,40,2330.69,3912.06,0.00
2024-12-08 16:53:27,64,3821,24,40,2331.25,3913.00,0.00
2024-12-08 16:53:27,65,3821,25,40,2295.39,3913.02,0.00
2024-12-08 16:53:27,65,3822,25,40,2281.52,3914.00,0.00
2024-12-08 16:53:27,66,3822,25,41,2246.96,3914.02,0.00
2024-12-08 16:53:27,65,3822,25,40,2277.34,3914.06,0.00
2024-12-08 16:53:27,65,3823,25,40,2277.29,3915.00,0.00
2024-12-08 16:53:27,66,3823,26,40,2242.78,3915.02,0.00
2024-12-08 16:53:27,66,3824,26,40,2228.52,3916.00,0.00
2024-12-08 16:53:27,67,3824,26,41,2195.26,3916.02,0.00
2024-12-08 16:53:27,66,3824,26,40,2224.99,3916.06,0.00
2024-12-08 16:53:27,65,3824,25,40,2234.24,3916.69,0.00
2024-12-08 16:53:27,65,3825,25,40,2258.57,3917.00,0.00
2024-12-08 16:53:27,66,3825,26,40,2224.34,3917.02,0.00
2024-12-08 16:53:27,66,3826,26,40,2210.07,3918.00,0.00
2024-12-08 16:53:27,67,3826,26,41,2177.09,3918.02,0.00
2024-12-08 16:53:27,66,3826,26,40,2207.13,3918.06,0.00
2024-12-08 16:53:27,65,3826,25,40,2217.28,3918.68,0.00
2024-12-08 16:53:27,65,3827,25,40,2241.03,3919.00,0.00
2024-12-08 16:53:27,66,3827,25,41,2207.07,3919.02,0.00
2024-12-08 16:53:27,66,3828,25,41,2192.79,3920.00,0.00
2024-12-08 16:53:27,67,3828,26,41,2160.06,3920.02,0.00
2024-12-08 16:53:27,66,3828,26,40,2190.44,3920.06,0.00
2024-12-08 16:53:27,65,3828,25,40,2182.99,3920.91,0.00
2024-12-08 16:53:27,65,3829,25,40,2239.76,3921.00,0.00
2024-12-08 16:53:27,66,3829,26,40,2205.82,3921.02,0.00
2024-12-08 16:53:27,65,3829,26,39,2225.31,3921.06,0.00
2024-12-08 16:53:27,65,3830,26,39,2225.25,3922.00,0.00
2024-12-08 16:53:27,66,3830,26,40,2191.53,3922.02,0.00
2024-12-08 16:53:27,67,3829,27,40,2135.52,3922.34,0.00
2024-12-08 16:53:27,66,3829,26,40,2183.56,3922.71,0.00
2024-12-08 16:53:27,66,3830,26,40,2208.14,3923.00,0.00
2024-12-08 16:53:27,67,3830,27,40,2175.18,3923.02,0.00
2024-12-08 16:53:27,66,3830,27,39,2205.79,3923.06,0.00
2024-12-08 16:53:27,65,3830,26,39,2200.34,3923.88,0.00
2024-12-08 16:53:28,65,3831,26,39,2316.33,3924.00,0.00
2024-12-08 16:53:28,66,3831,27,39,2281.24,3924.02,0.00
2024-12-08 16:53:28,66,3832,27,39,2266.95,3925.00,0.00
2024-12-08 16:53:28,67,3832,28,39,2233.11,3925.02,0.00
2024-12-08 16:53:28,66,3832,28,38,2263.41,3925.06,0.00
2024-12-08 16:53:28,66,3833,28,38,2262.77,3926.00,0.00
2024-12-08 16:53:28,67,3833,29,38,2228.99,3926.02,0.00
2024-12-08 16:53:28,66,3833,28,38,2223.85,3926.71,0.00
2024-12-08 16:53:28,66,3834,28,38,2248.47,3927.00,0.00
2024-12-08 16:53:28,67,3834,29,38,2214.91,3927.02,0.00
2024-12-08 16:53:28,66,3834,29,37,2244.92,3927.06,0.00
2024-12-08 16:53:28,66,3835,29,37,2244.28,3928.00,0.00
2024-12-08 16:53:28,67,3835,30,37,2210.78,3928.02,0.00
2024-12-08 16:53:28,67,3836,30,37,2196.10,3929.00,0.00
2024-12-08 16:53:28,68,3836,30,38,2163.80,3929.02,0.00
2024-12-08 16:53:28,67,3836,30,37,2192.60,3929.06,0.00
2024-12-08 16:53:28,67,3837,30,37,2191.38,3930.00,0.00
2024-12-08 16:53:28,68,3837,31,37,2159.15,3930.02,0.00
2024-12-08 16:53:28,67,3837,30,37,2170.95,3930.22,0.00
2024-12-08 16:53:28,67,3838,30,37,2176.13,3931.00,0.00
2024-12-08 16:53:28,68,3838,30,38,2144.13,3931.02,0.00
2024-12-08 16:53:28,67,3838,30,37,2173.22,3931.06,0.00
2024-12-08 16:53:28,67,3839,30,37,2171.99,3932.00,0.00
2024-12-08 16:53:28,68,3839,31,37,2140.05,3932.02,0.00
2024-12-08 16:53:28,68,3840,31,37,2124.98,3933.00,0.00
2024-12-08 16:53:28,69,3840,31,38,2094.18,3933.01,0.00
2024-12-08 16:53:28,68,3840,31,37,2122.68,3933.06,0.00
2024-12-08 16:53:28,67,3840,30,37,2108.49,3933.97,0.00
2024-12-08 16:53:28,67,3841,30,37,2166.05,3934.00,0.00
2024-12-08 16:53:28,68,3841,31,37,2134.19,3934.02,0.00
2024-12-08 16:53:28,67,3841,30,37,2132.14,3934.39,0.00
2024-12-08 16:53:28,67,3842,30,37,2167.19,3935.00,0.00
2024-12-08 16:53:28,68,3842,30,38,2135.32,3935.02,0.00
2024-12-08 16:53:28,67,3842,30,37,2141.36,3935.06,0.00
2024-12-08 16:53:28,68,3841,31,37,2104.70,3935.22,0.00
2024-12-08 16:53:28,68,3842,31,37,2139.33,3936.00,0.00
2024-12-08 16:53:28,69,3842,32,37,2108.33,3936.01,0.00
2024-12-08 16:53:28,68,3842,32,36,2125.45,3936.06,0.00
2024-12-08 16:53:28,67,3842,31,36,2118.64,3936.58,0.00
2024-12-08 16:53:28,67,3843,31,36,2220.00,3937.00,0.00
2024-12-08 16:53:28,68,3843,31,37,2187.35,3937.02,0.00
2024-12-08 16:53:28,67,3843,31,36,2205.91,3937.06,0.00
2024-12-08 16:53:28,68,3842,32,36,2170.59,3937.16,0.00
2024-12-08 16:53:28,68,3843,32,36,2212.81,3938.00,0.00
2024-12-08 16:53:28,69,3843,32,37,2180.74,3938.01,0.00
2024-12-08 16:53:28,68,3843,32,36,2198.92,3938.06,0.00
2024-12-08 16:53:28,68,3844,32,36,2255.08,3939.00,0.00
2024-12-08 16:53:28,69,3844,32,37,2222.39,3939.01,0.00
2024-12-08 16:53:28,68,3844,32,36,2241.19,3939.06,0.00
2024-12-08 16:53:28,67,3844,31,36,2228.49,3939.66,0.00
2024-12-08 16:53:28,67,3845,31,36,2274.03,3940.00,0.00
2024-12-08 16:53:28,68,3845,32,36,2240.58,3940.02,0.00
2024-12-08 16:53:28,67,3845,31,36,2244.64,3940.09,0.00
2024-12-08 16:53:28,67,3846,31,36,2268.13,3941.00,0.00
2024-12-08 16:53:28,68,3846,32,36,2234.78,3941.02,0.00
2024-12-08 16:53:28,67,3846,32,35,2265.20,3941.06,0.00
2024-12-08 16:53:28,67,3847,32,35,2264.00,3942.00,0.00
2024-12-08 16:53:28,68,3847,32,36,2230.71,3942.02,0.00
2024-12-08 16:53:28,68,3848,32,36,2215.62,3943.00,0.00
2024-12-08 16:53:28,69,3848,33,36,2183.51,3943.01,0.00
2024-12-08 16:53:28,68,3848,33,35,2212.73,3943.06,0.00
2024-12-08 16:53:28,69,3847,33,36,2179.54,3943.12,0.00
2024-12-08 16:53:28,69,3848,33,36,2183.36,3944.00,0.00
2024-12-08 16:53:28,70,3848,33,37,2152.17,3944.01,0.00
2024-12-08 16:53:28,71,3847,33,38,2106.36,3944.16,0.00
2024-12-08 16:53:28,71,3848,33,38,2217.37,3945.00,0.00
2024-12-08 16:53:28,72,3848,33,39,2186.58,3945.01,0.00
2024-12-08 16:53:28,72,3849,33,39,2237.62,3946.00,0.00
2024-12-08 16:53:28,73,3849,33,40,2206.97,3946.01,0.00
2024-12-08 16:53:28,72,3849,32,40,2237.08,3946.01,0.00
2024-12-08 16:53:28,72,3850,32,40,2227.61,3947.00,0.00
2024-12-08 16:53:28,73,3850,33,40,2197.10,3947.01,0.00
2024-12-08 16:53:28,72,3850,32,40,2204.33,3947.29,0.00
2024-12-08 16:53:28,72,3851,32,40,2230.47,3948.00,0.00
2024-12-08 16:53:28,73,3851,32,41,2199.92,3948.01,0.00
2024-12-08 16:53:28,72,3851,32,40,2223.90,3948.04,0.00
2024-12-08 16:53:28,72,3852,32,40,2219.52,3949.00,0.00
2024-12-08 16:53:28,73,3852,32,41,2189.11,3949.01,0.00
2024-12-08 16:53:28,74,3851,33,41,2102.37,3949.95,0.00
2024-12-08 16:53:28,74,3852,33,41,2155.79,3950.00,0.00
2024-12-08 16:53:28,75,3852,33,42,2127.05,3950.01,0.00
2024-12-08 16:53:28,74,3852,32,42,2118.02,3950.32,0.00
2024-12-08 16:53:28,74,3853,32,42,2198.53,3951.00,0.00
2024-12-08 16:53:28,75,3853,32,43,2169.22,3951.01,0.00
2024-12-08 16:53:28,74,3853,31,43,2178.86,3951.24,0.00
2024-12-08 16:53:29,74,3854,31,43,2198.19,3952.00,0.00
2024-12-08 16:53:29,75,3854,32,43,2168.88,3952.01,0.00
2024-12-08 16:53:29,74,3854,31,43,2178.51,3952.24,0.00
2024-12-08 16:53:29,74,3855,31,43,2194.73,3953.00,0.00
2024-12-08 16:53:29,75,3855,32,43,2165.46,3953.01,0.00
2024-12-08 16:53:29,75,3856,32,43,2153.69,3954.00,0.00
2024-12-08 16:53:29,76,3856,32,44,2125.35,3954.01,0.00
2024-12-08 16:53:29,76,3857,32,44,2104.08,3955.00,0.00
2024-12-08 16:53:29,77,3857,32,45,2076.76,3955.01,0.00
2024-12-08 16:53:29,76,3857,32,44,2097.85,3955.05,0.00
2024-12-08 16:53:29,76,3858,32,44,2085.47,3956.00,0.00
2024-12-08 16:53:29,77,3858,33,44,2058.38,3956.01,0.00
2024-12-08 16:53:29,76,3858,33,43,2075.06,3956.05,0.00
2024-12-08 16:53:29,76,3859,33,43,2062.69,3957.00,0.00
2024-12-08 16:53:29,77,3859,33,44,2035.90,3957.01,0.00
2024-12-08 16:53:29,76,3859,33,43,2049.17,3957.08,0.00
2024-12-08 16:53:29,75,3859,32,43,2048.15,3957.47,0.00
2024-12-08 16:53:29,74,3859,31,43,2070.74,3957.49,0.00
2024-12-08 16:53:29,73,3859,30,43,2090.55,3957.70,0.00
2024-12-08 16:53:29,73,3860,30,43,2133.07,3958.00,0.00
2024-12-08 16:53:29,74,3860,30,44,2104.25,3958.01,0.00
2024-12-08 16:53:29,73,3860,29,44,2103.82,3958.12,0.00
2024-12-08 16:53:29,73,3860,29,44,2123.65,3959.00,0.00
2024-12-08 16:53:29,74,3860,29,45,2094.95,3959.01,0.00
2024-12-08 16:53:29,73,3860,28,45,2101.96,3959.01,0.00
2024-12-08 16:53:29,72,3860,28,44,2128.42,3959.07,0.00
2024-12-08 16:53:29,72,3861,28,44,2147.09,3960.00,0.00
2024-12-08 16:53:29,73,3861,28,45,2117.68,3960.01,0.00
2024-12-08 16:53:29,72,3861,28,44,2133.35,3960.07,0.00
2024-12-08 16:53:29,73,3860,28,45,2052.98,3960.85,0.00
2024-12-08 16:53:29,73,3861,28,45,2106.82,3961.00,0.00
2024-12-08 16:53:29,74,3861,29,45,2078.35,3961.01,0.00
2024-12-08 16:53:29,73,3861,28,45,2070.20,3961.67,0.00
2024-12-08 16:53:29,73,3862,28,45,2165.97,3962.00,0.00
2024-12-08 16:53:29,74,3862,29,45,2136.70,3962.01,0.00
2024-12-08 16:53:29,73,3862,29,44,2164.88,3962.03,0.00
2024-12-08 16:53:29,72,3862,28,44,2188.35,3962.03,0.00
2024-12-08 16:53:29,71,3862,28,43,2218.06,3962.04,0.00
2024-12-08 16:53:29,70,3862,27,43,2243.00,3962.20,0.00
2024-12-08 16:53:29,70,3863,27,43,2267.63,3963.00,0.00
2024-12-08 16:53:29,71,3863,28,43,2235.69,3963.01,0.00
2024-12-08 16:53:29,70,3863,27,43,2254.05,3963.04,0.00
2024-12-08 16:53:29,70,3864,27,43,2259.88,3964.00,0.00
2024-12-08 16:53:29,71,3864,27,44,2228.05,3964.01,0.00
2024-12-08 16:53:29,70,3864,26,44,2259.32,3964.01,0.00
2024-12-08 16:53:29,71,3863,27,44,2227.50,3964.04,0.00
2024-12-08 16:53:29,70,3863,27,43,2268.96,3964.04,0.00
2024-12-08 16:53:29,71,3862,27,44,2205.45,3964.79,0.00
2024-12-08 16:53:29,71,3863,27,44,2250.41,3965.00,0.00
2024-12-08 16:53:29,72,3863,28,44,2219.15,3965.01,0.00
2024-12-08 16:53:29,71,3863,27,44,2191.01,3965.59,0.00
2024-12-08 16:53:29,71,3864,27,44,2342.69,3966.00,0.00
2024-12-08 16:53:29,72,3864,28,44,2310.15,3966.01,0.00
2024-12-08 16:53:29,71,3864,28,43,2341.79,3966.03,0.00
2024-12-08 16:53:29,71,3865,28,43,2334.86,3967.00,0.00
2024-12-08 16:53:29,72,3865,28,44,2302.43,3967.01,0.00
2024-12-08 16:53:29,71,3865,27,44,2315.92,3967.18,0.00
2024-12-08 16:53:29,72,3864,27,45,2261.49,3967.78,0.00
2024-12-08 16:53:29,72,3865,27,45,2357.54,3968.00,0.00
2024-12-08 16:53:29,73,3865,27,46,2325.25,3968.01,0.00
2024-12-08 16:53:29,72,3865,27,45,2356.45,3968.03,0.00
2024-12-08 16:53:29,71,3865,26,45,2360.16,3968.42,0.00
2024-12-08 16:53:29,71,3866,26,45,2449.49,3969.00,0.00
2024-12-08 16:53:29,72,3866,27,45,2415.47,3969.01,0.00
2024-12-08 16:53:29,71,3866,27,44,2437.20,3969.03,0.00
2024-12-08 16:53:29,71,3867,27,44,2432.77,3970.00,0.00
2024-12-08 16:53:29,72,3867,27,45,2398.98,3970.01,0.00
2024-12-08 16:53:29,71,3867,26,45,2414.93,3970.17,0.00
2024-12-08 16:53:29,71,3868,26,45,2412.67,3971.00,0.00
2024-12-08 16:53:29,72,3868,26,46,2379.17,3971.01,0.00
2024-12-08 16:53:29,71,3868,26,45,2409.33,3971.04,0.00
2024-12-08 16:53:29,70,3868,25,45,2437.55,3971.17,0.00
2024-12-08 16:53:29,71,3867,25,46,2394.92,3971.41,0.00
2024-12-08 16:53:29,72,3866,25,47,2354.69,3971.96,0.00
2024-12-08 16:53:29,72,3867,25,47,2409.89,3972.00,0.00
2024-12-08 16:53:29,73,3867,25,48,2376.88,3972.01,0.00
2024-12-08 16:53:29,73,3868,25,48,2461.84,3973.00,0.00
2024-12-08 16:53:29,74,3868,26,48,2428.57,3973.01,0.00
2024-12-08 16:53:29,73,3868,26,47,2459.13,3973.04,0.00
2024-12-08 16:53:29,72,3868,25,47,2475.16,3973.39,0.00
2024-12-08 16:53:29,72,3869,25,47,2484.47,3974.00,0.00
2024-12-08 16:53:29,73,3869,26,47,2450.43,3974.01,0.00
2024-12-08 16:53:29,73,3870,26,47,2433.63,3975.00,0.00
2024-12-08 16:53:29,74,3870,27,47,2400.74,3975.01,0.00
2024-12-08 16:53:29,73,3870,27,46,2430.37,3975.04,0.00
2024-12-08 16:53:29,74,3869,27,47,2379.47,3975.53,0.00
2024-12-08 16:53:29,75,3868,28,47,2358.95,3975.64,0.00
2024-12-08 16:53:29,75,3869,28,47,2380.46,3976.00,0.00
2024-12-08 16:53:29,76,3869,28,48,2349.14,3976.01,0.00
2024-12-08 16:53:29,76,3870,28,48,2436.07,3977.00,0.00
2024-12-08 16:53:29,77,3870,29,48,2404.43,3977.01,0.00
2024-12-08 16:53:29,76,3870,29,47,2433.47,3977.04,0.00
2024-12-08 16:53:30,76,3871,29,47,2427.26,3978.00,0.00
2024-12-08 16:53:30,77,3871,30,47,2395.74,3978.01,0.00
2024-12-08 16:53:30,78,3870,30,48,2335.65,3978.53,0.00
2024-12-08 16:53:30,78,3871,30,48,2356.19,3979.00,0.00
2024-12-08 16:53:30,79,3871,31,48,2326.37,3979.01,0.00
2024-12-08 16:53:30,78,3871,31,47,2354.17,3979.04,0.00
2024-12-08 16:53:30,78,3872,31,47,2397.56,3980.00,0.00
2024-12-08 16:53:30,79,3872,32,47,2367.21,3980.01,0.00
2024-12-08 16:53:30,79,3873,32,47,2347.78,3981.00,0.00
2024-12-08 16:53:30,80,3873,32,48,2318.43,3981.01,0.00
2024-12-08 16:53:30,79,3873,32,47,2345.78,3981.04,0.00
2024-12-08 16:53:30,78,3873,31,47,2371.80,3981.14,0.00
2024-12-08 16:53:30,78,3874,31,47,2367.76,3982.00,0.00
2024-12-08 16:53:30,79,3874,32,47,2337.79,3982.01,0.00
2024-12-08 16:53:30,79,3875,32,47,2318.06,3983.00,0.00
2024-12-08 16:53:30,80,3875,32,48,2289.09,3983.01,0.00
2024-12-08 16:53:30,81,3874,32,49,2260.83,3983.04,0.00
2024-12-08 16:53:30,80,3874,32,48,2296.57,3983.05,0.00
2024-12-08 16:53:30,80,3875,32,48,2287.90,3984.00,0.00
2024-12-08 16:53:30,81,3875,33,48,2259.66,3984.01,0.00
2024-12-08 16:53:30,80,3875,32,48,2244.79,3984.75,0.00
2024-12-08 16:53:30,80,3876,32,48,2334.64,3985.00,0.00
2024-12-08 16:53:30,81,3876,32,49,2305.82,3985.01,0.00
2024-12-08 16:53:30,80,3876,32,48,2332.16,3985.04,0.00
2024-12-08 16:53:30,79,3876,31,48,2357.68,3985.14,0.00
2024-12-08 16:53:30,78,3876,30,48,2387.39,3985.14,0.00
2024-12-08 16:53:30,78,3877,30,48,2383.25,3986.00,0.00
2024-12-08 16:53:30,79,3877,31,48,2353.08,3986.01,0.00
2024-12-08 16:53:30,78,3877,30,48,2366.43,3986.15,0.00
2024-12-08 16:53:30,77,3877,29,48,2375.16,3986.68,0.00
2024-12-08 16:53:30,77,3878,29,48,2414.25,3987.00,0.00
2024-12-08 16:53:30,78,3878,29,49,2383.30,3987.01,0.00
2024-12-08 16:53:30,77,3878,29,48,2411.67,3987.04,0.00
2024-12-08 16:53:30,76,3878,28,48,2439.76,3987.13,0.00
2024-12-08 16:53:30,76,3879,28,48,2436.17,3988.00,0.00
2024-12-08 16:53:30,77,3879,29,48,2404.53,3988.01,0.00
2024-12-08 16:53:30,76,3879,28,48,2413.15,3988.21,0.00
2024-12-08 16:53:30,77,3878,29,48,2374.67,3988.42,0.00
2024-12-08 16:53:30,77,3879,29,48,2421.87,3989.00,0.00
2024-12-08 16:53:30,78,3879,30,48,2390.82,3989.01,0.00
2024-12-08 16:53:30,77,3879,30,47,2419.29,3989.04,0.00
2024-12-08 16:53:30,76,3879,29,47,2448.00,3989.12,0.00
2024-12-08 16:53:30,76,3880,29,47,2496.88,3990.00,0.00
2024-12-08 16:53:30,77,3880,29,48,2464.46,3990.01,0.00
2024-12-08 16:53:30,77,3881,29,48,2446.22,3991.00,0.00
2024-12-08 16:53:30,78,3881,30,48,2414.86,3991.01,0.00
2024-12-08 16:53:30,77,3881,30,47,2443.12,3991.04,0.00
2024-12-08 16:53:30,77,3882,30,47,2436.46,3992.00,0.00
2024-12-08 16:53:30,78,3882,31,47,2405.22,3992.01,0.00
2024-12-08 16:53:30,77,3882,30,47,2406.41,3992.09,0.00
2024-12-08 16:53:30,77,3883,30,47,2422.55,3993.00,0.00
2024-12-08 16:53:30,78,3883,30,48,2391.49,3993.01,0.00
2024-12-08 16:53:30,77,3883,29,48,2421.53,3993.03,0.00
2024-12-08 16:53:30,76,3883,29,47,2451.29,3993.03,0.00
2024-12-08 16:53:30,76,3884,29,47,2444.53,3994.00,0.00
2024-12-08 16:53:30,77,3884,29,48,2412.78,3994.01,0.00
2024-12-08 16:53:30,77,3885,29,48,2394.71,3995.00,0.00
2024-12-08 16:53:30,78,3885,30,48,2364.01,3995.01,0.00
2024-12-08 16:53:30,77,3885,30,47,2392.13,3995.03,0.00
2024-12-08 16:53:30,78,3884,31,47,2350.33,3995.33,0.00
2024-12-08 16:53:30,77,3884,30,47,2389.81,3995.68,0.00
2024-12-08 16:53:30,76,3884,29,47,2420.72,3995.68,0.00
2024-12-08 16:53:30,76,3885,29,47,2460.92,3996.00,0.00
2024-12-08 16:53:30,77,3885,29,48,2428.96,3996.01,0.00
2024-12-08 16:53:30,78,3884,29,49,2378.96,3996.26,0.00
2024-12-08 16:53:30,78,3885,29,49,2441.83,3997.00,0.00
2024-12-08 16:53:30,79,3885,30,49,2410.92,3997.01,0.00
2024-12-08 16:53:30,78,3885,30,48,2439.79,3997.03,0.00
2024-12-08 16:53:30,78,3886,30,48,2483.33,3998.00,0.00
2024-12-08 16:53:30,79,3886,30,49,2451.89,3998.01,0.00
2024-12-08 16:53:30,79,3887,30,49,2433.17,3999.00,0.00
2024-12-08 16:53:30,80,3887,31,49,2402.76,3999.01,0.00
2024-12-08 16:53:30,79,3887,31,48,2430.65,3999.03,0.00
2024-12-08 16:53:30,78,3887,30,48,2420.19,3999.90,0.00
2024-12-08 16:53:30,78,3888,30,48,2467.45,4000.00,0.00
2024-12-08 16:53:30,79,3888,30,49,2436.21,4000.01,0.00
2024-12-08 16:53:30,79,3889,30,49,2416.64,4001.00,0.00
2024-12-08 16:53:30,80,3889,31,49,2386.43,4001.01,0.00
2024-12-08 16:53:30,79,3889,31,48,2411.59,4001.03,0.00
2024-12-08 16:53:30,80,3888,32,48,2374.30,4001.19,0.00
2024-12-08 16:53:30,79,3888,31,48,2406.72,4001.73,0.00
2024-12-08 16:53:30,79,3889,31,48,2446.95,4002.00,0.00
2024-12-08 16:53:30,80,3889,31,49,2416.36,4002.01,0.00
2024-12-08 16:53:30,81,3888,31,50,2375.18,4002.07,0.00
2024-12-08 16:53:30,81,3889,31,50,2428.63,4003.00,0.00
2024-12-08 16:53:30,82,3889,32,50,2399.01,4003.01,0.00
2024-12-08 16:53:30,81,3889,32,49,2423.70,4003.03,0.00
2024-12-08 16:53:30,80,3889,31,49,2420.49,4003.73,0.00
2024-12-08 16:53:31,80,3890,31,49,2509.79,4004.00,0.00
2024-12-08 16:53:31,81,3890,31,50,2478.80,4004.01,0.00
2024-12-08 16:53:31,81,3891,31,50,2454.10,4005.00,0.00
2024-12-08 16:53:31,82,3891,31,51,2424.17,4005.01,0.00
2024-12-08 16:53:31,83,3890,31,52,2394.96,4005.04,0.00
2024-12-08 16:53:31,82,3890,31,51,2430.04,4005.04,0.00
2024-12-08 16:53:31,81,3890,31,50,2450.91,4005.12,0.00
2024-12-08 16:53:31,81,3891,31,50,2444.45,4006.00,0.00
2024-12-08 16:53:31,82,3891,32,50,2414.64,4006.01,0.00
2024-12-08 16:53:31,82,3892,32,50,2442.04,4007.00,0.00
2024-12-08 16:53:31,83,3892,33,50,2412.62,4007.01,0.00
2024-12-08 16:53:31,82,3892,33,49,2436.68,4007.04,0.00
2024-12-08 16:53:31,82,3893,33,49,2425.49,4008.00,0.00
2024-12-08 16:53:31,83,3893,34,49,2396.27,4008.01,0.00
2024-12-08 16:53:31,82,3893,33,49,2410.41,4008.15,0.00
2024-12-08 16:53:31,81,3893,32,49,2398.04,4008.94,0.00
2024-12-08 16:53:31,81,3894,32,49,2445.10,4009.00,0.00
2024-12-08 16:53:31,82,3894,32,50,2415.28,4009.01,0.00
2024-12-08 16:53:31,81,3894,32,49,2439.68,4009.04,0.00
2024-12-08 16:53:31,82,3893,33,49,2388.02,4009.55,0.00
2024-12-08 16:53:31,82,3894,33,49,2415.75,4010.00,0.00
2024-12-08 16:53:31,83,3894,34,49,2386.64,4010.01,0.00
2024-12-08 16:53:31,84,3893,35,49,2329.95,4010.49,0.00
2024-12-08 16:53:31,84,3894,35,49,2410.79,4011.00,0.00
2024-12-08 16:53:31,85,3894,35,50,2382.43,4011.01,0.00
2024-12-08 16:53:31,84,3894,35,49,2406.04,4011.04,0.00
2024-12-08 16:53:31,85,3893,35,50,2371.21,4011.22,0.00
2024-12-08 16:53:31,85,3894,35,50,2441.01,4012.00,0.00
2024-12-08 16:53:31,86,3894,36,50,2412.63,4012.01,0.00
2024-12-08 16:53:31,87,3893,37,50,2370.66,4012.16,0.00
2024-12-08 16:53:31,87,3894,37,50,2431.53,4013.00,0.00
2024-12-08 16:53:31,88,3894,37,51,2403.89,4013.01,0.00
2024-12-08 16:53:31,87,3894,37,50,2427.39,4013.03,0.00
2024-12-08 16:53:31,86,3894,36,50,2409.52,4013.94,0.00
2024-12-08 16:53:31,86,3895,36,50,2500.47,4014.00,0.00
2024-12-08 16:53:31,87,3895,36,51,2471.73,4014.01,0.00
2024-12-08 16:53:31,86,3895,35,51,2477.55,4014.16,0.00
2024-12-08 16:53:31,86,3896,35,51,2488.29,4015.00,0.00
2024-12-08 16:53:31,87,3896,36,51,2459.69,4015.01,0.00
2024-12-08 16:53:31,86,3896,36,50,2483.64,4015.04,0.00
2024-12-08 16:53:31,85,3896,35,50,2499.16,4015.04,0.00
2024-12-08 16:53:31,84,3896,34,50,2498.39,4015.69,0.00
2024-12-08 16:53:31,84,3897,34,50,2533.76,4016.00,0.00
2024-12-08 16:53:31,85,3897,35,50,2503.95,4016.01,0.00
2024-12-08 16:53:31,84,3897,34,50,2513.63,4016.18,0.00
2024-12-08 16:53:31,84,3898,34,50,2507.61,4017.00,0.00
2024-12-08 16:53:31,85,3898,34,51,2478.11,4017.01,0.00
2024-12-08 16:53:31,84,3898,34,50,2502.85,4017.04,0.00
2024-12-08 16:53:31,83,3898,34,49,2526.19,4017.16,0.00
2024-12-08 16:53:31,83,3899,34,49,2519.48,4018.00,0.00
2024-12-08 16:53:31,84,3899,35,49,2489.49,4018.01,0.00
2024-12-08 16:53:31,85,3898,36,49,2423.45,4018.54,0.00
2024-12-08 16:53:31,85,3899,36,49,2468.60,4019.00,0.00
2024-12-08 16:53:31,86,3899,36,50,2439.90,4019.01,0.00
2024-12-08 16:53:31,86,3900,36,50,2474.26,4020.00,0.00
2024-12-08 16:53:31,87,3900,37,50,2445.82,4020.01,0.00
2024-12-08 16:53:31,87,3901,37,50,2425.88,4021.00,0.00
2024-12-08 16:53:31,88,3901,37,51,2398.31,4021.01,0.00
2024-12-08 16:53:31,87,3901,37,50,2415.26,4021.03,0.00
2024-12-08 16:53:31,86,3901,36,50,2436.41,4021.20,0.00
2024-12-08 16:53:31,86,3902,36,50,2430.82,4022.00,0.00
2024-12-08 16:53:31,87,3902,37,50,2402.88,4022.01,0.00
2024-12-08 16:53:31,87,3903,37,50,2380.56,4023.00,0.00
2024-12-08 16:53:31,88,3903,38,50,2353.50,4023.01,0.00
2024-12-08 16:53:31,87,3903,38,49,2378.26,4023.03,0.00
2024-12-08 16:53:31,87,3904,38,49,2366.10,4024.00,0.00
2024-12-08 16:53:31,88,3904,39,49,2339.21,4024.01,0.00
2024-12-08 16:53:31,87,3904,38,49,2349.53,4024.20,0.00
2024-12-08 16:53:31,87,3905,38,49,2356.27,4025.00,0.00
2024-12-08 16:53:31,88,3905,38,50,2329.50,4025.01,0.00
2024-12-08 16:53:31,88,3906,38,50,2313.81,4026.00,0.00
2024-12-08 16:53:31,89,3906,38,51,2287.81,4026.01,0.00
2024-12-08 16:53:31,88,3906,37,51,2296.06,4026.23,0.00
2024-12-08 16:53:31,88,3907,37,51,2290.43,4027.00,0.00
2024-12-08 16:53:31,89,3907,38,51,2264.70,4027.01,0.00
2024-12-08 16:53:31,88,3907,38,50,2284.95,4027.03,0.00
2024-12-08 16:53:31,87,3907,37,50,2255.22,4027.98,0.00
2024-12-08 16:53:31,87,3908,37,50,2300.60,4028.00,0.00
2024-12-08 16:53:31,88,3908,38,50,2274.46,4028.01,0.00
2024-12-08 16:53:31,87,3908,38,49,2289.97,4028.03,0.00
2024-12-08 16:53:31,88,3907,39,49,2263.05,4028.08,0.00
2024-12-08 16:53:31,89,3906,39,50,2255.28,4028.10,0.00
2024-12-08 16:53:31,88,3906,38,50,2265.54,4028.75,0.00
2024-12-08 16:53:31,88,3907,38,50,2283.12,4029.00,0.00
2024-12-08 16:53:31,89,3907,38,51,2257.47,4029.01,0.00
2024-12-08 16:53:31,90,3906,38,52,2232.38,4029.03,0.00
2024-12-08 16:53:31,89,3906,38,51,2245.31,4029.28,0.00
2024-12-08 16:53:31,90,3905,39,51,2205.79,4029.67,0.00
2024-12-08 16:53:31,91,3904,39,52,2191.33,4029.73,0.00
2024-12-08 16:53:31,91,3905,39,52,2311.81,4030.00,0.00
2024-12-08 16:53:31,92,3905,40,52,2286.68,4030.01,0.00
2024-12-08 16:53:32,92,3906,40,52,2396.74,4031.00,0.00
2024-12-08 16:53:32,93,3906,41,52,2370.97,4031.01,0.00
2024-12-08 16:53:32,92,3906,41,51,2392.37,4031.03,0.00
2024-12-08 16:53:32,92,3907,41,51,2380.24,4032.00,0.00
2024-12-08 16:53:32,93,3907,42,51,2354.65,4032.01,0.00
2024-12-08 16:53:32,93,3908,42,51,2346.38,4033.00,0.00
2024-12-08 16:53:32,94,3908,42,52,2321.42,4033.01,0.00
2024-12-08 16:53:32,93,3908,41,52,2327.40,4033.26,0.00
2024-12-08 16:53:32,93,3909,41,52,2336.11,4034.00,0.00
2024-12-08 16:53:32,94,3909,41,53,2311.25,4034.01,0.00
2024-12-08 16:53:32,94,3910,41,53,2296.94,4035.00,0.00
2024-12-08 16:53:32,95,3910,42,53,2272.76,4035.01,0.00
2024-12-08 16:53:32,95,3911,42,53,2251.95,4036.00,0.00
2024-12-08 16:53:32,96,3911,43,53,2228.49,4036.01,0.00
2024-12-08 16:53:32,95,3911,43,52,2245.17,4036.04,0.00
2024-12-08 16:53:32,95,3912,43,52,2232.53,4037.00,0.00
2024-12-08 16:53:32,96,3912,44,52,2209.28,4037.01,0.00
2024-12-08 16:53:32,95,3912,43,52,2195.07,4037.74,0.00
2024-12-08 16:53:32,94,3912,42,52,2213.31,4037.81,0.00
2024-12-08 16:53:32,94,3913,42,52,2248.68,4038.00,0.00
2024-12-08 16:53:32,95,3913,42,53,2225.01,4038.01,0.00
2024-12-08 16:53:32,95,3914,42,53,2214.06,4039.00,0.00
2024-12-08 16:53:32,96,3914,43,53,2191.00,4039.01,0.00
2024-12-08 16:53:32,95,3914,42,53,2194.60,4039.28,0.00
2024-12-08 16:53:32,95,3915,42,53,2198.35,4040.00,0.00
2024-12-08 16:53:32,96,3915,42,54,2175.45,4040.01,0.00
2024-12-08 16:53:32,97,3914,43,54,2107.88,4040.94,0.00
2024-12-08 16:53:32,97,3915,43,54,2133.43,4041.00,0.00
2024-12-08 16:53:32,98,3915,43,55,2111.66,4041.01,0.00
2024-12-08 16:53:32,97,3915,43,54,2128.87,4041.04,0.00
2024-12-08 16:53:32,96,3915,42,54,2151.01,4041.04,0.00
2024-12-08 16:53:32,97,3914,43,54,2121.80,4041.24,0.00
2024-12-08 16:53:32,96,3914,42,54,2169.19,4041.29,0.00
2024-12-08 16:53:32,97,3913,42,55,2128.39,4041.75,0.00
2024-12-08 16:53:32,97,3914,42,55,2210.25,4042.00,0.00
2024-12-08 16:53:32,98,3914,42,56,2187.69,4042.01,0.00
2024-12-08 16:53:32,98,3915,42,56,2257.59,4043.00,0.00
2024-12-08 16:53:32,99,3915,42,57,2234.78,4043.01,0.00
2024-12-08 16:53:32,98,3915,41,57,2216.95,4043.68,0.00
2024-12-08 16:53:32,98,3916,41,57,2245.66,4044.00,0.00
2024-12-08 16:53:32,99,3916,42,57,2222.98,4044.01,0.00
2024-12-08 16:53:32,99,3917,42,57,2198.85,4045.00,0.00
2024-12-08 16:53:32,100,3917,43,57,2176.86,4045.01,0.00
2024-12-08 16:53:32,99,3917,43,56,2194.78,4045.04,0.00
2024-12-08 16:53:32,100,3916,44,56,2165.20,4045.25,0.00
2024-12-08 16:53:32,99,3916,43,56,2197.97,4045.49,0.00
2024-12-08 16:53:32,99,3917,43,56,2216.83,4046.00,0.00
2024-12-08 16:53:32,100,3917,43,57,2194.66,4046.01,0.00
2024-12-08 16:53:32,99,3917,43,56,2210.72,4046.04,0.00
2024-12-08 16:53:32,99,3918,43,56,2235.97,4047.00,0.00
2024-12-08 16:53:32,100,3918,43,57,2213.61,4047.01,0.00
2024-12-08 16:53:32,99,3918,43,56,2229.85,4047.04,0.00
2024-12-08 16:53:32,98,3918,42,56,2242.78,4047.29,0.00
2024-12-08 16:53:32,98,3919,42,56,2237.10,4048.00,0.00
2024-12-08 16:53:32,99,3919,43,56,2214.51,4048.01,0.00
2024-12-08 16:53:32,98,3919,43,55,2213.57,4048.05,0.00
2024-12-08 16:53:32,98,3920,43,55,2214.79,4049.00,0.00
2024-12-08 16:53:32,99,3920,43,56,2192.42,4049.01,0.00
2024-12-08 16:53:32,98,3920,43,55,2208.20,4049.05,0.00
2024-12-08 16:53:32,97,3920,42,55,2221.85,4049.28,0.00
2024-12-08 16:53:32,96,3920,41,55,2218.68,4049.71,0.00
2024-12-08 16:53:32,96,3921,41,55,2249.28,4050.00,0.00
2024-12-08 16:53:32,97,3921,42,55,2226.09,4050.01,0.00
2024-12-08 16:53:32,96,3921,42,54,2240.01,4050.08,0.00
2024-12-08 16:53:32,96,3922,42,54,2226.18,4051.00,0.00
2024-12-08 16:53:32,97,3922,42,55,2203.23,4051.01,0.00
2024-12-08 16:53:32,96,3922,42,54,2216.06,4051.08,0.00
2024-12-08 16:53:32,95,3922,41,54,2214.54,4051.27,0.00
2024-12-08 16:53:32,95,3923,41,54,2226.22,4052.00,0.00
2024-12-08 16:53:32,96,3923,42,54,2203.03,4052.01,0.00
2024-12-08 16:53:32,97,3922,43,54,2180.32,4052.03,0.00
2024-12-08 16:53:32,96,3922,43,53,2218.25,4052.09,0.00
2024-12-08 16:53:32,97,3921,44,53,2151.68,4052.72,0.00
2024-12-08 16:53:32,97,3922,44,53,2191.59,4053.00,0.00
2024-12-08 16:53:32,98,3922,45,53,2169.23,4053.01,0.00
2024-12-08 16:53:32,97,3922,45,52,2182.00,4053.08,0.00
2024-12-08 16:53:32,96,3922,44,52,2187.45,4053.47,0.00
2024-12-08 16:53:32,95,3922,43,52,2201.10,4053.50,0.00
2024-12-08 16:53:32,95,3923,43,52,2308.98,4054.00,0.00
2024-12-08 16:53:32,96,3923,44,52,2284.93,4054.01,0.00
2024-12-08 16:53:32,95,3923,44,51,2297.48,4054.11,0.00
2024-12-08 16:53:32,94,3923,43,51,2301.75,4054.43,0.00
2024-12-08 16:53:32,94,3924,43,51,2322.00,4055.00,0.00
2024-12-08 16:53:32,95,3924,44,51,2297.56,4055.01,0.00
2024-12-08 16:53:32,94,3924,44,50,2318.57,4055.04,0.00
2024-12-08 16:53:32,93,3924,43,50,2338.98,4055.12,0.00
2024-12-08 16:53:32,93,3925,43,50,2329.93,4056.00,0.00
2024-12-08 16:53:32,94,3925,43,51,2305.14,4056.01,0.00
2024-12-08 16:53:32,93,3925,43,50,2319.05,4056.10,0.00
2024-12-08 16:53:32,92,3925,42,50,2300.93,4056.73,0.00
2024-12-08 16:53:33,92,3926,42,50,2334.23,4057.00,0.00
2024-12-08 16:53:33,93,3926,43,50,2309.13,4057.01,0.00
2024-12-08 16:53:33,94,3925,44,50,2260.96,4057.40,0.00
2024-12-08 16:53:33,94,3926,44,50,2297.99,4058.00,0.00
2024-12-08 16:53:33,95,3926,45,50,2273.80,4058.01,0.00
2024-12-08 16:53:33,96,3925,45,51,2221.16,4058.54,0.00
2024-12-08 16:53:33,96,3926,45,51,2295.99,4059.00,0.00
2024-12-08 16:53:33,97,3926,45,52,2272.32,4059.01,0.00
2024-12-08 16:53:33,97,3927,45,52,2296.11,4060.00,0.00
2024-12-08 16:53:33,98,3927,45,53,2272.68,4060.01,0.00
2024-12-08 16:53:33,98,3928,45,53,2249.62,4061.00,0.00
2024-12-08 16:53:33,99,3928,46,53,2226.89,4061.01,0.00
2024-12-08 16:53:33,98,3928,46,52,2245.90,4061.09,0.00
2024-12-08 16:53:33,97,3928,45,52,2259.92,4061.31,0.00
2024-12-08 16:53:33,96,3928,44,52,2267.94,4061.70,0.00
2024-12-08 16:53:33,96,3929,44,52,2281.14,4062.00,0.00
2024-12-08 16:53:33,97,3929,45,52,2257.62,4062.01,0.00
2024-12-08 16:53:33,96,3929,44,52,2279.46,4062.04,0.00
2024-12-08 16:53:33,95,3929,44,51,2295.33,4062.08,0.00
2024-12-08 16:53:33,94,3929,43,51,2279.62,4062.63,0.00
2024-12-08 16:53:33,93,3929,42,51,2291.13,4062.94,0.00
2024-12-08 16:53:33,93,3930,42,51,2332.25,4063.00,0.00
2024-12-08 16:53:33,94,3930,43,51,2307.44,4063.01,0.00
2024-12-08 16:53:33,93,3930,42,51,2331.82,4063.02,0.00
2024-12-08 16:53:33,92,3930,42,50,2347.47,4063.09,0.00
2024-12-08 16:53:33,93,3929,42,51,2300.81,4063.61,0.00
2024-12-08 16:53:33,94,3928,43,51,2277.51,4063.90,0.00
2024-12-08 16:53:33,94,3929,43,51,2320.40,4064.00,0.00
2024-12-08 16:53:33,95,3929,43,52,2295.98,4064.01,0.00
2024-12-08 16:53:33,94,3929,43,51,2319.12,4064.03,0.00
2024-12-08 16:53:33,93,3929,42,51,2343.62,4064.03,0.00
2024-12-08 16:53:33,92,3929,42,50,2359.39,4064.08,0.00
2024-12-08 16:53:33,92,3930,42,50,2432.88,4065.00,0.00
2024-12-08 16:53:33,93,3930,43,50,2406.72,4065.01,0.00
2024-12-08 16:53:33,92,3930,43,49,2421.86,4065.08,0.00
2024-12-08 16:53:33,91,3930,42,49,2427.07,4065.22,0.00
2024-12-08 16:53:33,92,3929,43,49,2390.44,4065.44,0.00
2024-12-08 16:53:33,92,3930,43,49,2418.63,4066.00,0.00
2024-12-08 16:53:33,93,3930,43,50,2392.62,4066.01,0.00
2024-12-08 16:53:33,93,3931,43,50,2416.93,4067.00,0.00
2024-12-08 16:53:33,94,3931,43,51,2391.22,4067.01,0.00
2024-12-08 16:53:33,93,3931,42,51,2379.99,4067.37,0.00
2024-12-08 16:53:33,93,3932,42,51,2397.95,4068.00,0.00
2024-12-08 16:53:33,94,3932,43,51,2372.44,4068.01,0.00
2024-12-08 16:53:33,93,3932,43,50,2373.04,4068.08,0.00
2024-12-08 16:53:33,94,3931,44,50,2335.27,4068.33,0.00
2024-12-08 16:53:33,94,3932,44,50,2372.97,4069.00,0.00
2024-12-08 16:53:33,95,3932,44,51,2347.99,4069.01,0.00
2024-12-08 16:53:33,94,3932,44,50,2363.03,4069.07,0.00
2024-12-08 16:53:33,93,3932,43,50,2376.81,4069.28,0.00
2024-12-08 16:53:33,94,3931,43,51,2342.34,4069.49,0.00
2024-12-08 16:53:33,95,3930,43,52,2324.13,4069.52,0.00
2024-12-08 16:53:33,95,3931,43,52,2370.43,4070.00,0.00
2024-12-08 16:53:33,96,3931,43,53,2345.74,4070.01,0.00
2024-12-08 16:53:33,95,3931,43,52,2369.16,4070.03,0.00
2024-12-08 16:53:33,94,3931,43,51,2385.28,4070.06,0.00
2024-12-08 16:53:33,94,3932,43,51,2451.89,4071.00,0.00
2024-12-08 16:53:33,95,3932,44,51,2426.08,4071.01,0.00
2024-12-08 16:53:33,94,3932,44,50,2450.60,4071.03,0.00
2024-12-08 16:53:33,93,3932,44,49,2466.90,4071.06,0.00
2024-12-08 16:53:33,92,3932,43,49,2484.42,4071.07,0.00
2024-12-08 16:53:33,93,3931,43,50,2452.49,4071.22,0.00
2024-12-08 16:53:33,94,3930,44,50,2400.41,4071.81,0.00
2024-12-08 16:53:33,94,3931,44,50,2440.79,4072.00,0.00
2024-12-08 16:53:33,95,3931,45,50,2415.10,4072.01,0.00
2024-12-08 16:53:33,94,3931,44,50,2439.93,4072.02,0.00
2024-12-08 16:53:33,95,3930,45,50,2382.39,4072.55,0.00
2024-12-08 16:53:33,94,3930,44,50,2410.63,4072.68,0.00
2024-12-08 16:53:33,94,3931,44,50,2508.08,4073.00,0.00
2024-12-08 16:53:33,95,3931,44,51,2481.68,4073.01,0.00
2024-12-08 16:53:33,94,3931,44,50,2505.93,4073.05,0.00
2024-12-08 16:53:33,93,3931,43,50,2524.52,4073.23,0.00
2024-12-08 16:53:33,92,3931,42,50,2546.17,4073.30,0.00
2024-12-08 16:53:33,92,3932,42,50,2586.33,4074.00,0.00
2024-12-08 16:53:33,93,3932,43,50,2558.52,4074.01,0.00
2024-12-08 16:53:33,92,3932,43,49,2575.28,4074.05,0.00
2024-12-08 16:53:33,92,3933,43,49,2558.65,4075.00,0.00
2024-12-08 16:53:33,93,3933,43,50,2531.14,4075.01,0.00
2024-12-08 16:53:33,92,3933,42,50,2536.52,4075.09,0.00
2024-12-08 16:53:33,92,3934,42,50,2539.97,4076.00,0.00
2024-12-08 16:53:33,93,3934,42,51,2512.66,4076.01,0.00
2024-12-08 16:53:33,92,3934,42,50,2537.33,4076.07,0.00
2024-12-08 16:53:33,93,3933,43,50,2508.30,4076.13,0.00
2024-12-08 16:53:33,92,3933,42,50,2514.70,4076.92,0.00
2024-12-08 16:53:33,93,3932,43,50,2485.21,4076.98,0.00
2024-12-08 16:53:33,93,3933,43,50,2529.07,4077.00,0.00
2024-12-08 16:53:33,94,3933,44,50,2502.16,4077.01,0.00
2024-12-08 16:53:33,93,3933,44,49,2518.12,4077.06,0.00
2024-12-08 16:53:33,92,3933,43,49,2519.69,4077.41,0.00
2024-12-08 16:53:33,92,3934,43,49,2627.62,4078.00,0.00
2024-12-08 16:53:33,93,3934,43,50,2599.37,4078.01,0.00
2024-12-08 16:53:33,94,3933,43,51,2570.43,4078.06,0.00
2024-12-08 16:53:33,93,3933,43,50,2627.46,4078.08,0.00
2024-12-08 16:53:33,93,3934,43,50,2613.80,4079.00,0.00
2024-12-08 16:53:33,94,3934,44,50,2585.99,4079.01,0.00
2024-12-08 16:53:33,93,3934,43,50,2612.50,4079.03,0.00
2024-12-08 16:53:33,93,3935,43,50,2628.82,4080.00,0.00
2024-12-08 16:53:33,94,3935,44,50,2600.85,4080.01,0.00
2024-12-08 16:53:33,93,3935,44,49,2626.65,4080.05,0.00
2024-12-08 16:53:34,93,3936,44,49,2607.11,4081.00,0.00
2024-12-08 16:53:34,94,3936,44,50,2579.37,4081.01,0.00
2024-12-08 16:53:34,93,3936,43,50,2549.34,4081.87,0.00
2024-12-08 16:53:34,93,3937,43,50,2588.08,4082.00,0.00
2024-12-08 16:53:34,94,3937,44,50,2560.55,4082.01,0.00
2024-12-08 16:53:34,93,3937,44,49,2585.91,4082.05,0.00
2024-12-08 16:53:34,92,3937,43,49,2571.19,4082.58,0.00
2024-12-08 16:53:34,92,3938,43,49,2594.99,4083.00,0.00
2024-12-08 16:53:34,93,3938,44,49,2567.09,4083.01,0.00
2024-12-08 16:53:34,92,3938,43,49,2565.15,4083.33,0.00
2024-12-08 16:53:34,92,3939,43,49,2572.98,4084.00,0.00
2024-12-08 16:53:34,93,3939,43,50,2545.31,4084.01,0.00
2024-12-08 16:53:34,93,3940,43,50,2520.90,4085.00,0.00
2024-12-08 16:53:34,94,3940,43,51,2494.08,4085.01,0.00
2024-12-08 16:53:34,93,3940,43,50,2502.22,4085.13,0.00
2024-12-08 16:53:34,92,3940,43,49,2525.92,4085.20,0.00
2024-12-08 16:53:34,91,3940,42,49,2531.59,4085.70,0.00
2024-12-08 16:53:34,91,3941,42,49,2549.59,4086.00,0.00
2024-12-08 16:53:34,92,3941,43,49,2521.87,4086.01,0.00
2024-12-08 16:53:34,92,3942,43,49,2496.93,4087.00,0.00
2024-12-08 16:53:34,93,3942,43,50,2470.08,4087.01,0.00
2024-12-08 16:53:34,92,3942,43,49,2490.74,4087.05,0.00
2024-12-08 16:53:34,92,3943,43,49,2476.73,4088.00,0.00
2024-12-08 16:53:34,93,3943,43,50,2450.10,4088.01,0.00
2024-12-08 16:53:34,92,3943,43,49,2467.42,4088.05,0.00
2024-12-08 16:53:34,91,3943,42,49,2487.85,4088.21,0.00
2024-12-08 16:53:34,91,3944,42,49,2480.54,4089.00,0.00
2024-12-08 16:53:34,92,3944,43,49,2453.57,4089.01,0.00
2024-12-08 16:53:34,91,3944,43,48,2471.12,4089.06,0.00
2024-12-08 16:53:34,92,3943,43,49,2410.52,4089.85,0.00
2024-12-08 16:53:34,92,3944,43,49,2440.54,4090.00,0.00
2024-12-08 16:53:34,93,3944,43,50,2414.29,4090.01,0.00
2024-12-08 16:53:34,92,3944,42,50,2436.56,4090.04,0.00
2024-12-08 16:53:34,92,3945,42,50,2474.65,4091.00,0.00
2024-12-08 16:53:34,93,3945,42,51,2448.04,4091.01,0.00
2024-12-08 16:53:34,92,3945,42,50,2464.01,4091.07,0.00
2024-12-08 16:53:34,91,3945,41,50,2448.23,4091.90,0.00
2024-12-08 16:53:34,91,3946,41,50,2489.22,4092.00,0.00
2024-12-08 16:53:34,92,3946,42,50,2462.16,4092.01,0.00
2024-12-08 16:53:34,91,3946,42,49,2478.01,4092.07,0.00
2024-12-08 16:53:34,90,3946,41,49,2475.21,4092.74,0.00
2024-12-08 16:53:34,90,3947,41,49,2492.24,4093.00,0.00
2024-12-08 16:53:34,91,3947,42,49,2464.85,4093.01,0.00
2024-12-08 16:53:34,90,3947,42,48,2480.45,4093.07,0.00
2024-12-08 16:53:34,90,3948,42,48,2469.67,4094.00,0.00
2024-12-08 16:53:34,91,3948,42,49,2442.53,4094.01,0.00
2024-12-08 16:53:34,90,3948,42,48,2457.87,4094.07,0.00
2024-12-08 16:53:34,90,3949,42,48,2447.27,4095.00,0.00
2024-12-08 16:53:34,91,3949,43,48,2420.38,4095.01,0.00
2024-12-08 16:53:34,91,3950,43,48,2398.47,4096.00,0.00
2024-12-08 16:53:34,92,3950,43,49,2372.40,4096.01,0.00
2024-12-08 16:53:34,91,3950,43,48,2395.35,4096.07,0.00
2024-12-08 16:53:34,92,3949,43,49,2364.90,4096.20,0.00
2024-12-08 16:53:34,91,3949,42,49,2419.27,4096.23,0.00
2024-12-08 16:53:34,91,3950,42,49,2415.26,4097.00,0.00
2024-12-08 16:53:34,92,3950,43,49,2389.01,4097.01,0.00
2024-12-08 16:53:34,91,3950,42,49,2408.88,4097.07,0.00
2024-12-08 16:53:34,90,3950,41,49,2397.79,4097.77,0.00
2024-12-08 16:53:34,90,3951,41,49,2479.46,4098.00,0.00
2024-12-08 16:53:34,91,3951,42,49,2452.22,4098.01,0.00
2024-12-08 16:53:34,90,3951,42,48,2472.67,4098.09,0.00
2024-12-08 16:53:34,91,3950,43,48,2419.70,4098.75,0.00
2024-12-08 16:53:34,91,3951,43,48,2440.17,4099.00,0.00
2024-12-08 16:53:34,92,3951,44,48,2413.65,4099.01,0.00
2024-12-08 16:53:34,91,3951,43,48,2414.54,4099.10,0.00
2024-12-08 16:53:34,91,3952,43,48,2467.48,4100.00,0.00
2024-12-08 16:53:34,92,3952,43,49,2440.66,4100.01,0.00
2024-12-08 16:53:34,91,3952,43,48,2461.21,4100.09,0.00
2024-12-08 16:53:34,92,3951,43,49,2432.69,4100.15,0.00
2024-12-08 16:53:34,93,3950,44,49,2405.25,4100.24,0.00
2024-12-08 16:53:34,94,3949,44,50,2356.51,4100.99,0.00
2024-12-08 16:53:34,94,3950,44,50,2400.15,4101.00,0.00
2024-12-08 16:53:34,95,3950,45,50,2374.89,4101.01,0.00
2024-12-08 16:53:34,95,3951,45,50,2479.48,4102.00,0.00
2024-12-08 16:53:34,96,3951,45,51,2453.65,4102.01,0.00
2024-12-08 16:53:34,95,3951,45,50,2473.47,4102.08,0.00
2024-12-08 16:53:34,96,3950,45,51,2425.79,4102.58,0.00
2024-12-08 16:53:34,95,3950,44,51,2458.38,4102.75,0.00
2024-12-08 16:53:34,95,3951,44,51,2474.14,4103.00,0.00
2024-12-08 16:53:34,96,3951,45,51,2448.37,4103.01,0.00
2024-12-08 16:53:34,95,3951,44,51,2442.25,4103.18,0.00
2024-12-08 16:53:34,96,3950,44,52,2411.74,4103.32,0.00
2024-12-08 16:53:34,96,3951,44,52,2490.51,4104.00,0.00
2024-12-08 16:53:34,97,3951,45,52,2464.83,4104.01,0.00
2024-12-08 16:53:34,96,3951,45,51,2484.98,4104.08,0.00
2024-12-08 16:53:34,95,3951,44,51,2505.16,4104.22,0.00
2024-12-08 16:53:34,95,3952,44,51,2542.42,4105.00,0.00
2024-12-08 16:53:34,96,3952,44,52,2515.93,4105.01,0.00
2024-12-08 16:53:34,95,3952,43,52,2524.37,4105.23,0.00
2024-12-08 16:53:34,95,3953,43,52,2519.27,4106.00,0.00
2024-12-08 16:53:35,96,3953,43,53,2493.02,4106.01,0.00
2024-12-08 16:53:35,95,3953,43,52,2514.54,4106.08,0.00
2024-12-08 16:53:35,96,3952,44,52,2478.21,4106.35,0.00
2024-12-08 16:53:35,95,3952,43,52,2515.56,4106.41,0.00
2024-12-08 16:53:35,96,3951,44,52,2483.88,4106.56,0.00
2024-12-08 16:53:35,96,3952,44,52,2523.58,4107.00,0.00
2024-12-08 16:53:35,97,3952,44,53,2497.56,4107.01,0.00
2024-12-08 16:53:35,98,3951,44,54,2452.06,4107.23,0.00
2024-12-08 16:53:35,98,3952,44,54,2572.03,4108.00,0.00
2024-12-08 16:53:35,99,3952,45,54,2546.05,4108.01,0.00
2024-12-08 16:53:35,98,3952,44,54,2564.92,4108.05,0.00
2024-12-08 16:53:35,99,3951,45,54,2519.64,4108.34,0.00
2024-12-08 16:53:35,99,3952,45,54,2608.31,4109.00,0.00
2024-12-08 16:53:35,100,3952,45,55,2582.22,4109.01,0.00
2024-12-08 16:53:35,100,3953,45,55,2604.59,4110.00,0.00
2024-12-08 16:53:35,101,3953,45,56,2578.80,4110.01,0.00
2024-12-08 16:53:35,101,3954,45,56,2555.01,4111.00,0.00
2024-12-08 16:53:35,102,3954,45,57,2529.96,4111.01,0.00
2024-12-08 16:53:35,101,3954,45,56,2548.12,4111.08,0.00
2024-12-08 16:53:35,102,3953,45,57,2492.95,4111.84,0.00
2024-12-08 16:53:35,101,3953,44,57,2504.76,4111.97,0.00
2024-12-08 16:53:35,101,3954,44,57,2544.27,4112.00,0.00
2024-12-08 16:53:35,102,3954,45,57,2519.33,4112.01,0.00
2024-12-08 16:53:35,103,3953,46,57,2468.33,4112.49,0.00
2024-12-08 16:53:35,103,3954,46,57,2527.82,4113.00,0.00
2024-12-08 16:53:35,104,3954,47,57,2503.52,4113.01,0.00
2024-12-08 16:53:35,103,3954,47,56,2521.47,4113.09,0.00
2024-12-08 16:53:35,103,3955,47,56,2548.33,4114.00,0.00
2024-12-08 16:53:35,104,3955,48,56,2523.83,4114.01,0.00
2024-12-08 16:53:35,103,3955,48,55,2520.80,4114.09,0.00
2024-12-08 16:53:35,103,3956,48,55,2523.78,4115.00,0.00
2024-12-08 16:53:35,104,3956,48,56,2499.52,4115.01,0.00
2024-12-08 16:53:35,103,3956,47,56,2505.50,4115.25,0.00
2024-12-08 16:53:35,103,3957,47,56,2499.22,4116.00,0.00
2024-12-08 16:53:35,104,3957,48,56,2475.19,4116.01,0.00
2024-12-08 16:53:35,103,3957,48,55,2494.85,4116.09,0.00
2024-12-08 16:53:35,103,3958,48,55,2480.98,4117.00,0.00
2024-12-08 16:53:35,104,3958,49,55,2457.13,4117.01,0.00
2024-12-08 16:53:35,104,3959,49,55,2430.26,4118.00,0.00
2024-12-08 16:53:35,105,3959,50,55,2407.12,4118.01,0.00
2024-12-08 16:53:35,104,3959,50,54,2425.93,4118.09,0.00
2024-12-08 16:53:35,103,3959,49,54,2425.20,4118.44,0.00
2024-12-08 16:53:35,103,3960,49,54,2442.40,4119.00,0.00
2024-12-08 16:53:35,104,3960,49,55,2418.91,4119.01,0.00
2024-12-08 16:53:35,103,3960,49,54,2440.41,4119.05,0.00
2024-12-08 16:53:35,102,3960,48,54,2439.32,4119.37,0.00
2024-12-08 16:53:35,102,3961,48,54,2449.96,4120.00,0.00
2024-12-08 16:53:35,103,3961,49,54,2426.17,4120.01,0.00
2024-12-08 16:53:35,104,3960,50,54,2383.89,4120.23,0.00
2024-12-08 16:53:35,105,3959,51,54,2376.95,4120.40,0.00
2024-12-08 16:53:35,106,3958,52,54,2355.40,4120.56,0.00
2024-12-08 16:53:35,106,3959,52,54,2382.36,4121.00,0.00
2024-12-08 16:53:35,107,3959,53,54,2360.09,4121.01,0.00
2024-12-08 16:53:35,106,3959,53,53,2368.52,4121.11,0.00
2024-12-08 16:53:35,105,3959,52,53,2384.47,4121.27,0.00
2024-12-08 16:53:35,105,3960,52,53,2499.16,4122.00,0.00
2024-12-08 16:53:35,106,3960,52,54,2475.58,4122.01,0.00
2024-12-08 16:53:35,105,3960,52,53,2488.97,4122.08,0.00
2024-12-08 16:53:35,105,3961,52,53,2474.93,4123.00,0.00
2024-12-08 16:53:35,106,3961,52,54,2451.58,4123.01,0.00
2024-12-08 16:53:35,105,3961,52,53,2464.35,4123.09,0.00
2024-12-08 16:53:35,105,3962,52,53,2449.84,4124.00,0.00
2024-12-08 16:53:35,106,3962,53,53,2426.73,4124.01,0.00
2024-12-08 16:53:35,105,3962,52,53,2410.80,4124.52,0.00
2024-12-08 16:53:35,105,3963,52,53,2429.75,4125.00,0.00
2024-12-08 16:53:35,106,3963,52,54,2406.83,4125.01,0.00
2024-12-08 16:53:35,105,3963,52,53,2425.07,4125.11,0.00
2024-12-08 16:53:35,105,3964,52,53,2411.98,4126.00,0.00
2024-12-08 16:53:35,106,3964,53,53,2389.22,4126.01,0.00
2024-12-08 16:53:35,105,3964,53,52,2395.76,4126.21,0.00
2024-12-08 16:53:35,106,3963,54,52,2368.92,4126.33,0.00
2024-12-08 16:53:35,107,3962,55,52,2330.10,4126.80,0.00
2024-12-08 16:53:35,107,3963,55,52,2351.47,4127.00,0.00
2024-12-08 16:53:35,108,3963,55,53,2329.70,4127.01,0.00
2024-12-08 16:53:35,107,3963,55,52,2345.72,4127.12,0.00
2024-12-08 16:53:35,108,3962,55,53,2310.03,4127.48,0.00
2024-12-08 16:53:35,108,3963,55,53,2403.27,4128.00,0.00
2024-12-08 16:53:35,109,3963,56,53,2381.22,4128.01,0.00
2024-12-08 16:53:35,109,3964,56,53,2393.92,4129.00,0.00
2024-12-08 16:53:35,110,3964,56,54,2372.15,4129.01,0.00
2024-12-08 16:53:35,109,3964,56,53,2387.90,4129.13,0.00
2024-12-08 16:53:35,108,3964,55,53,2384.96,4129.51,0.00
2024-12-08 16:53:35,108,3965,55,53,2403.28,4130.00,0.00
2024-12-08 16:53:35,109,3965,56,53,2381.23,4130.01,0.00
2024-12-08 16:53:35,109,3966,56,53,2355.68,4131.00,0.00
2024-12-08 16:53:35,110,3966,57,53,2334.26,4131.01,0.00
2024-12-08 16:53:35,109,3966,57,52,2347.39,4131.16,0.00
2024-12-08 16:53:36,109,3967,57,52,2335.73,4132.00,0.00
2024-12-08 16:53:36,110,3967,58,52,2314.50,4132.01,0.00
2024-12-08 16:53:36,110,3968,58,52,2289.13,4133.00,0.00
2024-12-08 16:53:36,111,3968,58,53,2268.51,4133.01,0.00
2024-12-08 16:53:36,110,3968,58,52,2279.80,4133.17,0.00
2024-12-08 16:53:36,111,3967,58,53,2252.63,4133.35,0.00
2024-12-08 16:53:36,111,3968,58,53,2261.24,4134.00,0.00
2024-12-08 16:53:36,112,3968,58,54,2241.05,4134.01,0.00
2024-12-08 16:53:36,111,3968,57,54,2219.78,4134.59,0.00
2024-12-08 16:53:36,112,3967,58,54,2194.52,4134.73,0.00
2024-12-08 16:53:36,111,3967,57,54,2223.63,4134.77,0.00
2024-12-08 16:53:36,111,3968,57,54,2288.62,4135.00,0.00
2024-12-08 16:53:36,112,3968,57,55,2268.19,4135.01,0.00
2024-12-08 16:53:36,111,3968,57,54,2279.66,4135.17,0.00
2024-12-08 16:53:36,110,3968,56,54,2287.24,4135.21,0.00
2024-12-08 16:53:36,110,3969,56,54,2330.21,4136.00,0.00
2024-12-08 16:53:36,111,3969,56,55,2309.22,4136.01,0.00
2024-12-08 16:53:36,110,3969,55,55,2315.18,4136.06,0.00
2024-12-08 16:53:36,111,3968,56,55,2281.42,4136.20,0.00
2024-12-08 16:53:36,110,3968,55,55,2323.66,4136.33,0.00
2024-12-08 16:53:36,110,3969,55,55,2333.88,4137.00,0.00
2024-12-08 16:53:36,111,3969,55,56,2312.85,4137.01,0.00
2024-12-08 16:53:36,110,3969,55,55,2329.74,4137.07,0.00
2024-12-08 16:53:36,109,3969,55,54,2344.70,4137.17,0.00
2024-12-08 16:53:36,110,3968,55,55,2313.72,4137.42,0.00
2024-12-08 16:53:36,111,3967,56,55,2294.98,4137.80,0.00
2024-12-08 16:53:36,111,3968,56,55,2352.54,4138.00,0.00
2024-12-08 16:53:36,112,3968,56,56,2331.53,4138.01,0.00
2024-12-08 16:53:36,111,3968,55,56,2351.42,4138.03,0.00
2024-12-08 16:53:36,110,3968,54,56,2346.90,4138.19,0.00
2024-12-08 16:53:36,110,3969,54,56,2426.80,4139.00,0.00
2024-12-08 16:53:36,111,3969,55,56,2404.94,4139.01,0.00
2024-12-08 16:53:36,110,3969,55,55,2402.02,4139.17,0.00
2024-12-08 16:53:36,110,3970,55,55,2405.93,4140.00,0.00
2024-12-08 16:53:36,111,3970,56,55,2384.26,4140.01,0.00
2024-12-08 16:53:36,110,3970,55,55,2386.85,4140.29,0.00
2024-12-08 16:53:36,110,3971,55,55,2380.54,4141.00,0.00
2024-12-08 16:53:36,111,3971,56,55,2359.09,4141.01,0.00
2024-12-08 16:53:36,110,3971,56,54,2371.21,4141.17,0.00
2024-12-08 16:53:36,111,3970,57,54,2332.17,4141.62,0.00
2024-12-08 16:53:36,112,3969,57,55,2317.71,4141.75,0.00
2024-12-08 16:53:36,112,3970,57,55,2330.47,4142.00,0.00
2024-12-08 16:53:36,113,3970,58,55,2309.84,4142.01,0.00
2024-12-08 16:53:36,114,3969,59,55,2262.54,4142.51,0.00
2024-12-08 16:53:36,114,3970,59,55,2364.60,4143.00,0.00
2024-12-08 16:53:36,115,3970,59,56,2344.04,4143.01,0.00
2024-12-08 16:53:36,114,3970,59,55,2355.56,4143.17,0.00
2024-12-08 16:53:36,115,3969,59,56,2315.72,4143.64,0.00
2024-12-08 16:53:36,116,3968,59,57,2314.08,4143.80,0.00
2024-12-08 16:53:36,115,3968,58,57,2337.07,4143.81,0.00
2024-12-08 16:53:36,115,3969,58,57,2400.07,4144.00,0.00
2024-12-08 16:53:36,116,3969,58,58,2379.38,4144.01,0.00
2024-12-08 16:53:36,116,3970,58,58,2432.47,4145.00,0.00
2024-12-08 16:53:36,117,3970,58,59,2411.68,4145.01,0.00
2024-12-08 16:53:36,116,3970,57,59,2431.76,4145.02,0.00
2024-12-08 16:53:36,116,3971,57,59,2411.12,4146.00,0.00
2024-12-08 16:53:36,117,3971,58,59,2390.51,4146.01,0.00
2024-12-08 16:53:36,118,3970,59,59,2352.43,4146.29,0.00
2024-12-08 16:53:36,118,3971,59,59,2352.05,4147.00,0.00
2024-12-08 16:53:36,119,3971,59,60,2332.28,4147.01,0.00
2024-12-08 16:53:36,118,3971,59,59,2349.60,4147.06,0.00
2024-12-08 16:53:36,117,3971,59,58,2359.08,4147.15,0.00
2024-12-08 16:53:36,116,3971,58,58,2374.46,4147.27,0.00
2024-12-08 16:53:36,115,3971,57,58,2376.29,4147.71,0.00
2024-12-08 16:53:36,114,3971,56,58,2389.81,4147.72,0.00
2024-12-08 16:53:36,115,3970,57,58,2359.77,4147.91,0.00
2024-12-08 16:53:36,115,3971,57,58,2430.18,4148.00,0.00
2024-12-08 16:53:36,116,3971,57,59,2409.23,4148.01,0.00
2024-12-08 16:53:36,115,3971,57,58,2428.38,4148.02,0.00
2024-12-08 16:53:36,114,3971,56,58,2447.87,4148.05,0.00
2024-12-08 16:53:36,113,3971,55,58,2461.48,4148.11,0.00
2024-12-08 16:53:36,114,3970,55,59,2434.13,4148.26,0.00
2024-12-08 16:53:36,114,3971,55,59,2482.45,4149.00,0.00
2024-12-08 16:53:36,115,3971,55,60,2460.87,4149.01,0.00
2024-12-08 16:53:36,116,3970,56,60,2437.16,4149.09,0.00
2024-12-08 16:53:36,115,3970,56,59,2483.64,4149.13,0.00
2024-12-08 16:53:36,115,3971,56,59,2503.45,4150.00,0.00
2024-12-08 16:53:36,116,3971,56,60,2481.87,4150.01,0.00
2024-12-08 16:53:36,116,3972,56,60,2496.28,4151.00,0.00
2024-12-08 16:53:36,117,3972,57,60,2474.94,4151.01,0.00
2024-12-08 16:53:36,118,3971,58,60,2438.21,4151.24,0.00
2024-12-08 16:53:36,118,3972,58,60,2428.65,4152.00,0.00
2024-12-08 16:53:36,119,3972,59,60,2408.24,4152.01,0.00
2024-12-08 16:53:36,118,3972,58,60,2428.30,4152.01,0.00
2024-12-08 16:53:36,117,3972,57,60,2446.94,4152.05,0.00
2024-12-08 16:53:36,116,3972,57,59,2458.40,4152.10,0.00
2024-12-08 16:53:36,117,3971,58,59,2402.75,4152.88,0.00
2024-12-08 16:53:36,117,3972,58,59,2457.52,4153.00,0.00
2024-12-08 16:53:36,118,3972,58,60,2436.69,4153.01,0.00
2024-12-08 16:53:36,117,3972,57,60,2449.03,4153.08,0.00
2024-12-08 16:53:36,118,3971,58,60,2403.83,4153.52,0.00
2024-12-08 16:53:36,118,3972,58,60,2454.22,4154.00,0.00
2024-12-08 16:53:37,119,3972,59,60,2433.59,4154.01,0.00
2024-12-08 16:53:37,119,3973,59,60,2437.91,4155.00,0.00
2024-12-08 16:53:37,120,3973,60,60,2417.59,4155.01,0.00
2024-12-08 16:53:37,119,3973,60,59,2430.26,4155.09,0.00
2024-12-08 16:53:37,120,3972,60,60,2403.84,4155.26,0.00
2024-12-08 16:53:37,120,3973,60,60,2410.43,4156.00,0.00
2024-12-08 16:53:37,121,3973,61,60,2390.51,4156.01,0.00
2024-12-08 16:53:37,120,3973,61,59,2399.73,4156.09,0.00
2024-12-08 16:53:37,119,3973,60,59,2409.08,4156.14,0.00
2024-12-08 16:53:37,120,3972,60,60,2376.67,4156.46,0.00
2024-12-08 16:53:37,121,3971,60,61,2352.52,4156.74,0.00
2024-12-08 16:53:37,121,3972,60,61,2414.75,4157.00,0.00
2024-12-08 16:53:37,122,3972,60,62,2394.96,4157.01,0.00
2024-12-08 16:53:37,121,3972,59,62,2405.17,4157.09,0.00
2024-12-08 16:53:37,120,3972,59,61,2418.63,4157.09,0.00
2024-12-08 16:53:37,119,3972,58,61,2411.57,4157.73,0.00
2024-12-08 16:53:37,119,3973,58,61,2504.97,4158.00,0.00
2024-12-08 16:53:37,120,3973,58,62,2484.09,4158.01,0.00
2024-12-08 16:53:37,119,3973,58,61,2494.87,4158.09,0.00
2024-12-08 16:53:37,120,3972,59,61,2470.99,4158.18,0.00
2024-12-08 16:53:37,119,3972,58,61,2496.68,4158.24,0.00
2024-12-08 16:53:37,119,3973,58,61,2485.05,4159.00,0.00
2024-12-08 16:53:37,120,3973,59,61,2464.34,4159.01,0.00
2024-12-08 16:53:37,121,3972,59,62,2440.57,4159.11,0.00
2024-12-08 16:53:37,120,3972,59,61,2462.65,4159.11,0.00
2024-12-08 16:53:37,119,3972,58,61,2452.12,4159.60,0.00
2024-12-08 16:53:37,119,3973,58,61,2502.94,4160.00,0.00
2024-12-08 16:53:37,120,3973,58,62,2482.09,4160.01,0.00
2024-12-08 16:53:37,119,3973,58,61,2492.50,4160.10,0.00
2024-12-08 16:53:37,118,3973,57,61,2506.99,4160.25,0.00
2024-12-08 16:53:37,117,3973,56,61,2517.82,4160.40,0.00
2024-12-08 16:53:37,117,3974,56,61,2561.66,4161.00,0.00
2024-12-08 16:53:37,118,3974,56,62,2539.95,4161.01,0.00
2024-12-08 16:53:37,117,3974,56,61,2550.32,4161.10,0.00
2024-12-08 16:53:37,116,3974,55,61,2558.35,4161.16,0.00
2024-12-08 16:53:37,117,3973,56,61,2524.52,4161.47,0.00
2024-12-08 16:53:37,117,3974,56,61,2550.45,4162.00,0.00
2024-12-08 16:53:37,118,3974,57,61,2528.83,4162.01,0.00
2024-12-08 16:53:37,117,3974,56,61,2527.62,4162.39,0.00
2024-12-08 16:53:37,118,3973,57,61,2480.96,4162.67,0.00
2024-12-08 16:53:37,118,3974,57,61,2543.18,4163.00,0.00
2024-12-08 16:53:37,119,3974,58,61,2521.81,4163.01,0.00
2024-12-08 16:53:37,118,3974,58,60,2538.63,4163.10,0.00
2024-12-08 16:53:37,119,3973,59,60,2500.36,4163.53,0.00
2024-12-08 16:53:37,118,3973,58,60,2513.13,4163.61,0.00
2024-12-08 16:53:37,118,3974,58,60,2565.08,4164.00,0.00
2024-12-08 16:53:37,119,3974,58,61,2543.53,4164.01,0.00
2024-12-08 16:53:37,118,3974,58,60,2561.59,4164.09,0.00
2024-12-08 16:53:37,118,3975,58,60,2580.49,4165.00,0.00
2024-12-08 16:53:37,119,3975,59,60,2558.80,4165.01,0.00
2024-12-08 16:53:37,118,3975,58,60,2580.13,4165.01,0.00
2024-12-08 16:53:37,117,3975,57,60,2584.85,4165.26,0.00
2024-12-08 16:53:37,118,3974,58,60,2537.97,4165.81,0.00
2024-12-08 16:53:37,118,3975,58,60,2573.18,4166.00,0.00
2024-12-08 16:53:37,119,3975,58,61,2551.56,4166.01,0.00
2024-12-08 16:53:37,119,3976,58,61,2559.09,4167.00,0.00
2024-12-08 16:53:37,120,3976,58,62,2537.77,4167.01,0.00
2024-12-08 16:53:37,120,3977,58,62,2506.00,4168.00,0.00
2024-12-08 16:53:37,121,3977,59,62,2485.29,4168.01,0.00
2024-12-08 16:53:37,120,3977,59,61,2501.52,4168.08,0.00
2024-12-08 16:53:37,121,3976,59,62,2479.82,4168.12,0.00
2024-12-08 16:53:37,120,3976,58,62,2453.42,4168.98,0.00
2024-12-08 16:53:37,120,3977,58,62,2487.14,4169.00,0.00
2024-12-08 16:53:37,121,3977,59,62,2466.58,4169.01,0.00
2024-12-08 16:53:37,120,3977,58,62,2486.79,4169.01,0.00
2024-12-08 16:53:37,120,3978,58,62,2498.39,4170.00,0.00
2024-12-08 16:53:37,121,3978,58,63,2477.74,4170.01,0.00
2024-12-08 16:53:37,120,3978,57,63,2474.16,4170.41,0.00
2024-12-08 16:53:37,119,3978,56,63,2484.05,4170.59,0.00
2024-12-08 16:53:37,119,3979,56,63,2493.36,4171.00,0.00
2024-12-08 16:53:37,120,3979,56,64,2472.58,4171.01,0.00
2024-12-08 16:53:37,119,3979,55,64,2474.78,4171.29,0.00
2024-12-08 16:53:37,119,3980,55,64,2464.02,4172.00,0.00
2024-12-08 16:53:37,120,3980,55,65,2443.49,4172.01,0.00
2024-12-08 16:53:37,119,3980,54,65,2463.67,4172.01,0.00
2024-12-08 16:53:37,118,3980,54,64,2476.10,4172.07,0.00
2024-12-08 16:53:37,119,3979,54,65,2447.29,4172.28,0.00
2024-12-08 16:53:37,119,3980,54,65,2456.18,4173.00,0.00
2024-12-08 16:53:37,120,3980,54,66,2435.71,4173.01,0.00
2024-12-08 16:53:37,119,3980,54,65,2448.14,4173.07,0.00
2024-12-08 16:53:37,119,3981,54,65,2460.56,4174.00,0.00
2024-12-08 16:53:37,120,3981,55,65,2440.06,4174.01,0.00
2024-12-08 16:53:37,119,3981,55,64,2452.52,4174.07,0.00
2024-12-08 16:53:37,118,3981,54,64,2460.07,4174.13,0.00
2024-12-08 16:53:37,119,3980,55,64,2420.68,4174.53,0.00
2024-12-08 16:53:37,118,3980,54,64,2433.97,4174.96,0.00
2024-12-08 16:53:37,118,3981,54,64,2467.62,4175.00,0.00
2024-12-08 16:53:37,119,3981,54,65,2446.88,4175.01,0.00
2024-12-08 16:53:37,119,3982,54,65,2459.05,4176.00,0.00
2024-12-08 16:53:37,120,3982,54,66,2438.56,4176.01,0.00
2024-12-08 16:53:37,121,3981,54,67,2417.04,4176.06,0.00
2024-12-08 16:53:38,121,3982,54,67,2415.69,4177.00,0.00
2024-12-08 16:53:38,122,3982,55,67,2395.89,4177.01,0.00
2024-12-08 16:53:38,121,3982,54,67,2399.97,4177.22,0.00
2024-12-08 16:53:38,120,3982,53,67,2416.53,4177.29,0.00
2024-12-08 16:53:38,119,3982,52,67,2411.06,4177.79,0.00
2024-12-08 16:53:38,119,3983,52,67,2468.82,4178.00,0.00
2024-12-08 16:53:38,120,3983,52,68,2448.25,4178.01,0.00
2024-12-08 16:53:38,120,3984,52,68,2411.21,4179.00,0.00
2024-12-08 16:53:38,121,3984,53,68,2391.29,4179.01,0.00
2024-12-08 16:53:38,120,3984,53,67,2407.89,4179.07,0.00
2024-12-08 16:53:38,121,3983,54,67,2384.90,4179.16,0.00
2024-12-08 16:53:38,122,3982,55,67,2365.58,4179.64,0.00
2024-12-08 16:53:38,121,3982,54,67,2360.54,4179.99,0.00
2024-12-08 16:53:38,121,3983,54,67,2391.46,4180.00,0.00
2024-12-08 16:53:38,122,3983,54,68,2371.86,4180.01,0.00
2024-12-08 16:53:38,121,3983,54,67,2384.93,4180.07,0.00
2024-12-08 16:53:38,121,3984,54,67,2421.91,4181.00,0.00
2024-12-08 16:53:38,122,3984,55,67,2402.06,4181.01,0.00
2024-12-08 16:53:38,121,3984,55,66,2414.68,4181.07,0.00
2024-12-08 16:53:38,120,3984,54,66,2393.07,4181.69,0.00
2024-12-08 16:53:38,120,3985,54,66,2404.48,4182.00,0.00
2024-12-08 16:53:38,121,3985,54,67,2384.61,4182.01,0.00
2024-12-08 16:53:38,120,3985,53,67,2396.47,4182.02,0.00
2024-12-08 16:53:38,121,3984,54,67,2374.96,4182.07,0.00
2024-12-08 16:53:38,120,3984,54,66,2398.59,4182.08,0.00
2024-12-08 16:53:38,120,3985,54,66,2380.72,4183.00,0.00
2024-12-08 16:53:38,121,3985,54,67,2361.05,4183.01,0.00
2024-12-08 16:53:38,120,3985,54,66,2373.44,4183.07,0.00
2024-12-08 16:53:38,120,3986,54,66,2376.94,4184.00,0.00
2024-12-08 16:53:38,121,3986,55,66,2357.29,4184.01,0.00
2024-12-08 16:53:38,120,3986,54,66,2368.61,4184.08,0.00
2024-12-08 16:53:38,119,3986,54,65,2382.53,4184.08,0.00
2024-12-08 16:53:38,119,3987,54,65,2366.59,4185.00,0.00
2024-12-08 16:53:38,120,3987,54,66,2346.87,4185.01,0.00
2024-12-08 16:53:38,119,3987,54,65,2358.19,4185.08,0.00
2024-12-08 16:53:38,120,3986,54,66,2334.73,4185.18,0.00
2024-12-08 16:53:38,119,3986,53,66,2366.42,4185.29,0.00
2024-12-08 16:53:38,118,3986,52,66,2385.42,4185.31,0.00
2024-12-08 16:53:38,117,3986,52,65,2380.55,4185.90,0.00
2024-12-08 16:53:38,117,3987,52,65,2404.22,4186.00,0.00
2024-12-08 16:53:38,118,3987,53,65,2383.85,4186.01,0.00
2024-12-08 16:53:38,118,3988,53,65,2396.13,4187.00,0.00
2024-12-08 16:53:38,119,3988,53,66,2376.00,4187.01,0.00
2024-12-08 16:53:38,120,3987,54,66,2339.89,4187.25,0.00
2024-12-08 16:53:38,119,3987,53,66,2389.00,4187.37,0.00
2024-12-08 16:53:38,118,3987,53,65,2385.09,4187.90,0.00
2024-12-08 16:53:38,118,3988,53,65,2408.57,4188.00,0.00
2024-12-08 16:53:38,119,3988,54,65,2388.33,4188.01,0.00
2024-12-08 16:53:38,118,3988,54,64,2385.33,4188.39,0.00
2024-12-08 16:53:38,118,3989,54,64,2419.88,4189.00,0.00
2024-12-08 16:53:38,119,3989,54,65,2399.55,4189.01,0.00
2024-12-08 16:53:38,118,3989,53,65,2376.23,4189.88,0.00
2024-12-08 16:53:38,118,3990,53,65,2391.18,4190.00,0.00
2024-12-08 16:53:38,119,3990,53,66,2371.09,4190.01,0.00
2024-12-08 16:53:38,120,3989,54,66,2349.60,4190.07,0.00
2024-12-08 16:53:38,119,3989,54,65,2375.70,4190.08,0.00
2024-12-08 16:53:38,118,3989,54,64,2384.81,4190.35,0.00
2024-12-08 16:53:38,118,3990,54,64,2376.56,4191.00,0.00
2024-12-08 16:53:38,119,3990,54,65,2356.59,4191.01,0.00
2024-12-08 16:53:38,118,3990,53,65,2370.52,4191.01,0.00
2024-12-08 16:53:38,117,3990,53,64,2384.01,4191.07,0.00
2024-12-08 16:53:38,117,3991,53,64,2414.96,4192.00,0.00
2024-12-08 16:53:38,118,3991,53,65,2394.50,4192.01,0.00
2024-12-08 16:53:38,117,3991,53,64,2408.55,4192.07,0.00
2024-12-08 16:53:38,116,3991,52,64,2412.39,4192.22,0.00
2024-12-08 16:53:38,117,3990,53,64,2385.74,4192.39,0.00
2024-12-08 16:53:38,117,3991,53,64,2421.63,4193.00,0.00
2024-12-08 16:53:38,118,3991,54,64,2401.11,4193.01,0.00
2024-12-08 16:53:38,117,3991,54,63,2414.85,4193.08,0.00
2024-12-08 16:53:38,116,3991,53,63,2427.08,4193.29,0.00
2024-12-08 16:53:38,117,3990,54,63,2386.19,4193.79,0.00
2024-12-08 16:53:38,117,3991,54,63,2440.03,4194.00,0.00
2024-12-08 16:53:38,118,3991,54,64,2419.35,4194.01,0.00
2024-12-08 16:53:38,117,3991,53,64,2436.11,4194.06,0.00
2024-12-08 16:53:38,116,3991,53,63,2452.42,4194.07,0.00
2024-12-08 16:53:38,117,3990,54,63,2401.94,4194.80,0.00
2024-12-08 16:53:38,117,3991,54,63,2470.55,4195.00,0.00
2024-12-08 16:53:38,118,3991,55,63,2449.62,4195.01,0.00
2024-12-08 16:53:38,117,3991,55,62,2463.77,4195.07,0.00
2024-12-08 16:53:38,116,3991,54,62,2473.83,4195.15,0.00
2024-12-08 16:53:38,116,3992,54,62,2508.69,4196.00,0.00
2024-12-08 16:53:38,117,3992,55,62,2487.25,4196.01,0.00
2024-12-08 16:53:38,116,3992,55,61,2487.02,4196.08,0.00
2024-12-08 16:53:38,117,3991,56,61,2429.35,4196.92,0.00
2024-12-08 16:53:38,117,3992,56,61,2463.86,4197.00,0.00
2024-12-08 16:53:38,118,3992,57,61,2442.98,4197.01,0.00
2024-12-08 16:53:38,119,3991,58,61,2388.30,4197.67,0.00
2024-12-08 16:53:38,119,3992,58,61,2449.44,4198.00,0.00
2024-12-08 16:53:38,120,3992,58,62,2429.03,4198.01,0.00
2024-12-08 16:53:39,120,3993,58,62,2439.62,4199.00,0.00
2024-12-08 16:53:39,121,3993,59,62,2419.46,4199.01,0.00
2024-12-08 16:53:39,121,3994,59,62,2389.29,4200.00,0.00
2024-12-08 16:53:39,122,3994,59,63,2369.71,4200.01,0.00
2024-12-08 16:53:39,121,3994,59,62,2382.03,4200.07,0.00
2024-12-08 16:53:39,121,3995,59,62,2362.23,4201.00,0.00
2024-12-08 16:53:39,122,3995,60,62,2342.87,4201.01,0.00
2024-12-08 16:53:39,122,3996,60,62,2314.49,4202.00,0.00
2024-12-08 16:53:39,123,3996,61,62,2295.67,4202.01,0.00
2024-12-08 16:53:39,122,3996,61,61,2310.04,4202.07,0.00
2024-12-08 16:53:39,121,3996,60,61,2319.49,4202.30,0.00
2024-12-08 16:53:39,121,3997,60,61,2309.59,4203.00,0.00
2024-12-08 16:53:39,122,3997,60,62,2290.66,4203.01,0.00
2024-12-08 16:53:39,121,3997,59,62,2307.53,4203.06,0.00
2024-12-08 16:53:39,120,3997,58,62,2302.13,4203.37,0.00
2024-12-08 16:53:39,120,3998,58,62,2309.46,4204.00,0.00
2024-12-08 16:53:39,121,3998,59,62,2290.37,4204.01,0.00
2024-12-08 16:53:39,120,3998,59,61,2296.11,4204.16,0.00
2024-12-08 16:53:39,120,3999,59,61,2285.66,4205.00,0.00
2024-12-08 16:53:39,121,3999,59,62,2266.77,4205.01,0.00
2024-12-08 16:53:39,121,4000,59,62,2236.76,4206.00,0.00
2024-12-08 16:53:39,122,4000,60,62,2218.42,4206.01,0.00
2024-12-08 16:53:39,121,4000,59,62,2234.35,4206.06,0.00
2024-12-08 16:53:39,120,4000,59,61,2250.42,4206.06,0.00
2024-12-08 16:53:39,119,4000,58,61,2257.29,4206.25,0.00
2024-12-08 16:53:39,119,4001,58,61,2258.13,4207.00,0.00
2024-12-08 16:53:39,120,4001,59,61,2239.31,4207.01,0.00
2024-12-08 16:53:39,119,4001,59,60,2254.26,4207.06,0.00
2024-12-08 16:53:39,119,4002,59,60,2231.47,4208.00,0.00
2024-12-08 16:53:39,120,4002,60,60,2212.88,4208.01,0.00
2024-12-08 16:53:39,120,4003,60,60,2185.40,4209.00,0.00
2024-12-08 16:53:39,121,4003,61,60,2167.33,4209.01,0.00
2024-12-08 16:53:39,120,4003,60,60,2185.04,4209.01,0.00
2024-12-08 16:53:39,119,4003,60,59,2168.56,4209.59,0.00
2024-12-08 16:53:39,120,4002,61,59,2148.42,4209.65,0.00
2024-12-08 16:53:39,119,4002,60,59,2164.19,4209.78,0.00
2024-12-08 16:53:39,119,4003,60,59,2176.99,4210.00,0.00
2024-12-08 16:53:39,120,4003,60,60,2158.85,4210.01,0.00
2024-12-08 16:53:39,119,4003,60,59,2172.77,4210.05,0.00
2024-12-08 16:53:39,119,4004,60,59,2184.73,4211.00,0.00
2024-12-08 16:53:39,120,4004,61,59,2166.52,4211.01,0.00
2024-12-08 16:53:39,119,4004,61,58,2180.86,4211.06,0.00
2024-12-08 16:53:39,118,4004,60,58,2196.49,4211.06,0.00
2024-12-08 16:53:39,119,4003,60,59,2166.55,4211.29,0.00
2024-12-08 16:53:39,119,4004,60,59,2191.02,4212.00,0.00
2024-12-08 16:53:39,120,4004,61,59,2172.76,4212.01,0.00
2024-12-08 16:53:39,119,4004,61,58,2167.64,4212.09,0.00
2024-12-08 16:53:39,118,4004,60,58,2176.10,4212.33,0.00
2024-12-08 16:53:39,118,4005,60,58,2213.72,4213.00,0.00
2024-12-08 16:53:39,119,4005,61,58,2195.11,4213.01,0.00
2024-12-08 16:53:39,118,4005,61,57,2204.33,4213.09,0.00
2024-12-08 16:53:39,117,4005,60,57,2206.08,4213.43,0.00
2024-12-08 16:53:39,117,4006,60,57,2211.93,4214.00,0.00
2024-12-08 16:53:39,118,4006,60,58,2193.19,4214.01,0.00
2024-12-08 16:53:39,117,4006,60,57,2202.87,4214.09,0.00
2024-12-08 16:53:39,118,4005,61,57,2177.82,4214.26,0.00
2024-12-08 16:53:39,117,4005,60,57,2203.32,4214.34,0.00
2024-12-08 16:53:39,117,4006,60,57,2203.06,4215.00,0.00
2024-12-08 16:53:39,118,4006,60,58,2184.39,4215.01,0.00
2024-12-08 16:53:39,117,4006,60,57,2150.66,4215.71,0.00
2024-12-08 16:53:39,117,4007,60,57,2210.69,4216.00,0.00
2024-12-08 16:53:39,118,4007,61,57,2191.95,4216.01,0.00
2024-12-08 16:53:39,117,4007,60,57,2155.82,4216.80,0.00
2024-12-08 16:53:39,117,4008,60,57,2183.37,4217.00,0.00
2024-12-08 16:53:39,118,4008,61,57,2164.87,4217.01,0.00
2024-12-08 16:53:39,117,4008,61,56,2176.08,4217.09,0.00
2024-12-08 16:53:39,118,4007,61,57,2152.66,4217.23,0.00
2024-12-08 16:53:39,119,4006,61,58,2157.65,4217.31,0.00
2024-12-08 16:53:39,118,4006,60,58,2197.35,4217.37,0.00
2024-12-08 16:53:39,117,4006,59,58,2205.22,4217.61,0.00
2024-12-08 16:53:39,117,4007,59,58,2224.40,4218.00,0.00
2024-12-08 16:53:39,118,4007,60,58,2205.55,4218.01,0.00
2024-12-08 16:53:39,117,4007,60,57,2214.48,4218.09,0.00
2024-12-08 16:53:39,116,4007,59,57,2228.48,4218.10,0.00
2024-12-08 16:53:39,117,4006,59,58,2203.00,4218.27,0.00
2024-12-08 16:53:39,117,4007,59,58,2303.84,4219.00,0.00
2024-12-08 16:53:39,118,4007,60,58,2284.32,4219.01,0.00
2024-12-08 16:53:39,119,4006,60,59,2264.42,4219.04,0.00
2024-12-08 16:53:39,118,4006,60,58,2315.66,4219.07,0.00
2024-12-08 16:53:39,117,4006,60,57,2326.28,4219.09,0.00
2024-12-08 16:53:39,118,4005,61,57,2300.54,4219.25,0.00
2024-12-08 16:53:39,118,4006,61,57,2324.22,4220.00,0.00
2024-12-08 16:53:39,119,4006,61,58,2304.69,4220.01,0.00
2024-12-08 16:53:39,118,4006,60,58,2323.86,4220.01,0.00
2024-12-08 16:53:39,117,4006,60,57,2332.30,4220.08,0.00
2024-12-08 16:53:39,116,4006,59,57,2319.59,4220.59,0.00
2024-12-08 16:53:39,116,4007,59,57,2410.63,4221.00,0.00
2024-12-08 16:53:39,117,4007,59,58,2390.02,4221.01,0.00
2024-12-08 16:53:39,116,4007,58,58,2408.17,4221.05,0.00
2024-12-08 16:53:39,115,4007,58,57,2422.87,4221.07,0.00
2024-12-08 16:53:40,115,4008,58,57,2402.05,4222.00,0.00
2024-12-08 16:53:40,116,4008,58,58,2381.34,4222.01,0.00
2024-12-08 16:53:40,115,4008,58,57,2394.00,4222.07,0.00
2024-12-08 16:53:40,114,4008,57,57,2405.38,4222.11,0.00
2024-12-08 16:53:40,113,4008,57,56,2420.00,4222.25,0.00
2024-12-08 16:53:40,112,4008,56,56,2436.75,4222.36,0.00
2024-12-08 16:53:40,111,4008,55,56,2448.68,4222.60,0.00
2024-12-08 16:53:40,111,4009,55,56,2469.78,4223.00,0.00
2024-12-08 16:53:40,112,4009,56,56,2447.73,4223.01,0.00
2024-12-08 16:53:40,111,4009,56,55,2460.30,4223.09,0.00
2024-12-08 16:53:40,110,4009,55,55,2480.93,4223.09,0.00
2024-12-08 16:53:40,109,4009,54,55,2486.48,4223.50,0.00
2024-12-08 16:53:40,109,4010,54,55,2504.15,4224.00,0.00
2024-12-08 16:53:40,110,4010,54,56,2481.38,4224.01,0.00
2024-12-08 16:53:40,109,4010,54,55,2493.72,4224.09,0.00
2024-12-08 16:53:40,109,4011,54,55,2477.23,4225.00,0.00
2024-12-08 16:53:40,110,4011,55,55,2454.71,4225.01,0.00
2024-12-08 16:53:40,109,4011,55,54,2466.41,4225.09,0.00
2024-12-08 16:53:40,108,4011,54,54,2484.22,4225.20,0.00
2024-12-08 16:53:40,107,4011,53,54,2496.38,4225.21,0.00
2024-12-08 16:53:40,107,4012,53,54,2498.47,4226.00,0.00
2024-12-08 16:53:40,108,4012,53,55,2475.34,4226.01,0.00
2024-12-08 16:53:40,107,4012,52,55,2471.08,4226.21,0.00
2024-12-08 16:53:40,107,4013,52,55,2470.34,4227.00,0.00
2024-12-08 16:53:40,108,4013,53,55,2447.47,4227.01,0.00
2024-12-08 16:53:40,109,4012,53,56,2425.02,4227.03,0.00
2024-12-08 16:53:40,108,4012,52,56,2455.32,4227.06,0.00
2024-12-08 16:53:40,107,4012,52,55,2473.14,4227.08,0.00
2024-12-08 16:53:40,107,4013,52,55,2467.00,4228.00,0.00
2024-12-08 16:53:40,108,4013,53,55,2444.15,4228.01,0.00
2024-12-08 16:53:40,107,4013,53,54,2462.29,4228.08,0.00
2024-12-08 16:53:40,108,4012,54,54,2402.36,4228.80,0.00
2024-12-08 16:53:40,108,4013,54,54,2462.45,4229.00,0.00
2024-12-08 16:53:40,109,4013,54,55,2439.86,4229.01,0.00
2024-12-08 16:53:40,109,4014,54,55,2458.53,4230.00,0.00
2024-12-08 16:53:40,110,4014,54,56,2436.18,4230.01,0.00
2024-12-08 16:53:40,109,4014,54,55,2412.15,4230.74,0.00
2024-12-08 16:53:40,109,4015,54,55,2440.32,4231.00,0.00
2024-12-08 16:53:40,110,4015,55,55,2418.13,4231.01,0.00
2024-12-08 16:53:40,109,4015,54,55,2392.23,4231.72,0.00
2024-12-08 16:53:40,109,4016,54,55,2419.26,4232.00,0.00
2024-12-08 16:53:40,110,4016,54,56,2397.27,4232.01,0.00
2024-12-08 16:53:40,110,4017,54,56,2371.28,4233.00,0.00
2024-12-08 16:53:40,111,4017,55,56,2349.92,4233.01,0.00
2024-12-08 16:53:40,110,4017,55,55,2366.69,4233.07,0.00
2024-12-08 16:53:40,110,4018,55,55,2351.06,4234.00,0.00
2024-12-08 16:53:40,111,4018,56,55,2329.88,4234.01,0.00
2024-12-08 16:53:40,110,4018,56,54,2344.15,4234.07,0.00
2024-12-08 16:53:40,109,4018,55,54,2346.30,4234.26,0.00
2024-12-08 16:53:40,109,4019,55,54,2354.15,4235.00,0.00
2024-12-08 16:53:40,110,4019,56,54,2332.75,4235.01,0.00
2024-12-08 16:53:40,109,4019,56,53,2347.47,4235.07,0.00
2024-12-08 16:53:40,108,4019,55,53,2352.01,4235.23,0.00
2024-12-08 16:53:40,108,4020,55,53,2359.15,4236.00,0.00
2024-12-08 16:53:40,109,4020,55,54,2337.51,4236.01,0.00
2024-12-08 16:53:40,108,4020,55,53,2335.26,4236.09,0.00
2024-12-08 16:53:40,109,4019,56,53,2289.18,4236.69,0.00
2024-12-08 16:53:40,109,4020,56,53,2325.20,4237.00,0.00
2024-12-08 16:53:40,110,4020,56,54,2304.06,4237.01,0.00
2024-12-08 16:53:40,111,4019,57,54,2253.35,4237.56,0.00
2024-12-08 16:53:40,111,4020,57,54,2345.06,4238.00,0.00
2024-12-08 16:53:40,112,4020,57,55,2324.13,4238.01,0.00
2024-12-08 16:53:40,112,4021,57,55,2344.73,4239.00,0.00
2024-12-08 16:53:40,113,4021,58,55,2323.98,4239.01,0.00
2024-12-08 16:53:40,112,4021,57,55,2343.73,4239.03,0.00
2024-12-08 16:53:40,112,4022,57,55,2322.07,4240.00,0.00
2024-12-08 16:53:40,113,4022,57,56,2301.52,4240.01,0.00
2024-12-08 16:53:40,112,4022,57,55,2311.50,4240.08,0.00
2024-12-08 16:53:40,112,4023,57,55,2295.69,4241.00,0.00
2024-12-08 16:53:40,113,4023,57,56,2275.38,4241.01,0.00
2024-12-08 16:53:40,114,4022,57,57,2255.42,4241.03,0.00
2024-12-08 16:53:40,113,4022,56,57,2278.77,4241.05,0.00
2024-12-08 16:53:40,114,4021,56,58,2233.26,4241.50,0.00
2024-12-08 16:53:40,114,4022,56,58,2255.48,4242.00,0.00
2024-12-08 16:53:40,115,4022,56,59,2235.87,4242.01,0.00
2024-12-08 16:53:40,114,4022,55,59,2254.38,4242.03,0.00
2024-12-08 16:53:40,115,4021,56,59,2234.41,4242.05,0.00
2024-12-08 16:53:40,114,4021,56,58,2271.52,4242.07,0.00
2024-12-08 16:53:40,115,4020,57,58,2229.83,4242.61,0.00
2024-12-08 16:53:40,115,4021,57,58,2321.26,4243.00,0.00
2024-12-08 16:53:40,116,4021,57,59,2301.25,4243.01,0.00
2024-12-08 16:53:40,115,4021,57,58,2316.49,4243.06,0.00
2024-12-08 16:53:40,114,4021,57,57,2334.66,4243.11,0.00
2024-12-08 16:53:40,114,4022,57,57,2393.98,4244.00,0.00
2024-12-08 16:53:40,115,4022,58,57,2373.17,4244.01,0.00
2024-12-08 16:53:40,114,4022,58,56,2388.81,4244.07,0.00
2024-12-08 16:53:40,114,4022,58,56,2371.91,4245.00,0.00
2024-12-08 16:53:40,115,4022,58,57,2351.28,4245.01,0.00
2024-12-08 16:53:40,114,4022,58,56,2364.87,4245.08,0.00
2024-12-08 16:53:40,113,4022,57,56,2360.61,4245.30,0.00
2024-12-08 16:53:40,114,4021,57,57,2323.37,4245.71,0.00
2024-12-08 16:53:41,114,4022,57,57,2378.60,4246.00,0.00
2024-12-08 16:53:41,115,4022,57,58,2357.92,4246.01,0.00
2024-12-08 16:53:41,114,4022,57,57,2371.56,4246.08,0.00
2024-12-08 16:53:41,113,4022,56,57,2383.06,4246.23,0.00
2024-12-08 16:53:41,113,4023,56,57,2426.02,4247.00,0.00
2024-12-08 16:53:41,114,4023,56,58,2404.74,4247.01,0.00
2024-12-08 16:53:41,113,4023,56,57,2418.91,4247.08,0.00
2024-12-08 16:53:41,114,4022,57,57,2382.31,4247.45,0.00
2024-12-08 16:53:41,113,4022,56,57,2414.13,4247.62,0.00
2024-12-08 16:53:41,112,4022,55,57,2416.42,4247.73,0.00
2024-12-08 16:53:41,112,4023,55,57,2443.19,4248.00,0.00
2024-12-08 16:53:41,113,4023,56,57,2421.57,4248.01,0.00
2024-12-08 16:53:41,112,4023,56,56,2436.02,4248.08,0.00
2024-12-08 16:53:41,112,4024,56,56,2457.25,4249.00,0.00
2024-12-08 16:53:41,113,4024,56,57,2435.50,4249.01,0.00
2024-12-08 16:53:41,112,4024,56,56,2450.08,4249.08,0.00
2024-12-08 16:53:41,112,4025,56,56,2432.84,4250.00,0.00
2024-12-08 16:53:41,113,4025,56,57,2411.31,4250.01,0.00
2024-12-08 16:53:41,112,4025,56,56,2425.67,4250.08,0.00
2024-12-08 16:53:41,113,4024,56,57,2403.83,4250.11,0.00
2024-12-08 16:53:41,112,4024,55,57,2454.51,4250.29,0.00
2024-12-08 16:53:41,111,4024,54,57,2470.54,4250.38,0.00
2024-12-08 16:53:41,111,4025,54,57,2481.45,4251.00,0.00
2024-12-08 16:53:41,112,4025,54,58,2459.29,4251.01,0.00
2024-12-08 16:53:41,111,4025,54,57,2474.21,4251.08,0.00
2024-12-08 16:53:41,112,4024,54,58,2432.20,4251.57,0.00
2024-12-08 16:53:41,113,4023,55,58,2415.63,4251.73,0.00
2024-12-08 16:53:41,114,4022,55,59,2401.91,4251.75,0.00
2024-12-08 16:53:41,114,4023,55,59,2488.27,4252.00,0.00
2024-12-08 16:53:41,115,4023,55,60,2466.63,4252.01,0.00
2024-12-08 16:53:41,114,4023,55,59,2479.74,4252.10,0.00
2024-12-08 16:53:41,113,4023,54,59,2496.41,4252.10,0.00
2024-12-08 16:53:41,114,4022,54,60,2460.46,4252.45,0.00
2024-12-08 16:53:41,114,4023,54,60,2601.90,4253.00,0.00
2024-12-08 16:53:41,115,4023,55,60,2579.28,4253.01,0.00
2024-12-08 16:53:41,114,4023,54,60,2581.86,4253.30,0.00
2024-12-08 16:53:41,114,4024,54,60,2614.36,4254.00,0.00
2024-12-08 16:53:41,115,4024,55,60,2591.63,4254.01,0.00
2024-12-08 16:53:41,115,4025,55,60,2563.16,4255.00,0.00
2024-12-08 16:53:41,116,4025,55,61,2541.06,4255.01,0.00
2024-12-08 16:53:41,115,4025,54,61,2560.23,4255.07,0.00
2024-12-08 16:53:41,114,4025,54,60,2580.83,4255.09,0.00
2024-12-08 16:53:41,113,4025,53,60,2593.98,4255.31,0.00
2024-12-08 16:53:41,113,4026,53,60,2585.90,4256.00,0.00
2024-12-08 16:53:41,114,4026,54,60,2563.22,4256.01,0.00
2024-12-08 16:53:41,113,4026,54,59,2578.03,4256.09,0.00
2024-12-08 16:53:41,113,4027,54,59,2559.62,4257.00,0.00
2024-12-08 16:53:41,114,4027,55,59,2537.17,4257.01,0.00
2024-12-08 16:53:41,113,4027,55,58,2550.63,4257.10,0.00
2024-12-08 16:53:41,113,4028,55,58,2532.18,4258.00,0.00
2024-12-08 16:53:41,114,4028,55,59,2509.97,4258.01,0.00
2024-12-08 16:53:41,113,4028,54,59,2524.69,4258.09,0.00
2024-12-08 16:53:41,112,4028,54,58,2541.90,4258.09,0.00
2024-12-08 16:53:41,112,4029,54,58,2538.28,4259.00,0.00
2024-12-08 16:53:41,113,4029,55,58,2515.82,4259.01,0.00
2024-12-08 16:53:41,112,4029,54,58,2511.78,4259.25,0.00
2024-12-08 16:53:41,112,4030,54,58,2513.69,4260.00,0.00
2024-12-08 16:53:41,113,4030,54,59,2491.45,4260.01,0.00
2024-12-08 16:53:41,114,4029,54,60,2469.23,4260.04,0.00
2024-12-08 16:53:41,113,4029,54,59,2512.98,4260.11,0.00
2024-12-08 16:53:41,112,4029,53,59,2527.49,4260.29,0.00
2024-12-08 16:53:41,112,4030,53,59,2515.61,4261.00,0.00
2024-12-08 16:53:41,113,4030,54,59,2493.35,4261.01,0.00
2024-12-08 16:53:41,112,4030,53,59,2514.49,4261.03,0.00
2024-12-08 16:53:41,111,4030,53,58,2529.50,4261.09,0.00
2024-12-08 16:53:41,112,4029,54,58,2479.61,4261.67,0.00
2024-12-08 16:53:41,112,4030,54,58,2532.92,4262.00,0.00
2024-12-08 16:53:41,113,4030,54,59,2510.50,4262.01,0.00
2024-12-08 16:53:41,112,4030,54,58,2523.55,4262.10,0.00
2024-12-08 16:53:41,113,4029,54,59,2459.13,4262.65,0.00
2024-12-08 16:53:41,113,4030,54,59,2525.96,4263.00,0.00
2024-12-08 16:53:41,114,4030,54,60,2503.81,4263.01,0.00
2024-12-08 16:53:41,113,4030,53,60,2522.99,4263.07,0.00
2024-12-08 16:53:41,112,4030,53,59,2539.43,4263.09,0.00
2024-12-08 16:53:41,111,4030,52,59,2554.82,4263.26,0.00
2024-12-08 16:53:41,111,4031,52,59,2578.46,4264.00,0.00
2024-12-08 16:53:41,112,4031,52,60,2555.44,4264.01,0.00
2024-12-08 16:53:41,111,4031,52,59,2568.52,4264.09,0.00
2024-12-08 16:53:41,110,4031,51,59,2544.31,4264.74,0.00
2024-12-08 16:53:41,110,4032,51,59,2568.16,4265.00,0.00
2024-12-08 16:53:41,111,4032,52,59,2545.02,4265.01,0.00
2024-12-08 16:53:41,110,4032,52,58,2557.35,4265.10,0.00
2024-12-08 16:53:41,109,4032,51,58,2564.50,4265.42,0.00
2024-12-08 16:53:41,110,4031,51,59,2535.53,4265.54,0.00
2024-12-08 16:53:41,110,4032,51,59,2549.01,4266.00,0.00
2024-12-08 16:53:41,111,4032,51,60,2526.05,4266.01,0.00
2024-12-08 16:53:41,110,4032,51,59,2538.20,4266.10,0.00
2024-12-08 16:53:41,109,4032,50,59,2541.73,4266.23,0.00
2024-12-08 16:53:41,110,4031,50,60,2518.24,4266.25,0.00
2024-12-08 16:53:41,109,4031,50,59,2538.91,4266.79,0.00
2024-12-08 16:53:41,109,4032,50,59,2608.36,4267.00,0.00
2024-12-08 16:53:41,110,4032,51,59,2584.64,4267.01,0.00
2024-12-08 16:53:41,109,4032,51,58,2597.05,4267.10,0.00
2024-12-08 16:53:41,108,4032,50,58,2616.92,4267.19,0.00
2024-12-08 16:53:41,107,4032,49,58,2622.41,4267.25,0.00
2024-12-08 16:53:41,107,4032,49,58,2667.47,4268.00,0.00
2024-12-08 16:53:41,108,4032,49,59,2642.77,4268.01,0.00
2024-12-08 16:53:41,107,4032,49,58,2656.35,4268.10,0.00
2024-12-08 16:53:41,108,4031,49,59,2605.52,4268.69,0.00
2024-12-08 16:53:42,108,4032,49,59,2623.88,4269.00,0.00
2024-12-08 16:53:42,109,4032,50,59,2599.81,4269.01,0.00
2024-12-08 16:53:42,108,4032,50,58,2612.47,4269.10,0.00
2024-12-08 16:53:42,108,4033,50,58,2633.01,4270.00,0.00
2024-12-08 16:53:42,109,4033,51,58,2608.85,4270.01,0.00
2024-12-08 16:53:42,110,4032,52,58,2585.13,4270.03,0.00
2024-12-08 16:53:42,111,4031,53,58,2550.43,4270.33,0.00
2024-12-08 16:53:42,111,4032,53,58,2562.50,4271.00,0.00
2024-12-08 16:53:42,112,4032,54,58,2539.62,4271.01,0.00
2024-12-08 16:53:42,111,4032,54,57,2556.39,4271.10,0.00
2024-12-08 16:53:42,110,4032,53,57,2545.90,4271.74,0.00
2024-12-08 16:53:42,111,4031,53,58,2515.79,4271.92,0.00
2024-12-08 16:53:42,111,4032,53,58,2614.37,4272.00,0.00
2024-12-08 16:53:42,112,4032,54,58,2591.03,4272.01,0.00
2024-12-08 16:53:42,111,4032,54,57,2610.53,4272.07,0.00
2024-12-08 16:53:42,110,4032,54,56,2624.56,4272.11,0.00
2024-12-08 16:53:42,109,4032,53,56,2636.05,4272.38,0.00
2024-12-08 16:53:42,110,4031,54,56,2610.16,4272.44,0.00
2024-12-08 16:53:42,110,4032,54,56,2650.62,4273.00,0.00
2024-12-08 16:53:42,111,4032,54,57,2626.74,4273.01,0.00
2024-12-08 16:53:42,110,4032,53,57,2643.19,4273.08,0.00
2024-12-08 16:53:42,111,4031,54,57,2584.60,4273.74,0.00
2024-12-08 16:53:42,111,4032,54,57,2673.24,4274.00,0.00
2024-12-08 16:53:42,112,4032,55,57,2649.37,4274.01,0.00
2024-12-08 16:53:42,113,4031,55,58,2600.04,4274.42,0.00
2024-12-08 16:53:42,112,4031,54,58,2598.79,4274.73,0.00
2024-12-08 16:53:42,112,4032,54,58,2663.71,4275.00,0.00
2024-12-08 16:53:42,113,4032,55,58,2640.13,4275.01,0.00
2024-12-08 16:53:42,113,4033,55,58,2650.34,4276.00,0.00
2024-12-08 16:53:42,114,4033,56,58,2627.09,4276.01,0.00
2024-12-08 16:53:42,113,4033,56,57,2642.56,4276.13,0.00
2024-12-08 16:53:42,113,4034,56,57,2628.38,4277.00,0.00
2024-12-08 16:53:42,114,4034,57,57,2605.32,4277.01,0.00
2024-12-08 16:53:42,113,4034,56,57,2588.58,4277.74,0.00
2024-12-08 16:53:42,113,4034,56,57,2615.30,4278.00,0.00
2024-12-08 16:53:42,114,4034,57,57,2592.36,4278.01,0.00
2024-12-08 16:53:42,113,4034,57,56,2608.45,4278.13,0.00
2024-12-08 16:53:42,114,4033,57,57,2573.32,4278.44,0.00
2024-12-08 16:53:42,114,4034,57,57,2588.38,4279.00,0.00
2024-12-08 16:53:42,115,4034,57,58,2565.87,4279.01,0.00
2024-12-08 16:53:42,114,4034,56,58,2582.91,4279.10,0.00
2024-12-08 16:53:42,114,4035,56,58,2611.12,4280.00,0.00
2024-12-08 16:53:42,115,4035,56,59,2588.42,4280.01,0.00
2024-12-08 16:53:42,114,4035,56,58,2603.47,4280.12,0.00
2024-12-08 16:53:42,113,4035,56,57,2625.99,4280.13,0.00
2024-12-08 16:53:42,114,4034,57,57,2565.69,4280.68,0.00
2024-12-08 16:53:42,114,4035,57,57,2591.76,4281.00,0.00
2024-12-08 16:53:42,115,4035,57,58,2569.22,4281.01,0.00
2024-12-08 16:53:42,115,4036,57,58,2577.58,4282.00,0.00
2024-12-08 16:53:42,116,4036,57,59,2555.36,4282.01,0.00
2024-12-08 16:53:42,117,4035,58,59,2530.59,4282.09,0.00
2024-12-08 16:53:42,116,4035,58,58,2577.19,4282.17,0.00
2024-12-08 16:53:42,115,4035,57,58,2564.86,4282.68,0.00
2024-12-08 16:53:42,115,4036,57,58,2588.58,4283.00,0.00
2024-12-08 16:53:42,116,4036,58,58,2566.27,4283.01,0.00
2024-12-08 16:53:42,116,4037,58,58,2572.55,4284.00,0.00
2024-12-08 16:53:42,117,4037,59,58,2550.56,4284.01,0.00
2024-12-08 16:53:42,118,4036,60,58,2527.52,4284.06,0.00
2024-12-08 16:53:42,117,4036,60,57,2563.52,4284.19,0.00
2024-12-08 16:53:42,118,4035,61,57,2539.28,4284.26,0.00
2024-12-08 16:53:42,117,4035,60,57,2579.69,4284.33,0.00
2024-12-08 16:53:42,117,4036,60,57,2586.57,4285.00,0.00
2024-12-08 16:53:42,118,4036,60,58,2564.65,4285.01,0.00
2024-12-08 16:53:42,119,4035,60,59,2543.09,4285.03,0.00
2024-12-08 16:53:42,120,4034,61,59,2520.85,4285.17,0.00
2024-12-08 16:53:42,120,4035,61,59,2586.84,4286.00,0.00
2024-12-08 16:53:42,121,4035,61,60,2565.46,4286.01,0.00
2024-12-08 16:53:42,120,4035,61,59,2575.85,4286.18,0.00
2024-12-08 16:53:42,120,4036,61,59,2634.25,4287.00,0.00
2024-12-08 16:53:42,121,4036,62,59,2612.47,4287.01,0.00
2024-12-08 16:53:42,120,4036,61,59,2601.94,4287.47,0.00
2024-12-08 16:53:42,120,4037,61,59,2615.21,4288.00,0.00
2024-12-08 16:53:42,121,4037,62,59,2593.59,4288.01,0.00
2024-12-08 16:53:42,120,4037,61,59,2608.49,4288.16,0.00
2024-12-08 16:53:42,119,4037,61,58,2625.73,4288.19,0.00
2024-12-08 16:53:42,118,4037,60,58,2644.39,4288.27,0.00
2024-12-08 16:53:42,119,4036,60,59,2621.81,4288.29,0.00
2024-12-08 16:53:42,119,4037,60,59,2618.34,4289.00,0.00
2024-12-08 16:53:42,120,4037,61,59,2596.52,4289.01,0.00
2024-12-08 16:53:42,120,4038,61,59,2603.98,4290.00,0.00
2024-12-08 16:53:42,121,4038,62,59,2582.46,4290.01,0.00
2024-12-08 16:53:42,120,4038,62,58,2598.66,4290.09,0.00
2024-12-08 16:53:42,119,4038,61,58,2616.05,4290.17,0.00
2024-12-08 16:53:42,120,4037,61,59,2575.18,4290.63,0.00
2024-12-08 16:53:42,120,4038,61,59,2590.53,4291.00,0.00
2024-12-08 16:53:42,121,4038,62,59,2569.12,4291.01,0.00
2024-12-08 16:53:42,122,4037,62,60,2546.33,4291.07,0.00
2024-12-08 16:53:42,121,4037,62,59,2591.38,4291.09,0.00
2024-12-08 16:53:42,120,4037,62,58,2605.81,4291.17,0.00
2024-12-08 16:53:42,121,4036,62,59,2583.92,4291.19,0.00
2024-12-08 16:53:42,122,4035,62,60,2585.28,4291.27,0.00
2024-12-08 16:53:43,122,4036,62,60,2610.82,4292.00,0.00
2024-12-08 16:53:43,123,4036,63,60,2589.59,4292.01,0.00
2024-12-08 16:53:43,122,4036,62,60,2584.95,4292.34,0.00
2024-12-08 16:53:43,123,4035,63,60,2552.58,4292.63,0.00
2024-12-08 16:53:43,122,4035,62,60,2574.96,4292.75,0.00
2024-12-08 16:53:43,122,4036,62,60,2704.85,4293.00,0.00
2024-12-08 16:53:43,123,4036,62,61,2682.86,4293.01,0.00
2024-12-08 16:53:43,122,4036,61,61,2699.80,4293.09,0.00
2024-12-08 16:53:43,123,4035,61,62,2652.58,4293.54,0.00
2024-12-08 16:53:43,123,4036,61,62,2710.11,4294.00,0.00
2024-12-08 16:53:43,124,4036,62,62,2688.25,4294.01,0.00
2024-12-08 16:53:43,124,4037,62,62,2698.55,4295.00,0.00
2024-12-08 16:53:43,125,4037,63,62,2676.96,4295.01,0.00
2024-12-08 16:53:43,125,4038,63,62,2647.75,4296.00,0.00
2024-12-08 16:53:43,126,4038,64,62,2626.73,4296.01,0.00
2024-12-08 16:53:43,127,4037,64,63,2601.98,4296.10,0.00
2024-12-08 16:53:43,126,4037,64,62,2624.70,4296.16,0.00
2024-12-08 16:53:43,126,4038,64,62,2609.56,4297.00,0.00
2024-12-08 16:53:43,127,4038,65,62,2589.01,4297.01,0.00
2024-12-08 16:53:43,126,4038,64,62,2586.18,4297.30,0.00
2024-12-08 16:53:43,126,4039,64,62,2624.85,4298.00,0.00
2024-12-08 16:53:43,127,4039,65,62,2604.18,4298.01,0.00
2024-12-08 16:53:43,128,4038,66,62,2563.56,4298.34,0.00
2024-12-08 16:53:43,128,4039,66,62,2582.45,4299.00,0.00
2024-12-08 16:53:43,129,4039,67,62,2562.43,4299.01,0.00
2024-12-08 16:53:43,128,4039,66,62,2578.59,4299.09,0.00
2024-12-08 16:53:43,129,4038,67,62,2536.75,4299.47,0.00
2024-12-08 16:53:43,130,4037,67,63,2522.87,4299.48,0.00
2024-12-08 16:53:43,130,4038,67,63,2571.24,4300.00,0.00
2024-12-08 16:53:43,131,4038,68,63,2551.61,4300.01,0.00
2024-12-08 16:53:43,132,4037,68,64,2498.93,4300.65,0.00
2024-12-08 16:53:43,132,4038,68,64,2577.72,4301.00,0.00
2024-12-08 16:53:43,133,4038,69,64,2558.34,4301.01,0.00
2024-12-08 16:53:43,132,4038,68,64,2574.50,4301.08,0.00
2024-12-08 16:53:43,131,4038,68,63,2590.56,4301.13,0.00
2024-12-08 16:53:43,131,4039,68,63,2605.99,4302.00,0.00
2024-12-08 16:53:43,132,4039,69,63,2586.25,4302.01,0.00
2024-12-08 16:53:43,131,4039,69,62,2594.23,4302.14,0.00
2024-12-08 16:53:43,130,4039,68,62,2606.65,4302.31,0.00
2024-12-08 16:53:43,130,4040,68,62,2596.82,4303.00,0.00
2024-12-08 16:53:43,131,4040,68,63,2577.00,4303.01,0.00
2024-12-08 16:53:43,130,4040,68,62,2584.96,4303.14,0.00
2024-12-08 16:53:43,129,4040,67,62,2581.60,4303.50,0.00
2024-12-08 16:53:43,130,4039,68,62,2560.11,4303.55,0.00
2024-12-08 16:53:43,130,4040,68,62,2584.92,4304.00,0.00
2024-12-08 16:53:43,131,4040,69,62,2565.19,4304.01,0.00
2024-12-08 16:53:43,130,4040,68,62,2578.35,4304.10,0.00
2024-12-08 16:53:43,129,4040,68,61,2590.67,4304.13,0.00
2024-12-08 16:53:43,130,4039,68,62,2563.53,4304.32,0.00
2024-12-08 16:53:43,130,4040,68,62,2618.28,4305.00,0.00
2024-12-08 16:53:43,131,4040,69,62,2598.30,4305.01,0.00
2024-12-08 16:53:43,130,4040,69,61,2593.17,4305.13,0.00
2024-12-08 16:53:43,131,4039,69,62,2570.12,4305.22,0.00
2024-12-08 16:53:43,132,4038,70,62,2548.57,4305.59,0.00
2024-12-08 16:53:43,133,4037,70,63,2520.28,4305.81,0.00
2024-12-08 16:53:43,133,4038,70,63,2581.30,4306.00,0.00
2024-12-08 16:53:43,134,4038,71,63,2562.03,4306.01,0.00
2024-12-08 16:53:43,133,4038,71,62,2569.37,4306.13,0.00
2024-12-08 16:53:43,134,4037,72,62,2545.74,4306.25,0.00
2024-12-08 16:53:43,134,4038,72,62,2647.61,4307.00,0.00
2024-12-08 16:53:43,135,4038,72,63,2628.00,4307.01,0.00
2024-12-08 16:53:43,136,4037,73,63,2583.55,4307.46,0.00
2024-12-08 16:53:43,136,4038,73,63,2615.65,4308.00,0.00
2024-12-08 16:53:43,137,4038,73,64,2596.55,4308.01,0.00
2024-12-08 16:53:43,136,4038,72,64,2596.45,4308.30,0.00
2024-12-08 16:53:43,135,4038,71,64,2598.03,4308.49,0.00
2024-12-08 16:53:43,135,4039,71,64,2636.41,4309.00,0.00
2024-12-08 16:53:43,136,4039,71,65,2617.03,4309.01,0.00
2024-12-08 16:53:43,135,4039,70,65,2633.88,4309.06,0.00
2024-12-08 16:53:43,134,4039,70,64,2649.39,4309.13,0.00
2024-12-08 16:53:43,135,4038,71,64,2605.64,4309.62,0.00
2024-12-08 16:53:43,135,4039,71,64,2617.44,4310.00,0.00
2024-12-08 16:53:43,136,4039,71,65,2598.19,4310.01,0.00
2024-12-08 16:53:43,137,4038,72,65,2577.67,4310.06,0.00
2024-12-08 16:53:43,136,4038,72,64,2592.22,4310.14,0.00
2024-12-08 16:53:43,137,4037,73,64,2545.00,4310.71,0.00
2024-12-08 16:53:43,137,4038,73,64,2602.19,4311.00,0.00
2024-12-08 16:53:43,138,4038,73,65,2583.33,4311.01,0.00
2024-12-08 16:53:43,139,4037,73,66,2560.14,4311.13,0.00
2024-12-08 16:53:43,138,4037,73,65,2585.85,4311.52,0.00
2024-12-08 16:53:43,139,4036,74,65,2549.56,4311.94,0.00
2024-12-08 16:53:43,139,4037,74,65,2629.02,4312.00,0.00
2024-12-08 16:53:43,140,4037,74,66,2610.24,4312.01,0.00
2024-12-08 16:53:43,141,4036,74,67,2591.72,4312.02,0.00
2024-12-08 16:53:43,141,4037,74,67,2640.91,4313.00,0.00
2024-12-08 16:53:43,142,4037,75,67,2622.31,4313.01,0.00
2024-12-08 16:53:43,141,4037,74,67,2637.28,4313.09,0.00
2024-12-08 16:53:43,142,4036,75,67,2602.11,4313.35,0.00
2024-12-08 16:53:43,142,4037,75,67,2636.77,4314.00,0.00
2024-12-08 16:53:43,143,4037,76,67,2618.33,4314.01,0.00
2024-12-08 16:53:44,142,4037,75,67,2635.57,4314.03,0.00
2024-12-08 16:53:44,141,4037,74,67,2651.84,4314.08,0.00
2024-12-08 16:53:44,142,4036,75,67,2619.86,4314.26,0.00
2024-12-08 16:53:44,142,4037,75,67,2667.67,4315.00,0.00
2024-12-08 16:53:44,143,4037,76,67,2649.01,4315.01,0.00
2024-12-08 16:53:44,142,4037,75,67,2651.56,4315.24,0.00
2024-12-08 16:53:44,141,4037,74,67,2638.09,4315.94,0.00
2024-12-08 16:53:44,141,4038,74,67,2696.61,4316.00,0.00
2024-12-08 16:53:44,142,4038,74,68,2677.62,4316.01,0.00
2024-12-08 16:53:44,141,4038,74,67,2689.30,4316.09,0.00
2024-12-08 16:53:44,142,4037,74,68,2632.42,4316.99,0.00
2024-12-08 16:53:44,142,4038,74,68,2650.67,4317.00,0.00
2024-12-08 16:53:44,143,4038,74,69,2632.13,4317.01,0.00
2024-12-08 16:53:44,142,4038,74,68,2641.59,4317.11,0.00
2024-12-08 16:53:44,143,4037,74,69,2615.95,4317.29,0.00
2024-12-08 16:53:44,144,4036,74,70,2596.07,4317.46,0.00
2024-12-08 16:53:44,145,4035,74,71,2572.11,4317.68,0.00
2024-12-08 16:53:44,146,4034,75,71,2539.90,4317.93,0.00
2024-12-08 16:53:44,146,4035,75,71,2597.33,4318.00,0.00
2024-12-08 16:53:44,147,4035,75,72,2579.67,4318.01,0.00
2024-12-08 16:53:44,146,4035,74,72,2594.12,4318.08,0.00
2024-12-08 16:53:44,145,4035,73,72,2577.65,4318.71,0.00
2024-12-08 16:53:44,144,4035,72,72,2592.58,4318.76,0.00
2024-12-08 16:53:44,144,4036,72,72,2732.24,4319.00,0.00
2024-12-08 16:53:44,145,4036,72,73,2713.40,4319.01,0.00
2024-12-08 16:53:44,145,4037,72,73,2688.65,4320.00,0.00
2024-12-08 16:53:44,146,4037,73,73,2670.23,4320.01,0.00
2024-12-08 16:53:44,146,4038,73,73,2641.30,4321.00,0.00
2024-12-08 16:53:44,147,4038,73,74,2623.33,4321.01,0.00
2024-12-08 16:53:44,146,4038,72,74,2639.55,4321.04,0.00
2024-12-08 16:53:44,145,4038,71,74,2637.17,4321.38,0.00
2024-12-08 16:53:44,145,4039,71,74,2627.54,4322.00,0.00
2024-12-08 16:53:44,146,4039,71,75,2609.55,4322.01,0.00
2024-12-08 16:53:44,145,4039,71,74,2621.92,4322.11,0.00
2024-12-08 16:53:44,145,4040,71,74,2600.80,4323.00,0.00
2024-12-08 16:53:44,146,4040,71,75,2582.98,4323.01,0.00
2024-12-08 16:53:44,145,4040,71,74,2591.60,4323.12,0.00
2024-12-08 16:53:44,144,4040,70,74,2576.62,4323.63,0.00
2024-12-08 16:53:44,144,4041,70,74,2590.73,4324.00,0.00
2024-12-08 16:53:44,145,4041,70,75,2572.87,4324.01,0.00
2024-12-08 16:53:44,144,4041,70,74,2581.47,4324.12,0.00
2024-12-08 16:53:44,144,4042,70,74,2560.92,4325.00,0.00
2024-12-08 16:53:44,145,4042,70,75,2543.26,4325.01,0.00
2024-12-08 16:53:44,144,4042,70,74,2551.20,4325.12,0.00
2024-12-08 16:53:44,144,4043,70,74,2530.76,4326.00,0.00
2024-12-08 16:53:44,145,4043,71,74,2513.30,4326.01,0.00
2024-12-08 16:53:44,146,4042,72,74,2479.59,4326.27,0.00
2024-12-08 16:53:44,146,4043,72,74,2493.17,4327.00,0.00
2024-12-08 16:53:44,147,4043,72,75,2476.21,4327.01,0.00
2024-12-08 16:53:44,148,4042,72,76,2426.41,4327.63,0.00
2024-12-08 16:53:44,148,4043,72,76,2484.44,4328.00,0.00
2024-12-08 16:53:44,149,4043,73,76,2467.76,4328.01,0.00
2024-12-08 16:53:44,148,4043,72,76,2464.97,4328.32,0.00
2024-12-08 16:53:44,148,4044,72,76,2483.21,4329.00,0.00
2024-12-08 16:53:44,149,4044,72,77,2466.54,4329.01,0.00
2024-12-08 16:53:44,148,4044,72,76,2473.30,4329.12,0.00
2024-12-08 16:53:44,147,4044,71,76,2476.83,4329.40,0.00
2024-12-08 16:53:44,147,4045,71,76,2468.40,4330.00,0.00
2024-12-08 16:53:44,148,4045,72,76,2451.72,4330.01,0.00
2024-12-08 16:53:44,147,4045,71,76,2464.83,4330.09,0.00
2024-12-08 16:53:44,146,4045,70,76,2465.16,4330.33,0.00
2024-12-08 16:53:44,146,4046,70,76,2461.04,4331.00,0.00
2024-12-08 16:53:44,147,4046,71,76,2444.30,4331.01,0.00
2024-12-08 16:53:44,148,4045,72,76,2426.62,4331.05,0.00
2024-12-08 16:53:44,148,4046,72,76,2406.03,4332.00,0.00
2024-12-08 16:53:44,149,4046,73,76,2389.89,4332.01,0.00
2024-12-08 16:53:44,149,4047,73,76,2386.52,4333.00,0.00
2024-12-08 16:53:44,150,4047,74,76,2370.61,4333.01,0.00
2024-12-08 16:53:44,151,4046,74,77,2353.21,4333.06,0.00
2024-12-08 16:53:44,150,4046,74,76,2375.37,4333.11,0.00
2024-12-08 16:53:44,149,4046,74,75,2386.59,4333.20,0.00
2024-12-08 16:53:44,150,4045,74,76,2365.25,4333.34,0.00
2024-12-08 16:53:44,150,4046,74,76,2370.78,4334.00,0.00
2024-12-08 16:53:44,151,4046,74,77,2355.08,4334.01,0.00
2024-12-08 16:53:44,150,4046,73,77,2367.06,4334.09,0.00
2024-12-08 16:53:44,149,4046,73,76,2380.01,4334.10,0.00
2024-12-08 16:53:44,150,4045,74,76,2354.22,4334.33,0.00
2024-12-08 16:53:44,149,4045,73,76,2362.84,4334.49,0.00
2024-12-08 16:53:44,150,4044,74,76,2341.22,4334.61,0.00
2024-12-08 16:53:44,151,4043,75,76,2331.52,4334.72,0.00
2024-12-08 16:53:44,152,4042,75,77,2318.00,4334.86,0.00
2024-12-08 16:53:44,152,4043,75,77,2401.96,4335.00,0.00
2024-12-08 16:53:44,153,4043,76,77,2386.26,4335.01,0.00
2024-12-08 16:53:45,154,4042,76,78,2367.97,4335.08,0.00
2024-12-08 16:53:45,153,4042,75,78,2395.30,4335.09,0.00
2024-12-08 16:53:45,152,4042,75,77,2408.49,4335.10,0.00
2024-12-08 16:53:45,152,4043,75,77,2499.15,4336.00,0.00
2024-12-08 16:53:45,153,4043,76,77,2482.81,4336.01,0.00
2024-12-08 16:53:45,154,4042,77,77,2423.88,4336.83,0.00
2024-12-08 16:53:45,153,4042,76,77,2442.54,4336.88,0.00
2024-12-08 16:53:45,153,4043,76,77,2483.67,4337.00,0.00
2024-12-08 16:53:45,154,4043,77,77,2467.54,4337.01,0.00
2024-12-08 16:53:45,153,4043,77,76,2475.04,4337.09,0.00
2024-12-08 16:53:45,153,4044,77,76,2479.56,4338.00,0.00
2024-12-08 16:53:45,154,4044,78,76,2463.46,4338.01,0.00
2024-12-08 16:53:45,153,4044,78,75,2472.66,4338.09,0.00
2024-12-08 16:53:45,152,4044,77,75,2478.98,4338.32,0.00
2024-12-08 16:53:45,152,4045,77,75,2476.44,4339.00,0.00
2024-12-08 16:53:45,153,4045,78,75,2460.26,4339.01,0.00
2024-12-08 16:53:45,152,4045,77,75,2471.11,4339.07,0.00
2024-12-08 16:53:45,153,4044,77,76,2431.40,4339.48,0.00
2024-12-08 16:53:45,154,4043,78,76,2410.47,4339.85,0.00
2024-12-08 16:53:45,154,4044,78,76,2435.96,4340.00,0.00
2024-12-08 16:53:45,155,4044,78,77,2420.25,4340.01,0.00
2024-12-08 16:53:45,156,4043,78,78,2362.75,4340.78,0.00
2024-12-08 16:53:45,155,4043,77,78,2378.29,4340.80,0.00
2024-12-08 16:53:45,155,4044,77,78,2446.17,4341.00,0.00
2024-12-08 16:53:45,156,4044,78,78,2430.49,4341.01,0.00
2024-12-08 16:53:45,157,4043,79,78,2379.55,4341.61,0.00
2024-12-08 16:53:45,157,4044,79,78,2416.64,4342.00,0.00
2024-12-08 16:53:45,158,4044,80,78,2401.34,4342.01,0.00
2024-12-08 16:53:45,157,4044,79,78,2415.81,4342.02,0.00
2024-12-08 16:53:45,156,4044,78,78,2430.47,4342.03,0.00
2024-12-08 16:53:45,155,4044,77,78,2444.57,4342.04,0.00
2024-12-08 16:53:45,154,4044,77,77,2458.48,4342.07,0.00
2024-12-08 16:53:45,153,4044,76,77,2451.15,4342.50,0.00
2024-12-08 16:53:45,153,4045,76,77,2475.36,4343.00,0.00
2024-12-08 16:53:45,154,4045,77,77,2459.29,4343.01,0.00
2024-12-08 16:53:45,153,4045,77,76,2471.34,4343.07,0.00
2024-12-08 16:53:45,152,4045,76,76,2478.09,4343.27,0.00
2024-12-08 16:53:45,151,4045,75,76,2491.93,4343.33,0.00
2024-12-08 16:53:45,152,4044,75,77,2455.51,4343.51,0.00
2024-12-08 16:53:45,153,4043,75,78,2436.42,4343.64,0.00
2024-12-08 16:53:45,153,4044,75,78,2458.57,4344.00,0.00
2024-12-08 16:53:45,154,4044,76,78,2442.60,4344.01,0.00
2024-12-08 16:53:45,153,4044,76,77,2453.74,4344.07,0.00
2024-12-08 16:53:45,154,4043,77,77,2411.70,4344.42,0.00
2024-12-08 16:53:45,155,4042,78,77,2398.95,4344.51,0.00
2024-12-08 16:53:45,155,4043,78,77,2474.16,4345.00,0.00
2024-12-08 16:53:45,156,4043,78,78,2458.29,4345.01,0.00
2024-12-08 16:53:45,156,4044,78,78,2487.81,4346.00,0.00
2024-12-08 16:53:45,157,4044,79,78,2471.96,4346.01,0.00
2024-12-08 16:53:45,158,4043,79,79,2443.13,4346.16,0.00
2024-12-08 16:53:45,159,4042,80,79,2412.34,4346.88,0.00
2024-12-08 16:53:45,159,4043,80,79,2437.33,4347.00,0.00
2024-12-08 16:53:45,160,4043,80,80,2422.09,4347.01,0.00
2024-12-08 16:53:45,161,4042,81,80,2368.72,4347.75,0.00
2024-12-08 16:53:45,161,4043,81,80,2434.25,4348.00,0.00
2024-12-08 16:53:45,162,4043,81,81,2419.22,4348.01,0.00
2024-12-08 16:53:45,161,4043,81,80,2429.95,4348.06,0.00
2024-12-08 16:53:45,160,4043,80,80,2433.27,4348.34,0.00
2024-12-08 16:53:45,159,4043,79,80,2448.30,4348.34,0.00
2024-12-08 16:53:45,159,4044,79,80,2462.31,4349.00,0.00
2024-12-08 16:53:45,160,4044,80,80,2446.92,4349.01,0.00
2024-12-08 16:53:45,161,4043,81,80,2430.12,4349.06,0.00
2024-12-08 16:53:45,160,4043,81,79,2447.76,4349.07,0.00
2024-12-08 16:53:45,161,4042,81,80,2405.78,4349.67,0.00
2024-12-08 16:53:45,161,4043,81,80,2416.32,4350.00,0.00
2024-12-08 16:53:45,162,4043,81,81,2401.40,4350.01,0.00
2024-12-08 16:53:45,161,4043,81,80,2412.29,4350.06,0.00
2024-12-08 16:53:45,160,4043,80,80,2421.67,4350.12,0.00
2024-12-08 16:53:45,159,4043,79,80,2427.67,4350.33,0.00
2024-12-08 16:53:45,158,4043,79,79,2439.96,4350.40,0.00
2024-12-08 16:53:45,158,4044,79,79,2496.82,4351.00,0.00
2024-12-08 16:53:45,159,4044,79,80,2481.12,4351.01,0.00
2024-12-08 16:53:45,158,4044,78,80,2496.54,4351.01,0.00
2024-12-08 16:53:45,157,4044,77,80,2510.54,4351.04,0.00
2024-12-08 16:53:45,156,4044,77,79,2526.07,4351.05,0.00
2024-12-08 16:53:45,155,4044,77,78,2542.09,4351.05,0.00
2024-12-08 16:53:45,154,4044,76,78,2546.78,4351.18,0.00
2024-12-08 16:53:45,153,4044,75,78,2554.71,4351.38,0.00
2024-12-08 16:53:45,152,4044,74,78,2556.28,4351.73,0.00
2024-12-08 16:53:45,152,4045,74,78,2573.39,4352.00,0.00
2024-12-08 16:53:45,153,4045,74,79,2556.57,4352.01,0.00
2024-12-08 16:53:45,152,4045,74,78,2571.12,4352.05,0.00
2024-12-08 16:53:45,152,4046,74,78,2547.63,4353.00,0.00
2024-12-08 16:53:45,153,4046,74,79,2530.98,4353.01,0.00
2024-12-08 16:53:45,152,4046,74,78,2544.72,4353.06,0.00
2024-12-08 16:53:45,151,4046,73,78,2550.37,4353.18,0.00
2024-12-08 16:53:45,151,4047,73,78,2543.97,4354.00,0.00
2024-12-08 16:53:45,152,4047,74,78,2527.23,4354.01,0.00
2024-12-08 16:53:45,152,4048,74,78,2501.79,4355.00,0.00
2024-12-08 16:53:45,153,4048,75,78,2485.43,4355.01,0.00
2024-12-08 16:53:45,154,4047,75,79,2458.31,4355.14,0.00
2024-12-08 16:53:45,155,4046,75,80,2459.21,4355.33,0.00
2024-12-08 16:53:46,156,4045,75,81,2436.59,4355.56,0.00
2024-12-08 16:53:46,156,4046,75,81,2448.15,4356.00,0.00
2024-12-08 16:53:46,157,4046,75,82,2432.56,4356.01,0.00
2024-12-08 16:53:46,156,4046,75,81,2440.63,4356.06,0.00
2024-12-08 16:53:46,155,4046,74,81,2444.07,4356.34,0.00
2024-12-08 16:53:46,154,4046,73,81,2459.66,4356.34,0.00
2024-12-08 16:53:46,154,4047,73,81,2533.09,4357.00,0.00
2024-12-08 16:53:46,155,4047,73,82,2516.75,4357.01,0.00
2024-12-08 16:53:46,156,4046,73,83,2500.62,4357.02,0.00
2024-12-08 16:53:46,157,4045,74,83,2480.11,4357.28,0.00
2024-12-08 16:53:46,158,4044,74,84,2466.80,4357.60,0.00
2024-12-08 16:53:46,158,4045,74,84,2481.45,4358.00,0.00
2024-12-08 16:53:46,159,4045,74,85,2465.85,4358.01,0.00
2024-12-08 16:53:46,160,4044,75,85,2450.44,4358.02,0.00
2024-12-08 16:53:46,160,4045,75,85,2504.41,4359.00,0.00
2024-12-08 16:53:46,161,4045,75,86,2488.86,4359.01,0.00
2024-12-08 16:53:46,160,4045,74,86,2484.74,4359.33,0.00
2024-12-08 16:53:46,160,4046,74,86,2510.26,4360.00,0.00
2024-12-08 16:53:46,161,4046,75,86,2494.66,4360.01,0.00
2024-12-08 16:53:46,160,4046,75,85,2505.92,4360.06,0.00
2024-12-08 16:53:46,159,4046,75,84,2521.41,4360.06,0.00
2024-12-08 16:53:46,159,4047,75,84,2497.55,4361.00,0.00
2024-12-08 16:53:46,160,4047,75,85,2481.94,4361.01,0.00
2024-12-08 16:53:46,159,4047,74,85,2495.65,4361.04,0.00
2024-12-08 16:53:46,158,4047,74,84,2510.07,4361.06,0.00
2024-12-08 16:53:46,159,4046,75,84,2480.96,4361.38,0.00
2024-12-08 16:53:46,159,4047,75,84,2476.17,4362.00,0.00
2024-12-08 16:53:46,160,4047,75,85,2460.70,4362.01,0.00
2024-12-08 16:53:46,159,4047,74,85,2463.05,4362.12,0.00
2024-12-08 16:53:46,159,4048,74,85,2480.03,4363.00,0.00
2024-12-08 16:53:46,160,4048,74,86,2464.53,4363.01,0.00
2024-12-08 16:53:46,159,4048,74,85,2475.40,4363.06,0.00
2024-12-08 16:53:46,158,4048,74,84,2490.79,4363.06,0.00
2024-12-08 16:53:46,157,4048,73,84,2485.89,4363.30,0.00
2024-12-08 16:53:46,156,4048,72,84,2500.73,4363.32,0.00
2024-12-08 16:53:46,157,4047,73,84,2475.73,4363.54,0.00
2024-12-08 16:53:46,157,4048,73,84,2495.81,4364.00,0.00
2024-12-08 16:53:46,158,4048,73,85,2480.01,4364.01,0.00
2024-12-08 16:53:46,159,4047,74,85,2463.06,4364.05,0.00
2024-12-08 16:53:46,160,4046,75,85,2450.68,4364.08,0.00
2024-12-08 16:53:46,161,4045,76,85,2411.86,4364.96,0.00
2024-12-08 16:53:46,161,4046,76,85,2465.58,4365.00,0.00
2024-12-08 16:53:46,162,4046,76,86,2450.36,4365.01,0.00
2024-12-08 16:53:46,163,4045,77,86,2427.33,4365.08,0.00
2024-12-08 16:53:46,164,4044,77,87,2403.55,4365.77,0.00
2024-12-08 16:53:46,164,4045,77,87,2511.22,4366.00,0.00
2024-12-08 16:53:46,165,4045,78,87,2496.00,4366.01,0.00
2024-12-08 16:53:46,164,4045,78,86,2502.73,4366.07,0.00
2024-12-08 16:53:46,163,4045,78,85,2517.58,4366.08,0.00
2024-12-08 16:53:46,163,4046,78,85,2554.87,4367.00,0.00
2024-12-08 16:53:46,164,4046,78,86,2539.29,4367.01,0.00
2024-12-08 16:53:46,164,4047,78,86,2511.49,4368.00,0.00
2024-12-08 16:53:46,165,4047,79,86,2496.27,4368.01,0.00
2024-12-08 16:53:46,166,4046,79,87,2449.06,4368.64,0.00
2024-12-08 16:53:46,165,4046,78,87,2463.93,4368.76,0.00
2024-12-08 16:53:46,165,4047,78,87,2469.81,4369.00,0.00
2024-12-08 16:53:46,166,4047,78,88,2454.93,4369.01,0.00
2024-12-08 16:53:46,165,4047,78,87,2463.22,4369.06,0.00
2024-12-08 16:53:46,166,4046,79,87,2445.48,4369.14,0.00
2024-12-08 16:53:46,167,4045,80,87,2440.82,4369.28,0.00
2024-12-08 16:53:46,166,4045,79,87,2457.94,4369.37,0.00
2024-12-08 16:53:46,167,4044,79,88,2433.40,4369.61,0.00
2024-12-08 16:53:46,167,4045,79,88,2464.95,4370.00,0.00
2024-12-08 16:53:46,168,4045,79,89,2450.28,4370.01,0.00
2024-12-08 16:53:46,169,4044,80,89,2434.50,4370.05,0.00
2024-12-08 16:53:46,168,4044,79,89,2443.29,4370.08,0.00
2024-12-08 16:53:46,167,4044,79,88,2456.51,4370.11,0.00
2024-12-08 16:53:46,167,4045,79,88,2517.81,4371.00,0.00
2024-12-08 16:53:46,168,4045,79,89,2502.82,4371.01,0.00
2024-12-08 16:53:46,167,4045,78,89,2469.49,4371.92,0.00
2024-12-08 16:53:46,167,4046,78,89,2514.97,4372.00,0.00
2024-12-08 16:53:46,168,4046,78,90,2500.00,4372.01,0.00
2024-12-08 16:53:46,167,4046,77,90,2482.58,4372.63,0.00
2024-12-08 16:53:46,167,4047,77,90,2483.22,4373.00,0.00
2024-12-08 16:53:46,168,4047,78,90,2468.44,4373.01,0.00
2024-12-08 16:53:46,169,4046,78,91,2451.53,4373.07,0.00
2024-12-08 16:53:46,169,4047,78,91,2441.31,4374.00,0.00
2024-12-08 16:53:46,170,4047,78,92,2426.95,4374.01,0.00
2024-12-08 16:53:46,169,4047,78,91,2432.29,4374.09,0.00
2024-12-08 16:53:46,170,4046,79,91,2382.57,4374.83,0.00
2024-12-08 16:53:46,170,4047,79,91,2428.78,4375.00,0.00
2024-12-08 16:53:46,171,4047,79,92,2414.58,4375.01,0.00
2024-12-08 16:53:47,171,4048,79,92,2411.46,4376.00,0.00
2024-12-08 16:53:47,172,4048,80,92,2397.44,4376.01,0.00
2024-12-08 16:53:47,171,4048,79,92,2389.58,4376.39,0.00
2024-12-08 16:53:47,172,4047,80,92,2353.41,4376.83,0.00
2024-12-08 16:53:47,172,4048,80,92,2369.59,4377.00,0.00
2024-12-08 16:53:47,173,4048,81,92,2355.89,4377.01,0.00
2024-12-08 16:53:47,172,4048,80,92,2367.82,4377.04,0.00
2024-12-08 16:53:47,171,4048,79,92,2361.56,4377.38,0.00
2024-12-08 16:53:47,170,4048,79,91,2358.20,4377.74,0.00
2024-12-08 16:53:47,170,4049,79,91,2390.28,4378.00,0.00
2024-12-08 16:53:47,171,4049,79,92,2376.31,4378.01,0.00
2024-12-08 16:53:47,170,4049,79,91,2384.12,4378.05,0.00
2024-12-08 16:53:47,169,4049,78,91,2396.95,4378.08,0.00
2024-12-08 16:53:47,168,4049,78,90,2410.95,4378.08,0.00
2024-12-08 16:53:47,168,4050,78,90,2386.31,4379.00,0.00
2024-12-08 16:53:47,169,4050,78,91,2372.19,4379.01,0.00
2024-12-08 16:53:47,168,4050,77,91,2376.28,4379.11,0.00
2024-12-08 16:53:47,168,4051,77,91,2360.95,4380.00,0.00
2024-12-08 16:53:47,169,4051,78,91,2346.98,4380.01,0.00
2024-12-08 16:53:47,168,4051,78,90,2352.37,4380.08,0.00
2024-12-08 16:53:47,168,4052,78,90,2333.73,4381.00,0.00
2024-12-08 16:53:47,169,4052,78,91,2319.92,4381.01,0.00
2024-12-08 16:53:47,168,4052,78,90,2324.89,4381.08,0.00
2024-12-08 16:53:47,168,4053,78,90,2302.79,4382.00,0.00
2024-12-08 16:53:47,169,4053,79,90,2289.17,4382.01,0.00
2024-12-08 16:53:47,168,4053,79,89,2297.07,4382.05,0.00
2024-12-08 16:53:47,167,4053,79,88,2309.53,4382.08,0.00
2024-12-08 16:53:47,166,4053,78,88,2323.18,4382.08,0.00
2024-12-08 16:53:47,166,4054,78,88,2299.12,4383.00,0.00
2024-12-08 16:53:47,167,4054,78,89,2285.35,4383.01,0.00
2024-12-08 16:53:47,166,4054,78,88,2291.48,4383.05,0.00
2024-12-08 16:53:47,165,4054,77,88,2280.99,4383.53,0.00
2024-12-08 16:53:47,165,4055,77,88,2287.16,4384.00,0.00
2024-12-08 16:53:47,166,4055,77,89,2273.39,4384.01,0.00
2024-12-08 16:53:47,165,4055,76,89,2286.64,4384.01,0.00
2024-12-08 16:53:47,164,4055,75,89,2300.10,4384.02,0.00
2024-12-08 16:53:47,163,4055,74,89,2306.70,4384.06,0.00
2024-12-08 16:53:47,162,4055,73,89,2320.66,4384.06,0.00
2024-12-08 16:53:47,163,4054,73,90,2293.47,4384.24,0.00
2024-12-08 16:53:47,163,4055,73,90,2307.70,4385.00,0.00
2024-12-08 16:53:47,164,4055,73,91,2293.63,4385.01,0.00
2024-12-08 16:53:47,163,4055,72,91,2306.90,4385.02,0.00
2024-12-08 16:53:47,162,4055,72,90,2313.85,4385.06,0.00
2024-12-08 16:53:47,161,4055,72,89,2327.95,4385.06,0.00
2024-12-08 16:53:47,160,4055,71,89,2342.23,4385.06,0.00
2024-12-08 16:53:47,159,4055,70,89,2348.24,4385.12,0.00
2024-12-08 16:53:47,159,4056,70,89,2364.68,4386.00,0.00
2024-12-08 16:53:47,160,4056,70,90,2349.90,4386.01,0.00
2024-12-08 16:53:47,159,4056,70,89,2361.11,4386.04,0.00
2024-12-08 16:53:47,158,4056,69,89,2330.39,4386.81,0.00
2024-12-08 16:53:47,159,4055,69,90,2314.11,4386.86,0.00
2024-12-08 16:53:47,159,4056,69,90,2339.89,4387.00,0.00
2024-12-08 16:53:47,160,4056,69,91,2325.27,4387.01,0.00
2024-12-08 16:53:47,159,4056,68,91,2327.72,4387.16,0.00
2024-12-08 16:53:47,159,4057,68,91,2341.93,4388.00,0.00
2024-12-08 16:53:47,160,4057,69,91,2327.29,4388.01,0.00
2024-12-08 16:53:47,160,4058,69,91,2298.62,4389.00,0.00
2024-12-08 16:53:47,161,4058,69,92,2284.35,4389.01,0.00
2024-12-08 16:53:47,160,4058,69,91,2283.73,4389.20,0.00
2024-12-08 16:53:47,159,4058,68,91,2290.43,4389.38,0.00
2024-12-08 16:53:47,160,4057,69,91,2259.58,4389.77,0.00
2024-12-08 16:53:48,160,4058,69,91,2273.53,4390.00,0.00
2024-12-08 16:53:48,161,4058,69,92,2259.41,4390.01,0.00
2024-12-08 16:53:48,160,4058,69,91,2269.44,4390.05,0.00
2024-12-08 16:53:48,159,4058,69,90,2283.16,4390.06,0.00
2024-12-08 16:53:48,159,4059,69,90,2285.86,4391.00,0.00
2024-12-08 16:53:48,160,4059,70,90,2271.57,4391.01,0.00
2024-12-08 16:53:48,159,4059,70,89,2278.43,4391.05,0.00
2024-12-08 16:53:48,158,4059,70,88,2292.29,4391.06,0.00
2024-12-08 16:53:48,157,4059,70,87,2306.61,4391.06,0.00
2024-12-08 16:53:48,156,4059,69,87,2306.44,4391.24,0.00
2024-12-08 16:53:48,157,4058,70,87,2263.49,4391.90,0.00
2024-12-08 16:53:48,157,4059,70,87,2301.90,4392.00,0.00
2024-12-08 16:53:48,158,4059,71,87,2287.33,4392.01,0.00
2024-12-08 16:53:48,159,4058,72,87,2253.95,4392.31,0.00
2024-12-08 16:53:48,159,4059,72,87,2294.43,4393.00,0.00
2024-12-08 16:53:48,160,4059,73,87,2280.09,4393.01,0.00
2024-12-08 16:53:48,159,4059,73,86,2285.86,4393.07,0.00
2024-12-08 16:53:48,158,4059,73,85,2300.05,4393.07,0.00
2024-12-08 16:53:48,157,4059,72,85,2301.19,4393.36,0.00
2024-12-08 16:53:48,157,4060,72,85,2321.94,4394.00,0.00
2024-12-08 16:53:48,158,4060,72,86,2307.24,4394.01,0.00
2024-12-08 16:53:48,157,4060,71,86,2300.63,4394.34,0.00
2024-12-08 16:53:48,158,4059,72,86,2276.43,4394.57,0.00
2024-12-08 16:53:48,158,4060,72,86,2286.76,4395.00,0.00
2024-12-08 16:53:48,159,4060,72,87,2272.38,4395.01,0.00
2024-12-08 16:53:48,158,4060,72,86,2283.98,4395.06,0.00
2024-12-08 16:53:48,158,4061,72,86,2286.01,4396.00,0.00
2024-12-08 16:53:48,159,4061,72,87,2271.63,4396.01,0.00
2024-12-08 16:53:48,160,4060,73,87,2253.99,4396.09,0.00
2024-12-08 16:53:48,160,4061,73,87,2247.67,4397.00,0.00
2024-12-08 16:53:48,161,4061,73,88,2233.71,4397.01,0.00
2024-12-08 16:53:48,160,4061,72,88,2226.04,4397.33,0.00
2024-12-08 16:53:48,160,4062,72,88,2248.91,4398.00,0.00
2024-12-08 16:53:48,161,4062,72,89,2234.94,4398.01,0.00
2024-12-08 16:53:48,162,4061,73,89,2195.13,4398.44,0.00
2024-12-08 16:53:48,162,4062,73,89,2210.20,4399.00,0.00
2024-12-08 16:53:48,163,4062,73,90,2196.64,4399.01,0.00
2024-12-08 16:53:48,162,4062,72,90,2208.91,4399.03,0.00
2024-12-08 16:53:48,161,4062,71,90,2221.01,4399.06,0.00
2024-12-08 16:53:48,160,4062,70,90,2212.60,4399.40,0.00
2024-12-08 16:53:48,160,4063,70,90,2236.55,4400.00,0.00
2024-12-08 16:53:48,161,4063,70,91,2222.66,4400.01,0.00
2024-12-08 16:53:48,162,4062,70,92,2192.11,4400.24,0.00
2024-12-08 16:53:48,161,4062,69,92,2201.42,4400.46,0.00
2024-12-08 16:53:48,162,4061,70,92,2172.82,4400.82,0.00
2024-12-08 16:53:48,162,4062,70,92,2194.16,4401.00,0.00
2024-12-08 16:53:48,163,4062,71,92,2180.70,4401.01,0.00
2024-12-08 16:53:48,162,4062,71,91,2187.39,4401.06,0.00
2024-12-08 16:53:48,161,4062,70,91,2198.79,4401.11,0.00
2024-12-08 16:53:48,160,4062,70,90,2196.06,4401.45,0.00
2024-12-08 16:53:48,161,4061,70,91,2169.64,4401.75,0.00
2024-12-08 16:53:48,161,4062,70,91,2247.52,4402.00,0.00
2024-12-08 16:53:48,162,4062,71,91,2233.65,4402.01,0.00
2024-12-08 16:53:48,161,4062,70,91,2244.82,4402.06,0.00
2024-12-08 16:53:48,160,4062,70,90,2258.29,4402.06,0.00
2024-12-08 16:53:48,159,4062,69,90,2256.56,4402.39,0.00
2024-12-08 16:53:48,160,4061,70,90,2220.58,4402.65,0.00
2024-12-08 16:53:48,161,4060,70,91,2212.11,4402.76,0.00
2024-12-08 16:53:48,161,4061,70,91,2263.71,4403.00,0.00
2024-12-08 16:53:48,162,4061,71,91,2249.74,4403.01,0.00
2024-12-08 16:53:48,161,4061,71,90,2260.45,4403.07,0.00
2024-12-08 16:53:48,160,4061,70,90,2247.96,4403.39,0.00
2024-12-08 16:53:48,161,4060,70,91,2209.04,4403.94,0.00
2024-12-08 16:53:48,161,4061,70,91,2289.74,4404.00,0.00
2024-12-08 16:53:48,162,4061,71,91,2275.61,4404.01,0.00
2024-12-08 16:53:48,163,4060,72,91,2260.31,4404.05,0.00
2024-12-08 16:53:48,162,4060,71,91,2282.43,4404.07,0.00
2024-12-08 16:53:48,161,4060,71,90,2296.06,4404.07,0.00
2024-12-08 16:53:48,162,4059,72,90,2276.79,4404.15,0.00
2024-12-08 16:53:48,161,4059,71,90,2298.66,4404.34,0.00
2024-12-08 16:53:48,161,4060,71,90,2324.79,4405.00,0.00
2024-12-08 16:53:48,162,4060,71,91,2310.44,4405.01,0.00
2024-12-08 16:53:48,161,4060,70,91,2322.90,4405.04,0.00
2024-12-08 16:53:48,160,4060,70,90,2336.32,4405.06,0.00
2024-12-08 16:53:48,160,4061,70,90,2376.07,4406.00,0.00
2024-12-08 16:53:48,161,4061,71,90,2361.31,4406.01,0.00
2024-12-08 16:53:48,160,4061,70,90,2373.34,4406.06,0.00
2024-12-08 16:53:48,159,4061,70,89,2386.91,4406.06,0.00
2024-12-08 16:53:48,159,4062,70,89,2362.75,4407.00,0.00
2024-12-08 16:53:48,160,4062,70,90,2347.98,4407.01,0.00
2024-12-08 16:53:48,159,4062,70,89,2359.18,4407.07,0.00
2024-12-08 16:53:48,158,4062,69,89,2367.46,4407.22,0.00
2024-12-08 16:53:48,157,4062,68,89,2374.74,4407.39,0.00
2024-12-08 16:53:49,156,4062,67,89,2370.89,4407.80,0.00
2024-12-08 16:53:49,156,4063,67,89,2388.04,4408.00,0.00
2024-12-08 16:53:49,157,4063,67,90,2372.83,4408.01,0.00
2024-12-08 16:53:49,156,4063,67,89,2384.40,4408.07,0.00
2024-12-08 16:53:49,155,4063,66,89,2370.96,4408.73,0.00
2024-12-08 16:53:49,155,4064,66,89,2373.81,4409.00,0.00
2024-12-08 16:53:49,156,4064,66,90,2358.60,4409.01,0.00
2024-12-08 16:53:49,155,4064,66,89,2368.16,4409.08,0.00
2024-12-08 16:53:49,154,4064,65,89,2380.96,4409.10,0.00
2024-12-08 16:53:49,153,4064,64,89,2383.94,4409.39,0.00
2024-12-08 16:53:49,153,4065,64,89,2383.44,4410.00,0.00
2024-12-08 16:53:49,154,4065,65,89,2367.96,4410.01,0.00
2024-12-08 16:53:49,153,4065,65,88,2378.86,4410.09,0.00
2024-12-08 16:53:49,153,4066,65,88,2353.85,4411.00,0.00
2024-12-08 16:53:49,154,4066,66,88,2338.56,4411.01,0.00
2024-12-08 16:53:49,153,4066,66,87,2350.42,4411.08,0.00
2024-12-08 16:53:49,152,4066,65,87,2365.59,4411.08,0.00
2024-12-08 16:53:49,152,4067,65,87,2340.15,4412.00,0.00
2024-12-08 16:53:49,153,4067,65,88,2324.85,4412.01,0.00
2024-12-08 16:53:49,152,4067,64,88,2287.10,4412.97,0.00
2024-12-08 16:53:49,152,4068,64,88,2314.71,4413.00,0.00
2024-12-08 16:53:49,153,4068,64,89,2299.58,4413.01,0.00
2024-12-08 16:53:49,154,4067,64,90,2250.23,4413.68,0.00
2024-12-08 16:53:49,153,4067,63,90,2278.38,4413.81,0.00
2024-12-08 16:53:49,153,4068,63,90,2295.66,4414.00,0.00
2024-12-08 16:53:49,154,4068,64,90,2280.75,4414.01,0.00
2024-12-08 16:53:49,155,4067,65,90,2250.72,4414.24,0.00
2024-12-08 16:53:49,156,4066,65,91,2226.09,4414.77,0.00
2024-12-08 16:53:49,156,4067,65,91,2273.68,4415.00,0.00
2024-12-08 16:53:49,157,4067,65,92,2259.20,4415.01,0.00
2024-12-08 16:53:49,158,4066,66,92,2226.81,4415.30,0.00
2024-12-08 16:53:49,158,4067,66,92,2275.12,4416.00,0.00
2024-12-08 16:53:49,159,4067,67,92,2260.81,4416.01,0.00
2024-12-08 16:53:49,160,4066,68,92,2244.50,4416.07,0.00
2024-12-08 16:53:49,159,4066,68,91,2270.56,4416.08,0.00
2024-12-08 16:53:49,158,4066,68,90,2284.38,4416.09,0.00
2024-12-08 16:53:49,157,4066,68,89,2298.65,4416.09,0.00
2024-12-08 16:53:49,156,4066,67,89,2300.45,4416.39,0.00
2024-12-08 16:53:49,156,4067,67,89,2318.83,4417.00,0.00
2024-12-08 16:53:49,157,4067,67,90,2304.06,4417.01,0.00
2024-12-08 16:53:49,156,4067,67,89,2315.18,4417.08,0.00
2024-12-08 16:53:49,155,4067,67,88,2329.83,4417.08,0.00
2024-12-08 16:53:49,154,4067,66,88,2344.11,4417.10,0.00
2024-12-08 16:53:49,153,4067,65,88,2334.12,4417.41,0.00
2024-12-08 16:53:49,153,4068,65,88,2365.83,4418.00,0.00
2024-12-08 16:53:49,154,4068,65,89,2350.47,4418.01,0.00
2024-12-08 16:53:49,154,4069,65,89,2319.84,4419.00,0.00
2024-12-08 16:53:49,155,4069,65,90,2304.87,4419.01,0.00
2024-12-08 16:53:49,154,4069,65,89,2313.27,4419.08,0.00
2024-12-08 16:53:49,155,4068,65,90,2290.97,4419.27,0.00
2024-12-08 16:53:49,155,4069,65,90,2276.58,4420.00,0.00
2024-12-08 16:53:49,156,4069,66,90,2261.99,4420.01,0.00
2024-12-08 16:53:49,157,4068,67,90,2218.69,4420.48,0.00
2024-12-08 16:53:49,157,4069,67,90,2267.76,4421.00,0.00
2024-12-08 16:53:49,158,4069,68,90,2253.41,4421.01,0.00
2024-12-08 16:53:49,157,4069,68,89,2257.66,4421.10,0.00
2024-12-08 16:53:49,157,4070,68,89,2270.00,4422.00,0.00
2024-12-08 16:53:49,158,4070,68,90,2255.64,4422.01,0.00
2024-12-08 16:53:49,159,4069,69,90,2240.29,4422.04,0.00
2024-12-08 16:53:49,160,4068,70,90,2249.52,4422.08,0.00
2024-12-08 16:53:49,159,4068,70,89,2257.56,4422.11,0.00
2024-12-08 16:53:49,158,4068,69,89,2261.77,4422.34,0.00
2024-12-08 16:53:49,159,4067,69,90,2226.58,4422.82,0.00
2024-12-08 16:53:49,159,4068,69,90,2244.21,4423.00,0.00
2024-12-08 16:53:49,160,4068,70,90,2230.18,4423.01,0.00
2024-12-08 16:53:49,159,4068,70,89,2235.71,4423.08,0.00
2024-12-08 16:53:49,158,4068,69,89,2221.27,4423.72,0.00
2024-12-08 16:53:49,158,4069,69,89,2309.95,4424.00,0.00
2024-12-08 16:53:49,159,4069,69,90,2295.42,4424.01,0.00
2024-12-08 16:53:49,158,4069,68,90,2301.27,4424.07,0.00
2024-12-08 16:53:49,157,4069,68,89,2308.89,4424.10,0.00
2024-12-08 16:53:49,156,4069,67,89,2308.96,4424.42,0.00
2024-12-08 16:53:49,156,4070,67,89,2312.19,4425.00,0.00
2024-12-08 16:53:49,157,4070,68,89,2297.47,4425.01,0.00
2024-12-08 16:53:49,156,4070,68,88,2302.98,4425.08,0.00
2024-12-08 16:53:49,155,4070,67,88,2306.44,4425.22,0.00
2024-12-08 16:53:49,155,4071,67,88,2300.82,4426.00,0.00
2024-12-08 16:53:49,156,4071,68,88,2286.07,4426.01,0.00
2024-12-08 16:53:49,155,4071,68,87,2289.25,4426.12,0.00
2024-12-08 16:53:49,155,4072,68,87,2275.68,4427.00,0.00
2024-12-08 16:53:49,156,4072,69,87,2261.09,4427.01,0.00
2024-12-08 16:53:49,155,4072,69,86,2265.06,4427.10,0.00
2024-12-08 16:53:49,154,4072,69,85,2279.48,4427.10,0.00
2024-12-08 16:53:49,153,4072,68,85,2276.80,4427.50,0.00
2024-12-08 16:53:49,153,4073,68,85,2277.05,4428.00,0.00
2024-12-08 16:53:49,154,4073,69,85,2262.26,4428.01,0.00
2024-12-08 16:53:50,154,4074,69,85,2230.20,4429.00,0.00
2024-12-08 16:53:50,155,4074,69,86,2215.82,4429.01,0.00
2024-12-08 16:53:50,154,4074,69,85,2224.86,4429.08,0.00
2024-12-08 16:53:50,153,4074,69,84,2238.83,4429.09,0.00
2024-12-08 16:53:50,154,4073,69,85,2206.29,4429.51,0.00
2024-12-08 16:53:50,154,4074,69,85,2209.81,4430.00,0.00
2024-12-08 16:53:50,155,4074,69,86,2195.55,4430.01,0.00
2024-12-08 16:53:50,154,4074,69,85,2202.69,4430.08,0.00
2024-12-08 16:53:50,154,4075,69,85,2208.63,4431.00,0.00
2024-12-08 16:53:50,155,4075,70,85,2194.38,4431.01,0.00
2024-12-08 16:53:50,154,4075,69,85,2207.15,4431.01,0.00
2024-12-08 16:53:50,153,4075,69,84,2217.55,4431.09,0.00
2024-12-08 16:53:50,153,4076,69,84,2194.85,4432.00,0.00
2024-12-08 16:53:50,154,4076,69,85,2180.60,4432.01,0.00
2024-12-08 16:53:50,153,4076,68,85,2194.66,4432.01,0.00
2024-12-08 16:53:50,152,4076,67,85,2204.44,4432.01,0.00
2024-12-08 16:53:50,151,4076,66,85,2216.41,4432.07,0.00
2024-12-08 16:53:50,150,4076,66,84,2230.30,4432.07,0.00
2024-12-08 16:53:50,150,4077,66,84,2218.96,4433.00,0.00
2024-12-08 16:53:50,151,4077,66,85,2204.27,4433.01,0.00
2024-12-08 16:53:50,150,4077,66,84,2214.85,4433.09,0.00
2024-12-08 16:53:50,151,4076,67,84,2182.61,4433.49,0.00
2024-12-08 16:53:50,150,4076,66,84,2182.69,4433.90,0.00
2024-12-08 16:53:50,150,4077,66,84,2207.90,4434.00,0.00
2024-12-08 16:53:50,151,4077,66,85,2193.27,4434.01,0.00
2024-12-08 16:53:50,150,4077,65,85,2205.85,4434.05,0.00
2024-12-08 16:53:50,149,4077,64,85,2219.47,4434.07,0.00
2024-12-08 16:53:50,148,4077,63,85,2234.17,4434.07,0.00
2024-12-08 16:53:50,148,4078,63,85,2237.80,4435.00,0.00
2024-12-08 16:53:50,149,4078,63,86,2222.78,4435.01,0.00
2024-12-08 16:53:50,150,4077,64,86,2206.50,4435.05,0.00
2024-12-08 16:53:50,149,4077,63,86,2223.71,4435.07,0.00
2024-12-08 16:53:50,148,4077,63,85,2234.54,4435.07,0.00
2024-12-08 16:53:50,149,4076,64,85,2202.98,4435.46,0.00
2024-12-08 16:53:50,148,4076,63,85,2205.29,4435.87,0.00
2024-12-08 16:53:50,148,4077,63,85,2229.67,4436.00,0.00
2024-12-08 16:53:50,149,4077,64,85,2214.70,4436.01,0.00
2024-12-08 16:53:50,148,4077,64,84,2227.29,4436.05,0.00
2024-12-08 16:53:50,147,4077,64,83,2240.34,4436.08,0.00
2024-12-08 16:53:50,146,4077,63,83,2251.11,4436.15,0.00
2024-12-08 16:53:50,145,4077,62,83,2258.65,4436.33,0.00
2024-12-08 16:53:50,146,4076,62,84,2225.16,4436.75,0.00
2024-12-08 16:53:50,147,4075,63,84,2216.68,4436.78,0.00
2024-12-08 16:53:50,147,4076,63,84,2304.09,4437.00,0.00
2024-12-08 16:53:50,148,4076,63,85,2288.52,4437.01,0.00
2024-12-08 16:53:50,147,4076,62,85,2301.40,4437.06,0.00
2024-12-08 16:53:50,146,4076,62,84,2315.64,4437.07,0.00
2024-12-08 16:53:50,147,4075,62,85,2259.20,4437.73,0.00
2024-12-08 16:53:50,147,4076,62,85,2357.83,4438.00,0.00
2024-12-08 16:53:50,148,4076,63,85,2341.90,4438.01,0.00
2024-12-08 16:53:50,147,4076,62,85,2355.14,4438.06,0.00
2024-12-08 16:53:50,146,4076,62,84,2370.36,4438.06,0.00
2024-12-08 16:53:50,147,4075,62,85,2327.34,4438.68,0.00
2024-12-08 16:53:50,148,4074,62,86,2331.83,4438.73,0.00
2024-12-08 16:53:50,149,4073,62,87,2301.77,4438.97,0.00
2024-12-08 16:53:50,149,4074,62,87,2360.49,4439.00,0.00
2024-12-08 16:53:50,150,4074,62,88,2344.75,4439.01,0.00
2024-12-08 16:53:50,149,4074,61,88,2359.31,4439.03,0.00
2024-12-08 16:53:50,150,4073,62,88,2343.58,4439.04,0.00
2024-12-08 16:53:50,149,4073,62,87,2377.21,4439.07,0.00
2024-12-08 16:53:50,148,4073,61,87,2372.88,4439.31,0.00
2024-12-08 16:53:50,149,4072,62,87,2356.06,4439.34,0.00
2024-12-08 16:53:50,149,4073,62,87,2466.45,4440.00,0.00
2024-12-08 16:53:50,150,4073,62,88,2450.01,4440.01,0.00
2024-12-08 16:53:50,149,4073,61,88,2429.36,4440.71,0.00
2024-12-08 16:53:50,149,4074,61,88,2503.46,4441.00,0.00
2024-12-08 16:53:50,150,4074,61,89,2486.77,4441.01,0.00
2024-12-08 16:53:50,151,4073,62,89,2460.93,4441.10,0.00
2024-12-08 16:53:50,151,4074,62,89,2474.77,4442.00,0.00
2024-12-08 16:53:50,152,4074,63,89,2458.49,4442.01,0.00
2024-12-08 16:53:50,152,4075,63,89,2461.77,4443.00,0.00
2024-12-08 16:53:50,153,4075,64,89,2445.68,4443.01,0.00
2024-12-08 16:53:50,152,4075,64,88,2453.33,4443.06,0.00
2024-12-08 16:53:50,152,4076,64,88,2430.34,4444.00,0.00
2024-12-08 16:53:50,153,4076,65,88,2414.45,4444.01,0.00
2024-12-08 16:53:50,152,4076,65,87,2424.79,4444.03,0.00
2024-12-08 16:53:50,151,4076,64,87,2439.40,4444.05,0.00
2024-12-08 16:53:50,151,4077,64,87,2414.17,4445.00,0.00
2024-12-08 16:53:50,152,4077,65,87,2398.29,4445.01,0.00
2024-12-08 16:53:50,151,4077,65,86,2396.55,4445.27,0.00
2024-12-08 16:53:50,152,4076,66,86,2368.34,4445.56,0.00
2024-12-08 16:53:50,152,4077,66,86,2384.00,4446.00,0.00
2024-12-08 16:53:50,153,4077,67,86,2368.42,4446.01,0.00
2024-12-08 16:53:50,152,4077,67,85,2381.39,4446.06,0.00
2024-12-08 16:53:50,151,4077,66,85,2383.10,4446.24,0.00
2024-12-08 16:53:50,151,4078,66,85,2397.53,4447.00,0.00
2024-12-08 16:53:50,152,4078,66,86,2381.76,4447.01,0.00
2024-12-08 16:53:50,151,4078,66,85,2394.62,4447.07,0.00
2024-12-08 16:53:50,150,4078,66,84,2407.91,4447.07,0.00
2024-12-08 16:53:50,149,4078,66,83,2422.53,4447.11,0.00
2024-12-08 16:53:50,148,4078,65,83,2436.56,4447.16,0.00
2024-12-08 16:53:50,148,4079,65,83,2416.84,4448.00,0.00
2024-12-08 16:53:50,149,4079,66,83,2400.62,4448.01,0.00
2024-12-08 16:53:50,148,4079,66,82,2413.87,4448.07,0.00
2024-12-08 16:53:50,147,4079,66,81,2429.38,4448.07,0.00
2024-12-08 16:53:51,147,4080,66,81,2405.70,4449.00,0.00
2024-12-08 16:53:51,148,4080,67,81,2389.45,4449.01,0.00
2024-12-08 16:53:51,147,4080,67,80,2402.10,4449.07,0.00
2024-12-08 16:53:51,147,4081,67,80,2378.16,4450.00,0.00
2024-12-08 16:53:51,148,4081,67,81,2362.09,4450.01,0.00
2024-12-08 16:53:51,147,4081,67,80,2373.35,4450.08,0.00
2024-12-08 16:53:51,146,4081,66,80,2368.95,4450.32,0.00
2024-12-08 16:53:51,147,4080,67,80,2326.82,4450.88,0.00
2024-12-08 16:53:51,147,4081,67,80,2355.37,4451.00,0.00
2024-12-08 16:53:51,148,4081,67,81,2339.46,4451.01,0.00
2024-12-08 16:53:51,147,4081,67,80,2350.86,4451.08,0.00
2024-12-08 16:53:51,148,4080,67,81,2334.98,4451.09,0.00
2024-12-08 16:53:51,147,4080,67,80,2378.86,4451.10,0.00
2024-12-08 16:53:51,146,4080,66,80,2382.44,4451.38,0.00
2024-12-08 16:53:51,147,4079,66,81,2349.88,4451.74,0.00
2024-12-08 16:53:51,147,4080,66,81,2403.94,4452.00,0.00
2024-12-08 16:53:51,148,4080,67,81,2387.69,4452.01,0.00
2024-12-08 16:53:51,147,4080,67,80,2398.83,4452.08,0.00
2024-12-08 16:53:51,146,4080,66,80,2374.06,4452.73,0.00
2024-12-08 16:53:51,146,4081,66,80,2451.96,4453.00,0.00
2024-12-08 16:53:51,147,4081,66,81,2435.28,4453.01,0.00
2024-12-08 16:53:51,146,4081,66,80,2448.94,4453.07,0.00
2024-12-08 16:53:51,145,4081,65,80,2446.43,4453.20,0.00
2024-12-08 16:53:51,145,4082,65,80,2438.13,4454.00,0.00
2024-12-08 16:53:51,146,4082,65,81,2421.43,4454.01,0.00
2024-12-08 16:53:51,147,4081,65,82,2404.36,4454.03,0.00
2024-12-08 16:53:51,146,4081,65,81,2433.37,4454.08,0.00
2024-12-08 16:53:51,146,4082,65,81,2405.13,4455.00,0.00
2024-12-08 16:53:51,147,4082,66,81,2388.77,4455.01,0.00
2024-12-08 16:53:51,146,4082,65,81,2403.62,4455.03,0.00
2024-12-08 16:53:51,145,4082,65,80,2416.53,4455.08,0.00
2024-12-08 16:53:51,145,4083,65,80,2417.05,4456.00,0.00
2024-12-08 16:53:51,146,4083,66,80,2400.49,4456.01,0.00
2024-12-08 16:53:51,145,4083,66,79,2411.86,4456.08,0.00
2024-12-08 16:53:51,146,4082,66,80,2354.28,4456.60,0.00
2024-12-08 16:53:51,146,4083,66,80,2376.02,4457.00,0.00
2024-12-08 16:53:51,147,4083,66,81,2359.85,4457.01,0.00
2024-12-08 16:53:51,147,4084,66,81,2349.60,4458.00,0.00
2024-12-08 16:53:51,148,4084,67,81,2333.72,4458.01,0.00
2024-12-08 16:53:51,149,4083,67,82,2316.29,4458.06,0.00
2024-12-08 16:53:51,148,4083,67,81,2358.77,4458.07,0.00
2024-12-08 16:53:51,147,4083,67,80,2369.66,4458.11,0.00
2024-12-08 16:53:51,146,4083,67,79,2364.60,4458.52,0.00
2024-12-08 16:53:51,145,4083,66,79,2373.21,4458.54,0.00
2024-12-08 16:53:51,145,4084,66,79,2380.96,4459.00,0.00
2024-12-08 16:53:51,146,4084,67,79,2364.65,4459.01,0.00
2024-12-08 16:53:51,147,4083,67,80,2347.37,4459.05,0.00
2024-12-08 16:53:51,148,4082,67,81,2309.70,4459.46,0.00
2024-12-08 16:53:51,148,4083,67,81,2360.21,4460.00,0.00
2024-12-08 16:53:51,149,4083,67,82,2344.37,4460.01,0.00
2024-12-08 16:53:51,148,4083,67,81,2351.61,4460.11,0.00
2024-12-08 16:53:51,147,4083,66,81,2353.12,4460.39,0.00
2024-12-08 16:53:51,147,4084,66,81,2402.35,4461.00,0.00
2024-12-08 16:53:51,148,4084,67,81,2386.12,4461.01,0.00
2024-12-08 16:53:51,147,4084,66,81,2399.06,4461.08,0.00
2024-12-08 16:53:51,146,4084,66,80,2412.75,4461.10,0.00
2024-12-08 16:53:51,145,4084,65,80,2414.77,4461.38,0.00
2024-12-08 16:53:51,145,4085,65,80,2402.84,4462.00,0.00
2024-12-08 16:53:51,146,4085,65,81,2386.38,4462.01,0.00
2024-12-08 16:53:51,145,4085,65,80,2399.50,4462.08,0.00
2024-12-08 16:53:51,144,4085,65,79,2413.77,4462.10,0.00
2024-12-08 16:53:51,143,4085,64,79,2414.65,4462.39,0.00
2024-12-08 16:53:51,143,4086,64,79,2416.27,4463.00,0.00
2024-12-08 16:53:51,144,4086,64,80,2399.49,4463.01,0.00
2024-12-08 16:53:51,143,4086,64,79,2412.89,4463.08,0.00
2024-12-08 16:53:51,142,4086,63,79,2429.56,4463.08,0.00
2024-12-08 16:53:51,141,4086,63,78,2444.58,4463.09,0.00
2024-12-08 16:53:51,140,4086,62,78,2445.79,4463.38,0.00
2024-12-08 16:53:51,139,4086,61,78,2453.99,4463.59,0.00
2024-12-08 16:53:51,138,4086,60,78,2450.88,4463.78,0.00
2024-12-08 16:53:51,138,4087,60,78,2471.32,4464.00,0.00
2024-12-08 16:53:51,139,4087,60,79,2453.54,4464.01,0.00
2024-12-08 16:53:51,138,4087,60,78,2452.61,4464.09,0.00
2024-12-08 16:53:51,138,4088,60,78,2438.84,4465.00,0.00
2024-12-08 16:53:51,139,4088,60,79,2421.30,4465.01,0.00
2024-12-08 16:53:51,140,4087,60,80,2400.22,4465.11,0.00
2024-12-08 16:53:51,139,4087,60,79,2439.78,4465.14,0.00
2024-12-08 16:53:51,138,4087,59,79,2446.87,4465.38,0.00
2024-12-08 16:53:51,138,4088,59,79,2435.75,4466.00,0.00
2024-12-08 16:53:51,139,4088,59,80,2418.23,4466.01,0.00
2024-12-08 16:53:51,140,4087,60,80,2380.34,4466.34,0.00
2024-12-08 16:53:51,141,4086,60,81,2364.66,4466.79,0.00
2024-12-08 16:53:51,140,4086,60,80,2384.59,4466.85,0.00
2024-12-08 16:53:51,140,4087,60,80,2438.34,4467.00,0.00
2024-12-08 16:53:51,141,4087,61,80,2421.04,4467.01,0.00
2024-12-08 16:53:51,142,4086,62,80,2384.28,4467.32,0.00
2024-12-08 16:53:51,143,4085,62,81,2371.25,4467.70,0.00
2024-12-08 16:53:51,143,4086,62,81,2451.80,4468.00,0.00
2024-12-08 16:53:51,144,4086,63,81,2434.77,4468.01,0.00
2024-12-08 16:53:51,145,4085,64,81,2384.97,4468.63,0.00
2024-12-08 16:53:52,145,4086,64,81,2462.32,4469.00,0.00
2024-12-08 16:53:52,146,4086,64,82,2445.46,4469.01,0.00
2024-12-08 16:53:52,147,4085,64,83,2402.25,4469.48,0.00
2024-12-08 16:53:52,147,4086,64,83,2443.05,4470.00,0.00
2024-12-08 16:53:52,148,4086,65,83,2426.54,4470.01,0.00
2024-12-08 16:53:52,147,4086,64,83,2442.75,4470.01,0.00
2024-12-08 16:53:52,146,4086,64,82,2455.85,4470.08,0.00
2024-12-08 16:53:52,147,4085,64,83,2423.45,4470.45,0.00
2024-12-08 16:53:52,147,4086,64,83,2451.62,4471.00,0.00
2024-12-08 16:53:52,148,4086,65,83,2435.05,4471.01,0.00
2024-12-08 16:53:52,148,4087,65,83,2440.98,4472.00,0.00
2024-12-08 16:53:52,149,4087,65,84,2424.59,4472.01,0.00
2024-12-08 16:53:52,148,4087,65,83,2431.05,4472.09,0.00
2024-12-08 16:53:52,148,4088,65,83,2412.90,4473.00,0.00
2024-12-08 16:53:52,149,4088,65,84,2396.71,4473.01,0.00
2024-12-08 16:53:52,150,4087,66,84,2380.43,4473.03,0.00
2024-12-08 16:53:52,149,4087,66,83,2392.54,4473.09,0.00
2024-12-08 16:53:52,149,4088,66,83,2369.59,4474.00,0.00
2024-12-08 16:53:52,150,4088,66,84,2353.79,4474.01,0.00
2024-12-08 16:53:52,149,4088,66,83,2364.52,4474.08,0.00
2024-12-08 16:53:52,148,4088,66,82,2380.20,4474.08,0.00
2024-12-08 16:53:52,147,4088,65,82,2396.08,4474.08,0.00
2024-12-08 16:53:52,146,4088,64,82,2359.91,4474.98,0.00
2024-12-08 16:53:52,146,4089,64,82,2420.30,4475.00,0.00
2024-12-08 16:53:52,147,4089,64,83,2403.84,4475.01,0.00
2024-12-08 16:53:52,146,4089,64,82,2414.84,4475.10,0.00
2024-12-08 16:53:52,145,4089,63,82,2412.55,4475.52,0.00
2024-12-08 16:53:52,145,4090,63,82,2408.71,4476.00,0.00
2024-12-08 16:53:52,146,4090,64,82,2392.21,4476.01,0.00
2024-12-08 16:53:52,145,4090,63,82,2405.97,4476.06,0.00
2024-12-08 16:53:52,146,4089,64,82,2388.27,4476.10,0.00
2024-12-08 16:53:52,145,4089,64,81,2415.19,4476.12,0.00
2024-12-08 16:53:52,146,4088,65,81,2391.03,4476.30,0.00
2024-12-08 16:53:52,147,4087,66,81,2378.44,4476.34,0.00
2024-12-08 16:53:52,147,4088,66,81,2386.74,4477.00,0.00
2024-12-08 16:53:52,148,4088,67,81,2370.61,4477.01,0.00
2024-12-08 16:53:52,147,4088,67,80,2379.78,4477.11,0.00
2024-12-08 16:53:52,146,4088,66,80,2359.71,4477.62,0.00
2024-12-08 16:53:52,146,4089,66,80,2465.48,4478.00,0.00
2024-12-08 16:53:52,147,4089,67,80,2448.71,4478.01,0.00
2024-12-08 16:53:52,146,4089,67,79,2459.40,4478.11,0.00
2024-12-08 16:53:52,147,4088,67,80,2437.21,4478.25,0.00
2024-12-08 16:53:52,148,4087,67,81,2418.38,4478.39,0.00
2024-12-08 16:53:52,149,4086,68,81,2389.44,4478.69,0.00
2024-12-08 16:53:52,149,4087,68,81,2402.31,4479.00,0.00
2024-12-08 16:53:52,150,4087,69,81,2386.30,4479.01,0.00
2024-12-08 16:53:52,149,4087,69,80,2398.15,4479.09,0.00
2024-12-08 16:53:52,148,4087,69,79,2411.94,4479.10,0.00
2024-12-08 16:53:52,149,4086,70,79,2390.07,4479.24,0.00
2024-12-08 16:53:52,148,4086,69,79,2407.76,4479.30,0.00
2024-12-08 16:53:52,149,4085,69,80,2382.98,4479.51,0.00
2024-12-08 16:53:52,149,4086,69,80,2482.62,4480.00,0.00
2024-12-08 16:53:52,150,4086,69,81,2466.07,4480.01,0.00
2024-12-08 16:53:52,149,4086,69,80,2476.36,4480.10,0.00
2024-12-08 16:53:52,149,4087,69,80,2512.46,4481.00,0.00
2024-12-08 16:53:52,150,4087,70,80,2495.71,4481.01,0.00
2024-12-08 16:53:52,149,4087,70,79,2508.30,4481.09,0.00
2024-12-08 16:53:52,148,4087,70,78,2523.43,4481.10,0.00
2024-12-08 16:53:52,147,4087,69,78,2526.92,4481.24,0.00
2024-12-08 16:53:52,148,4086,70,78,2493.17,4481.57,0.00
2024-12-08 16:53:52,149,4085,70,79,2476.31,4481.85,0.00
2024-12-08 16:53:52,149,4086,70,79,2503.52,4482.00,0.00
2024-12-08 16:53:52,150,4086,70,80,2486.83,4482.01,0.00
2024-12-08 16:53:52,149,4086,70,79,2497.85,4482.09,0.00
2024-12-08 16:53:52,148,4086,70,78,2494.38,4482.52,0.00
2024-12-08 16:53:52,148,4087,70,78,2551.96,4483.00,0.00
2024-12-08 16:53:52,149,4087,70,79,2534.83,4483.01,0.00
2024-12-08 16:53:52,150,4086,70,80,2517.05,4483.04,0.00
2024-12-08 16:53:52,149,4086,70,79,2532.78,4483.14,0.00
2024-12-08 16:53:52,148,4086,69,79,2529.38,4483.35,0.00
2024-12-08 16:53:52,147,4086,68,79,2545.07,4483.37,0.00
2024-12-08 16:53:52,148,4085,68,80,2510.23,4483.78,0.00
2024-12-08 16:53:52,148,4086,68,80,2547.98,4484.00,0.00
2024-12-08 16:53:52,149,4086,69,80,2530.88,4484.01,0.00
2024-12-08 16:53:52,150,4085,69,81,2512.54,4484.05,0.00
2024-12-08 16:53:52,149,4085,69,80,2529.13,4484.15,0.00
2024-12-08 16:53:52,149,4086,69,80,2569.68,4485.00,0.00
2024-12-08 16:53:52,150,4086,69,81,2552.54,4485.01,0.00
2024-12-08 16:53:52,149,4086,68,81,2562.78,4485.05,0.00
2024-12-08 16:53:52,148,4086,68,80,2572.54,4485.14,0.00
2024-12-08 16:53:52,147,4086,67,80,2579.60,4485.35,0.00
2024-12-08 16:53:52,147,4087,67,80,2612.07,4486.00,0.00
2024-12-08 16:53:52,148,4087,68,80,2594.42,4486.01,0.00
2024-12-08 16:53:52,147,4087,67,80,2609.36,4486.06,0.00
2024-12-08 16:53:52,146,4087,67,79,2620.49,4486.13,0.00
2024-12-08 16:53:52,146,4088,67,79,2599.59,4487.00,0.00
2024-12-08 16:53:52,147,4088,68,79,2581.91,4487.01,0.00
2024-12-08 16:53:52,146,4088,67,79,2587.35,4487.09,0.00
2024-12-08 16:53:52,145,4088,67,78,2599.93,4487.12,0.00
2024-12-08 16:53:52,146,4087,68,78,2564.47,4487.51,0.00
2024-12-08 16:53:52,147,4086,69,78,2566.33,4487.65,0.00
2024-12-08 16:53:52,148,4085,70,78,2553.31,4487.76,0.00
2024-12-08 16:53:52,148,4086,70,78,2578.69,4488.00,0.00
2024-12-08 16:53:52,149,4086,71,78,2561.39,4488.01,0.00
2024-12-08 16:53:52,148,4086,71,77,2569.64,4488.13,0.00
2024-12-08 16:53:52,149,4085,72,77,2524.33,4488.74,0.00
2024-12-08 16:53:52,148,4085,71,77,2547.15,4488.74,0.00
2024-12-08 16:53:53,148,4086,71,77,2645.02,4489.00,0.00
2024-12-08 16:53:53,149,4086,72,77,2627.27,4489.01,0.00
2024-12-08 16:53:53,150,4085,73,77,2609.76,4489.02,0.00
2024-12-08 16:53:53,149,4085,73,76,2643.89,4489.09,0.00
2024-12-08 16:53:53,149,4086,73,76,2649.83,4490.00,0.00
2024-12-08 16:53:53,150,4086,74,76,2632.16,4490.01,0.00
2024-12-08 16:53:53,149,4086,74,75,2646.26,4490.08,0.00
2024-12-08 16:53:53,149,4087,74,75,2651.72,4491.00,0.00
2024-12-08 16:53:53,150,4087,75,75,2634.04,4491.01,0.00
2024-12-08 16:53:53,149,4087,74,75,2648.15,4491.08,0.00
2024-12-08 16:53:53,148,4087,73,75,2640.82,4491.41,0.00
2024-12-08 16:53:53,149,4086,74,75,2613.86,4491.62,0.00
2024-12-08 16:53:53,149,4087,74,75,2636.78,4492.00,0.00
2024-12-08 16:53:53,150,4087,74,76,2619.20,4492.01,0.00
2024-12-08 16:53:53,149,4087,73,76,2633.21,4492.08,0.00
2024-12-08 16:53:53,148,4087,72,76,2650.70,4492.08,0.00
2024-12-08 16:53:53,147,4087,72,75,2658.35,4492.15,0.00
2024-12-08 16:53:53,146,4087,72,74,2675.57,4492.17,0.00
2024-12-08 16:53:53,147,4086,72,75,2638.91,4492.60,0.00
2024-12-08 16:53:53,148,4085,72,76,2629.90,4492.63,0.00
2024-12-08 16:53:53,148,4086,72,76,2678.31,4493.00,0.00
2024-12-08 16:53:53,149,4086,73,76,2660.34,4493.01,0.00
2024-12-08 16:53:53,150,4085,73,77,2611.87,4493.57,0.00
2024-12-08 16:53:53,151,4084,73,78,2591.39,4493.69,0.00
2024-12-08 16:53:53,151,4085,73,78,2661.63,4494.00,0.00
2024-12-08 16:53:53,152,4085,74,78,2644.12,4494.01,0.00
2024-12-08 16:53:53,151,4085,73,78,2658.10,4494.08,0.00
2024-12-08 16:53:53,152,4084,74,78,2623.77,4494.33,0.00
2024-12-08 16:53:53,151,4084,73,78,2635.39,4494.55,0.00
2024-12-08 16:53:53,151,4085,73,78,2692.90,4495.00,0.00
2024-12-08 16:53:53,152,4085,73,79,2675.18,4495.01,0.00
2024-12-08 16:53:53,151,4085,73,78,2688.18,4495.09,0.00
2024-12-08 16:53:53,152,4084,73,79,2669.32,4495.13,0.00
2024-12-08 16:53:53,152,4085,73,79,2682.62,4496.00,0.00
2024-12-08 16:53:53,153,4085,73,80,2665.08,4496.01,0.00
2024-12-08 16:53:53,152,4085,73,79,2677.63,4496.09,0.00
2024-12-08 16:53:53,151,4085,72,79,2692.71,4496.14,0.00
2024-12-08 16:53:53,150,4085,71,79,2701.44,4496.33,0.00
2024-12-08 16:53:53,150,4086,71,79,2719.60,4497.00,0.00
2024-12-08 16:53:53,151,4086,72,79,2701.59,4497.01,0.00
2024-12-08 16:53:53,151,4087,72,79,2676.96,4498.00,0.00
2024-12-08 16:53:53,152,4087,73,79,2659.35,4498.01,0.00
2024-12-08 16:53:53,153,4086,74,79,2641.97,4498.02,0.00
2024-12-08 16:53:53,153,4087,74,79,2618.16,4499.00,0.00
2024-12-08 16:53:53,154,4087,75,79,2601.16,4499.01,0.00
2024-12-08 16:53:53,155,4086,76,79,2561.79,4499.37,0.00
2024-12-08 16:53:53,155,4087,76,79,2599.58,4500.00,0.00
2024-12-08 16:53:53,156,4087,76,80,2582.91,4500.01,0.00
2024-12-08 16:53:53,155,4087,76,79,2590.33,4500.08,0.00
2024-12-08 16:53:53,154,4087,75,79,2603.00,4500.16,0.00
2024-12-08 16:53:53,154,4088,75,79,2611.76,4501.00,0.00
2024-12-08 16:53:53,155,4088,76,79,2594.91,4501.01,0.00
2024-12-08 16:53:53,154,4088,75,79,2605.65,4501.06,0.00
2024-12-08 16:53:53,155,4087,76,79,2551.51,4501.75,0.00
2024-12-08 16:53:53,156,4086,76,80,2540.65,4501.76,0.00
2024-12-08 16:53:53,156,4087,76,80,2564.50,4502.00,0.00
2024-12-08 16:53:53,157,4087,77,80,2548.17,4502.01,0.00
2024-12-08 16:53:53,156,4087,76,80,2561.08,4502.08,0.00
2024-12-08 16:53:53,155,4087,76,79,2577.31,4502.08,0.00
2024-12-08 16:53:53,154,4087,75,79,2583.24,4502.32,0.00
2024-12-08 16:53:53,154,4088,75,79,2627.78,4503.00,0.00
2024-12-08 16:53:53,155,4088,76,79,2610.82,4503.01,0.00
2024-12-08 16:53:53,156,4087,76,80,2592.95,4503.05,0.00
2024-12-08 16:53:53,156,4088,76,80,2593.76,4504.00,0.00
2024-12-08 16:53:53,157,4088,77,80,2577.24,4504.01,0.00
2024-12-08 16:53:53,158,4087,78,80,2540.59,4504.32,0.00
2024-12-08 16:53:53,158,4088,78,80,2569.97,4505.00,0.00
2024-12-08 16:53:53,159,4088,79,80,2553.81,4505.01,0.00
2024-12-08 16:53:53,158,4088,79,79,2560.32,4505.09,0.00
2024-12-08 16:53:53,157,4088,78,79,2564.52,4505.33,0.00
2024-12-08 16:53:53,158,4087,79,79,2533.09,4505.68,0.00
2024-12-08 16:53:53,158,4088,79,79,2576.44,4506.00,0.00
2024-12-08 16:53:53,159,4088,80,79,2560.24,4506.01,0.00
2024-12-08 16:53:53,159,4089,80,79,2554.88,4507.00,0.00
2024-12-08 16:53:53,160,4089,80,80,2538.91,4507.01,0.00
2024-12-08 16:53:53,159,4089,80,79,2549.25,4507.08,0.00
2024-12-08 16:53:53,158,4089,79,79,2552.31,4507.34,0.00
2024-12-08 16:53:53,159,4088,80,79,2528.69,4507.52,0.00
2024-12-08 16:53:53,158,4088,79,79,2540.85,4507.75,0.00
2024-12-08 16:53:53,157,4088,78,79,2554.31,4507.82,0.00
2024-12-08 16:53:53,157,4089,78,79,2563.36,4508.00,0.00
2024-12-08 16:53:53,158,4089,79,79,2547.14,4508.01,0.00
2024-12-08 16:53:53,157,4089,78,79,2546.27,4508.22,0.00
2024-12-08 16:53:53,158,4088,79,79,2497.97,4508.86,0.00
2024-12-08 16:53:53,158,4089,79,79,2552.58,4509.00,0.00
2024-12-08 16:53:53,159,4089,80,79,2536.53,4509.01,0.00
2024-12-08 16:53:53,158,4089,80,78,2542.92,4509.09,0.00
2024-12-08 16:53:53,159,4088,81,78,2525.24,4509.14,0.00
2024-12-08 16:53:53,158,4088,80,78,2558.70,4509.32,0.00
2024-12-08 16:53:53,158,4089,80,78,2577.55,4510.00,0.00
2024-12-08 16:53:54,159,4089,80,79,2561.34,4510.01,0.00
2024-12-08 16:53:54,160,4088,81,79,2515.13,4510.57,0.00
2024-12-08 16:53:54,160,4089,81,79,2550.35,4511.00,0.00
2024-12-08 16:53:54,161,4089,81,80,2534.51,4511.01,0.00
2024-12-08 16:53:54,160,4089,81,79,2545.31,4511.08,0.00
2024-12-08 16:53:54,159,4089,80,79,2557.09,4511.17,0.00
2024-12-08 16:53:54,158,4089,79,79,2568.13,4511.29,0.00
2024-12-08 16:53:54,158,4090,79,79,2580.59,4512.00,0.00
2024-12-08 16:53:54,159,4090,79,80,2564.36,4512.01,0.00
2024-12-08 16:53:54,158,4090,78,80,2559.53,4512.34,0.00
2024-12-08 16:53:54,159,4089,79,80,2537.82,4512.48,0.00
2024-12-08 16:53:54,160,4088,79,81,2533.54,4512.51,0.00
2024-12-08 16:53:54,160,4089,79,81,2538.83,4513.00,0.00
2024-12-08 16:53:54,161,4089,80,81,2523.06,4513.01,0.00
2024-12-08 16:53:54,160,4089,80,80,2534.35,4513.08,0.00
2024-12-08 16:53:54,161,4088,80,81,2503.99,4513.42,0.00
2024-12-08 16:53:54,162,4087,81,81,2501.10,4513.46,0.00
2024-12-08 16:53:54,161,4087,80,81,2495.65,4513.70,0.00
2024-12-08 16:53:54,162,4086,80,82,2471.48,4513.90,0.00
2024-12-08 16:53:54,162,4087,80,82,2559.55,4514.00,0.00
2024-12-08 16:53:54,163,4087,80,83,2543.85,4514.01,0.00
2024-12-08 16:53:54,162,4087,80,82,2555.97,4514.08,0.00
2024-12-08 16:53:54,162,4088,80,82,2612.19,4515.00,0.00
2024-12-08 16:53:54,163,4088,81,82,2596.17,4515.01,0.00
2024-12-08 16:53:54,162,4088,81,81,2608.61,4515.08,0.00
2024-12-08 16:53:54,161,4088,80,81,2624.53,4515.08,0.00
2024-12-08 16:53:54,160,4088,79,81,2629.11,4515.33,0.00
2024-12-08 16:53:54,160,4089,79,81,2612.90,4516.00,0.00
2024-12-08 16:53:54,161,4089,80,81,2596.67,4516.01,0.00
2024-12-08 16:53:54,160,4089,80,80,2608.71,4516.09,0.00
2024-12-08 16:53:54,159,4089,79,80,2610.12,4516.28,0.00
2024-12-08 16:53:54,160,4088,79,81,2592.55,4516.31,0.00
2024-12-08 16:53:54,159,4088,78,81,2613.99,4516.52,0.00
2024-12-08 16:53:54,159,4089,78,81,2621.16,4517.00,0.00
2024-12-08 16:53:54,160,4089,78,82,2604.77,4517.01,0.00
2024-12-08 16:53:54,161,4088,79,82,2573.41,4517.23,0.00
2024-12-08 16:53:54,162,4087,79,83,2546.26,4517.79,0.00
2024-12-08 16:53:54,162,4088,79,83,2595.23,4518.00,0.00
2024-12-08 16:53:54,163,4088,79,84,2579.31,4518.01,0.00
2024-12-08 16:53:54,162,4088,78,84,2592.57,4518.05,0.00
2024-12-08 16:53:54,161,4088,77,84,2589.60,4518.34,0.00
2024-12-08 16:53:54,161,4088,77,84,2640.50,4519.00,0.00
2024-12-08 16:53:54,162,4088,78,84,2624.20,4519.01,0.00
2024-12-08 16:53:54,163,4087,79,84,2607.28,4519.04,0.00
2024-12-08 16:53:54,162,4087,79,83,2624.19,4519.10,0.00
2024-12-08 16:53:54,162,4088,79,83,2604.40,4520.00,0.00
2024-12-08 16:53:54,163,4088,79,84,2588.42,4520.01,0.00
2024-12-08 16:53:54,164,4087,79,85,2529.37,4520.84,0.00
2024-12-08 16:53:54,165,4086,79,86,2529.47,4520.87,0.00
2024-12-08 16:53:54,165,4087,79,86,2592.33,4521.00,0.00
2024-12-08 16:53:54,166,4087,80,86,2576.71,4521.01,0.00
2024-12-08 16:53:54,165,4087,80,85,2586.24,4521.08,0.00
2024-12-08 16:53:54,165,4088,80,85,2615.70,4522.00,0.00
2024-12-08 16:53:54,166,4088,80,86,2599.95,4522.01,0.00
2024-12-08 16:53:54,165,4088,80,85,2606.23,4522.09,0.00
2024-12-08 16:53:54,164,4088,79,85,2621.84,4522.09,0.00
2024-12-08 16:53:54,163,4088,78,85,2637.65,4522.09,0.00
2024-12-08 16:53:54,162,4088,78,84,2653.65,4522.09,0.00
2024-12-08 16:53:54,161,4088,78,83,2663.54,4522.23,0.00
2024-12-08 16:53:54,162,4087,79,83,2644.61,4522.30,0.00
2024-12-08 16:53:54,163,4086,79,84,2622.19,4522.62,0.00
2024-12-08 16:53:54,163,4087,79,84,2634.84,4523.00,0.00
2024-12-08 16:53:54,164,4087,80,84,2618.78,4523.01,0.00
2024-12-08 16:53:54,163,4087,79,84,2622.81,4523.15,0.00
2024-12-08 16:53:54,164,4086,80,84,2597.53,4523.37,0.00
2024-12-08 16:53:54,163,4086,79,84,2632.63,4523.45,0.00
2024-12-08 16:53:54,162,4086,78,84,2629.36,4523.75,0.00
2024-12-08 16:53:54,163,4085,79,84,2610.50,4523.82,0.00
2024-12-08 16:53:54,163,4086,79,84,2689.75,4524.00,0.00
2024-12-08 16:53:54,164,4086,79,85,2673.35,4524.01,0.00
2024-12-08 16:53:54,163,4086,79,84,2684.79,4524.08,0.00
2024-12-08 16:53:54,162,4086,79,83,2701.08,4524.08,0.00
2024-12-08 16:53:54,162,4087,79,83,2717.79,4525.00,0.00
2024-12-08 16:53:54,163,4087,79,84,2701.12,4525.01,0.00
2024-12-08 16:53:54,162,4087,79,83,2713.08,4525.08,0.00
2024-12-08 16:53:54,161,4087,78,83,2686.99,4525.65,0.00
2024-12-08 16:53:54,162,4086,79,83,2669.02,4525.69,0.00
2024-12-08 16:53:54,162,4087,79,83,2685.20,4526.00,0.00
2024-12-08 16:53:54,163,4087,79,84,2668.73,4526.01,0.00
2024-12-08 16:53:54,162,4087,79,83,2680.77,4526.08,0.00
2024-12-08 16:53:54,163,4086,80,83,2637.63,4526.69,0.00
2024-12-08 16:53:54,163,4087,80,83,2686.48,4527.00,0.00
2024-12-08 16:53:54,164,4087,81,83,2670.10,4527.01,0.00
2024-12-08 16:53:54,163,4087,81,82,2670.96,4527.08,0.00
2024-12-08 16:53:54,163,4088,81,82,2685.15,4528.00,0.00
2024-12-08 16:53:54,164,4088,82,82,2668.78,4528.01,0.00
2024-12-08 16:53:54,163,4088,82,81,2680.44,4528.08,0.00
2024-12-08 16:53:54,164,4087,82,82,2636.73,4528.70,0.00
2024-12-08 16:53:54,164,4088,82,82,2646.92,4529.00,0.00
2024-12-08 16:53:54,165,4088,82,83,2630.88,4529.01,0.00
2024-12-08 16:53:54,164,4088,81,83,2635.92,4529.07,0.00
2024-12-08 16:53:54,165,4087,82,83,2600.87,4529.50,0.00
2024-12-08 16:53:55,165,4088,82,83,2645.71,4530.00,0.00
2024-12-08 16:53:55,166,4088,83,83,2629.77,4530.01,0.00
2024-12-08 16:53:55,165,4088,83,82,2641.62,4530.07,0.00
2024-12-08 16:53:55,166,4087,84,82,2613.57,4530.35,0.00
2024-12-08 16:53:55,166,4088,84,82,2644.31,4531.00,0.00
2024-12-08 16:53:55,167,4088,84,83,2628.47,4531.01,0.00
2024-12-08 16:53:55,166,4088,84,82,2631.49,4531.04,0.00
2024-12-08 16:53:55,165,4088,84,81,2645.25,4531.07,0.00
2024-12-08 16:53:55,166,4087,85,81,2609.36,4531.52,0.00
2024-12-08 16:53:55,166,4088,85,81,2654.22,4532.00,0.00
2024-12-08 16:53:55,167,4088,86,81,2638.32,4532.01,0.00
2024-12-08 16:53:55,166,4088,86,80,2650.42,4532.07,0.00
2024-12-08 16:53:55,167,4087,87,80,2625.39,4532.28,0.00
2024-12-08 16:53:55,167,4088,87,80,2641.41,4533.00,0.00
2024-12-08 16:53:55,168,4088,88,80,2625.69,4533.01,0.00
2024-12-08 16:53:55,167,4088,87,80,2640.88,4533.01,0.00
2024-12-08 16:53:55,166,4088,87,79,2652.98,4533.07,0.00
2024-12-08 16:53:55,165,4088,86,79,2645.51,4533.50,0.00
2024-12-08 16:53:55,166,4087,86,80,2622.57,4533.66,0.00
2024-12-08 16:53:55,166,4088,86,80,2666.86,4534.00,0.00
2024-12-08 16:53:55,167,4088,86,81,2650.89,4534.01,0.00
2024-12-08 16:53:55,166,4088,86,80,2662.78,4534.07,0.00
2024-12-08 16:53:55,167,4087,87,80,2617.19,4534.50,0.00
2024-12-08 16:53:55,167,4088,87,80,2651.09,4535.00,0.00
2024-12-08 16:53:55,168,4088,87,81,2635.31,4535.01,0.00
2024-12-08 16:53:55,167,4088,86,81,2650.56,4535.01,0.00
2024-12-08 16:53:55,166,4088,85,81,2665.44,4535.03,0.00
2024-12-08 16:53:55,165,4088,85,80,2668.41,4535.06,0.00
2024-12-08 16:53:55,166,4087,86,80,2626.57,4535.64,0.00
2024-12-08 16:53:55,166,4088,86,80,2664.16,4536.00,0.00
2024-12-08 16:53:55,167,4088,86,81,2648.20,4536.01,0.00
2024-12-08 16:53:55,167,4089,86,81,2647.78,4537.00,0.00
2024-12-08 16:53:55,168,4089,87,81,2632.02,4537.01,0.00
2024-12-08 16:53:55,167,4089,86,81,2626.93,4537.34,0.00
2024-12-08 16:53:55,168,4088,86,82,2592.24,4537.66,0.00
2024-12-08 16:53:55,168,4089,86,82,2610.13,4538.00,0.00
2024-12-08 16:53:55,169,4089,87,82,2594.68,4538.01,0.00
2024-12-08 16:53:55,168,4089,86,82,2608.25,4538.04,0.00
2024-12-08 16:53:55,167,4089,85,82,2623.33,4538.05,0.00
2024-12-08 16:53:55,166,4089,85,81,2633.12,4538.05,0.00
2024-12-08 16:53:55,166,4090,85,81,2634.07,4539.00,0.00
2024-12-08 16:53:55,167,4090,85,82,2618.29,4539.01,0.00
2024-12-08 16:53:55,166,4090,85,81,2626.98,4539.05,0.00
2024-12-08 16:53:55,165,4090,85,80,2642.62,4539.05,0.00
2024-12-08 16:53:55,164,4090,84,80,2645.44,4539.33,0.00
2024-12-08 16:53:55,165,4089,84,81,2621.51,4539.52,0.00
2024-12-08 16:53:55,166,4088,85,81,2613.71,4539.61,0.00
2024-12-08 16:53:55,167,4087,85,82,2593.02,4539.90,0.00
2024-12-08 16:53:55,167,4088,85,82,2606.52,4540.00,0.00
2024-12-08 16:53:55,168,4088,86,82,2591.01,4540.01,0.00
2024-12-08 16:53:55,168,4089,86,82,2641.69,4541.00,0.00
2024-12-08 16:53:55,169,4089,87,82,2626.05,4541.01,0.00
2024-12-08 16:53:55,168,4089,86,82,2620.11,4541.35,0.00
2024-12-08 16:53:55,169,4088,87,82,2591.82,4541.46,0.00
2024-12-08 16:53:55,169,4089,87,82,2604.90,4542.00,0.00
2024-12-08 16:53:55,170,4089,88,82,2589.58,4542.01,0.00
2024-12-08 16:53:55,171,4088,88,83,2563.58,4542.14,0.00
2024-12-08 16:53:55,171,4089,88,83,2586.93,4543.00,0.00
2024-12-08 16:53:55,172,4089,89,83,2571.89,4543.01,0.00
2024-12-08 16:53:55,171,4089,89,82,2584.56,4543.05,0.00
2024-12-08 16:53:55,172,4088,89,83,2558.47,4543.30,0.00
2024-12-08 16:53:55,173,4087,89,84,2559.71,4543.34,0.00
2024-12-08 16:53:55,172,4087,88,84,2579.15,4543.60,0.00
2024-12-08 16:53:55,171,4087,87,84,2586.12,4543.78,0.00
2024-12-08 16:53:55,171,4088,87,84,2616.67,4544.00,0.00
2024-12-08 16:53:55,172,4088,87,85,2601.46,4544.01,0.00
2024-12-08 16:53:55,171,4088,86,85,2594.57,4544.37,0.00
2024-12-08 16:53:55,171,4089,86,85,2638.46,4545.00,0.00
2024-12-08 16:53:55,172,4089,87,85,2623.12,4545.01,0.00
2024-12-08 16:53:55,171,4089,86,85,2601.30,4545.51,0.00
2024-12-08 16:53:55,171,4090,86,85,2604.24,4546.00,0.00
2024-12-08 16:53:55,172,4090,86,86,2589.10,4546.01,0.00
2024-12-08 16:53:55,171,4090,86,85,2595.05,4546.05,0.00
2024-12-08 16:53:55,171,4091,86,85,2555.82,4547.00,0.00
2024-12-08 16:53:55,172,4091,87,85,2540.96,4547.01,0.00
2024-12-08 16:53:55,171,4091,87,84,2552.79,4547.06,0.00
2024-12-08 16:53:55,171,4092,87,84,2514.35,4548.00,0.00
2024-12-08 16:53:55,172,4092,87,85,2499.73,4548.01,0.00
2024-12-08 16:53:55,171,4092,86,85,2501.89,4548.06,0.00
2024-12-08 16:53:55,170,4092,85,85,2515.81,4548.06,0.00
2024-12-08 16:53:55,169,4092,85,84,2529.62,4548.06,0.00
2024-12-08 16:53:55,170,4091,85,85,2507.84,4548.22,0.00
2024-12-08 16:53:55,169,4091,85,84,2518.15,4548.30,0.00
2024-12-08 16:53:55,170,4090,85,85,2502.01,4548.34,0.00
2024-12-08 16:53:55,171,4089,85,86,2490.59,4548.39,0.00
2024-12-08 16:53:55,172,4088,86,86,2463.37,4548.76,0.00
2024-12-08 16:53:55,172,4089,86,86,2484.18,4549.00,0.00
2024-12-08 16:53:55,173,4089,87,86,2469.82,4549.01,0.00
2024-12-08 16:53:55,172,4089,86,86,2475.99,4549.04,0.00
2024-12-08 16:53:55,173,4088,87,86,2454.07,4549.10,0.00
2024-12-08 16:53:55,172,4088,87,85,2454.29,4549.33,0.00
2024-12-08 16:53:55,173,4087,88,85,2438.54,4549.38,0.00
2024-12-08 16:53:55,174,4086,89,85,2415.76,4549.82,0.00
2024-12-08 16:53:56,174,4087,89,85,2542.71,4550.00,0.00
2024-12-08 16:53:56,175,4087,90,85,2528.18,4550.01,0.00
2024-12-08 16:53:56,174,4087,89,85,2540.87,4550.02,0.00
2024-12-08 16:53:56,173,4087,88,85,2550.56,4550.03,0.00
2024-12-08 16:53:56,172,4087,87,85,2544.43,4550.34,0.00
2024-12-08 16:53:56,173,4086,88,85,2508.43,4550.81,0.00
2024-12-08 16:53:56,173,4087,88,85,2602.58,4551.00,0.00
2024-12-08 16:53:56,174,4087,88,86,2587.62,4551.01,0.00
2024-12-08 16:53:56,174,4088,88,86,2577.16,4552.00,0.00
2024-12-08 16:53:56,175,4088,89,86,2562.44,4552.01,0.00
2024-12-08 16:53:56,174,4088,89,85,2574.30,4552.04,0.00
2024-12-08 16:53:56,173,4088,88,85,2579.52,4552.24,0.00
2024-12-08 16:53:56,174,4087,88,86,2556.41,4552.43,0.00
2024-12-08 16:53:56,173,4087,87,86,2531.81,4552.97,0.00
2024-12-08 16:53:56,173,4088,87,86,2556.58,4553.00,0.00
2024-12-08 16:53:56,174,4088,87,87,2541.89,4553.01,0.00
2024-12-08 16:53:56,173,4088,87,86,2554.75,4553.04,0.00
2024-12-08 16:53:56,174,4087,88,86,2521.65,4553.46,0.00
2024-12-08 16:53:56,173,4087,88,85,2506.38,4553.90,0.00
2024-12-08 16:53:56,173,4088,88,85,2554.64,4554.00,0.00
2024-12-08 16:53:56,174,4088,89,85,2539.96,4554.01,0.00
2024-12-08 16:53:56,173,4088,89,84,2552.81,4554.04,0.00
2024-12-08 16:53:56,172,4088,89,83,2567.45,4554.04,0.00
2024-12-08 16:53:56,173,4087,89,84,2551.30,4554.08,0.00
2024-12-08 16:53:56,172,4087,89,83,2582.45,4554.08,0.00
2024-12-08 16:53:56,173,4086,89,84,2561.26,4554.23,0.00
2024-12-08 16:53:56,172,4086,88,84,2590.51,4554.35,0.00
2024-12-08 16:53:56,172,4087,88,84,2602.12,4555.00,0.00
2024-12-08 16:53:56,173,4087,89,84,2587.08,4555.01,0.00
2024-12-08 16:53:56,174,4086,90,84,2570.91,4555.05,0.00
2024-12-08 16:53:56,173,4086,90,83,2610.55,4555.05,0.00
2024-12-08 16:53:56,172,4086,90,82,2584.28,4555.71,0.00
2024-12-08 16:53:56,172,4087,90,82,2650.73,4556.00,0.00
2024-12-08 16:53:56,173,4087,90,83,2635.40,4556.01,0.00
2024-12-08 16:53:56,172,4087,89,83,2648.89,4556.04,0.00
2024-12-08 16:53:56,171,4087,88,83,2649.86,4556.23,0.00
2024-12-08 16:53:56,171,4087,88,83,2664.87,4557.00,0.00
2024-12-08 16:53:56,172,4087,89,83,2649.38,4557.01,0.00
2024-12-08 16:53:56,171,4087,88,83,2629.17,4557.57,0.00
2024-12-08 16:53:56,171,4088,88,83,2636.42,4558.00,0.00
2024-12-08 16:53:56,172,4088,89,83,2621.10,4558.01,0.00
2024-12-08 16:53:56,171,4088,89,82,2605.96,4558.33,0.00
2024-12-08 16:53:56,172,4087,90,82,2588.70,4558.38,0.00
2024-12-08 16:53:56,173,4086,91,82,2571.67,4558.47,0.00
2024-12-08 16:53:56,173,4087,91,82,2573.73,4559.00,0.00
2024-12-08 16:53:56,174,4087,92,82,2558.93,4559.01,0.00
2024-12-08 16:53:56,173,4087,92,81,2560.51,4559.16,0.00
2024-12-08 16:53:56,174,4086,92,82,2516.52,4559.76,0.00
2024-12-08 16:53:56,175,4085,92,83,2510.01,4559.90,0.00
2024-12-08 16:53:56,175,4086,92,83,2575.50,4560.00,0.00
2024-12-08 16:53:56,176,4086,92,84,2560.87,4560.01,0.00
2024-12-08 16:53:56,177,4085,93,84,2545.37,4560.04,0.00
2024-12-08 16:53:56,176,4085,93,83,2577.47,4560.05,0.00
2024-12-08 16:53:56,177,4084,93,84,2536.24,4560.57,0.00
2024-12-08 16:53:56,177,4085,93,84,2594.02,4561.00,0.00
2024-12-08 16:53:56,178,4085,94,84,2579.45,4561.01,0.00
2024-12-08 16:53:56,179,4084,94,85,2545.29,4561.34,0.00
2024-12-08 16:53:56,178,4084,94,84,2573.73,4561.48,0.00
2024-12-08 16:53:56,178,4085,94,84,2624.67,4562.00,0.00
2024-12-08 16:53:56,179,4085,94,85,2610.00,4562.01,0.00
2024-12-08 16:53:56,180,4084,95,85,2594.75,4562.03,0.00
2024-12-08 16:53:56,179,4084,94,85,2612.22,4562.36,0.00
2024-12-08 16:53:56,180,4083,94,86,2584.68,4562.66,0.00
2024-12-08 16:53:56,180,4084,94,86,2636.76,4563.00,0.00
2024-12-08 16:53:56,181,4084,94,87,2622.19,4563.01,0.00
2024-12-08 16:53:56,180,4084,93,87,2636.00,4563.02,0.00
2024-12-08 16:53:56,179,4084,93,86,2643.36,4563.06,0.00
2024-12-08 16:53:56,178,4084,93,85,2655.25,4563.12,0.00
2024-12-08 16:53:56,179,4083,93,86,2633.59,4563.29,0.00
2024-12-08 16:53:56,178,4083,92,86,2648.87,4563.39,0.00
2024-12-08 16:53:56,178,4084,92,86,2691.63,4564.00,0.00
2024-12-08 16:53:56,179,4084,93,86,2676.59,4564.01,0.00
2024-12-08 16:53:56,178,4084,93,85,2683.68,4564.06,0.00
2024-12-08 16:53:56,179,4083,94,85,2645.39,4564.59,0.00
2024-12-08 16:53:56,180,4082,94,86,2636.08,4564.68,0.00
2024-12-08 16:53:56,180,4083,94,86,2669.55,4565.00,0.00
2024-12-08 16:53:56,181,4083,94,87,2654.81,4565.01,0.00
2024-12-08 16:53:56,180,4083,94,86,2667.04,4565.03,0.00
2024-12-08 16:53:56,179,4083,94,85,2680.67,4565.06,0.00
2024-12-08 16:53:56,178,4083,94,84,2695.48,4565.06,0.00
2024-12-08 16:53:56,177,4083,93,84,2705.67,4565.16,0.00
2024-12-08 16:53:56,176,4083,92,84,2715.94,4565.27,0.00
2024-12-08 16:53:56,176,4084,92,84,2750.41,4566.00,0.00
2024-12-08 16:53:56,177,4084,92,85,2734.87,4566.01,0.00
2024-12-08 16:53:56,176,4084,92,84,2742.66,4566.06,0.00
2024-12-08 16:53:56,177,4083,93,84,2704.03,4566.34,0.00
2024-12-08 16:53:56,178,4082,94,84,2671.29,4566.90,0.00
2024-12-08 16:53:56,178,4083,94,84,2694.47,4567.00,0.00
2024-12-08 16:53:56,179,4083,95,84,2679.41,4567.01,0.00
2024-12-08 16:53:56,178,4083,95,83,2691.66,4567.03,0.00
2024-12-08 16:53:56,179,4082,95,84,2673.71,4567.10,0.00
2024-12-08 16:53:56,180,4081,95,85,2657.38,4567.25,0.00
2024-12-08 16:53:56,179,4081,94,85,2678.97,4567.29,0.00
2024-12-08 16:53:56,178,4081,93,85,2691.55,4567.34,0.00
2024-12-08 16:53:57,178,4082,93,85,2738.29,4568.00,0.00
2024-12-08 16:53:57,179,4082,94,85,2722.99,4568.01,0.00
2024-12-08 16:53:57,178,4082,94,84,2727.45,4568.07,0.00
2024-12-08 16:53:57,177,4082,93,84,2739.59,4568.14,0.00
2024-12-08 16:53:57,178,4081,93,85,2723.69,4568.16,0.00
2024-12-08 16:53:57,179,4080,93,86,2717.04,4568.46,0.00
2024-12-08 16:53:57,179,4081,93,86,2780.88,4569.00,0.00
2024-12-08 16:53:57,180,4081,94,86,2765.43,4569.01,0.00
2024-12-08 16:53:57,181,4080,95,86,2728.10,4569.39,0.00
2024-12-08 16:53:57,182,4079,95,87,2722.46,4569.50,0.00
2024-12-08 16:53:57,182,4080,95,87,2775.27,4570.00,0.00
2024-12-08 16:53:57,183,4080,95,88,2760.10,4570.01,0.00
2024-12-08 16:53:57,184,4079,96,88,2702.75,4570.82,0.00
2024-12-08 16:53:57,184,4080,96,88,2764.86,4571.00,0.00
2024-12-08 16:53:57,185,4080,96,89,2749.92,4571.01,0.00
2024-12-08 16:53:57,185,4081,96,89,2738.36,4572.00,0.00
2024-12-08 16:53:57,186,4081,96,90,2723.64,4572.01,0.00
2024-12-08 16:53:57,187,4080,96,91,2708.11,4572.04,0.00
2024-12-08 16:53:57,186,4080,96,90,2725.87,4572.04,0.00
2024-12-08 16:53:57,185,4080,96,89,2738.16,4572.09,0.00
2024-12-08 16:53:57,184,4080,95,89,2702.23,4572.96,0.00
2024-12-08 16:53:57,184,4081,95,89,2725.14,4573.00,0.00
2024-12-08 16:53:57,185,4081,96,89,2710.41,4573.01,0.00
2024-12-08 16:53:57,184,4081,95,89,2713.98,4573.06,0.00
2024-12-08 16:53:57,183,4081,95,88,2727.82,4573.08,0.00
2024-12-08 16:53:57,184,4080,96,88,2694.78,4573.49,0.00
2024-12-08 16:53:57,184,4081,96,88,2719.38,4574.00,0.00
2024-12-08 16:53:57,185,4081,97,88,2704.68,4574.01,0.00
2024-12-08 16:53:57,184,4081,97,87,2712.69,4574.05,0.00
2024-12-08 16:53:57,183,4081,97,86,2726.03,4574.08,0.00
2024-12-08 16:53:57,184,4080,97,87,2689.72,4574.52,0.00
2024-12-08 16:53:57,184,4081,97,87,2716.62,4575.00,0.00
2024-12-08 16:53:57,185,4081,98,87,2701.93,4575.01,0.00
2024-12-08 16:53:57,184,4081,98,86,2708.20,4575.08,0.00
2024-12-08 16:53:57,184,4082,98,86,2703.88,4576.00,0.00
2024-12-08 16:53:57,185,4082,98,87,2689.26,4576.01,0.00
2024-12-08 16:53:57,186,4081,99,87,2673.10,4576.05,0.00
2024-12-08 16:53:57,185,4081,99,86,2693.50,4576.07,0.00
2024-12-08 16:53:57,184,4081,98,86,2707.40,4576.08,0.00
2024-12-08 16:53:57,183,4081,97,86,2711.97,4576.30,0.00
2024-12-08 16:53:57,182,4081,96,86,2714.82,4576.35,0.00
2024-12-08 16:53:57,182,4082,96,86,2706.89,4577.00,0.00
2024-12-08 16:53:57,183,4082,97,86,2692.10,4577.01,0.00
2024-12-08 16:53:57,184,4081,98,86,2643.58,4577.60,0.00
2024-12-08 16:53:57,184,4082,98,86,2680.29,4578.00,0.00
2024-12-08 16:53:57,185,4082,99,86,2665.80,4578.01,0.00
2024-12-08 16:53:57,184,4082,99,85,2671.62,4578.08,0.00
2024-12-08 16:53:57,184,4083,99,85,2671.64,4579.00,0.00
2024-12-08 16:53:57,185,4083,99,86,2657.20,4579.01,0.00
2024-12-08 16:53:57,185,4084,99,86,2620.21,4580.00,0.00
2024-12-08 16:53:57,186,4084,99,87,2606.12,4580.01,0.00
2024-12-08 16:53:57,185,4084,99,86,2613.32,4580.08,0.00
2024-12-08 16:53:57,186,4083,100,86,2567.95,4580.72,0.00
2024-12-08 16:53:57,185,4083,99,86,2584.53,4580.80,0.00
2024-12-08 16:53:57,185,4084,99,86,2590.05,4581.00,0.00
2024-12-08 16:53:57,186,4084,100,86,2576.13,4581.01,0.00
2024-12-08 16:53:57,185,4084,100,85,2581.63,4581.08,0.00
2024-12-08 16:53:57,184,4084,100,84,2595.42,4581.08,0.00
2024-12-08 16:53:57,183,4084,99,84,2604.54,4581.18,0.00
2024-12-08 16:53:57,182,4084,98,84,2605.54,4581.25,0.00
2024-12-08 16:53:57,182,4085,98,84,2619.84,4582.00,0.00
2024-12-08 16:53:57,183,4085,98,85,2605.53,4582.01,0.00
2024-12-08 16:53:57,182,4085,98,84,2615.76,4582.08,0.00
2024-12-08 16:53:57,183,4084,99,84,2595.01,4582.24,0.00
2024-12-08 16:53:58,184,4083,99,85,2600.52,4582.30,0.00
2024-12-08 16:53:58,183,4083,98,85,2607.75,4582.56,0.00
2024-12-08 16:53:58,183,4084,98,85,2613.01,4583.00,0.00
2024-12-08 16:53:58,184,4084,98,86,2598.81,4583.01,0.00
2024-12-08 16:53:58,183,4084,98,85,2600.26,4583.09,0.00
2024-12-08 16:53:58,183,4085,98,85,2627.78,4584.00,0.00
2024-12-08 16:53:58,184,4085,99,85,2613.50,4584.01,0.00
2024-12-08 16:53:58,183,4085,98,85,2622.81,4584.03,0.00
2024-12-08 16:53:58,182,4085,97,85,2611.36,4584.45,0.00
2024-12-08 16:53:58,182,4086,97,85,2610.26,4585.00,0.00
2024-12-08 16:53:58,183,4086,98,85,2596.00,4585.01,0.00
2024-12-08 16:53:58,182,4086,98,84,2601.48,4585.08,0.00
2024-12-08 16:53:58,183,4085,99,84,2586.76,4585.10,0.00
2024-12-08 16:53:58,184,4084,99,85,2585.67,4585.12,0.00
2024-12-08 16:53:58,183,4084,98,85,2596.56,4585.39,0.00
2024-12-08 16:53:58,183,4085,98,85,2582.87,4586.00,0.00
2024-12-08 16:53:58,184,4085,98,86,2568.83,4586.01,0.00
2024-12-08 16:53:58,183,4085,98,85,2578.89,4586.08,0.00
2024-12-08 16:53:58,184,4084,99,85,2561.02,4586.17,0.00
2024-12-08 16:53:58,183,4084,98,85,2566.01,4586.49,0.00
2024-12-08 16:53:58,183,4085,98,85,2607.54,4587.00,0.00
2024-12-08 16:53:58,184,4085,98,86,2593.37,4587.01,0.00
2024-12-08 16:53:58,183,4085,97,86,2599.05,4587.08,0.00
2024-12-08 16:53:58,182,4085,96,86,2613.08,4587.08,0.00
2024-12-08 16:53:58,181,4085,95,86,2625.07,4587.09,0.00
2024-12-08 16:53:58,180,4085,94,86,2634.16,4587.21,0.00
2024-12-08 16:53:58,180,4086,94,86,2641.39,4588.00,0.00
2024-12-08 16:53:58,181,4086,95,86,2626.80,4588.01,0.00
2024-12-08 16:53:58,180,4086,94,86,2624.71,4588.16,0.00
2024-12-08 16:53:58,179,4086,93,86,2611.85,4588.57,0.00
2024-12-08 16:53:58,179,4087,93,86,2616.44,4589.00,0.00
2024-12-08 16:53:58,180,4087,94,86,2601.90,4589.01,0.00
2024-12-08 16:53:58,181,4086,94,87,2553.45,4589.58,0.00
2024-12-08 16:53:58,180,4086,93,87,2571.43,4589.66,0.00
2024-12-08 16:53:58,180,4087,93,87,2574.76,4590.00,0.00
2024-12-08 16:53:58,181,4087,93,88,2560.53,4590.01,0.00
2024-12-08 16:53:58,180,4087,92,88,2574.00,4590.01,0.00
2024-12-08 16:53:58,179,4087,91,88,2573.56,4590.16,0.00
2024-12-08 16:53:58,179,4088,91,88,2574.67,4591.00,0.00
2024-12-08 16:53:58,180,4088,92,88,2560.37,4591.01,0.00
2024-12-08 16:53:58,179,4088,91,88,2567.20,4591.09,0.00
2024-12-08 16:53:58,178,4088,91,87,2577.24,4591.09,0.00
2024-12-08 16:53:58,177,4088,90,87,2557.37,4591.55,0.00
2024-12-08 16:53:58,177,4089,90,87,2550.02,4592.00,0.00
2024-12-08 16:53:58,178,4089,90,88,2535.69,4592.01,0.00
2024-12-08 16:53:58,177,4089,90,87,2548.77,4592.03,0.00
2024-12-08 16:53:58,176,4089,90,86,2551.18,4592.09,0.00
2024-12-08 16:53:58,175,4089,90,85,2554.70,4592.33,0.00
2024-12-08 16:53:58,174,4089,89,85,2566.47,4592.38,0.00
2024-12-08 16:53:58,174,4090,89,85,2559.14,4593.00,0.00
2024-12-08 16:53:58,175,4090,90,85,2544.52,4593.01,0.00
2024-12-08 16:53:58,176,4089,91,85,2529.55,4593.03,0.00
2024-12-08 16:53:58,175,4089,90,85,2551.36,4593.05,0.00
2024-12-08 16:53:58,174,4089,90,84,2554.24,4593.09,0.00
2024-12-08 16:53:58,175,4088,91,84,2531.05,4593.29,0.00
2024-12-08 16:53:58,175,4089,91,84,2535.12,4594.00,0.00
2024-12-08 16:53:58,176,4089,91,85,2520.71,4594.01,0.00
2024-12-08 16:53:58,177,4088,91,86,2462.30,4594.75,0.00
2024-12-08 16:53:58,177,4089,91,86,2524.35,4595.00,0.00
2024-12-08 16:53:58,178,4089,92,86,2510.17,4595.01,0.00
2024-12-08 16:53:58,177,4089,91,86,2520.16,4595.07,0.00
2024-12-08 16:53:58,176,4089,91,85,2532.13,4595.07,0.00
2024-12-08 16:53:58,175,4089,91,84,2546.08,4595.08,0.00
2024-12-08 16:53:58,175,4090,91,84,2543.45,4596.00,0.00
2024-12-08 16:53:58,176,4090,91,85,2529.00,4596.01,0.00
2024-12-08 16:53:58,175,4090,91,84,2539.81,4596.08,0.00
2024-12-08 16:53:58,175,4091,91,84,2510.51,4597.00,0.00
2024-12-08 16:53:58,176,4091,91,85,2496.25,4597.01,0.00
2024-12-08 16:53:58,175,4091,91,84,2505.57,4597.09,0.00
2024-12-08 16:53:58,174,4091,90,84,2489.48,4597.60,0.00
2024-12-08 16:53:58,174,4092,90,84,2494.84,4598.00,0.00
2024-12-08 16:53:58,175,4092,91,84,2480.59,4598.01,0.00
2024-12-08 16:53:58,174,4092,91,83,2489.87,4598.09,0.00
2024-12-08 16:53:58,175,4091,91,84,2441.30,4598.59,0.00
2024-12-08 16:53:58,175,4092,91,84,2455.72,4599.00,0.00
2024-12-08 16:53:58,176,4092,91,85,2441.77,4599.01,0.00
2024-12-08 16:53:58,175,4092,90,85,2445.78,4599.10,0.00
2024-12-08 16:53:58,174,4092,89,85,2453.67,4599.15,0.00
2024-12-08 16:53:58,173,4092,88,85,2441.29,4599.69,0.00
2024-12-08 16:53:58,173,4093,88,85,2476.34,4600.00,0.00
2024-12-08 16:53:58,174,4093,88,86,2462.10,4600.01,0.00
2024-12-08 16:53:58,173,4093,87,86,2457.30,4600.30,0.00
2024-12-08 16:53:58,172,4093,86,86,2459.17,4600.33,0.00
2024-12-08 16:53:58,172,4094,86,86,2450.61,4601.00,0.00
2024-12-08 16:53:58,173,4094,86,87,2436.45,4601.01,0.00
2024-12-08 16:53:58,172,4094,86,86,2443.17,4601.09,0.00
2024-12-08 16:53:58,171,4094,85,86,2441.17,4601.28,0.00
2024-12-08 16:53:58,170,4094,85,85,2425.44,4601.77,0.00
2024-12-08 16:53:59,170,4095,85,85,2442.13,4602.00,0.00
2024-12-08 16:53:59,171,4095,86,85,2427.85,4602.01,0.00
2024-12-08 16:53:59,172,4094,87,85,2413.73,4602.02,0.00
2024-12-08 16:53:59,171,4094,87,84,2446.83,4602.11,0.00
2024-12-08 16:53:59,170,4094,86,84,2451.66,4602.20,0.00
2024-12-08 16:53:59,170,4095,86,84,2436.85,4603.00,0.00
2024-12-08 16:53:59,171,4095,87,84,2422.60,4603.01,0.00
2024-12-08 16:53:59,170,4095,86,84,2416.89,4603.29,0.00
2024-12-08 16:53:59,169,4095,85,84,2426.87,4603.39,0.00
2024-12-08 16:53:59,168,4095,85,83,2418.01,4603.67,0.00
2024-12-08 16:53:59,169,4094,85,84,2399.41,4603.77,0.00
2024-12-08 16:53:59,168,4094,84,84,2420.17,4603.79,0.00
2024-12-08 16:53:59,168,4095,84,84,2465.28,4604.00,0.00
2024-12-08 16:53:59,169,4095,85,84,2450.69,4604.01,0.00
2024-12-08 16:53:59,168,4095,85,83,2457.64,4604.08,0.00
2024-12-08 16:53:59,167,4095,84,83,2449.03,4604.46,0.00
2024-12-08 16:53:59,167,4096,84,83,2479.16,4605.00,0.00
2024-12-08 16:53:59,168,4096,85,83,2464.40,4605.01,0.00
2024-12-08 16:53:59,167,4096,85,82,2471.33,4605.11,0.00
2024-12-08 16:53:59,166,4096,84,82,2465.48,4605.36,0.00
2024-12-08 16:53:59,166,4097,84,82,2462.19,4606.00,0.00
2024-12-08 16:53:59,167,4097,84,83,2447.45,4606.01,0.00
2024-12-08 16:53:59,166,4097,84,82,2454.22,4606.11,0.00
2024-12-08 16:53:59,167,4096,84,83,2437.05,4606.18,0.00
2024-12-08 16:53:59,166,4096,83,83,2466.24,4606.40,0.00
2024-12-08 16:53:59,167,4095,84,83,2429.94,4606.83,0.00
2024-12-08 16:53:59,167,4096,84,83,2452.77,4607.00,0.00
2024-12-08 16:53:59,168,4096,84,84,2438.17,4607.01,0.00
2024-12-08 16:53:59,167,4096,84,83,2444.70,4607.11,0.00
2024-12-08 16:53:59,168,4095,85,83,2418.71,4607.38,0.00
2024-12-08 16:53:59,167,4095,84,83,2418.45,4607.80,0.00
2024-12-08 16:53:59,167,4096,84,83,2492.00,4608.00,0.00
2024-12-08 16:53:59,168,4096,84,84,2477.16,4608.01,0.00
2024-12-08 16:53:59,167,4096,83,84,2486.91,4608.10,0.00
2024-12-08 16:53:59,166,4096,83,83,2499.67,4608.11,0.00
2024-12-08 16:53:59,166,4097,83,83,2501.25,4609.00,0.00
2024-12-08 16:53:59,167,4097,84,83,2486.27,4609.01,0.00
2024-12-08 16:53:59,168,4096,85,83,2432.20,4609.66,0.00
2024-12-08 16:53:59,168,4097,85,83,2452.28,4610.00,0.00
2024-12-08 16:53:59,169,4097,86,83,2437.77,4610.01,0.00
2024-12-08 16:53:59,168,4097,85,83,2450.11,4610.05,0.00
2024-12-08 16:53:59,168,4098,85,83,2447.45,4611.00,0.00
2024-12-08 16:53:59,169,4098,85,84,2432.97,4611.01,0.00
2024-12-08 16:53:59,168,4098,84,84,2410.45,4611.68,0.00
2024-12-08 16:53:59,168,4099,84,84,2413.76,4612.00,0.00
2024-12-08 16:53:59,169,4099,85,84,2399.48,4612.01,0.00
2024-12-08 16:53:59,168,4099,84,84,2409.14,4612.10,0.00
2024-12-08 16:53:59,167,4099,84,83,2420.26,4612.11,0.00
2024-12-08 16:53:59,167,4100,84,83,2395.95,4613.00,0.00
2024-12-08 16:53:59,168,4100,84,84,2381.68,4613.01,0.00
2024-12-08 16:53:59,167,4100,84,83,2390.75,4613.11,0.00
2024-12-08 16:53:59,168,4099,84,84,2341.81,4613.63,0.00
2024-12-08 16:53:59,168,4100,84,84,2353.34,4614.00,0.00
2024-12-08 16:53:59,169,4100,84,85,2339.42,4614.01,0.00
2024-12-08 16:53:59,168,4100,84,84,2347.15,4614.11,0.00
2024-12-08 16:53:59,169,4099,85,84,2332.18,4614.15,0.00
2024-12-08 16:53:59,168,4099,85,83,2349.22,4614.35,0.00
2024-12-08 16:53:59,167,4099,84,83,2343.32,4614.63,0.00
2024-12-08 16:53:59,168,4098,85,83,2317.47,4614.90,0.00
2024-12-08 16:53:59,168,4099,85,83,2370.84,4615.00,0.00
2024-12-08 16:53:59,169,4099,86,83,2356.81,4615.01,0.00
2024-12-08 16:53:59,170,4098,87,83,2336.88,4615.12,0.00
2024-12-08 16:53:59,169,4098,87,82,2376.66,4615.12,0.00
2024-12-08 16:53:59,168,4098,86,82,2371.63,4615.34,0.00
2024-12-08 16:53:59,167,4098,85,82,2357.60,4615.95,0.00
2024-12-08 16:53:59,167,4099,85,82,2438.07,4616.00,0.00
2024-12-08 16:53:59,168,4099,86,82,2423.55,4616.01,0.00
2024-12-08 16:53:59,169,4098,87,82,2380.13,4616.46,0.00
2024-12-08 16:53:59,170,4097,87,83,2369.21,4616.75,0.00
2024-12-08 16:53:59,169,4097,86,83,2390.37,4616.76,0.00
2024-12-08 16:53:59,169,4098,86,83,2434.28,4617.00,0.00
2024-12-08 16:53:59,170,4098,86,84,2419.96,4617.01,0.00
2024-12-08 16:53:59,171,4097,86,85,2364.71,4617.77,0.00
2024-12-08 16:53:59,171,4098,86,85,2437.67,4618.00,0.00
2024-12-08 16:53:59,172,4098,87,85,2423.50,4618.01,0.00
2024-12-08 16:53:59,171,4098,87,84,2426.92,4618.12,0.00
2024-12-08 16:53:59,170,4098,86,84,2426.61,4618.43,0.00
2024-12-08 16:53:59,171,4097,86,85,2400.24,4618.68,0.00
2024-12-08 16:53:59,171,4098,86,85,2442.31,4619.00,0.00
2024-12-08 16:53:59,172,4098,86,86,2428.11,4619.01,0.00
2024-12-08 16:53:59,171,4098,85,86,2425.10,4619.26,0.00
2024-12-08 16:53:59,172,4097,86,86,2405.26,4619.37,0.00
2024-12-08 16:54:00,172,4098,86,86,2436.03,4620.00,0.00
2024-12-08 16:54:00,173,4098,87,86,2421.95,4620.01,0.00
2024-12-08 16:54:00,172,4098,87,85,2429.25,4620.11,0.00
2024-12-08 16:54:00,171,4098,87,84,2442.65,4620.12,0.00
2024-12-08 16:54:00,170,4098,87,83,2456.75,4620.12,0.00
2024-12-08 16:54:00,170,4099,87,83,2455.47,4621.00,0.00
2024-12-08 16:54:00,171,4099,87,84,2441.11,4621.01,0.00
2024-12-08 16:54:00,171,4100,87,84,2409.84,4622.00,0.00
2024-12-08 16:54:00,172,4100,88,84,2395.83,4622.01,0.00
2024-12-08 16:54:00,171,4100,88,83,2397.73,4622.13,0.00
2024-12-08 16:54:00,170,4100,87,83,2411.57,4622.13,0.00
2024-12-08 16:54:00,169,4100,87,82,2425.56,4622.13,0.00
2024-12-08 16:54:00,168,4100,86,82,2437.95,4622.17,0.00
2024-12-08 16:54:00,168,4101,86,82,2419.42,4623.00,0.00
2024-12-08 16:54:00,169,4101,86,83,2405.10,4623.01,0.00
2024-12-08 16:54:00,168,4101,85,83,2417.78,4623.04,0.00
2024-12-08 16:54:00,167,4101,84,83,2421.15,4623.13,0.00
2024-12-08 16:54:00,167,4102,84,83,2397.09,4624.00,0.00
2024-12-08 16:54:00,168,4102,85,83,2382.83,4624.01,0.00
2024-12-08 16:54:00,167,4102,85,82,2383.93,4624.13,0.00
2024-12-08 16:54:00,166,4102,85,81,2394.35,4624.22,0.00
2024-12-08 16:54:00,167,4101,85,82,2339.32,4624.80,0.00
2024-12-08 16:54:00,167,4102,85,82,2358.10,4625.00,0.00
2024-12-08 16:54:00,168,4102,86,82,2344.06,4625.01,0.00
2024-12-08 16:54:00,167,4102,85,82,2355.08,4625.07,0.00
2024-12-08 16:54:00,166,4102,85,81,2362.74,4625.11,0.00
2024-12-08 16:54:00,165,4102,85,80,2376.23,4625.12,0.00
2024-12-08 16:54:00,164,4102,85,79,2384.08,4625.25,0.00
2024-12-08 16:54:00,163,4102,84,79,2387.09,4625.43,0.00
2024-12-08 16:54:00,163,4103,84,79,2404.13,4626.00,0.00
2024-12-08 16:54:00,164,4103,85,79,2389.47,4626.01,0.00
2024-12-08 16:54:00,163,4103,84,79,2398.65,4626.07,0.00
2024-12-08 16:54:00,162,4103,83,79,2411.20,4626.12,0.00
2024-12-08 16:54:00,161,4103,83,78,2425.02,4626.12,0.00
2024-12-08 16:54:00,161,4104,83,78,2395.15,4627.00,0.00
2024-12-08 16:54:00,162,4104,83,79,2380.36,4627.01,0.00
2024-12-08 16:54:00,161,4104,82,79,2383.37,4627.07,0.00
2024-12-08 16:54:00,160,4104,81,79,2376.82,4627.34,0.00
2024-12-08 16:54:00,161,4103,82,79,2358.95,4627.40,0.00
2024-12-08 16:54:00,161,4104,82,79,2376.03,4628.00,0.00
2024-12-08 16:54:00,162,4104,82,80,2361.36,4628.01,0.00
2024-12-08 16:54:00,161,4104,81,80,2370.90,4628.11,0.00
2024-12-08 16:54:00,160,4104,81,79,2381.38,4628.11,0.00
2024-12-08 16:54:00,160,4105,81,79,2381.45,4629.00,0.00
2024-12-08 16:54:00,161,4105,82,79,2366.66,4629.01,0.00
2024-12-08 16:54:00,162,4104,83,79,2347.80,4629.11,0.00
2024-12-08 16:54:00,161,4104,82,79,2330.24,4629.66,0.00
2024-12-08 16:54:00,161,4105,82,79,2340.70,4630.00,0.00
2024-12-08 16:54:00,162,4105,83,79,2326.26,4630.01,0.00
2024-12-08 16:54:00,161,4105,83,78,2335.29,4630.12,0.00
2024-12-08 16:54:00,160,4105,82,78,2309.36,4630.88,0.00
2024-12-08 16:54:00,160,4106,82,78,2349.98,4631.00,0.00
2024-12-08 16:54:00,161,4106,82,79,2335.38,4631.01,0.00
2024-12-08 16:54:00,162,4105,83,79,2320.12,4631.04,0.00
2024-12-08 16:54:00,161,4105,83,78,2346.08,4631.12,0.00
2024-12-08 16:54:00,160,4105,83,77,2347.20,4631.33,0.00
2024-12-08 16:54:00,161,4104,83,78,2309.14,4631.60,0.00
2024-12-08 16:54:00,162,4103,84,78,2297.29,4631.70,0.00
2024-12-08 16:54:00,163,4102,84,79,2289.22,4631.78,0.00
2024-12-08 16:54:00,163,4103,84,79,2314.40,4632.00,0.00
2024-12-08 16:54:00,164,4103,85,79,2300.29,4632.01,0.00
2024-12-08 16:54:00,163,4103,85,78,2307.91,4632.12,0.00
2024-12-08 16:54:00,164,4102,86,78,2265.47,4632.68,0.00
2024-12-08 16:54:00,164,4103,86,78,2380.68,4633.00,0.00
2024-12-08 16:54:00,165,4103,87,78,2366.26,4633.01,0.00
2024-12-08 16:54:00,164,4103,86,78,2373.65,4633.06,0.00
2024-12-08 16:54:00,163,4103,86,77,2384.25,4633.12,0.00
2024-12-08 16:54:00,164,4102,86,78,2343.23,4633.62,0.00
2024-12-08 16:54:00,164,4102,86,78,2393.53,4634.00,0.00
2024-12-08 16:54:00,165,4102,87,78,2379.02,4634.01,0.00
2024-12-08 16:54:00,164,4102,86,78,2388.49,4634.11,0.00
2024-12-08 16:54:00,163,4102,86,77,2401.72,4634.12,0.00
2024-12-08 16:54:00,162,4102,85,77,2399.26,4634.44,0.00
2024-12-08 16:54:00,162,4103,85,77,2419.38,4635.00,0.00
2024-12-08 16:54:00,163,4103,85,78,2404.54,4635.01,0.00
2024-12-08 16:54:00,162,4103,85,77,2410.55,4635.12,0.00
2024-12-08 16:54:00,161,4103,84,77,2422.44,4635.18,0.00
2024-12-08 16:54:00,160,4103,83,77,2437.39,4635.18,0.00
2024-12-08 16:54:00,159,4103,82,77,2437.31,4635.33,0.00
2024-12-08 16:54:00,159,4104,82,77,2435.70,4636.00,0.00
2024-12-08 16:54:00,160,4104,82,78,2420.47,4636.01,0.00
2024-12-08 16:54:00,159,4104,81,78,2423.79,4636.10,0.00
2024-12-08 16:54:00,158,4104,81,77,2437.37,4636.11,0.00
2024-12-08 16:54:00,159,4103,81,78,2413.63,4636.31,0.00
2024-12-08 16:54:00,160,4102,81,79,2373.79,4636.66,0.00
2024-12-08 16:54:00,160,4103,81,79,2410.05,4637.00,0.00
2024-12-08 16:54:00,161,4103,81,80,2395.09,4637.01,0.00
2024-12-08 16:54:00,160,4103,80,80,2404.59,4637.12,0.00
2024-12-08 16:54:00,159,4103,80,79,2417.96,4637.12,0.00
2024-12-08 16:54:00,158,4103,80,78,2431.06,4637.17,0.00
2024-12-08 16:54:00,157,4103,79,78,2427.99,4637.36,0.00
2024-12-08 16:54:00,156,4103,78,78,2440.31,4637.42,0.00
2024-12-08 16:54:00,157,4102,79,78,2424.77,4637.43,0.00
2024-12-08 16:54:00,158,4101,80,78,2416.60,4637.65,0.00
2024-12-08 16:54:00,158,4102,80,78,2498.46,4638.00,0.00
2024-12-08 16:54:00,159,4102,80,79,2482.75,4638.01,0.00
2024-12-08 16:54:01,158,4102,79,79,2482.04,4638.06,0.00
2024-12-08 16:54:01,157,4102,79,78,2493.15,4638.12,0.00
2024-12-08 16:54:01,157,4103,79,78,2529.69,4639.00,0.00
2024-12-08 16:54:01,158,4103,80,78,2513.68,4639.01,0.00
2024-12-08 16:54:01,157,4103,79,78,2522.34,4639.10,0.00
2024-12-08 16:54:01,156,4103,79,77,2534.35,4639.12,0.00
2024-12-08 16:54:01,155,4103,78,77,2549.97,4639.14,0.00
2024-12-08 16:54:01,154,4103,77,77,2557.72,4639.33,0.00
2024-12-08 16:54:01,154,4104,77,77,2556.97,4640.00,0.00
2024-12-08 16:54:01,155,4104,77,78,2540.47,4640.01,0.00
2024-12-08 16:54:01,154,4104,76,78,2552.19,4640.10,0.00
2024-12-08 16:54:01,153,4104,76,77,2565.53,4640.12,0.00
2024-12-08 16:54:01,152,4104,75,77,2576.93,4640.15,0.00
2024-12-08 16:54:01,152,4105,75,77,2568.27,4641.00,0.00
2024-12-08 16:54:01,153,4105,76,77,2551.49,4641.01,0.00
2024-12-08 16:54:01,152,4105,76,76,2560.68,4641.12,0.00
2024-12-08 16:54:01,151,4105,75,76,2564.82,4641.39,0.00
2024-12-08 16:54:01,150,4105,74,76,2569.71,4641.46,0.00
2024-12-08 16:54:01,150,4106,74,76,2575.98,4642.00,0.00
2024-12-08 16:54:01,151,4106,75,76,2558.92,4642.01,0.00
2024-12-08 16:54:01,150,4106,75,75,2567.05,4642.13,0.00
2024-12-08 16:54:01,151,4105,75,76,2544.24,4642.27,0.00
2024-12-08 16:54:01,150,4105,75,75,2572.06,4642.33,0.00
2024-12-08 16:54:01,149,4105,74,75,2558.00,4642.75,0.00
2024-12-08 16:54:01,149,4106,74,75,2577.52,4643.00,0.00
2024-12-08 16:54:01,150,4106,75,75,2560.34,4643.01,0.00
2024-12-08 16:54:01,149,4106,74,75,2575.36,4643.05,0.00
2024-12-08 16:54:01,150,4105,75,75,2556.04,4643.11,0.00
2024-12-08 16:54:01,149,4105,75,74,2593.15,4643.13,0.00
2024-12-08 16:54:01,149,4106,75,74,2603.01,4644.00,0.00
2024-12-08 16:54:01,150,4106,75,75,2585.66,4644.01,0.00
2024-12-08 16:54:01,149,4106,75,74,2598.21,4644.11,0.00
2024-12-08 16:54:01,149,4107,75,74,2603.15,4645.00,0.00
2024-12-08 16:54:01,150,4107,76,74,2585.79,4645.01,0.00
2024-12-08 16:54:01,149,4107,76,73,2592.91,4645.12,0.00
2024-12-08 16:54:01,148,4107,75,73,2598.83,4645.35,0.00
2024-12-08 16:54:01,148,4108,75,73,2600.53,4646.00,0.00
2024-12-08 16:54:01,149,4108,75,74,2583.07,4646.01,0.00
2024-12-08 16:54:01,148,4108,75,73,2592.41,4646.12,0.00
2024-12-08 16:54:01,147,4108,74,73,2592.08,4646.31,0.00
2024-12-08 16:54:01,146,4108,73,73,2607.00,4646.37,0.00
2024-12-08 16:54:01,146,4109,73,73,2609.98,4647.00,0.00
2024-12-08 16:54:01,147,4109,73,74,2592.23,4647.01,0.00
2024-12-08 16:54:01,146,4109,72,74,2602.39,4647.12,0.00
2024-12-08 16:54:01,146,4110,72,74,2587.30,4648.00,0.00
2024-12-08 16:54:01,147,4110,73,74,2569.70,4648.01,0.00
2024-12-08 16:54:01,146,4110,73,73,2585.09,4648.05,0.00
2024-12-08 16:54:01,145,4110,73,72,2598.46,4648.12,0.00
2024-12-08 16:54:01,144,4110,72,72,2573.89,4648.77,0.00
2024-12-08 16:54:01,144,4111,72,72,2595.71,4649.00,0.00
2024-12-08 16:54:01,145,4111,72,73,2577.81,4649.01,0.00
2024-12-08 16:54:01,144,4111,72,72,2586.40,4649.13,0.00
2024-12-08 16:54:01,145,4110,73,72,2555.52,4649.43,0.00
2024-12-08 16:54:01,145,4111,73,72,2553.36,4650.00,0.00
2024-12-08 16:54:01,146,4111,73,73,2535.87,4650.01,0.00
2024-12-08 16:54:01,145,4111,73,72,2544.10,4650.13,0.00
2024-12-08 16:54:01,146,4110,73,73,2514.35,4650.41,0.00
2024-12-08 16:54:01,147,4109,74,73,2511.53,4650.50,0.00
2024-12-08 16:54:01,146,4109,73,73,2516.20,4650.84,0.00
2024-12-08 16:54:01,146,4110,73,73,2572.41,4651.00,0.00
2024-12-08 16:54:01,147,4110,74,73,2554.91,4651.01,0.00
2024-12-08 16:54:01,146,4110,73,73,2565.76,4651.12,0.00
2024-12-08 16:54:01,145,4110,73,72,2579.61,4651.13,0.00
2024-12-08 16:54:01,146,4109,73,73,2540.49,4651.61,0.00
2024-12-08 16:54:01,146,4110,73,73,2632.32,4652.00,0.00
2024-12-08 16:54:01,147,4110,73,74,2614.42,4652.01,0.00
2024-12-08 16:54:01,146,4110,73,73,2623.45,4652.13,0.00
2024-12-08 16:54:01,146,4111,73,73,2634.48,4653.00,0.00
2024-12-08 16:54:01,147,4111,73,74,2616.56,4653.01,0.00
2024-12-08 16:54:01,148,4110,74,74,2562.56,4653.60,0.00
2024-12-08 16:54:01,148,4111,74,74,2587.71,4654.00,0.00
2024-12-08 16:54:01,149,4111,75,74,2570.35,4654.01,0.00
2024-12-08 16:54:01,150,4110,75,75,2532.21,4654.34,0.00
2024-12-08 16:54:01,150,4111,75,75,2578.68,4655.00,0.00
2024-12-08 16:54:01,151,4111,75,76,2561.60,4655.01,0.00
2024-12-08 16:54:01,152,4110,75,77,2543.83,4655.04,0.00
2024-12-08 16:54:01,153,4109,75,78,2532.69,4655.09,0.00
2024-12-08 16:54:01,152,4109,74,78,2559.49,4655.12,0.00
2024-12-08 16:54:01,151,4109,73,78,2557.11,4655.40,0.00
2024-12-08 16:54:01,151,4110,73,78,2582.32,4656.00,0.00
2024-12-08 16:54:01,152,4110,73,79,2565.33,4656.01,0.00
2024-12-08 16:54:01,151,4110,73,78,2570.03,4656.13,0.00
2024-12-08 16:54:01,152,4109,73,79,2549.15,4656.23,0.00
2024-12-08 16:54:01,152,4110,73,79,2618.88,4657.00,0.00
2024-12-08 16:54:01,153,4110,74,79,2601.77,4657.01,0.00
2024-12-08 16:54:01,152,4110,74,78,2610.65,4657.14,0.00
2024-12-08 16:54:01,151,4110,73,78,2618.71,4657.22,0.00
2024-12-08 16:54:01,152,4109,74,78,2590.54,4657.45,0.00
2024-12-08 16:54:01,152,4110,74,78,2654.67,4658.00,0.00
2024-12-08 16:54:01,153,4110,75,78,2637.32,4658.01,0.00
2024-12-08 16:54:01,152,4110,74,78,2652.18,4658.05,0.00
2024-12-08 16:54:01,151,4110,74,77,2663.91,4658.13,0.00
2024-12-08 16:54:01,152,4109,75,77,2624.87,4658.59,0.00
2024-12-08 16:54:01,152,4110,75,77,2666.87,4659.00,0.00
2024-12-08 16:54:01,153,4110,75,78,2649.44,4659.01,0.00
2024-12-08 16:54:01,152,4110,75,77,2658.29,4659.14,0.00
2024-12-08 16:54:01,151,4110,74,77,2673.42,4659.14,0.00
2024-12-08 16:54:02,151,4111,74,77,2693.82,4660.00,0.00
2024-12-08 16:54:02,152,4111,74,78,2676.09,4660.01,0.00
2024-12-08 16:54:02,151,4111,73,78,2690.65,4660.07,0.00
2024-12-08 16:54:02,150,4111,72,78,2706.74,4660.10,0.00
2024-12-08 16:54:02,149,4111,71,78,2697.80,4660.29,0.00
2024-12-08 16:54:02,149,4112,71,78,2696.41,4661.00,0.00
2024-12-08 16:54:02,150,4112,71,79,2678.43,4661.01,0.00
2024-12-08 16:54:02,149,4112,70,79,2695.68,4661.01,0.00
2024-12-08 16:54:02,148,4112,70,78,2704.17,4661.13,0.00
2024-12-08 16:54:02,149,4111,71,78,2637.94,4661.86,0.00
2024-12-08 16:54:02,149,4112,71,78,2666.23,4662.00,0.00
2024-12-08 16:54:02,150,4112,71,79,2648.46,4662.01,0.00
2024-12-08 16:54:02,149,4112,71,78,2661.89,4662.09,0.00
2024-12-08 16:54:02,148,4112,70,78,2679.56,4662.10,0.00
2024-12-08 16:54:02,147,4112,70,77,2694.31,4662.12,0.00
2024-12-08 16:54:02,146,4112,70,76,2706.53,4662.25,0.00
2024-12-08 16:54:02,146,4113,70,76,2722.99,4663.00,0.00
2024-12-08 16:54:02,147,4113,71,76,2704.47,4663.01,0.00
2024-12-08 16:54:02,146,4113,71,75,2718.56,4663.10,0.00
2024-12-08 16:54:02,145,4113,70,75,2728.00,4663.15,0.00
2024-12-08 16:54:02,144,4113,69,75,2737.25,4663.20,0.00
2024-12-08 16:54:02,145,4112,70,75,2695.80,4663.70,0.00
2024-12-08 16:54:02,146,4111,70,76,2673.40,4663.98,0.00
2024-12-08 16:54:02,146,4112,70,76,2705.05,4664.00,0.00
2024-12-08 16:54:02,147,4112,70,77,2686.65,4664.01,0.00
2024-12-08 16:54:02,147,4113,70,77,2716.88,4665.00,0.00
2024-12-08 16:54:02,148,4113,70,78,2698.53,4665.01,0.00
2024-12-08 16:54:02,149,4112,71,78,2676.38,4665.11,0.00
2024-12-08 16:54:02,148,4112,71,77,2697.94,4665.12,0.00
2024-12-08 16:54:02,148,4113,71,77,2675.47,4666.00,0.00
2024-12-08 16:54:02,149,4113,72,77,2657.52,4666.01,0.00
2024-12-08 16:54:02,148,4113,71,77,2674.51,4666.03,0.00
2024-12-08 16:54:02,147,4113,70,77,2682.90,4666.10,0.00
2024-12-08 16:54:02,148,4112,70,78,2629.22,4666.85,0.00
2024-12-08 16:54:02,148,4113,70,78,2686.70,4667.00,0.00
2024-12-08 16:54:02,149,4113,71,78,2668.67,4667.01,0.00
2024-12-08 16:54:02,148,4113,70,78,2685.45,4667.03,0.00
2024-12-08 16:54:02,149,4112,71,78,2630.89,4667.67,0.00
2024-12-08 16:54:02,149,4113,71,78,2683.98,4668.00,0.00
2024-12-08 16:54:02,150,4113,71,79,2666.08,4668.01,0.00
2024-12-08 16:54:02,149,4113,71,78,2673.67,4668.09,0.00
2024-12-08 16:54:02,149,4114,71,78,2686.73,4669.00,0.00
2024-12-08 16:54:02,150,4114,72,78,2668.81,4669.01,0.00
2024-12-08 16:54:02,149,4114,71,78,2685.17,4669.03,0.00
2024-12-08 16:54:02,149,4115,71,78,2653.49,4670.00,0.00
2024-12-08 16:54:02,150,4115,72,78,2635.80,4670.01,0.00
2024-12-08 16:54:02,149,4115,72,77,2645.37,4670.07,0.00
2024-12-08 16:54:02,148,4115,72,76,2662.93,4670.07,0.00
2024-12-08 16:54:02,149,4114,72,77,2640.58,4670.16,0.00
2024-12-08 16:54:02,148,4114,71,77,2675.55,4670.35,0.00
2024-12-08 16:54:02,149,4113,72,77,2632.24,4670.91,0.00
2024-12-08 16:54:02,149,4114,72,77,2649.55,4671.00,0.00
2024-12-08 16:54:02,150,4114,72,78,2631.89,4671.01,0.00
2024-12-08 16:54:02,149,4114,71,78,2648.45,4671.03,0.00
2024-12-08 16:54:02,148,4114,71,77,2664.15,4671.07,0.00
2024-12-08 16:54:02,148,4115,71,77,2702.23,4672.00,0.00
2024-12-08 16:54:02,149,4115,72,77,2684.09,4672.01,0.00
2024-12-08 16:54:02,150,4114,72,78,2617.77,4672.85,0.00
2024-12-08 16:54:02,150,4115,72,78,2646.24,4673.00,0.00
2024-12-08 16:54:02,151,4115,73,78,2628.71,4673.01,0.00
2024-12-08 16:54:02,152,4114,74,78,2597.33,4673.18,0.00
2024-12-08 16:54:02,153,4113,74,79,2579.20,4673.37,0.00
2024-12-08 16:54:02,153,4114,74,79,2612.92,4674.00,0.00
2024-12-08 16:54:02,154,4114,74,80,2595.96,4674.01,0.00
2024-12-08 16:54:02,155,4113,74,81,2536.97,4674.80,0.00
2024-12-08 16:54:02,155,4114,74,81,2614.74,4675.00,0.00
2024-12-08 16:54:02,156,4114,74,82,2597.98,4675.01,0.00
2024-12-08 16:54:02,156,4115,74,82,2593.85,4676.00,0.00
2024-12-08 16:54:02,157,4115,75,82,2577.32,4676.01,0.00
2024-12-08 16:54:02,158,4114,76,82,2560.72,4676.03,0.00
2024-12-08 16:54:02,157,4114,76,81,2599.10,4676.07,0.00
2024-12-08 16:54:02,156,4114,76,80,2615.46,4676.07,0.00
2024-12-08 16:54:02,155,4114,75,80,2581.73,4676.97,0.00
2024-12-08 16:54:02,155,4115,75,80,2610.42,4677.00,0.00
2024-12-08 16:54:02,156,4115,76,80,2593.68,4677.01,0.00
2024-12-08 16:54:02,155,4115,75,80,2607.43,4677.06,0.00
2024-12-08 16:54:02,155,4116,75,80,2607.74,4678.00,0.00
2024-12-08 16:54:02,156,4116,75,81,2591.03,4678.01,0.00
2024-12-08 16:54:02,155,4116,75,80,2600.66,4678.06,0.00
2024-12-08 16:54:02,155,4117,75,80,2574.59,4679.00,0.00
2024-12-08 16:54:02,156,4117,76,80,2558.09,4679.01,0.00
2024-12-08 16:54:02,155,4117,76,79,2571.30,4679.06,0.00
2024-12-08 16:54:02,154,4117,75,79,2572.28,4679.38,0.00
2024-12-08 16:54:02,153,4117,74,79,2572.89,4679.58,0.00
2024-12-08 16:54:02,154,4116,75,79,2550.79,4679.71,0.00
2024-12-08 16:54:02,154,4117,75,79,2575.63,4680.00,0.00
2024-12-08 16:54:02,155,4117,75,80,2559.02,4680.01,0.00
2024-12-08 16:54:02,156,4116,76,80,2523.35,4680.29,0.00
2024-12-08 16:54:02,155,4116,75,80,2555.98,4680.39,0.00
2024-12-08 16:54:02,156,4115,76,80,2536.92,4680.46,0.00
2024-12-08 16:54:03,156,4116,76,80,2588.60,4681.00,0.00
2024-12-08 16:54:03,157,4116,77,80,2572.11,4681.01,0.00
2024-12-08 16:54:03,156,4116,77,79,2580.52,4681.06,0.00
2024-12-08 16:54:03,155,4116,76,79,2568.42,4681.54,0.00
2024-12-08 16:54:03,156,4115,77,79,2550.47,4681.58,0.00
2024-12-08 16:54:03,157,4114,77,80,2530.59,4681.92,0.00
2024-12-08 16:54:03,157,4115,77,80,2617.37,4682.00,0.00
2024-12-08 16:54:03,158,4115,77,81,2600.81,4682.01,0.00
2024-12-08 16:54:03,157,4115,76,81,2614.54,4682.06,0.00
2024-12-08 16:54:03,156,4115,76,80,2631.00,4682.06,0.00
2024-12-08 16:54:03,155,4115,75,80,2634.64,4682.32,0.00
2024-12-08 16:54:03,155,4116,75,80,2679.83,4683.00,0.00
2024-12-08 16:54:03,156,4116,75,81,2662.65,4683.01,0.00
2024-12-08 16:54:03,155,4116,75,80,2664.75,4683.06,0.00
2024-12-08 16:54:03,156,4115,75,81,2612.28,4683.81,0.00
2024-12-08 16:54:03,156,4116,75,81,2660.08,4684.00,0.00
2024-12-08 16:54:03,157,4116,76,81,2643.14,4684.01,0.00
2024-12-08 16:54:03,158,4115,76,82,2615.68,4684.11,0.00
2024-12-08 16:54:03,157,4115,75,82,2648.19,4684.19,0.00
2024-12-08 16:54:03,158,4114,75,83,2596.39,4684.70,0.00
2024-12-08 16:54:03,158,4115,75,83,2640.81,4685.00,0.00
2024-12-08 16:54:03,159,4115,75,84,2624.20,4685.01,0.00
2024-12-08 16:54:03,158,4115,74,84,2617.46,4685.35,0.00
2024-12-08 16:54:03,157,4115,73,84,2610.69,4685.75,0.00
2024-12-08 16:54:03,157,4116,73,84,2656.73,4686.00,0.00
2024-12-08 16:54:03,158,4116,73,85,2639.92,4686.01,0.00
2024-12-08 16:54:03,157,4116,73,84,2652.28,4686.06,0.00
2024-12-08 16:54:03,156,4116,72,84,2630.22,4686.64,0.00
2024-12-08 16:54:03,155,4116,71,84,2615.44,4686.95,0.00
2024-12-08 16:54:03,155,4117,71,84,2630.68,4687.00,0.00
2024-12-08 16:54:03,156,4117,71,85,2613.81,4687.01,0.00
2024-12-08 16:54:03,155,4117,71,84,2620.47,4687.08,0.00
2024-12-08 16:54:03,154,4117,71,83,2604.09,4687.53,0.00
2024-12-08 16:54:03,155,4116,71,84,2581.31,4687.67,0.00
2024-12-08 16:54:03,155,4117,71,84,2600.54,4688.00,0.00
2024-12-08 16:54:03,156,4117,72,84,2583.87,4688.01,0.00
2024-12-08 16:54:03,155,4117,72,83,2548.10,4688.89,0.00
2024-12-08 16:54:03,155,4118,72,83,2598.78,4689.00,0.00
2024-12-08 16:54:03,156,4118,72,84,2582.12,4689.01,0.00
2024-12-08 16:54:03,156,4119,72,84,2550.37,4690.00,0.00
2024-12-08 16:54:03,157,4119,72,85,2534.13,4690.01,0.00
2024-12-08 16:54:03,156,4119,72,84,2541.37,4690.06,0.00
2024-12-08 16:54:03,155,4119,72,83,2557.00,4690.07,0.00
2024-12-08 16:54:03,154,4119,71,83,2557.94,4690.38,0.00
2024-12-08 16:54:03,154,4120,71,83,2547.70,4691.00,0.00
2024-12-08 16:54:03,155,4120,72,83,2531.27,4691.01,0.00
2024-12-08 16:54:03,156,4119,73,83,2474.38,4691.69,0.00
2024-12-08 16:54:03,156,4120,73,83,2498.38,4692.00,0.00
2024-12-08 16:54:03,157,4120,73,84,2482.47,4692.01,0.00
2024-12-08 16:54:03,157,4121,73,84,2485.50,4693.00,0.00
2024-12-08 16:54:03,158,4121,74,84,2469.77,4693.01,0.00
2024-12-08 16:54:03,159,4120,74,85,2443.05,4693.13,0.00
2024-12-08 16:54:03,158,4120,73,85,2472.89,4693.20,0.00
2024-12-08 16:54:03,158,4121,73,85,2459.09,4694.00,0.00
2024-12-08 16:54:03,159,4121,73,86,2443.62,4694.01,0.00
2024-12-08 16:54:03,158,4121,73,85,2449.01,4694.09,0.00
2024-12-08 16:54:03,157,4121,73,84,2464.31,4694.09,0.00
2024-12-08 16:54:03,156,4121,73,83,2473.49,4694.22,0.00
2024-12-08 16:54:03,157,4120,73,84,2450.91,4694.38,0.00
2024-12-08 16:54:03,157,4121,73,84,2475.81,4695.00,0.00
2024-12-08 16:54:03,158,4121,73,85,2460.14,4695.01,0.00
2024-12-08 16:54:03,157,4121,72,85,2473.10,4695.06,0.00
2024-12-08 16:54:03,156,4121,72,84,2485.94,4695.06,0.00
2024-12-08 16:54:03,155,4121,71,84,2467.81,4695.70,0.00
2024-12-08 16:54:03,155,4122,71,84,2501.67,4696.00,0.00
2024-12-08 16:54:03,156,4122,72,84,2485.64,4696.01,0.00
2024-12-08 16:54:03,155,4122,72,83,2498.06,4696.08,0.00
2024-12-08 16:54:03,154,4122,71,83,2511.23,4696.14,0.00
2024-12-08 16:54:03,155,4121,71,84,2484.20,4696.38,0.00
2024-12-08 16:54:03,154,4121,70,84,2482.34,4696.89,0.00
2024-12-08 16:54:03,154,4122,70,84,2507.23,4697.00,0.00
2024-12-08 16:54:03,155,4122,70,85,2491.05,4697.01,0.00
2024-12-08 16:54:03,154,4122,70,84,2503.59,4697.08,0.00
2024-12-08 16:54:03,155,4121,71,84,2476.25,4697.20,0.00
2024-12-08 16:54:03,156,4120,71,85,2480.29,4697.32,0.00
2024-12-08 16:54:03,156,4121,71,85,2526.09,4698.00,0.00
2024-12-08 16:54:03,157,4121,71,86,2510.00,4698.01,0.00
2024-12-08 16:54:03,156,4121,70,86,2523.40,4698.06,0.00
2024-12-08 16:54:03,155,4121,69,86,2538.77,4698.07,0.00
2024-12-08 16:54:03,155,4122,69,86,2575.15,4699.00,0.00
2024-12-08 16:54:03,156,4122,70,86,2558.64,4699.01,0.00
2024-12-08 16:54:03,155,4122,70,85,2565.47,4699.08,0.00
2024-12-08 16:54:03,155,4123,70,85,2544.88,4700.00,0.00
2024-12-08 16:54:03,156,4123,70,86,2528.57,4700.01,0.00
2024-12-08 16:54:03,155,4123,70,85,2535.20,4700.08,0.00
2024-12-08 16:54:03,156,4122,70,86,2496.77,4700.56,0.00
2024-12-08 16:54:03,155,4122,69,86,2504.61,4700.63,0.00
2024-12-08 16:54:03,155,4123,69,86,2515.91,4701.00,0.00
2024-12-08 16:54:03,156,4123,69,87,2499.78,4701.01,0.00
2024-12-08 16:54:03,155,4123,69,86,2508.95,4701.07,0.00
2024-12-08 16:54:03,154,4123,69,85,2524.94,4701.07,0.00
2024-12-08 16:54:03,153,4123,68,85,2520.59,4701.52,0.00
2024-12-08 16:54:04,153,4124,68,85,2544.95,4702.00,0.00
2024-12-08 16:54:04,154,4124,69,85,2528.42,4702.01,0.00
2024-12-08 16:54:04,153,4124,68,85,2544.64,4702.01,0.00
2024-12-08 16:54:04,152,4124,67,85,2544.66,4702.22,0.00
2024-12-08 16:54:04,152,4125,67,85,2510.75,4703.00,0.00
2024-12-08 16:54:04,153,4125,68,85,2494.34,4703.01,0.00
2024-12-08 16:54:04,152,4125,67,85,2507.48,4703.07,0.00
2024-12-08 16:54:04,151,4125,67,84,2519.41,4703.07,0.00
2024-12-08 16:54:04,150,4125,66,84,2520.95,4703.39,0.00
2024-12-08 16:54:04,149,4125,66,83,2524.28,4703.61,0.00
2024-12-08 16:54:04,149,4126,66,83,2522.26,4704.00,0.00
2024-12-08 16:54:04,150,4126,67,83,2505.45,4704.01,0.00
2024-12-08 16:54:04,149,4126,67,82,2517.56,4704.09,0.00
2024-12-08 16:54:04,148,4126,66,82,2515.56,4704.30,0.00
2024-12-08 16:54:04,148,4127,66,82,2511.98,4705.00,0.00
2024-12-08 16:54:04,149,4127,66,83,2495.12,4705.01,0.00
2024-12-08 16:54:04,148,4127,66,82,2507.23,4705.09,0.00
2024-12-08 16:54:04,147,4127,65,82,2509.67,4705.40,0.00
2024-12-08 16:54:04,148,4126,66,82,2482.66,4705.62,0.00
2024-12-08 16:54:04,149,4125,66,83,2475.82,4705.67,0.00
2024-12-08 16:54:04,149,4126,66,83,2486.75,4706.00,0.00
2024-12-08 16:54:04,150,4126,66,84,2470.17,4706.01,0.00
2024-12-08 16:54:04,149,4126,66,83,2482.98,4706.08,0.00
2024-12-08 16:54:04,148,4126,66,82,2496.90,4706.10,0.00
2024-12-08 16:54:04,147,4126,65,82,2462.17,4706.82,0.00
2024-12-08 16:54:04,147,4127,65,82,2543.14,4707.00,0.00
2024-12-08 16:54:04,148,4127,65,83,2525.96,4707.01,0.00
2024-12-08 16:54:04,147,4127,64,83,2542.62,4707.01,0.00
2024-12-08 16:54:04,146,4127,63,83,2558.76,4707.03,0.00
2024-12-08 16:54:04,145,4127,62,83,2574.47,4707.07,0.00
2024-12-08 16:54:04,144,4127,62,82,2591.69,4707.07,0.00
2024-12-08 16:54:04,145,4126,62,83,2535.60,4707.66,0.00
2024-12-08 16:54:04,144,4126,62,82,2557.07,4707.79,0.00
2024-12-08 16:54:04,144,4127,62,82,2558.02,4708.00,0.00
2024-12-08 16:54:04,145,4127,62,83,2540.38,4708.01,0.00
2024-12-08 16:54:04,144,4127,62,82,2547.06,4708.08,0.00
2024-12-08 16:54:04,145,4126,63,82,2522.71,4708.24,0.00
2024-12-08 16:54:04,146,4125,64,82,2479.50,4708.86,0.00
2024-12-08 16:54:04,145,4125,63,82,2486.29,4708.90,0.00
2024-12-08 16:54:04,145,4126,63,82,2546.45,4709.00,0.00
2024-12-08 16:54:04,146,4126,63,83,2529.01,4709.01,0.00
2024-12-08 16:54:04,145,4126,63,82,2540.96,4709.08,0.00
2024-12-08 16:54:04,144,4126,62,82,2531.59,4709.32,0.00
2024-12-08 16:54:04,144,4127,62,82,2571.37,4710.00,0.00
2024-12-08 16:54:04,145,4127,63,82,2553.64,4710.01,0.00
2024-12-08 16:54:04,144,4127,63,81,2564.88,4710.11,0.00
2024-12-08 16:54:04,143,4127,63,80,2562.97,4710.22,0.00
2024-12-08 16:54:04,142,4127,62,80,2571.41,4710.25,0.00
2024-12-08 16:54:04,142,4128,62,80,2554.65,4711.00,0.00
2024-12-08 16:54:04,143,4128,63,80,2536.78,4711.01,0.00
2024-12-08 16:54:04,144,4127,64,80,2514.29,4711.13,0.00
2024-12-08 16:54:04,143,4127,63,80,2545.47,4711.39,0.00
2024-12-08 16:54:04,144,4126,63,81,2526.82,4711.42,0.00
2024-12-08 16:54:04,144,4127,63,81,2522.18,4712.00,0.00
2024-12-08 16:54:04,145,4127,63,82,2504.78,4712.01,0.00
2024-12-08 16:54:04,144,4127,62,82,2518.61,4712.08,0.00
2024-12-08 16:54:04,143,4127,62,81,2486.58,4712.95,0.00
2024-12-08 16:54:04,143,4128,62,81,2570.40,4713.00,0.00
2024-12-08 16:54:04,144,4128,62,82,2552.55,4713.01,0.00
2024-12-08 16:54:04,143,4128,61,82,2511.92,4713.95,0.00
2024-12-08 16:54:04,143,4129,61,82,2537.91,4714.00,0.00
2024-12-08 16:54:04,144,4129,61,83,2520.28,4714.01,0.00
2024-12-08 16:54:04,144,4130,61,83,2490.55,4715.00,0.00
2024-12-08 16:54:04,145,4130,61,84,2473.37,4715.01,0.00
2024-12-08 16:54:04,144,4130,60,84,2486.33,4715.09,0.00
2024-12-08 16:54:04,143,4130,59,84,2503.38,4715.09,0.00
2024-12-08 16:54:04,143,4131,59,84,2473.38,4716.00,0.00
2024-12-08 16:54:04,144,4131,60,84,2456.20,4716.01,0.00
2024-12-08 16:54:04,143,4131,60,83,2468.80,4716.09,0.00
2024-12-08 16:54:04,142,4131,59,83,2442.53,4716.97,0.00
2024-12-08 16:54:04,142,4132,59,83,2474.11,4717.00,0.00
2024-12-08 16:54:04,143,4132,60,83,2456.81,4717.01,0.00
2024-12-08 16:54:04,144,4131,60,84,2436.67,4717.08,0.00
2024-12-08 16:54:04,143,4131,60,83,2464.61,4717.10,0.00
2024-12-08 16:54:04,143,4132,60,83,2440.97,4718.00,0.00
2024-12-08 16:54:04,144,4132,61,83,2424.02,4718.01,0.00
2024-12-08 16:54:04,143,4132,60,83,2416.21,4718.25,0.00
2024-12-08 16:54:04,143,4133,60,83,2445.87,4719.00,0.00
2024-12-08 16:54:04,144,4133,61,83,2428.89,4719.01,0.00
2024-12-08 16:54:04,143,4133,60,83,2443.47,4719.04,0.00
2024-12-08 16:54:04,142,4133,60,82,2451.73,4719.08,0.00
2024-12-08 16:54:04,141,4133,60,81,2468.79,4719.09,0.00
2024-12-08 16:54:04,140,4133,59,81,2454.69,4719.73,0.00
2024-12-08 16:54:04,139,4133,58,81,2471.44,4719.75,0.00
2024-12-08 16:54:04,139,4134,58,81,2480.13,4720.00,0.00
2024-12-08 16:54:04,140,4134,59,81,2462.41,4720.01,0.00
2024-12-08 16:54:04,141,4133,59,82,2444.62,4720.03,0.00
2024-12-08 16:54:04,140,4133,58,82,2474.40,4720.04,0.00
2024-12-08 16:54:04,139,4133,58,81,2489.17,4720.09,0.00
2024-12-08 16:54:04,140,4132,58,82,2453.29,4720.46,0.00
2024-12-08 16:54:04,140,4133,58,82,2480.26,4721.00,0.00
2024-12-08 16:54:04,141,4133,59,82,2462.67,4721.01,0.00
2024-12-08 16:54:04,140,4133,58,82,2478.67,4721.02,0.00
2024-12-08 16:54:04,139,4133,58,81,2493.13,4721.07,0.00
2024-12-08 16:54:04,138,4133,57,81,2496.17,4721.23,0.00
2024-12-08 16:54:04,138,4134,57,81,2561.12,4722.00,0.00
2024-12-08 16:54:04,139,4134,57,82,2542.70,4722.01,0.00
2024-12-08 16:54:04,140,4133,57,83,2522.53,4722.06,0.00
2024-12-08 16:54:04,139,4133,57,82,2540.35,4722.08,0.00
2024-12-08 16:54:05,140,4132,58,82,2499.91,4722.55,0.00
2024-12-08 16:54:05,141,4131,59,82,2488.24,4722.77,0.00
2024-12-08 16:54:05,141,4132,59,82,2505.85,4723.00,0.00
2024-12-08 16:54:05,142,4132,60,82,2488.20,4723.01,0.00
2024-12-08 16:54:05,141,4132,60,81,2500.52,4723.09,0.00
2024-12-08 16:54:05,141,4133,60,81,2576.03,4724.00,0.00
2024-12-08 16:54:05,142,4133,60,82,2557.89,4724.01,0.00
2024-12-08 16:54:05,141,4133,59,82,2563.00,4724.10,0.00
2024-12-08 16:54:05,141,4134,59,82,2552.09,4725.00,0.00
2024-12-08 16:54:05,142,4134,59,83,2534.12,4725.01,0.00
2024-12-08 16:54:05,141,4134,58,83,2548.77,4725.07,0.00
2024-12-08 16:54:05,142,4133,58,84,2504.06,4725.50,0.00
2024-12-08 16:54:05,142,4134,58,84,2511.30,4726.00,0.00
2024-12-08 16:54:05,143,4134,59,84,2493.74,4726.01,0.00
2024-12-08 16:54:05,142,4134,58,84,2508.01,4726.07,0.00
2024-12-08 16:54:05,142,4135,58,84,2511.02,4727.00,0.00
2024-12-08 16:54:05,143,4135,59,84,2493.46,4727.01,0.00
2024-12-08 16:54:05,144,4134,60,84,2473.22,4727.08,0.00
2024-12-08 16:54:05,143,4134,59,84,2459.80,4727.97,0.00
2024-12-08 16:54:05,143,4135,59,84,2491.24,4728.00,0.00
2024-12-08 16:54:05,144,4135,60,84,2473.94,4728.01,0.00
2024-12-08 16:54:05,144,4136,60,84,2481.41,4729.00,0.00
2024-12-08 16:54:05,145,4136,61,84,2464.30,4729.01,0.00
2024-12-08 16:54:05,146,4135,61,85,2415.89,4729.28,0.00
2024-12-08 16:54:05,146,4136,61,85,2432.18,4730.00,0.00
2024-12-08 16:54:05,147,4136,62,85,2415.64,4730.01,0.00
2024-12-08 16:54:05,146,4136,61,85,2409.30,4730.08,0.00
2024-12-08 16:54:05,145,4136,60,85,2424.97,4730.09,0.00
2024-12-08 16:54:05,144,4136,60,84,2441.56,4730.09,0.00
2024-12-08 16:54:05,145,4135,60,85,2417.57,4730.26,0.00
2024-12-08 16:54:05,145,4136,60,85,2444.27,4731.00,0.00
2024-12-08 16:54:05,146,4136,60,86,2427.53,4731.01,0.00
2024-12-08 16:54:05,145,4136,59,86,2437.68,4731.05,0.00
2024-12-08 16:54:05,144,4136,59,85,2446.73,4731.07,0.00
2024-12-08 16:54:05,143,4136,58,85,2463.50,4731.07,0.00
2024-12-08 16:54:05,143,4137,58,85,2457.42,4732.00,0.00
2024-12-08 16:54:05,144,4137,59,85,2440.36,4732.01,0.00
2024-12-08 16:54:05,143,4137,59,84,2452.81,4732.06,0.00
2024-12-08 16:54:05,142,4137,59,83,2422.26,4732.90,0.00
2024-12-08 16:54:05,142,4138,59,83,2436.95,4733.00,0.00
2024-12-08 16:54:05,143,4138,59,84,2419.91,4733.01,0.00
2024-12-08 16:54:05,142,4138,59,83,2433.82,4733.07,0.00
2024-12-08 16:54:05,143,4137,60,83,2385.81,4733.69,0.00
2024-12-08 16:54:05,143,4138,60,83,2399.08,4734.00,0.00
2024-12-08 16:54:05,144,4138,61,83,2382.42,4734.01,0.00
2024-12-08 16:54:05,143,4138,60,83,2390.16,4734.06,0.00
2024-12-08 16:54:05,142,4138,60,82,2405.99,4734.06,0.00
2024-12-08 16:54:05,141,4138,59,82,2420.72,4734.11,0.00
2024-12-08 16:54:05,140,4138,59,81,2419.95,4734.47,0.00
2024-12-08 16:54:05,141,4137,60,81,2401.79,4734.50,0.00
2024-12-08 16:54:05,141,4138,60,81,2458.14,4735.00,0.00
2024-12-08 16:54:05,142,4138,61,81,2440.83,4735.01,0.00
2024-12-08 16:54:05,141,4138,61,80,2454.80,4735.06,0.00
2024-12-08 16:54:05,141,4139,61,80,2457.71,4736.00,0.00
2024-12-08 16:54:05,142,4139,62,80,2440.40,4736.01,0.00
2024-12-08 16:54:05,141,4139,61,80,2411.14,4736.64,0.00
2024-12-08 16:54:05,141,4140,61,80,2422.40,4737.00,0.00
2024-12-08 16:54:05,142,4140,62,80,2405.34,4737.01,0.00
2024-12-08 16:54:05,141,4140,62,79,2417.39,4737.06,0.00
2024-12-08 16:54:05,140,4140,62,78,2433.98,4737.07,0.00
2024-12-08 16:54:05,140,4141,62,78,2402.10,4738.00,0.00
2024-12-08 16:54:05,141,4141,63,78,2385.06,4738.01,0.00
2024-12-08 16:54:05,140,4141,63,77,2380.32,4738.07,0.00
2024-12-08 16:54:05,139,4141,63,76,2374.60,4738.32,0.00
2024-12-08 16:54:05,140,4140,63,77,2357.64,4738.33,0.00
2024-12-08 16:54:05,139,4140,62,77,2393.40,4738.42,0.00
2024-12-08 16:54:05,139,4141,62,77,2389.66,4739.00,0.00
2024-12-08 16:54:05,140,4141,62,78,2372.59,4739.01,0.00
2024-12-08 16:54:05,139,4141,61,78,2387.43,4739.05,0.00
2024-12-08 16:54:05,138,4141,61,77,2401.30,4739.06,0.00
2024-12-08 16:54:05,137,4141,60,77,2400.70,4739.41,0.00
2024-12-08 16:54:05,136,4141,59,77,2418.00,4739.41,0.00
2024-12-08 16:54:06,135,4141,58,77,2421.17,4739.42,0.00
2024-12-08 16:54:06,135,4142,58,77,2436.38,4740.00,0.00
2024-12-08 16:54:06,136,4142,59,77,2418.46,4740.01,0.00
2024-12-08 16:54:06,135,4142,59,76,2433.59,4740.06,0.00
2024-12-08 16:54:06,134,4142,58,76,2418.96,4740.55,0.00
2024-12-08 16:54:06,133,4142,57,76,2420.58,4740.69,0.00
2024-12-08 16:54:06,133,4143,57,76,2436.15,4741.00,0.00
2024-12-08 16:54:06,134,4143,58,76,2417.97,4741.01,0.00
2024-12-08 16:54:06,133,4143,58,75,2432.24,4741.06,0.00
2024-12-08 16:54:06,132,4143,57,75,2434.32,4741.29,0.00
2024-12-08 16:54:06,133,4142,58,75,2396.80,4741.67,0.00
2024-12-08 16:54:06,132,4142,57,75,2424.64,4741.67,0.00
2024-12-08 16:54:06,133,4141,58,75,2387.79,4741.95,0.00
2024-12-08 16:54:06,133,4142,58,75,2423.13,4742.00,0.00
2024-12-08 16:54:06,134,4142,59,75,2405.05,4742.01,0.00
2024-12-08 16:54:06,133,4142,59,74,2418.87,4742.06,0.00
2024-12-08 16:54:06,132,4142,58,74,2403.33,4742.40,0.00
2024-12-08 16:54:06,131,4142,58,73,2377.57,4742.88,0.00
2024-12-08 16:54:06,131,4143,58,73,2480.48,4743.00,0.00
2024-12-08 16:54:06,132,4143,59,73,2461.69,4743.01,0.00
2024-12-08 16:54:06,131,4143,59,72,2476.16,4743.06,0.00
2024-12-08 16:54:06,130,4143,58,72,2493.01,4743.06,0.00
2024-12-08 16:54:06,131,4142,59,72,2466.30,4743.16,0.00
2024-12-08 16:54:06,130,4142,59,71,2450.58,4743.76,0.00
2024-12-08 16:54:06,130,4143,59,71,2475.95,4744.00,0.00
2024-12-08 16:54:06,131,4143,59,72,2457.05,4744.01,0.00
2024-12-08 16:54:06,130,4143,59,71,2471.22,4744.06,0.00
2024-12-08 16:54:06,131,4142,59,72,2445.58,4744.14,0.00
2024-12-08 16:54:06,130,4142,58,72,2452.77,4744.29,0.00
2024-12-08 16:54:06,129,4142,58,71,2461.56,4744.50,0.00
2024-12-08 16:54:06,129,4143,58,71,2497.21,4745.00,0.00
2024-12-08 16:54:06,130,4143,59,71,2478.00,4745.01,0.00
2024-12-08 16:54:06,129,4143,59,70,2492.08,4745.07,0.00
2024-12-08 16:54:06,130,4142,60,70,2428.36,4745.95,0.00
2024-12-08 16:54:06,130,4143,60,70,2485.71,4746.00,0.00
2024-12-08 16:54:06,131,4143,61,70,2466.73,4746.01,0.00
2024-12-08 16:54:06,130,4143,60,70,2480.62,4746.08,0.00
2024-12-08 16:54:06,129,4143,60,69,2497.64,4746.08,0.00
2024-12-08 16:54:06,129,4144,60,69,2524.07,4747.00,0.00
2024-12-08 16:54:06,130,4144,60,70,2504.65,4747.01,0.00
2024-12-08 16:54:06,131,4143,60,71,2474.31,4747.11,0.00
2024-12-08 16:54:06,132,4142,60,72,2480.41,4747.22,0.00
2024-12-08 16:54:06,131,4142,59,72,2497.39,4747.67,0.00
2024-12-08 16:54:06,131,4143,59,72,2518.30,4748.00,0.00
2024-12-08 16:54:06,132,4143,59,73,2499.22,4748.01,0.00
2024-12-08 16:54:06,131,4143,59,72,2510.70,4748.08,0.00
2024-12-08 16:54:06,131,4144,59,72,2554.05,4749.00,0.00
2024-12-08 16:54:06,132,4144,59,73,2534.70,4749.01,0.00
2024-12-08 16:54:06,131,4144,59,72,2549.27,4749.08,0.00
2024-12-08 16:54:06,132,4143,60,72,2507.67,4749.49,0.00
2024-12-08 16:54:06,132,4144,60,72,2511.74,4750.00,0.00
2024-12-08 16:54:06,133,4144,60,73,2492.86,4750.01,0.00
2024-12-08 16:54:06,132,4144,59,73,2510.67,4750.02,0.00
2024-12-08 16:54:06,131,4144,58,73,2529.11,4750.03,0.00
2024-12-08 16:54:06,130,4144,58,72,2547.11,4750.05,0.00
2024-12-08 16:54:06,129,4144,57,72,2511.35,4750.90,0.00
2024-12-08 16:54:06,129,4145,57,72,2578.33,4751.00,0.00
2024-12-08 16:54:06,130,4145,58,72,2558.50,4751.01,0.00
2024-12-08 16:54:06,129,4145,57,72,2529.92,4751.74,0.00
2024-12-08 16:54:06,129,4146,57,72,2553.68,4752.00,0.00
2024-12-08 16:54:06,130,4146,57,73,2534.03,4752.01,0.00
2024-12-08 16:54:06,131,4145,58,73,2462.95,4752.88,0.00
2024-12-08 16:54:06,131,4146,58,73,2491.04,4753.00,0.00
2024-12-08 16:54:06,132,4146,59,73,2472.17,4753.01,0.00
2024-12-08 16:54:06,133,4145,59,74,2425.01,4753.38,0.00
2024-12-08 16:54:06,134,4144,59,75,2405.17,4753.76,0.00
2024-12-08 16:54:06,134,4145,59,75,2472.42,4754.00,0.00
2024-12-08 16:54:06,135,4145,59,76,2454.10,4754.01,0.00
2024-12-08 16:54:06,134,4145,59,75,2469.88,4754.05,0.00
2024-12-08 16:54:06,133,4145,58,75,2449.51,4754.65,0.00
2024-12-08 16:54:07,133,4146,58,75,2540.43,4755.00,0.00
2024-12-08 16:54:07,134,4146,58,76,2521.47,4755.01,0.00
2024-12-08 16:54:07,133,4146,58,75,2534.72,4755.05,0.00
2024-12-08 16:54:07,132,4146,58,74,2553.56,4755.05,0.00
2024-12-08 16:54:07,132,4147,58,74,2530.22,4756.00,0.00
2024-12-08 16:54:07,133,4147,58,75,2511.19,4756.01,0.00
2024-12-08 16:54:07,132,4147,58,74,2519.79,4756.07,0.00
2024-12-08 16:54:07,132,4148,58,74,2507.58,4757.00,0.00
2024-12-08 16:54:07,133,4148,58,75,2488.73,4757.01,0.00
2024-12-08 16:54:07,132,4148,57,75,2506.15,4757.03,0.00
2024-12-08 16:54:07,131,4148,56,75,2516.21,4757.06,0.00
2024-12-08 16:54:07,130,4148,55,75,2535.20,4757.06,0.00
2024-12-08 16:54:07,130,4149,55,75,2520.93,4758.00,0.00
2024-12-08 16:54:07,131,4149,56,75,2501.68,4758.01,0.00
2024-12-08 16:54:07,130,4149,55,75,2510.33,4758.07,0.00
2024-12-08 16:54:07,131,4148,55,76,2468.29,4758.57,0.00
2024-12-08 16:54:07,131,4149,55,76,2502.21,4759.00,0.00
2024-12-08 16:54:07,132,4149,55,77,2483.26,4759.01,0.00
2024-12-08 16:54:07,131,4149,55,76,2491.69,4759.07,0.00
2024-12-08 16:54:07,130,4149,54,76,2499.64,4759.12,0.00
2024-12-08 16:54:07,131,4148,55,76,2467.58,4759.41,0.00
2024-12-08 16:54:07,131,4149,55,76,2503.30,4760.00,0.00
2024-12-08 16:54:07,132,4149,55,77,2484.33,4760.01,0.00
2024-12-08 16:54:07,131,4149,55,76,2500.04,4760.05,0.00
2024-12-08 16:54:07,132,4148,56,76,2454.92,4760.61,0.00
2024-12-08 16:54:07,132,4149,56,76,2503.02,4761.00,0.00
2024-12-08 16:54:07,133,4149,57,76,2484.20,4761.01,0.00
2024-12-08 16:54:07,132,4149,56,76,2501.23,4761.04,0.00
2024-12-08 16:54:07,131,4149,56,75,2511.60,4761.06,0.00
2024-12-08 16:54:07,131,4150,56,75,2525.04,4762.00,0.00
2024-12-08 16:54:07,132,4150,57,75,2505.91,4762.01,0.00
2024-12-08 16:54:07,131,4150,57,74,2517.80,4762.04,0.00
2024-12-08 16:54:07,131,4151,57,74,2489.91,4763.00,0.00
2024-12-08 16:54:07,132,4151,58,74,2471.05,4763.01,0.00
2024-12-08 16:54:07,131,4151,58,73,2479.39,4763.07,0.00
2024-12-08 16:54:07,132,4150,58,74,2459.53,4763.11,0.00
2024-12-08 16:54:07,131,4150,57,74,2467.81,4763.29,0.00
2024-12-08 16:54:07,130,4150,56,74,2482.80,4763.38,0.00
2024-12-08 16:54:07,131,4149,56,75,2435.62,4763.90,0.00
2024-12-08 16:54:07,131,4150,56,75,2470.39,4764.00,0.00
2024-12-08 16:54:07,132,4150,56,76,2451.67,4764.01,0.00
2024-12-08 16:54:07,131,4150,56,75,2465.67,4764.05,0.00
2024-12-08 16:54:07,132,4149,56,76,2441.97,4764.17,0.00
2024-12-08 16:54:07,131,4149,56,75,2450.32,4764.63,0.00
2024-12-08 16:54:07,131,4150,56,75,2527.57,4765.00,0.00
2024-12-08 16:54:07,132,4150,57,75,2508.43,4765.01,0.00
2024-12-08 16:54:07,131,4150,56,75,2511.89,4765.18,0.00
2024-12-08 16:54:07,130,4150,55,75,2522.84,4765.36,0.00
2024-12-08 16:54:07,131,4149,56,75,2501.78,4765.41,0.00
2024-12-08 16:54:07,131,4150,56,75,2551.65,4766.00,0.00
2024-12-08 16:54:07,132,4150,57,75,2532.32,4766.01,0.00
2024-12-08 16:54:07,131,4150,57,74,2541.12,4766.07,0.00
2024-12-08 16:54:07,131,4151,57,74,2564.39,4767.00,0.00
2024-12-08 16:54:07,132,4151,58,74,2544.96,4767.01,0.00
2024-12-08 16:54:07,132,4152,58,74,2516.87,4768.00,0.00
2024-12-08 16:54:07,133,4152,59,74,2497.94,4768.01,0.00
2024-12-08 16:54:07,132,4152,59,73,2507.48,4768.05,0.00
2024-12-08 16:54:07,132,4153,59,73,2484.52,4769.00,0.00
2024-12-08 16:54:07,133,4153,59,74,2465.84,4769.01,0.00
2024-12-08 16:54:07,132,4153,59,73,2477.77,4769.05,0.00
2024-12-08 16:54:07,133,4152,59,74,2404.35,4769.93,0.00
2024-12-08 16:54:07,133,4153,59,74,2438.85,4770.00,0.00
2024-12-08 16:54:07,134,4153,60,74,2420.65,4770.01,0.00
2024-12-08 16:54:07,133,4153,59,74,2436.70,4770.05,0.00
2024-12-08 16:54:07,132,4153,59,73,2454.08,4770.06,0.00
2024-12-08 16:54:07,131,4153,58,73,2472.45,4770.06,0.00
2024-12-08 16:54:07,131,4154,58,73,2471.85,4771.00,0.00
2024-12-08 16:54:07,132,4154,58,74,2453.12,4771.01,0.00
2024-12-08 16:54:07,131,4154,58,73,2468.95,4771.06,0.00
2024-12-08 16:54:07,132,4153,59,73,2448.44,4771.11,0.00
2024-12-08 16:54:07,131,4153,58,73,2433.13,4771.64,0.00
2024-12-08 16:54:07,131,4154,58,73,2438.29,4772.00,0.00
2024-12-08 16:54:07,132,4154,59,73,2419.82,4772.01,0.00
2024-12-08 16:54:07,131,4154,58,73,2436.48,4772.04,0.00
2024-12-08 16:54:07,130,4154,58,72,2453.76,4772.06,0.00
2024-12-08 16:54:07,131,4153,58,73,2398.25,4772.86,0.00
2024-12-08 16:54:07,130,4153,58,72,2414.75,4772.90,0.00
2024-12-08 16:54:07,130,4154,58,72,2483.48,4773.00,0.00
2024-12-08 16:54:07,131,4154,58,73,2464.52,4773.01,0.00
2024-12-08 16:54:07,130,4154,57,73,2482.38,4773.02,0.00
2024-12-08 16:54:07,130,4155,57,73,2495.34,4774.00,0.00
2024-12-08 16:54:07,131,4155,58,73,2476.29,4774.01,0.00
2024-12-08 16:54:07,130,4155,58,72,2484.70,4774.07,0.00
2024-12-08 16:54:07,131,4154,58,73,2450.90,4774.40,0.00
2024-12-08 16:54:07,131,4155,58,73,2445.09,4775.00,0.00
2024-12-08 16:54:07,132,4155,58,74,2426.57,4775.01,0.00
2024-12-08 16:54:07,133,4154,59,74,2405.83,4775.08,0.00
2024-12-08 16:54:07,132,4154,59,73,2451.92,4775.08,0.00
2024-12-08 16:54:07,131,4154,59,72,2445.48,4775.58,0.00
2024-12-08 16:54:07,131,4155,59,72,2482.72,4776.00,0.00
2024-12-08 16:54:07,132,4155,60,72,2463.91,4776.01,0.00
2024-12-08 16:54:07,131,4155,59,72,2482.35,4776.01,0.00
2024-12-08 16:54:07,130,4155,58,72,2490.82,4776.07,0.00
2024-12-08 16:54:08,129,4155,57,72,2509.76,4776.07,0.00
2024-12-08 16:54:08,129,4156,57,72,2535.78,4777.00,0.00
2024-12-08 16:54:08,130,4156,57,73,2516.28,4777.01,0.00
2024-12-08 16:54:08,131,4155,57,74,2465.65,4777.53,0.00
2024-12-08 16:54:08,131,4156,57,74,2487.20,4778.00,0.00
2024-12-08 16:54:08,132,4156,57,75,2468.36,4778.01,0.00
2024-12-08 16:54:08,132,4157,57,75,2476.78,4779.00,0.00
2024-12-08 16:54:08,133,4157,57,76,2458.15,4779.01,0.00
2024-12-08 16:54:08,134,4156,58,76,2429.13,4779.10,0.00
2024-12-08 16:54:08,133,4156,57,76,2467.96,4779.36,0.00
2024-12-08 16:54:08,133,4157,57,76,2459.21,4780.00,0.00
2024-12-08 16:54:08,134,4157,58,76,2440.86,4780.01,0.00
2024-12-08 16:54:08,133,4157,58,75,2454.91,4780.05,0.00
2024-12-08 16:54:08,134,4156,58,76,2436.59,4780.07,0.00
2024-12-08 16:54:08,133,4156,57,76,2424.44,4780.74,0.00
2024-12-08 16:54:08,134,4155,58,76,2396.71,4780.93,0.00
2024-12-08 16:54:08,133,4155,57,76,2406.42,4780.96,0.00
2024-12-08 16:54:08,133,4156,57,76,2476.54,4781.00,0.00
2024-12-08 16:54:08,134,4156,57,77,2458.06,4781.01,0.00
2024-12-08 16:54:08,133,4156,56,77,2474.39,4781.05,0.00
2024-12-08 16:54:08,133,4156,56,77,2524.22,4782.00,0.00
2024-12-08 16:54:08,134,4156,56,78,2505.38,4782.01,0.00
2024-12-08 16:54:08,133,4156,56,77,2514.17,4782.06,0.00
2024-12-08 16:54:08,133,4157,56,77,2499.60,4783.00,0.00
2024-12-08 16:54:08,134,4157,57,77,2480.95,4783.01,0.00
2024-12-08 16:54:08,133,4157,57,76,2489.20,4783.07,0.00
2024-12-08 16:54:08,132,4157,56,76,2478.57,4783.67,0.00
2024-12-08 16:54:08,132,4158,56,76,2492.45,4784.00,0.00
2024-12-08 16:54:08,133,4158,57,76,2473.71,4784.01,0.00
2024-12-08 16:54:08,132,4158,57,75,2481.96,4784.07,0.00
2024-12-08 16:54:08,131,4158,57,74,2500.69,4784.07,0.00
2024-12-08 16:54:08,131,4159,57,74,2482.17,4785.00,0.00
2024-12-08 16:54:08,132,4159,58,74,2463.37,4785.01,0.00
2024-12-08 16:54:08,131,4159,58,73,2474.51,4785.05,0.00
2024-12-08 16:54:08,131,4159,58,73,2451.27,4786.00,0.00
2024-12-08 16:54:08,132,4159,58,74,2432.70,4786.01,0.00
2024-12-08 16:54:08,131,4159,58,73,2441.06,4786.06,0.00
2024-12-08 16:54:08,132,4158,59,73,2418.23,4786.17,0.00
2024-12-08 16:54:08,132,4159,59,73,2416.60,4787.00,0.00
2024-12-08 16:54:08,133,4159,60,73,2398.43,4787.01,0.00
2024-12-08 16:54:08,132,4159,60,72,2406.46,4787.06,0.00
2024-12-08 16:54:08,133,4158,61,72,2369.42,4787.47,0.00
2024-12-08 16:54:08,132,4158,60,72,2405.98,4787.50,0.00
2024-12-08 16:54:08,133,4157,61,72,2366.87,4787.94,0.00
2024-12-08 16:54:08,133,4158,61,72,2438.20,4788.00,0.00
2024-12-08 16:54:08,134,4158,62,72,2420.00,4788.01,0.00
2024-12-08 16:54:08,133,4158,62,71,2433.89,4788.05,0.00
2024-12-08 16:54:08,134,4157,62,72,2376.67,4788.87,0.00
2024-12-08 16:54:08,134,4158,62,72,2467.19,4789.00,0.00
2024-12-08 16:54:08,135,4158,62,73,2448.91,4789.01,0.00
2024-12-08 16:54:08,134,4158,62,72,2457.20,4789.06,0.00
2024-12-08 16:54:08,134,4159,62,72,2481.01,4790.00,0.00
2024-12-08 16:54:08,135,4159,63,72,2462.64,4790.01,0.00
2024-12-08 16:54:08,134,4159,63,71,2471.02,4790.06,0.00
2024-12-08 16:54:08,135,4158,63,72,2433.33,4790.48,0.00
2024-12-08 16:54:08,136,4157,63,73,2434.13,4790.70,0.00
2024-12-08 16:54:08,136,4158,63,73,2478.40,4791.00,0.00
2024-12-08 16:54:08,137,4158,64,73,2460.31,4791.01,0.00
2024-12-08 16:54:08,136,4158,64,72,2460.81,4791.21,0.00
2024-12-08 16:54:08,135,4158,63,72,2471.99,4791.36,0.00
2024-12-08 16:54:08,135,4159,63,72,2540.38,4792.00,0.00
2024-12-08 16:54:08,136,4159,63,73,2521.70,4792.01,0.00
2024-12-08 16:54:08,135,4159,63,72,2530.45,4792.06,0.00
2024-12-08 16:54:08,135,4160,63,72,2508.58,4793.00,0.00
2024-12-08 16:54:08,136,4160,64,72,2490.14,4793.01,0.00
2024-12-08 16:54:08,135,4160,64,71,2504.33,4793.04,0.00
2024-12-08 16:54:08,134,4160,64,70,2522.31,4793.05,0.00
2024-12-08 16:54:08,135,4159,65,70,2466.36,4793.85,0.00
2024-12-08 16:54:08,135,4160,65,70,2484.96,4794.00,0.00
2024-12-08 16:54:08,136,4160,65,71,2466.69,4794.01,0.00
2024-12-08 16:54:08,135,4160,65,70,2475.38,4794.05,0.00
2024-12-08 16:54:08,134,4160,65,69,2491.49,4794.10,0.00
2024-12-08 16:54:08,134,4161,65,69,2514.65,4795.00,0.00
2024-12-08 16:54:08,135,4161,66,69,2496.03,4795.01,0.00
2024-12-08 16:54:08,134,4161,66,68,2505.00,4795.05,0.00
2024-12-08 16:54:08,133,4161,65,68,2509.14,4795.35,0.00
2024-12-08 16:54:08,133,4162,65,68,2503.18,4796.00,0.00
2024-12-08 16:54:08,134,4162,66,68,2484.50,4796.01,0.00
2024-12-08 16:54:08,133,4162,65,68,2502.46,4796.02,0.00
2024-12-08 16:54:08,132,4162,64,68,2510.88,4796.02,0.00
2024-12-08 16:54:08,131,4162,64,67,2523.09,4796.03,0.00
2024-12-08 16:54:08,130,4162,64,66,2542.13,4796.03,0.00
2024-12-08 16:54:08,130,4163,64,66,2516.90,4797.00,0.00
2024-12-08 16:54:08,131,4163,64,67,2497.69,4797.01,0.00
2024-12-08 16:54:08,130,4163,64,66,2515.43,4797.03,0.00
2024-12-08 16:54:08,131,4162,64,67,2482.40,4797.34,0.00
2024-12-08 16:54:08,131,4163,64,67,2507.83,4798.00,0.00
2024-12-08 16:54:08,132,4163,65,67,2488.83,4798.01,0.00
2024-12-08 16:54:08,131,4163,65,66,2498.68,4798.04,0.00
2024-12-08 16:54:09,131,4164,65,66,2517.34,4799.00,0.00
2024-12-08 16:54:09,132,4164,65,67,2498.27,4799.01,0.00
2024-12-08 16:54:09,133,4163,65,68,2436.85,4799.74,0.00
2024-12-08 16:54:09,133,4164,65,68,2456.51,4800.00,0.00
2024-12-08 16:54:09,134,4164,66,68,2438.18,4800.01,0.00
2024-12-08 16:54:09,133,4164,66,67,2451.82,4800.03,0.00
2024-12-08 16:54:09,133,4165,66,67,2461.66,4801.00,0.00
2024-12-08 16:54:09,134,4165,67,67,2443.29,4801.01,0.00
2024-12-08 16:54:09,133,4165,67,66,2452.64,4801.04,0.00
2024-12-08 16:54:09,132,4165,67,65,2452.93,4801.40,0.00
2024-12-08 16:54:09,132,4166,67,65,2457.40,4802.00,0.00
2024-12-08 16:54:09,133,4166,68,65,2438.93,4802.01,0.00
2024-12-08 16:54:09,134,4165,69,65,2419.65,4802.05,0.00
2024-12-08 16:54:09,134,4166,69,65,2417.44,4803.00,0.00
2024-12-08 16:54:09,135,4166,70,65,2399.53,4803.01,0.00
2024-12-08 16:54:09,134,4166,69,65,2408.48,4803.04,0.00
2024-12-08 16:54:09,134,4167,69,65,2431.23,4804.00,0.00
2024-12-08 16:54:09,135,4167,70,65,2413.22,4804.01,0.00
2024-12-08 16:54:09,134,4167,69,65,2408.13,4804.33,0.00
2024-12-08 16:54:09,135,4166,69,66,2381.10,4804.53,0.00
2024-12-08 16:54:09,135,4167,69,66,2420.13,4805.00,0.00
2024-12-08 16:54:09,136,4167,69,67,2402.34,4805.01,0.00
2024-12-08 16:54:09,135,4167,68,67,2419.42,4805.02,0.00
2024-12-08 16:54:09,134,4167,67,67,2437.12,4805.02,0.00
2024-12-08 16:54:09,133,4167,67,66,2447.50,4805.02,0.00
2024-12-08 16:54:09,132,4167,66,66,2465.68,4805.02,0.00
2024-12-08 16:54:09,131,4167,66,65,2484.13,4805.02,0.00
2024-12-08 16:54:09,130,4167,65,65,2487.91,4805.32,0.00
2024-12-08 16:54:09,131,4166,66,65,2445.72,4805.82,0.00
2024-12-08 16:54:09,131,4167,66,65,2510.85,4806.00,0.00
2024-12-08 16:54:09,132,4167,67,65,2491.83,4806.01,0.00
2024-12-08 16:54:09,131,4167,67,64,2502.42,4806.02,0.00
2024-12-08 16:54:09,132,4166,67,65,2471.16,4806.28,0.00
2024-12-08 16:54:09,133,4165,68,65,2460.33,4806.63,0.00
2024-12-08 16:54:09,133,4166,68,65,2513.38,4807.00,0.00
2024-12-08 16:54:09,134,4166,69,65,2494.63,4807.01,0.00
2024-12-08 16:54:09,133,4166,69,64,2507.24,4807.02,0.00
2024-12-08 16:54:09,132,4166,69,63,2525.87,4807.02,0.00
2024-12-08 16:54:09,131,4166,68,63,2517.46,4807.58,0.00
2024-12-08 16:54:09,132,4165,69,63,2489.42,4807.78,0.00
2024-12-08 16:54:09,132,4166,69,63,2580.28,4808.00,0.00
2024-12-08 16:54:09,133,4166,70,63,2560.88,4808.01,0.00
2024-12-08 16:54:09,132,4166,69,63,2545.94,4808.52,0.00
2024-12-08 16:54:09,132,4167,69,63,2595.84,4809.00,0.00
2024-12-08 16:54:09,133,4167,69,64,2576.32,4809.01,0.00
2024-12-08 16:54:09,132,4167,69,63,2587.46,4809.02,0.00
2024-12-08 16:54:09,133,4166,70,63,2533.60,4809.74,0.00
2024-12-08 16:54:09,133,4167,70,63,2568.18,4810.00,0.00
2024-12-08 16:54:09,134,4167,70,64,2549.01,4810.01,0.00
2024-12-08 16:54:09,133,4167,70,63,2562.03,4810.02,0.00
2024-12-08 16:54:09,132,4167,70,62,2576.37,4810.11,0.00
2024-12-08 16:54:09,131,4167,69,62,2584.59,4810.35,0.00
2024-12-08 16:54:09,131,4168,69,62,2612.57,4811.00,0.00
2024-12-08 16:54:09,132,4168,69,63,2592.78,4811.01,0.00
2024-12-08 16:54:09,131,4168,68,63,2611.84,4811.02,0.00
2024-12-08 16:54:09,130,4168,68,62,2631.19,4811.02,0.00
2024-12-08 16:54:09,130,4169,68,62,2606.57,4812.00,0.00
2024-12-08 16:54:09,131,4169,69,62,2586.67,4812.01,0.00
2024-12-08 16:54:09,130,4169,69,61,2605.46,4812.02,0.00
2024-12-08 16:54:09,129,4169,69,60,2625.61,4812.02,0.00
2024-12-08 16:54:09,128,4169,68,60,2643.12,4812.02,0.00
2024-12-08 16:54:09,128,4170,68,60,2634.27,4813.00,0.00
2024-12-08 16:54:09,129,4170,69,60,2613.85,4813.01,0.00
2024-12-08 16:54:09,128,4170,69,59,2632.76,4813.02,0.00
2024-12-08 16:54:09,129,4169,70,59,2595.31,4813.39,0.00
2024-12-08 16:54:09,129,4170,70,59,2603.57,4814.00,0.00
2024-12-08 16:54:09,130,4170,70,60,2583.54,4814.01,0.00
2024-12-08 16:54:09,130,4171,70,60,2597.03,4815.00,0.00
2024-12-08 16:54:09,131,4171,71,60,2577.21,4815.01,0.00
2024-12-08 16:54:09,130,4171,70,60,2543.62,4815.74,0.00
2024-12-08 16:54:09,131,4170,71,60,2518.77,4815.86,0.00
2024-12-08 16:54:09,131,4171,71,60,2553.08,4816.00,0.00
2024-12-08 16:54:09,132,4171,71,61,2533.74,4816.01,0.00
2024-12-08 16:54:09,131,4171,71,60,2545.73,4816.02,0.00
2024-12-08 16:54:09,131,4172,71,60,2557.65,4817.00,0.00
2024-12-08 16:54:09,132,4172,71,61,2538.28,4817.01,0.00
2024-12-08 16:54:09,131,4172,70,61,2556.18,4817.01,0.00
2024-12-08 16:54:09,130,4172,70,60,2573.62,4817.02,0.00
2024-12-08 16:54:09,131,4171,71,60,2518.66,4817.78,0.00
2024-12-08 16:54:09,131,4172,71,60,2551.93,4818.00,0.00
2024-12-08 16:54:09,132,4172,71,61,2532.60,4818.01,0.00
2024-12-08 16:54:09,132,4173,71,61,2541.40,4819.00,0.00
2024-12-08 16:54:09,133,4173,71,62,2522.29,4819.01,0.00
2024-12-08 16:54:09,132,4173,70,62,2541.03,4819.01,0.00
2024-12-08 16:54:09,131,4173,69,62,2550.01,4819.07,0.00
2024-12-08 16:54:09,132,4172,70,62,2481.98,4819.80,0.00
2024-12-08 16:54:10,132,4173,70,62,2519.97,4820.00,0.00
2024-12-08 16:54:10,133,4173,71,62,2501.02,4820.01,0.00
2024-12-08 16:54:10,132,4173,70,62,2519.61,4820.01,0.00
2024-12-08 16:54:10,131,4173,70,61,2537.37,4820.03,0.00
2024-12-08 16:54:10,130,4173,69,61,2519.81,4820.62,0.00
2024-12-08 16:54:10,130,4174,69,61,2575.73,4821.00,0.00
2024-12-08 16:54:10,131,4174,69,62,2556.06,4821.01,0.00
2024-12-08 16:54:10,130,4174,68,62,2575.36,4821.01,0.00
2024-12-08 16:54:10,129,4174,68,61,2592.70,4821.02,0.00
2024-12-08 16:54:10,130,4173,68,62,2552.06,4821.46,0.00
2024-12-08 16:54:10,130,4174,68,62,2553.93,4822.00,0.00
2024-12-08 16:54:10,131,4174,69,62,2534.44,4822.01,0.00
2024-12-08 16:54:10,130,4174,69,61,2553.56,4822.01,0.00
2024-12-08 16:54:10,129,4174,69,60,2568.87,4822.04,0.00
2024-12-08 16:54:10,128,4174,68,60,2573.04,4822.36,0.00
2024-12-08 16:54:10,127,4174,67,60,2575.93,4822.55,0.00
2024-12-08 16:54:10,127,4175,67,60,2630.57,4823.00,0.00
2024-12-08 16:54:10,128,4175,68,60,2610.01,4823.01,0.00
2024-12-08 16:54:10,127,4175,67,60,2630.19,4823.01,0.00
2024-12-08 16:54:10,127,4176,67,60,2599.36,4824.00,0.00
2024-12-08 16:54:10,128,4176,67,61,2579.06,4824.01,0.00
2024-12-08 16:54:10,127,4176,67,60,2594.43,4824.03,0.00
2024-12-08 16:54:10,126,4176,66,60,2613.88,4824.05,0.00
2024-12-08 16:54:10,125,4176,65,60,2603.22,4824.70,0.00
2024-12-08 16:54:10,125,4177,65,60,2611.95,4825.00,0.00
2024-12-08 16:54:10,126,4177,66,60,2591.22,4825.01,0.00
2024-12-08 16:54:10,127,4176,67,60,2570.05,4825.04,0.00
2024-12-08 16:54:10,127,4177,67,60,2586.77,4826.00,0.00
2024-12-08 16:54:10,128,4177,68,60,2566.56,4826.01,0.00
2024-12-08 16:54:10,127,4177,67,60,2586.39,4826.01,0.00
2024-12-08 16:54:10,128,4176,68,60,2535.81,4826.50,0.00
2024-12-08 16:54:10,128,4177,68,60,2595.82,4827.00,0.00
2024-12-08 16:54:10,129,4177,68,61,2575.70,4827.01,0.00
2024-12-08 16:54:10,128,4177,67,61,2595.45,4827.01,0.00
2024-12-08 16:54:10,127,4177,66,61,2590.21,4827.38,0.00
2024-12-08 16:54:10,127,4178,66,61,2625.60,4828.00,0.00
2024-12-08 16:54:10,128,4178,67,61,2605.09,4828.01,0.00
2024-12-08 16:54:10,127,4178,67,60,2615.74,4828.06,0.00
2024-12-08 16:54:10,126,4178,66,60,2632.18,4828.15,0.00
2024-12-08 16:54:10,125,4178,65,60,2645.18,4828.32,0.00
2024-12-08 16:54:10,125,4179,65,60,2635.97,4829.00,0.00
2024-12-08 16:54:10,126,4179,65,61,2615.05,4829.01,0.00
2024-12-08 16:54:10,125,4179,65,60,2625.57,4829.10,0.00
2024-12-08 16:54:10,124,4179,65,59,2636.78,4829.30,0.00
2024-12-08 16:54:10,125,4178,65,60,2614.92,4829.33,0.00
2024-12-08 16:54:10,126,4177,65,61,2608.45,4829.52,0.00
2024-12-08 16:54:10,126,4178,65,61,2624.51,4830.00,0.00
2024-12-08 16:54:10,127,4178,65,62,2603.85,4830.01,0.00
2024-12-08 16:54:10,128,4177,66,62,2582.38,4830.05,0.00
2024-12-08 16:54:10,127,4177,66,61,2612.25,4830.12,0.00
2024-12-08 16:54:10,126,4177,65,61,2609.27,4830.30,0.00
2024-12-08 16:54:10,127,4176,65,62,2580.83,4830.48,0.00
2024-12-08 16:54:10,127,4177,65,62,2686.93,4831.00,0.00
2024-12-08 16:54:10,128,4177,66,62,2665.94,4831.01,0.00
2024-12-08 16:54:10,127,4177,66,61,2675.55,4831.11,0.00
2024-12-08 16:54:10,126,4177,65,61,2674.98,4831.28,0.00
2024-12-08 16:54:10,126,4178,65,61,2755.60,4832.00,0.00
2024-12-08 16:54:10,127,4178,66,61,2733.91,4832.01,0.00
2024-12-08 16:54:10,126,4178,65,61,2754.84,4832.02,0.00
2024-12-08 16:54:10,127,4177,65,62,2732.40,4832.05,0.00
2024-12-08 16:54:10,126,4177,64,62,2763.30,4832.06,0.00
2024-12-08 16:54:10,125,4177,64,61,2776.91,4832.10,0.00
2024-12-08 16:54:10,126,4176,64,62,2739.66,4832.44,0.00
2024-12-08 16:54:10,126,4177,64,62,2769.22,4833.00,0.00
2024-12-08 16:54:10,127,4177,65,62,2747.41,4833.01,0.00
2024-12-08 16:54:10,126,4177,64,62,2768.46,4833.02,0.00
2024-12-08 16:54:10,125,4177,64,61,2778.26,4833.11,0.00
2024-12-08 16:54:10,125,4178,64,61,2836.42,4834.00,0.00
2024-12-08 16:54:10,126,4178,65,61,2813.91,4834.01,0.00
2024-12-08 16:54:10,125,4178,65,60,2823.31,4834.12,0.00
2024-12-08 16:54:10,126,4177,66,60,2754.07,4834.79,0.00
2024-12-08 16:54:10,126,4178,66,60,2788.78,4835.00,0.00
2024-12-08 16:54:10,127,4178,67,60,2766.82,4835.01,0.00
2024-12-08 16:54:10,126,4178,67,59,2775.77,4835.12,0.00
2024-12-08 16:54:10,125,4178,66,59,2790.69,4835.27,0.00
2024-12-08 16:54:10,126,4177,66,60,2755.27,4835.56,0.00
2024-12-08 16:54:10,125,4177,65,60,2788.93,4835.59,0.00
2024-12-08 16:54:10,125,4178,65,60,2831.40,4836.00,0.00
2024-12-08 16:54:10,126,4178,66,60,2808.93,4836.01,0.00
2024-12-08 16:54:10,125,4178,66,59,2821.19,4836.12,0.00
2024-12-08 16:54:10,124,4178,65,59,2829.83,4836.19,0.00
2024-12-08 16:54:10,124,4179,65,59,2868.97,4837.00,0.00
2024-12-08 16:54:10,125,4179,66,59,2846.02,4837.01,0.00
2024-12-08 16:54:10,124,4179,65,59,2867.43,4837.03,0.00
2024-12-08 16:54:10,123,4179,64,59,2886.14,4837.05,0.00
2024-12-08 16:54:10,122,4179,64,58,2899.10,4837.11,0.00
2024-12-08 16:54:10,123,4178,65,58,2870.84,4837.22,0.00
2024-12-08 16:54:10,124,4177,65,59,2853.55,4837.64,0.00
2024-12-08 16:54:10,124,4178,65,59,2886.60,4838.00,0.00
2024-12-08 16:54:10,125,4178,66,59,2863.51,4838.01,0.00
2024-12-08 16:54:10,126,4177,66,60,2840.41,4838.03,0.00
2024-12-08 16:54:10,125,4177,66,59,2854.25,4838.11,0.00
2024-12-08 16:54:10,126,4176,67,59,2824.76,4838.27,0.00
2024-12-08 16:54:10,125,4176,66,59,2848.41,4838.62,0.00
2024-12-08 16:54:10,125,4177,66,59,2931.15,4839.00,0.00
2024-12-08 16:54:10,126,4177,67,59,2907.89,4839.01,0.00
2024-12-08 16:54:10,125,4177,67,58,2918.79,4839.10,0.00
2024-12-08 16:54:10,124,4177,66,58,2921.09,4839.52,0.00
2024-12-08 16:54:10,123,4177,65,58,2926.03,4839.63,0.00
2024-12-08 16:54:10,123,4178,65,58,3026.65,4840.00,0.00
2024-12-08 16:54:10,124,4178,65,59,3002.24,4840.01,0.00
2024-12-08 16:54:11,123,4178,64,59,3022.69,4840.09,0.00
2024-12-08 16:54:11,124,4177,65,59,2997.54,4840.12,0.00
2024-12-08 16:54:11,123,4177,65,58,3023.88,4840.12,0.00
2024-12-08 16:54:11,124,4176,65,59,2994.47,4840.24,0.00
2024-12-08 16:54:11,123,4176,64,59,3031.05,4840.46,0.00
2024-12-08 16:54:11,123,4177,64,59,3042.68,4841.00,0.00
2024-12-08 16:54:11,124,4177,64,60,3018.14,4841.01,0.00
2024-12-08 16:54:11,124,4178,64,60,3062.39,4842.00,0.00
2024-12-08 16:54:11,125,4178,65,60,3037.89,4842.01,0.00
2024-12-08 16:54:11,124,4178,64,60,3053.07,4842.13,0.00
2024-12-08 16:54:11,123,4178,64,59,3076.31,4842.14,0.00
2024-12-08 16:54:11,123,4179,64,59,3072.28,4843.00,0.00
2024-12-08 16:54:11,124,4179,65,59,3047.51,4843.01,0.00
2024-12-08 16:54:11,124,4180,65,59,3013.51,4844.00,0.00
2024-12-08 16:54:11,125,4180,65,60,2989.40,4844.01,0.00
2024-12-08 16:54:11,124,4180,65,59,3011.19,4844.05,0.00
2024-12-08 16:54:11,123,4180,65,58,3029.00,4844.14,0.00
2024-12-08 16:54:11,124,4179,65,59,2983.92,4844.54,0.00
2024-12-08 16:54:11,124,4180,65,59,2999.51,4845.00,0.00
2024-12-08 16:54:11,125,4180,65,60,2975.52,4845.01,0.00
2024-12-08 16:54:11,124,4180,64,60,2997.19,4845.05,0.00
2024-12-08 16:54:11,123,4180,64,59,3020.69,4845.07,0.00
2024-12-08 16:54:11,124,4179,64,60,2976.98,4845.30,0.00
2024-12-08 16:54:11,125,4178,65,60,2953.23,4845.43,0.00
2024-12-08 16:54:11,124,4178,64,60,2986.27,4845.60,0.00
2024-12-08 16:54:11,124,4179,64,60,3045.20,4846.00,0.00
2024-12-08 16:54:11,125,4179,64,61,3020.83,4846.01,0.00
2024-12-08 16:54:11,126,4178,65,61,2996.86,4846.02,0.00
2024-12-08 16:54:11,125,4178,64,61,3026.68,4846.06,0.00
2024-12-08 16:54:11,124,4178,64,60,3045.25,4846.13,0.00
2024-12-08 16:54:11,123,4178,63,60,3035.58,4846.71,0.00
2024-12-08 16:54:11,123,4179,63,60,3121.99,4847.00,0.00
2024-12-08 16:54:11,124,4179,63,61,3096.82,4847.01,0.00
2024-12-08 16:54:11,123,4179,62,61,3118.08,4847.04,0.00
2024-12-08 16:54:11,122,4179,61,61,3118.66,4847.27,0.00
2024-12-08 16:54:11,121,4179,60,61,3124.07,4847.65,0.00
2024-12-08 16:54:11,121,4180,60,61,3184.81,4848.00,0.00
2024-12-08 16:54:11,122,4180,60,62,3158.71,4848.01,0.00
2024-12-08 16:54:11,122,4181,60,62,3120.63,4849.00,0.00
2024-12-08 16:54:11,123,4181,61,62,3095.26,4849.01,0.00
2024-12-08 16:54:11,122,4181,61,61,3118.67,4849.04,0.00
2024-12-08 16:54:11,122,4182,61,61,3080.86,4850.00,0.00
2024-12-08 16:54:11,123,4182,62,61,3055.82,4850.01,0.00
2024-12-08 16:54:11,122,4182,62,60,3070.98,4850.12,0.00
2024-12-08 16:54:11,121,4182,61,60,3070.78,4850.46,0.00
2024-12-08 16:54:11,121,4183,61,60,3083.17,4851.00,0.00
2024-12-08 16:54:11,122,4183,62,60,3057.89,4851.01,0.00
2024-12-08 16:54:11,121,4183,61,60,3080.11,4851.07,0.00
2024-12-08 16:54:11,120,4183,60,60,3049.55,4851.73,0.00
2024-12-08 16:54:11,120,4184,60,60,3075.92,4852.00,0.00
2024-12-08 16:54:11,121,4184,60,61,3050.50,4852.01,0.00
2024-12-08 16:54:11,120,4184,60,60,3069.91,4852.11,0.00
2024-12-08 16:54:11,119,4184,59,60,3091.95,4852.19,0.00
2024-12-08 16:54:11,120,4183,59,61,3062.99,4852.27,0.00
2024-12-08 16:54:11,121,4182,60,61,3027.46,4852.87,0.00
2024-12-08 16:54:11,121,4183,60,61,3049.42,4853.00,0.00
2024-12-08 16:54:11,122,4183,61,61,3024.42,4853.01,0.00
2024-12-08 16:54:11,121,4183,60,61,3024.22,4853.12,0.00
2024-12-08 16:54:11,122,4182,60,62,2956.81,4853.89,0.00
2024-12-08 16:54:11,122,4183,60,62,3074.26,4854.00,0.00
2024-12-08 16:54:11,123,4183,60,63,3049.26,4854.01,0.00
2024-12-08 16:54:11,123,4184,60,63,3046.99,4855.00,0.00
2024-12-08 16:54:11,124,4184,61,63,3022.42,4855.01,0.00
2024-12-08 16:54:11,123,4184,61,62,3040.33,4855.11,0.00
2024-12-08 16:54:11,122,4184,61,61,3045.19,4855.33,0.00
2024-12-08 16:54:11,122,4185,61,61,3036.91,4856.00,0.00
2024-12-08 16:54:11,123,4185,62,61,3012.22,4856.01,0.00
2024-12-08 16:54:11,123,4186,62,61,2991.90,4857.00,0.00
2024-12-08 16:54:11,124,4186,63,61,2967.77,4857.01,0.00
2024-12-08 16:54:11,125,4185,64,61,2918.17,4857.40,0.00
2024-12-08 16:54:11,124,4185,63,61,2967.29,4857.60,0.00
2024-12-08 16:54:11,124,4186,63,61,2978.62,4858.00,0.00
2024-12-08 16:54:11,125,4186,64,61,2954.79,4858.01,0.00
2024-12-08 16:54:11,125,4187,64,61,2956.65,4859.00,0.00
2024-12-08 16:54:11,126,4187,65,61,2933.18,4859.01,0.00
2024-12-08 16:54:11,125,4187,65,60,2954.34,4859.05,0.00
2024-12-08 16:54:11,124,4187,64,60,2923.89,4859.86,0.00
2024-12-08 16:54:11,124,4188,64,60,2940.47,4860.00,0.00
2024-12-08 16:54:11,125,4188,64,61,2916.95,4860.01,0.00
2024-12-08 16:54:11,124,4188,64,60,2933.45,4860.07,0.00
2024-12-08 16:54:11,124,4189,64,60,2912.46,4861.00,0.00
2024-12-08 16:54:11,125,4189,65,60,2889.16,4861.01,0.00
2024-12-08 16:54:11,126,4188,66,60,2828.35,4861.65,0.00
2024-12-08 16:54:11,127,4187,66,61,2809.64,4861.81,0.00
2024-12-08 16:54:11,127,4188,66,61,2852.60,4862.00,0.00
2024-12-08 16:54:11,128,4188,66,62,2830.31,4862.01,0.00
2024-12-08 16:54:12,129,4187,66,63,2806.14,4862.07,0.00
2024-12-08 16:54:12,129,4188,66,63,2874.77,4863.00,0.00
2024-12-08 16:54:12,130,4188,67,63,2852.66,4863.01,0.00
2024-12-08 16:54:12,129,4188,67,62,2872.91,4863.04,0.00
2024-12-08 16:54:12,128,4188,67,61,2894.23,4863.06,0.00
2024-12-08 16:54:12,127,4188,67,60,2910.13,4863.07,0.00
2024-12-08 16:54:12,128,4187,67,61,2847.98,4863.91,0.00
2024-12-08 16:54:12,128,4188,67,61,2885.43,4864.00,0.00
2024-12-08 16:54:12,129,4188,67,62,2863.06,4864.01,0.00
2024-12-08 16:54:12,130,4187,68,62,2840.30,4864.04,0.00
2024-12-08 16:54:12,129,4187,68,61,2866.12,4864.09,0.00
2024-12-08 16:54:12,130,4186,69,61,2842.96,4864.12,0.00
2024-12-08 16:54:12,129,4186,68,61,2862.03,4864.24,0.00
2024-12-08 16:54:12,128,4186,67,61,2847.86,4864.91,0.00
2024-12-08 16:54:12,128,4187,67,61,2919.75,4865.00,0.00
2024-12-08 16:54:12,129,4187,68,61,2897.12,4865.01,0.00
2024-12-08 16:54:12,128,4187,68,60,2910.67,4865.08,0.00
2024-12-08 16:54:12,129,4186,69,60,2832.76,4865.86,0.00
2024-12-08 16:54:12,128,4186,68,60,2866.34,4865.91,0.00
2024-12-08 16:54:12,128,4187,68,60,2976.26,4866.00,0.00
2024-12-08 16:54:12,129,4187,69,60,2953.19,4866.01,0.00
2024-12-08 16:54:12,130,4186,69,61,2898.18,4866.42,0.00
2024-12-08 16:54:12,131,4185,70,61,2893.16,4866.45,0.00
2024-12-08 16:54:12,131,4186,70,61,2955.19,4867.00,0.00
2024-12-08 16:54:12,132,4186,71,61,2932.80,4867.01,0.00
2024-12-08 16:54:12,133,4185,72,61,2890.65,4867.29,0.00
2024-12-08 16:54:12,132,4185,72,60,2930.81,4867.29,0.00
2024-12-08 16:54:12,133,4184,72,61,2887.82,4867.74,0.00
2024-12-08 16:54:12,133,4185,72,61,2985.35,4868.00,0.00
2024-12-08 16:54:12,134,4185,72,62,2963.07,4868.01,0.00
2024-12-08 16:54:12,134,4186,72,62,3007.92,4869.00,0.00
2024-12-08 16:54:12,135,4186,73,62,2985.64,4869.01,0.00
2024-12-08 16:54:12,134,4186,72,62,3003.77,4869.08,0.00
2024-12-08 16:54:12,134,4187,72,62,2974.18,4870.00,0.00
2024-12-08 16:54:12,135,4187,72,63,2952.15,4870.01,0.00
2024-12-08 16:54:12,134,4187,72,62,2965.13,4870.08,0.00
2024-12-08 16:54:12,134,4188,72,62,2942.80,4871.00,0.00
2024-12-08 16:54:12,135,4188,73,62,2921.01,4871.01,0.00
2024-12-08 16:54:12,134,4188,73,61,2939.57,4871.06,0.00
2024-12-08 16:54:12,133,4188,73,60,2956.91,4871.08,0.00
2024-12-08 16:54:12,132,4188,72,60,2971.21,4871.11,0.00
2024-12-08 16:54:12,132,4189,72,60,2965.36,4872.00,0.00
2024-12-08 16:54:12,133,4189,73,60,2943.06,4872.01,0.00
2024-12-08 16:54:12,132,4189,73,59,2958.01,4872.08,0.00
2024-12-08 16:54:12,132,4190,73,59,2933.52,4873.00,0.00
2024-12-08 16:54:12,133,4190,74,59,2911.47,4873.01,0.00
2024-12-08 16:54:12,132,4190,74,58,2924.34,4873.09,0.00
2024-12-08 16:54:12,131,4190,73,58,2933.28,4873.10,0.00
2024-12-08 16:54:12,131,4191,73,58,2922.08,4874.00,0.00
2024-12-08 16:54:12,132,4191,73,59,2899.94,4874.01,0.00
2024-12-08 16:54:12,132,4192,73,59,2869.68,4875.00,0.00
2024-12-08 16:54:12,133,4192,74,59,2848.10,4875.01,0.00
2024-12-08 16:54:12,134,4191,74,60,2784.29,4875.75,0.00
2024-12-08 16:54:12,134,4192,74,60,2800.60,4876.00,0.00
2024-12-08 16:54:12,135,4192,74,61,2779.86,4876.01,0.00
2024-12-08 16:54:12,135,4193,74,61,2772.98,4877.00,0.00
2024-12-08 16:54:12,136,4193,74,62,2752.59,4877.01,0.00
2024-12-08 16:54:12,137,4192,74,63,2732.50,4877.02,0.00
2024-12-08 16:54:12,136,4192,74,62,2760.87,4877.07,0.00
2024-12-08 16:54:12,135,4192,74,61,2774.11,4877.10,0.00
2024-12-08 16:54:12,135,4193,74,61,2740.18,4878.00,0.00
2024-12-08 16:54:12,136,4193,74,62,2720.03,4878.01,0.00
2024-12-08 16:54:12,135,4193,74,61,2731.92,4878.09,0.00
2024-12-08 16:54:12,134,4193,73,61,2747.57,4878.09,0.00
2024-12-08 16:54:12,135,4192,74,61,2710.38,4878.45,0.00
2024-12-08 16:54:12,135,4193,74,61,2760.69,4879.00,0.00
2024-12-08 16:54:12,136,4193,75,61,2740.39,4879.01,0.00
2024-12-08 16:54:12,135,4193,75,60,2752.42,4879.09,0.00
2024-12-08 16:54:12,136,4192,76,60,2715.11,4879.46,0.00
2024-12-08 16:54:12,137,4191,77,60,2698.18,4879.53,0.00
2024-12-08 16:54:12,138,4190,77,61,2670.96,4879.71,0.00
2024-12-08 16:54:12,137,4190,77,60,2689.58,4879.73,0.00
2024-12-08 16:54:12,137,4191,77,60,2739.28,4880.00,0.00
2024-12-08 16:54:12,138,4191,77,61,2719.43,4880.01,0.00
2024-12-08 16:54:12,137,4191,77,60,2730.42,4880.10,0.00
2024-12-08 16:54:12,138,4190,77,61,2675.12,4880.55,0.00
2024-12-08 16:54:12,137,4190,76,61,2690.48,4880.83,0.00
2024-12-08 16:54:12,137,4191,76,61,2814.13,4881.00,0.00
2024-12-08 16:54:12,138,4191,77,61,2793.74,4881.01,0.00
2024-12-08 16:54:12,137,4191,77,60,2804.56,4881.10,0.00
2024-12-08 16:54:12,137,4192,77,60,2798.86,4882.00,0.00
2024-12-08 16:54:12,138,4192,78,60,2778.57,4882.01,0.00
2024-12-08 16:54:12,137,4192,77,60,2771.86,4882.21,0.00
2024-12-08 16:54:12,138,4191,77,61,2724.95,4882.76,0.00
2024-12-08 16:54:12,137,4191,77,60,2735.89,4882.87,0.00
2024-12-08 16:54:12,138,4190,78,60,2715.71,4882.88,0.00
2024-12-08 16:54:12,138,4191,78,60,2748.72,4883.00,0.00
2024-12-08 16:54:12,139,4191,79,60,2728.95,4883.01,0.00
2024-12-08 16:54:12,138,4191,79,59,2738.15,4883.12,0.00
2024-12-08 16:54:12,139,4190,80,59,2693.95,4883.35,0.00
2024-12-08 16:54:13,139,4191,80,59,2775.21,4884.00,0.00
2024-12-08 16:54:13,140,4191,80,60,2755.39,4884.01,0.00
2024-12-08 16:54:13,139,4191,80,59,2764.36,4884.12,0.00
2024-12-08 16:54:13,140,4190,80,60,2709.92,4884.56,0.00
2024-12-08 16:54:13,139,4190,79,60,2720.96,4884.78,0.00
2024-12-08 16:54:13,140,4189,80,60,2700.84,4884.81,0.00
2024-12-08 16:54:13,140,4190,80,60,2786.90,4885.00,0.00
2024-12-08 16:54:13,141,4190,80,61,2767.13,4885.01,0.00
2024-12-08 16:54:13,140,4190,80,60,2772.99,4885.14,0.00
2024-12-08 16:54:13,139,4190,79,60,2777.25,4885.40,0.00
2024-12-08 16:54:13,138,4190,78,60,2782.35,4885.69,0.00
2024-12-08 16:54:13,138,4191,78,60,2869.01,4886.00,0.00
2024-12-08 16:54:13,139,4191,79,60,2848.37,4886.01,0.00
2024-12-08 16:54:13,138,4191,78,60,2867.25,4886.03,0.00
2024-12-08 16:54:13,137,4191,78,59,2874.67,4886.15,0.00
2024-12-08 16:54:13,138,4190,78,60,2840.15,4886.45,0.00
2024-12-08 16:54:13,137,4190,77,60,2854.20,4886.80,0.00
2024-12-08 16:54:13,138,4189,78,60,2829.33,4886.90,0.00
2024-12-08 16:54:13,138,4190,78,60,2862.01,4887.00,0.00
2024-12-08 16:54:13,139,4190,78,61,2841.42,4887.01,0.00
2024-12-08 16:54:13,138,4190,77,61,2818.30,4887.46,0.00
2024-12-08 16:54:13,138,4191,77,61,2894.79,4888.00,0.00
2024-12-08 16:54:13,139,4191,78,61,2873.97,4888.01,0.00
2024-12-08 16:54:13,140,4190,79,61,2847.20,4888.15,0.00
2024-12-08 16:54:13,139,4190,79,60,2894.78,4888.17,0.00
2024-12-08 16:54:13,140,4189,79,61,2868.21,4888.31,0.00
2024-12-08 16:54:13,140,4190,79,61,2878.94,4889.00,0.00
2024-12-08 16:54:13,141,4190,80,61,2858.53,4889.01,0.00
2024-12-08 16:54:13,141,4191,80,61,2889.97,4890.00,0.00
2024-12-08 16:54:13,142,4191,81,61,2869.62,4890.01,0.00
2024-12-08 16:54:13,141,4191,81,60,2886.19,4890.08,0.00
2024-12-08 16:54:13,140,4191,81,59,2902.65,4890.16,0.00
2024-12-08 16:54:13,139,4191,80,59,2896.64,4890.64,0.00
2024-12-08 16:54:13,140,4190,81,59,2875.26,4890.66,0.00
2024-12-08 16:54:13,140,4191,81,59,2882.35,4891.00,0.00
2024-12-08 16:54:13,141,4191,81,60,2861.91,4891.01,0.00
2024-12-08 16:54:13,140,4191,81,59,2853.77,4891.16,0.00
2024-12-08 16:54:13,141,4190,82,59,2801.58,4891.75,0.00
2024-12-08 16:54:13,141,4191,82,59,2861.81,4892.00,0.00
2024-12-08 16:54:13,142,4191,82,60,2841.66,4892.01,0.00
2024-12-08 16:54:13,141,4191,81,60,2819.00,4892.55,0.00
2024-12-08 16:54:13,141,4192,81,60,2865.24,4893.00,0.00
2024-12-08 16:54:13,142,4192,82,60,2845.06,4893.01,0.00
2024-12-08 16:54:13,141,4192,81,60,2862.83,4893.05,0.00
2024-12-08 16:54:13,140,4192,80,60,2881.89,4893.07,0.00
2024-12-08 16:54:13,139,4192,79,60,2881.26,4893.35,0.00
2024-12-08 16:54:13,139,4193,79,60,2880.74,4894.00,0.00
2024-12-08 16:54:13,140,4193,79,61,2860.16,4894.01,0.00
2024-12-08 16:54:13,139,4193,79,60,2873.05,4894.16,0.00
2024-12-08 16:54:13,138,4193,78,60,2892.46,4894.18,0.00
2024-12-08 16:54:13,137,4193,78,59,2911.79,4894.18,0.00
2024-12-08 16:54:13,136,4193,77,59,2900.16,4894.58,0.00
2024-12-08 16:54:13,136,4194,77,59,2901.19,4895.00,0.00
2024-12-08 16:54:13,137,4194,77,60,2880.01,4895.01,0.00
2024-12-08 16:54:13,136,4194,76,60,2868.91,4895.40,0.00
2024-12-08 16:54:13,136,4195,76,60,2873.35,4896.00,0.00
2024-12-08 16:54:13,137,4195,77,60,2852.37,4896.01,0.00
2024-12-08 16:54:13,136,4195,76,60,2869.78,4896.07,0.00
2024-12-08 16:54:13,136,4196,76,60,2840.37,4897.00,0.00
2024-12-08 16:54:13,137,4196,77,60,2819.63,4897.01,0.00
2024-12-08 16:54:13,136,4196,76,60,2838.23,4897.04,0.00
2024-12-08 16:54:13,135,4196,76,59,2857.81,4897.07,0.00
2024-12-08 16:54:13,134,4196,75,59,2848.60,4897.52,0.00
2024-12-08 16:54:13,135,4195,75,60,2825.34,4897.58,0.00
2024-12-08 16:54:13,135,4196,75,60,2836.80,4898.00,0.00
2024-12-08 16:54:13,136,4196,75,61,2815.94,4898.01,0.00
2024-12-08 16:54:13,135,4196,75,60,2825.97,4898.16,0.00
2024-12-08 16:54:13,134,4196,74,60,2838.72,4898.34,0.00
2024-12-08 16:54:13,133,4196,73,60,2858.98,4898.35,0.00
2024-12-08 16:54:13,133,4197,73,60,2885.11,4899.00,0.00
2024-12-08 16:54:13,134,4197,73,61,2863.58,4899.01,0.00
2024-12-08 16:54:13,133,4197,72,61,2879.56,4899.12,0.00
2024-12-08 16:54:13,134,4196,72,62,2819.66,4899.78,0.00
2024-12-08 16:54:13,135,4195,72,63,2803.17,4899.83,0.00
2024-12-08 16:54:13,135,4196,72,63,2821.82,4900.00,0.00
2024-12-08 16:54:13,136,4196,73,63,2801.07,4900.01,0.00
2024-12-08 16:54:13,135,4196,73,62,2813.17,4900.17,0.00
2024-12-08 16:54:13,134,4196,72,62,2810.22,4900.66,0.00
2024-12-08 16:54:13,135,4195,72,63,2789.40,4900.67,0.00
2024-12-08 16:54:13,135,4196,72,63,2876.78,4901.00,0.00
2024-12-08 16:54:13,136,4196,73,63,2855.63,4901.01,0.00
2024-12-08 16:54:13,135,4196,73,62,2861.23,4901.17,0.00
2024-12-08 16:54:13,135,4197,73,62,2879.18,4902.00,0.00
2024-12-08 16:54:13,136,4197,73,63,2858.01,4902.01,0.00
2024-12-08 16:54:13,135,4197,72,63,2875.22,4902.08,0.00
2024-12-08 16:54:13,134,4197,72,62,2884.96,4902.17,0.00
2024-12-08 16:54:13,134,4198,72,62,2866.83,4903.00,0.00
2024-12-08 16:54:13,135,4198,72,63,2845.60,4903.01,0.00
2024-12-08 16:54:13,136,4197,72,64,2816.80,4903.18,0.00
2024-12-08 16:54:13,136,4198,72,64,2810.89,4904.00,0.00
2024-12-08 16:54:13,137,4198,72,65,2790.38,4904.01,0.00
2024-12-08 16:54:13,138,4197,72,66,2762.24,4904.17,0.00
2024-12-08 16:54:13,137,4197,72,65,2795.31,4904.19,0.00
2024-12-08 16:54:13,138,4196,72,66,2737.75,4904.94,0.00
2024-12-08 16:54:14,138,4197,72,66,2807.47,4905.00,0.00
2024-12-08 16:54:14,139,4197,73,66,2787.27,4905.01,0.00
2024-12-08 16:54:14,138,4197,72,66,2795.44,4905.15,0.00
2024-12-08 16:54:14,139,4196,72,67,2748.69,4905.56,0.00
2024-12-08 16:54:14,139,4197,72,67,2851.48,4906.00,0.00
2024-12-08 16:54:14,140,4197,73,67,2831.11,4906.01,0.00
2024-12-08 16:54:14,141,4196,73,68,2807.58,4906.09,0.00
2024-12-08 16:54:14,140,4196,73,67,2849.05,4906.19,0.00
2024-12-08 16:54:14,139,4196,72,67,2835.62,4906.76,0.00
2024-12-08 16:54:14,139,4197,72,67,2880.64,4907.00,0.00
2024-12-08 16:54:14,140,4197,72,68,2860.07,4907.01,0.00
2024-12-08 16:54:14,140,4198,72,68,2853.15,4908.00,0.00
2024-12-08 16:54:14,141,4198,73,68,2832.92,4908.01,0.00
2024-12-08 16:54:14,140,4198,73,67,2844.11,4908.18,0.00
2024-12-08 16:54:14,139,4198,72,67,2830.29,4908.51,0.00
2024-12-08 16:54:14,138,4198,71,67,2827.94,4908.77,0.00
2024-12-08 16:54:14,138,4199,71,67,2852.32,4909.00,0.00
2024-12-08 16:54:14,139,4199,72,67,2831.80,4909.01,0.00
2024-12-08 16:54:14,138,4199,72,66,2822.15,4909.18,0.00
2024-12-08 16:54:14,137,4199,72,65,2823.32,4909.45,0.00
2024-12-08 16:54:14,136,4199,71,65,2827.28,4909.73,0.00
2024-12-08 16:54:14,136,4200,71,65,2850.25,4910.00,0.00
2024-12-08 16:54:14,137,4200,71,66,2829.44,4910.01,0.00
2024-12-08 16:54:14,136,4200,71,65,2834.07,4910.18,0.00
2024-12-08 16:54:14,135,4200,70,65,2845.97,4910.20,0.00
2024-12-08 16:54:14,136,4199,70,66,2823.25,4910.25,0.00
2024-12-08 16:54:14,135,4199,69,66,2863.88,4910.39,0.00
2024-12-08 16:54:14,136,4198,70,66,2815.76,4910.96,0.00
2024-12-08 16:54:14,136,4199,70,66,2865.63,4911.00,0.00
2024-12-08 16:54:14,137,4199,70,67,2844.72,4911.01,0.00
2024-12-08 16:54:14,138,4198,70,68,2796.16,4911.45,0.00
2024-12-08 16:54:14,138,4199,70,68,2878.17,4912.00,0.00
2024-12-08 16:54:14,139,4199,70,69,2857.46,4912.01,0.00
2024-12-08 16:54:14,139,4200,70,69,2863.03,4913.00,0.00
2024-12-08 16:54:14,140,4200,71,69,2842.58,4913.01,0.00
2024-12-08 16:54:14,139,4200,70,69,2857.76,4913.11,0.00
2024-12-08 16:54:14,138,4200,69,69,2878.12,4913.11,0.00
2024-12-08 16:54:14,137,4200,68,69,2869.03,4913.49,0.00
2024-12-08 16:54:14,137,4201,68,69,2880.05,4914.00,0.00
2024-12-08 16:54:14,138,4201,69,69,2859.19,4914.01,0.00
2024-12-08 16:54:14,137,4201,69,68,2870.07,4914.18,0.00
2024-12-08 16:54:14,137,4202,69,68,2851.58,4915.00,0.00
2024-12-08 16:54:14,138,4202,69,69,2830.92,4915.01,0.00
2024-12-08 16:54:14,137,4202,68,69,2846.23,4915.11,0.00
2024-12-08 16:54:14,137,4203,68,69,2826.05,4916.00,0.00
2024-12-08 16:54:14,138,4203,69,69,2805.57,4916.01,0.00
2024-12-08 16:54:14,137,4203,69,68,2820.70,4916.11,0.00
2024-12-08 16:54:14,138,4202,70,68,2797.79,4916.17,0.00
2024-12-08 16:54:14,138,4203,70,68,2802.74,4917.00,0.00
2024-12-08 16:54:14,139,4203,70,69,2782.57,4917.01,0.00
2024-12-08 16:54:14,140,4202,70,70,2716.71,4917.82,0.00
2024-12-08 16:54:14,140,4203,70,70,2781.21,4918.00,0.00
2024-12-08 16:54:14,141,4203,70,71,2761.49,4918.01,0.00
2024-12-08 16:54:14,141,4204,70,71,2772.05,4919.00,0.00
2024-12-08 16:54:14,142,4204,71,71,2752.53,4919.01,0.00
2024-12-08 16:54:14,141,4204,70,71,2768.58,4919.07,0.00
2024-12-08 16:54:14,141,4205,70,71,2744.83,4920.00,0.00
2024-12-08 16:54:14,142,4205,71,71,2725.50,4920.01,0.00
2024-12-08 16:54:14,142,4206,71,71,2693.36,4921.00,0.00
2024-12-08 16:54:14,143,4206,71,72,2674.52,4921.01,0.00
2024-12-08 16:54:14,144,4205,71,73,2652.22,4921.10,0.00
2024-12-08 16:54:14,143,4205,71,72,2684.21,4921.15,0.00
2024-12-08 16:54:14,144,4204,71,73,2664.89,4921.18,0.00
2024-12-08 16:54:14,144,4205,71,73,2674.61,4922.00,0.00
2024-12-08 16:54:14,145,4205,71,74,2656.16,4922.01,0.00
2024-12-08 16:54:14,144,4205,71,73,2664.06,4922.15,0.00
2024-12-08 16:54:14,143,4205,70,73,2673.41,4922.34,0.00
2024-12-08 16:54:14,144,4204,70,74,2651.46,4922.42,0.00
2024-12-08 16:54:14,145,4203,71,74,2634.97,4922.77,0.00
2024-12-08 16:54:14,146,4202,72,74,2613.30,4922.88,0.00
2024-12-08 16:54:14,146,4203,72,74,2699.04,4923.00,0.00
2024-12-08 16:54:14,147,4203,73,74,2680.67,4923.01,0.00
2024-12-08 16:54:14,146,4203,72,74,2693.68,4923.11,0.00
2024-12-08 16:54:14,145,4203,72,73,2707.38,4923.15,0.00
2024-12-08 16:54:14,145,4204,72,73,2788.35,4924.00,0.00
2024-12-08 16:54:14,146,4204,73,73,2769.26,4924.01,0.00
2024-12-08 16:54:14,145,4204,72,73,2777.18,4924.09,0.00
2024-12-08 16:54:14,144,4204,72,72,2776.76,4924.35,0.00
2024-12-08 16:54:14,143,4204,71,72,2795.49,4924.36,0.00
2024-12-08 16:54:14,144,4203,72,72,2769.65,4924.50,0.00
2024-12-08 16:54:14,144,4204,72,72,2794.64,4925.00,0.00
2024-12-08 16:54:14,145,4204,73,72,2775.37,4925.01,0.00
2024-12-08 16:54:14,146,4203,74,72,2756.36,4925.02,0.00
2024-12-08 16:54:14,147,4202,74,73,2752.70,4925.05,0.00
2024-12-08 16:54:14,148,4201,74,74,2725.07,4925.68,0.00
2024-12-08 16:54:14,148,4202,74,74,2786.87,4926.00,0.00
2024-12-08 16:54:14,149,4202,75,74,2768.16,4926.01,0.00
2024-12-08 16:54:15,148,4202,75,73,2774.95,4926.16,0.00
2024-12-08 16:54:15,148,4203,75,73,2852.81,4927.00,0.00
2024-12-08 16:54:15,149,4203,76,73,2833.66,4927.01,0.00
2024-12-08 16:54:15,148,4203,76,72,2828.24,4927.16,0.00
2024-12-08 16:54:15,148,4204,76,72,2818.42,4928.00,0.00
2024-12-08 16:54:15,149,4204,76,73,2799.50,4928.01,0.00
2024-12-08 16:54:15,148,4204,75,73,2812.80,4928.12,0.00
2024-12-08 16:54:15,147,4204,75,72,2825.25,4928.16,0.00
2024-12-08 16:54:15,148,4203,75,73,2766.80,4928.95,0.00
2024-12-08 16:54:15,148,4204,75,73,2810.50,4929.00,0.00
2024-12-08 16:54:15,149,4204,76,73,2791.64,4929.01,0.00
2024-12-08 16:54:15,148,4204,76,72,2798.58,4929.16,0.00
2024-12-08 16:54:15,147,4204,75,72,2812.92,4929.16,0.00
2024-12-08 16:54:15,148,4203,75,73,2785.52,4929.35,0.00
2024-12-08 16:54:15,149,4202,76,73,2780.79,4929.48,0.00
2024-12-08 16:54:15,149,4203,76,73,2849.98,4930.00,0.00
2024-12-08 16:54:15,150,4203,77,73,2830.98,4930.01,0.00
2024-12-08 16:54:15,149,4203,76,73,2847.68,4930.05,0.00
2024-12-08 16:54:15,148,4203,75,73,2863.61,4930.11,0.00
2024-12-08 16:54:15,147,4203,74,73,2864.73,4930.33,0.00
2024-12-08 16:54:15,147,4204,74,73,2931.23,4931.00,0.00
2024-12-08 16:54:15,148,4204,75,73,2911.42,4931.01,0.00
2024-12-08 16:54:15,149,4203,75,74,2844.16,4931.60,0.00
2024-12-08 16:54:15,149,4204,75,74,2858.13,4932.00,0.00
2024-12-08 16:54:15,150,4204,75,75,2839.08,4932.01,0.00
2024-12-08 16:54:15,149,4204,74,75,2856.16,4932.04,0.00
2024-12-08 16:54:15,148,4204,74,74,2865.84,4932.15,0.00
2024-12-08 16:54:15,149,4203,74,75,2837.28,4932.35,0.00
2024-12-08 16:54:15,148,4203,73,75,2849.90,4932.55,0.00
2024-12-08 16:54:15,148,4204,73,75,2893.29,4933.00,0.00
2024-12-08 16:54:15,149,4204,74,75,2873.88,4933.01,0.00
2024-12-08 16:54:15,150,4203,74,76,2853.42,4933.05,0.00
2024-12-08 16:54:15,151,4202,74,77,2856.48,4933.13,0.00
2024-12-08 16:54:15,151,4203,74,77,2863.21,4934.00,0.00
2024-12-08 16:54:15,152,4203,75,77,2844.38,4934.01,0.00
2024-12-08 16:54:15,151,4203,74,77,2858.35,4934.10,0.00
2024-12-08 16:54:15,150,4203,74,76,2870.35,4934.14,0.00
2024-12-08 16:54:15,151,4202,74,77,2833.52,4934.52,0.00
2024-12-08 16:54:15,150,4202,73,77,2855.01,4934.75,0.00
2024-12-08 16:54:15,150,4203,73,77,2928.25,4935.00,0.00
2024-12-08 16:54:15,151,4203,74,77,2908.86,4935.01,0.00
2024-12-08 16:54:15,150,4203,73,77,2925.97,4935.05,0.00
2024-12-08 16:54:15,149,4203,73,76,2937.37,4935.14,0.00
2024-12-08 16:54:15,150,4202,73,77,2865.94,4935.91,0.00
2024-12-08 16:54:15,150,4203,73,77,2929.53,4936.00,0.00
2024-12-08 16:54:15,151,4203,73,78,2910.13,4936.01,0.00
2024-12-08 16:54:15,150,4203,73,77,2918.40,4936.15,0.00
2024-12-08 16:54:15,151,4202,73,78,2853.67,4936.80,0.00
2024-12-08 16:54:15,151,4203,73,78,2913.22,4937.00,0.00
2024-12-08 16:54:15,152,4203,73,79,2894.05,4937.01,0.00
2024-12-08 16:54:15,151,4203,73,78,2902.16,4937.15,0.00
2024-12-08 16:54:15,152,4202,74,78,2838.02,4937.79,0.00
2024-12-08 16:54:15,152,4203,74,78,2897.23,4938.00,0.00
2024-12-08 16:54:15,153,4203,74,79,2878.29,4938.01,0.00
2024-12-08 16:54:15,152,4203,73,79,2896.58,4938.01,0.00
2024-12-08 16:54:15,151,4203,73,78,2903.47,4938.16,0.00
2024-12-08 16:54:15,150,4203,72,78,2904.24,4938.45,0.00
2024-12-08 16:54:15,150,4204,72,78,2939.16,4939.00,0.00
2024-12-08 16:54:15,151,4204,72,79,2919.70,4939.01,0.00
2024-12-08 16:54:15,150,4204,72,78,2926.39,4939.17,0.00
2024-12-08 16:54:15,150,4205,72,78,2901.51,4940.00,0.00
2024-12-08 16:54:15,151,4205,73,78,2882.29,4940.01,0.00
2024-12-08 16:54:15,152,4204,74,78,2830.93,4940.28,0.00
2024-12-08 16:54:15,151,4204,73,78,2850.35,4940.32,0.00
2024-12-08 16:54:15,151,4205,73,78,2847.82,4941.00,0.00
2024-12-08 16:54:15,152,4205,74,78,2829.08,4941.01,0.00
2024-12-08 16:54:15,151,4205,74,77,2839.04,4941.18,0.00
2024-12-08 16:54:15,150,4205,73,77,2845.82,4941.41,0.00
2024-12-08 16:54:15,151,4204,73,78,2815.86,4941.64,0.00
2024-12-08 16:54:15,151,4205,73,78,2854.55,4942.00,0.00
2024-12-08 16:54:15,152,4205,74,78,2835.77,4942.01,0.00
2024-12-08 16:54:15,152,4206,74,78,2834.15,4943.00,0.00
2024-12-08 16:54:15,153,4206,74,79,2815.63,4943.01,0.00
2024-12-08 16:54:15,152,4206,73,79,2833.51,4943.01,0.00
2024-12-08 16:54:15,153,4205,74,79,2811.78,4943.09,0.00
2024-12-08 16:54:15,153,4206,74,79,2802.49,4944.00,0.00
2024-12-08 16:54:15,154,4206,74,80,2784.29,4944.01,0.00
2024-12-08 16:54:15,153,4206,74,79,2789.94,4944.17,0.00
2024-12-08 16:54:15,153,4207,74,79,2792.88,4945.00,0.00
2024-12-08 16:54:15,154,4207,75,79,2774.74,4945.01,0.00
2024-12-08 16:54:15,153,4207,74,79,2791.60,4945.03,0.00
2024-12-08 16:54:15,154,4206,75,79,2770.29,4945.10,0.00
2024-12-08 16:54:15,153,4206,75,78,2808.37,4945.12,0.00
2024-12-08 16:54:15,154,4205,75,79,2758.63,4945.55,0.00
2024-12-08 16:54:15,154,4206,75,79,2768.49,4946.00,0.00
2024-12-08 16:54:15,155,4206,76,79,2750.63,4946.01,0.00
2024-12-08 16:54:15,154,4206,76,78,2756.66,4946.11,0.00
2024-12-08 16:54:15,153,4206,75,78,2774.35,4946.11,0.00
2024-12-08 16:54:16,152,4206,74,78,2745.30,4946.82,0.00
2024-12-08 16:54:16,152,4207,74,78,2821.75,4947.00,0.00
2024-12-08 16:54:16,153,4207,74,79,2803.31,4947.01,0.00
2024-12-08 16:54:16,152,4207,73,79,2783.51,4947.57,0.00
2024-12-08 16:54:16,152,4208,73,79,2780.12,4948.00,0.00
2024-12-08 16:54:16,153,4208,74,79,2761.95,4948.01,0.00
2024-12-08 16:54:16,152,4208,74,78,2715.59,4948.97,0.00
2024-12-08 16:54:16,152,4209,74,78,2740.51,4949.00,0.00
2024-12-08 16:54:16,153,4209,75,78,2722.60,4949.01,0.00
2024-12-08 16:54:16,152,4209,74,78,2727.95,4949.11,0.00
2024-12-08 16:54:16,153,4208,75,78,2706.57,4949.20,0.00
2024-12-08 16:54:16,154,4207,76,78,2658.95,4949.94,0.00
2024-12-08 16:54:16,154,4208,76,78,2678.41,4950.00,0.00
2024-12-08 16:54:16,155,4208,76,79,2661.13,4950.01,0.00
2024-12-08 16:54:16,156,4207,76,80,2643.76,4950.03,0.00
2024-12-08 16:54:16,155,4207,76,79,2660.72,4950.10,0.00
2024-12-08 16:54:16,155,4208,76,79,2697.39,4951.00,0.00
2024-12-08 16:54:16,156,4208,77,79,2680.10,4951.01,0.00
2024-12-08 16:54:16,157,4207,78,79,2660.84,4951.06,0.00
2024-12-08 16:54:16,158,4206,78,80,2657.49,4951.10,0.00
2024-12-08 16:54:16,157,4206,77,80,2676.29,4951.16,0.00
2024-12-08 16:54:16,156,4206,77,79,2656.23,4951.42,0.00
2024-12-08 16:54:16,155,4206,76,79,2666.65,4951.56,0.00
2024-12-08 16:54:16,155,4207,76,79,2708.59,4952.00,0.00
2024-12-08 16:54:16,156,4207,76,80,2691.23,4952.01,0.00
2024-12-08 16:54:16,155,4207,75,80,2704.16,4952.09,0.00
2024-12-08 16:54:16,154,4207,75,79,2721.08,4952.10,0.00
2024-12-08 16:54:16,153,4207,74,79,2738.30,4952.10,0.00
2024-12-08 16:54:16,152,4207,74,78,2749.60,4952.11,0.00
2024-12-08 16:54:16,151,4207,73,78,2742.60,4952.34,0.00
2024-12-08 16:54:16,151,4208,73,78,2805.65,4953.00,0.00
2024-12-08 16:54:16,152,4208,73,79,2787.19,4953.01,0.00
2024-12-08 16:54:16,151,4208,72,79,2799.95,4953.11,0.00
2024-12-08 16:54:16,150,4208,72,78,2814.65,4953.11,0.00
2024-12-08 16:54:16,150,4209,72,78,2798.67,4954.00,0.00
2024-12-08 16:54:16,151,4209,72,79,2780.13,4954.01,0.00
2024-12-08 16:54:16,150,4209,71,79,2775.21,4954.35,0.00
2024-12-08 16:54:16,151,4208,72,79,2743.51,4954.63,0.00
2024-12-08 16:54:16,152,4207,73,79,2732.99,4954.69,0.00
2024-12-08 16:54:16,152,4208,73,79,2753.38,4955.00,0.00
2024-12-08 16:54:16,153,4208,74,79,2735.39,4955.01,0.00
2024-12-08 16:54:16,154,4207,75,79,2686.72,4955.51,0.00
2024-12-08 16:54:16,155,4206,75,80,2665.34,4955.68,0.00
2024-12-08 16:54:16,155,4207,75,80,2750.42,4956.00,0.00
2024-12-08 16:54:16,156,4207,75,81,2732.79,4956.01,0.00
2024-12-08 16:54:16,157,4206,75,82,2701.24,4956.18,0.00
2024-12-08 16:54:16,157,4207,75,82,2773.81,4957.00,0.00
2024-12-08 16:54:16,158,4207,75,83,2756.25,4957.01,0.00
2024-12-08 16:54:16,157,4207,74,83,2768.80,4957.10,0.00
2024-12-08 16:54:16,156,4207,73,83,2767.75,4957.34,0.00
2024-12-08 16:54:16,157,4206,74,83,2738.86,4957.58,0.00
2024-12-08 16:54:16,158,4205,74,84,2716.67,4957.81,0.00
2024-12-08 16:54:16,159,4204,75,84,2714.90,4957.86,0.00
2024-12-08 16:54:16,159,4205,75,84,2769.58,4958.00,0.00
2024-12-08 16:54:16,160,4205,75,85,2752.27,4958.01,0.00
2024-12-08 16:54:16,159,4205,75,84,2760.27,4958.12,0.00
2024-12-08 16:54:16,159,4206,75,84,2828.98,4959.00,0.00
2024-12-08 16:54:16,160,4206,75,85,2811.30,4959.01,0.00
2024-12-08 16:54:16,159,4206,75,84,2820.72,4959.12,0.00
2024-12-08 16:54:16,158,4206,74,84,2827.92,4959.23,0.00
2024-12-08 16:54:16,159,4205,74,85,2780.20,4959.84,0.00
2024-12-08 16:54:16,158,4205,73,85,2820.70,4959.94,0.00
2024-12-08 16:54:16,158,4206,73,85,2849.31,4960.00,0.00
2024-12-08 16:54:16,159,4206,73,86,2831.39,4960.01,0.00
2024-12-08 16:54:16,158,4206,72,86,2844.41,4960.09,0.00
2024-12-08 16:54:16,157,4206,72,85,2855.91,4960.13,0.00
2024-12-08 16:54:16,158,4205,72,86,2822.25,4960.46,0.00
2024-12-08 16:54:16,157,4205,71,86,2844.16,4960.52,0.00
2024-12-08 16:54:16,157,4206,71,86,2881.89,4961.00,0.00
2024-12-08 16:54:16,158,4206,72,86,2863.65,4961.01,0.00
2024-12-08 16:54:16,159,4205,72,87,2815.24,4961.48,0.00
2024-12-08 16:54:16,159,4206,72,87,2860.72,4962.00,0.00
2024-12-08 16:54:16,160,4206,72,88,2842.84,4962.01,0.00
2024-12-08 16:54:16,161,4205,72,89,2784.66,4962.67,0.00
2024-12-08 16:54:16,161,4206,72,89,2842.13,4963.00,0.00
2024-12-08 16:54:16,162,4206,73,89,2824.58,4963.01,0.00
2024-12-08 16:54:16,163,4205,74,89,2775.57,4963.47,0.00
2024-12-08 16:54:16,164,4204,75,89,2767.18,4963.59,0.00
2024-12-08 16:54:17,164,4205,75,89,2795.78,4964.00,0.00
2024-12-08 16:54:17,165,4205,76,89,2778.84,4964.01,0.00
2024-12-08 16:54:17,164,4205,75,89,2789.31,4964.06,0.00
2024-12-08 16:54:17,163,4205,75,88,2798.22,4964.12,0.00
2024-12-08 16:54:17,162,4205,74,88,2775.96,4964.73,0.00
2024-12-08 16:54:17,162,4206,74,88,2853.15,4965.00,0.00
2024-12-08 16:54:17,163,4206,75,88,2835.64,4965.01,0.00
2024-12-08 16:54:17,162,4206,75,87,2803.26,4965.65,0.00
2024-12-08 16:54:17,162,4207,75,87,2815.40,4966.00,0.00
2024-12-08 16:54:17,163,4207,76,87,2798.12,4966.01,0.00
2024-12-08 16:54:17,162,4207,76,86,2810.84,4966.04,0.00
2024-12-08 16:54:17,161,4207,76,85,2826.16,4966.08,0.00
2024-12-08 16:54:17,161,4208,76,85,2801.11,4967.00,0.00
2024-12-08 16:54:17,162,4208,77,85,2783.82,4967.01,0.00
2024-12-08 16:54:17,161,4208,76,85,2798.96,4967.03,0.00
2024-12-08 16:54:17,162,4207,76,86,2781.68,4967.04,0.00
2024-12-08 16:54:17,161,4207,76,85,2799.64,4967.39,0.00
2024-12-08 16:54:17,161,4208,76,85,2792.80,4968.00,0.00
2024-12-08 16:54:17,162,4208,76,86,2775.56,4968.01,0.00
2024-12-08 16:54:17,162,4209,76,86,2769.54,4969.00,0.00
2024-12-08 16:54:17,163,4209,77,86,2752.55,4969.01,0.00
2024-12-08 16:54:17,162,4209,77,85,2762.53,4969.10,0.00
2024-12-08 16:54:17,161,4209,77,84,2774.75,4969.20,0.00
2024-12-08 16:54:17,162,4208,78,84,2743.62,4969.49,0.00
2024-12-08 16:54:17,163,4207,78,85,2724.50,4969.80,0.00
2024-12-08 16:54:17,164,4206,78,86,2708.87,4969.90,0.00
2024-12-08 16:54:17,165,4205,79,86,2693.11,4969.95,0.00
2024-12-08 16:54:17,164,4205,78,86,2699.57,4969.98,0.00
2024-12-08 16:54:17,164,4206,78,86,2728.68,4970.00,0.00
2024-12-08 16:54:17,165,4206,79,86,2712.14,4970.01,0.00
2024-12-08 16:54:17,164,4206,78,86,2728.06,4970.02,0.00
2024-12-08 16:54:17,163,4206,78,85,2738.43,4970.10,0.00
2024-12-08 16:54:17,162,4206,77,85,2752.26,4970.11,0.00
2024-12-08 16:54:17,161,4206,76,85,2757.80,4970.34,0.00
2024-12-08 16:54:17,162,4205,77,85,2736.83,4970.43,0.00
2024-12-08 16:54:17,162,4206,77,85,2877.06,4971.00,0.00
2024-12-08 16:54:17,163,4206,78,85,2859.41,4971.01,0.00
2024-12-08 16:54:17,162,4206,78,84,2870.00,4971.10,0.00
2024-12-08 16:54:17,161,4206,77,84,2877.96,4971.19,0.00
2024-12-08 16:54:17,162,4205,78,84,2852.27,4971.36,0.00
2024-12-08 16:54:17,162,4206,78,84,2885.27,4972.00,0.00
2024-12-08 16:54:17,163,4206,79,84,2867.57,4972.01,0.00
2024-12-08 16:54:17,162,4206,78,84,2852.20,4972.47,0.00
2024-12-08 16:54:17,162,4207,78,84,2887.60,4973.00,0.00
2024-12-08 16:54:17,163,4207,78,85,2869.88,4973.01,0.00
2024-12-08 16:54:17,162,4207,77,85,2883.28,4973.09,0.00
2024-12-08 16:54:17,162,4208,77,85,2851.56,4974.00,0.00
2024-12-08 16:54:17,163,4208,77,86,2834.06,4974.01,0.00
2024-12-08 16:54:17,162,4208,77,85,2843.30,4974.11,0.00
2024-12-08 16:54:17,161,4208,76,85,2850.17,4974.21,0.00
2024-12-08 16:54:17,160,4208,75,85,2860.89,4974.35,0.00
2024-12-08 16:54:17,160,4209,75,85,2859.83,4975.00,0.00
2024-12-08 16:54:17,161,4209,75,86,2842.07,4975.01,0.00
2024-12-08 16:54:17,160,4209,75,85,2840.59,4975.11,0.00
2024-12-08 16:54:17,160,4210,75,85,2826.63,4976.00,0.00
2024-12-08 16:54:17,161,4210,75,86,2809.07,4976.01,0.00
2024-12-08 16:54:17,162,4209,75,87,2751.91,4976.67,0.00
2024-12-08 16:54:17,162,4210,75,87,2759.74,4977.00,0.00
2024-12-08 16:54:17,163,4210,76,87,2742.81,4977.01,0.00
2024-12-08 16:54:17,162,4210,76,86,2755.47,4977.09,0.00
2024-12-08 16:54:17,161,4210,76,85,2771.04,4977.10,0.00
2024-12-08 16:54:17,160,4210,75,85,2749.89,4977.67,0.00
2024-12-08 16:54:17,160,4211,75,85,2795.89,4978.00,0.00
2024-12-08 16:54:17,161,4211,76,85,2778.53,4978.01,0.00
2024-12-08 16:54:17,161,4212,76,85,2746.70,4979.00,0.00
2024-12-08 16:54:17,162,4212,76,86,2729.74,4979.01,0.00
2024-12-08 16:54:17,161,4212,75,86,2743.63,4979.06,0.00
2024-12-08 16:54:17,160,4212,74,86,2759.22,4979.09,0.00
2024-12-08 16:54:17,161,4211,75,86,2725.43,4979.31,0.00
2024-12-08 16:54:17,160,4211,74,86,2743.25,4979.34,0.00
2024-12-08 16:54:17,160,4212,74,86,2729.08,4980.00,0.00
2024-12-08 16:54:17,161,4212,74,87,2712.13,4980.01,0.00
2024-12-08 16:54:17,160,4212,74,86,2721.33,4980.10,0.00
2024-12-08 16:54:17,160,4213,74,86,2725.69,4981.00,0.00
2024-12-08 16:54:17,161,4213,74,87,2708.76,4981.01,0.00
2024-12-08 16:54:17,160,4213,73,87,2721.36,4981.09,0.00
2024-12-08 16:54:17,161,4212,73,88,2703.53,4981.12,0.00
2024-12-08 16:54:17,160,4212,72,88,2733.89,4981.34,0.00
2024-12-08 16:54:17,160,4213,72,88,2720.15,4982.00,0.00
2024-12-08 16:54:17,161,4213,72,89,2703.25,4982.01,0.00
2024-12-08 16:54:17,160,4213,71,89,2719.22,4982.03,0.00
2024-12-08 16:54:17,161,4212,71,90,2700.18,4982.08,0.00
2024-12-08 16:54:17,160,4212,70,90,2744.94,4982.09,0.00
2024-12-08 16:54:17,161,4211,71,90,2693.17,4982.68,0.00
2024-12-08 16:54:17,162,4210,72,90,2683.05,4982.74,0.00
2024-12-08 16:54:17,162,4211,72,90,2736.77,4983.00,0.00
2024-12-08 16:54:17,163,4211,73,90,2719.98,4983.01,0.00
2024-12-08 16:54:18,162,4211,72,90,2735.24,4983.03,0.00
2024-12-08 16:54:18,161,4211,71,90,2749.77,4983.08,0.00
2024-12-08 16:54:18,160,4211,70,90,2766.65,4983.08,0.00
2024-12-08 16:54:18,161,4210,71,90,2731.89,4983.32,0.00
2024-12-08 16:54:18,161,4211,71,90,2836.43,4984.00,0.00
2024-12-08 16:54:18,162,4211,72,90,2818.92,4984.01,0.00
2024-12-08 16:54:18,161,4211,72,89,2826.25,4984.08,0.00
2024-12-08 16:54:18,160,4211,71,89,2800.41,4984.79,0.00
2024-12-08 16:54:18,160,4212,71,89,2852.31,4985.00,0.00
2024-12-08 16:54:18,161,4212,71,90,2834.59,4985.01,0.00
2024-12-08 16:54:18,160,4212,70,90,2828.13,4985.36,0.00
2024-12-08 16:54:18,160,4213,70,90,2815.27,4986.00,0.00
2024-12-08 16:54:18,161,4213,70,91,2797.78,4986.01,0.00
2024-12-08 16:54:18,160,4213,69,91,2813.11,4986.04,0.00
2024-12-08 16:54:18,159,4213,68,91,2829.55,4986.06,0.00
2024-12-08 16:54:18,158,4213,68,90,2843.04,4986.06,0.00
2024-12-08 16:54:18,157,4213,68,89,2860.84,4986.06,0.00
2024-12-08 16:54:18,157,4214,68,89,2831.42,4987.00,0.00
2024-12-08 16:54:18,158,4214,69,89,2813.50,4987.01,0.00
2024-12-08 16:54:18,157,4214,69,88,2828.27,4987.06,0.00
2024-12-08 16:54:18,157,4215,69,88,2798.56,4988.00,0.00
2024-12-08 16:54:18,158,4215,70,88,2780.85,4988.01,0.00
2024-12-08 16:54:18,157,4215,70,87,2795.42,4988.06,0.00
2024-12-08 16:54:18,157,4216,70,87,2765.75,4989.00,0.00
2024-12-08 16:54:18,158,4216,70,88,2748.24,4989.01,0.00
2024-12-08 16:54:18,157,4216,69,88,2752.72,4989.02,0.00
2024-12-08 16:54:18,158,4215,70,88,2734.68,4989.04,0.00
2024-12-08 16:54:18,157,4215,70,87,2760.06,4989.08,0.00
2024-12-08 16:54:18,158,4214,71,87,2735.36,4989.24,0.00
2024-12-08 16:54:18,158,4215,71,87,2735.60,4990.00,0.00
2024-12-08 16:54:18,159,4215,71,88,2718.39,4990.01,0.00
2024-12-08 16:54:18,158,4215,70,88,2732.78,4990.06,0.00
2024-12-08 16:54:18,157,4215,70,87,2747.64,4990.07,0.00
2024-12-08 16:54:18,158,4214,70,88,2721.15,4990.27,0.00
2024-12-08 16:54:18,157,4214,69,88,2735.33,4990.31,0.00
2024-12-08 16:54:18,158,4213,70,88,2699.16,4990.65,0.00
2024-12-08 16:54:18,158,4214,70,88,2779.02,4991.00,0.00
2024-12-08 16:54:18,159,4214,71,88,2761.55,4991.01,0.00
2024-12-08 16:54:18,158,4214,71,87,2775.60,4991.06,0.00
2024-12-08 16:54:18,157,4214,71,86,2788.51,4991.06,0.00
2024-12-08 16:54:18,158,4213,72,86,2759.88,4991.30,0.00
2024-12-08 16:54:18,158,4214,72,86,2826.10,4992.00,0.00
2024-12-08 16:54:18,159,4214,72,87,2808.32,4992.01,0.00
2024-12-08 16:54:18,158,4214,72,86,2822.65,4992.06,0.00
2024-12-08 16:54:18,157,4214,72,85,2837.77,4992.06,0.00
2024-12-08 16:54:18,157,4215,72,85,2840.98,4993.00,0.00
2024-12-08 16:54:18,158,4215,72,86,2823.00,4993.01,0.00
2024-12-08 16:54:18,157,4215,72,85,2835.31,4993.06,0.00
2024-12-08 16:54:18,156,4215,71,85,2829.40,4993.53,0.00
2024-12-08 16:54:18,156,4216,71,85,2824.76,4994.00,0.00
2024-12-08 16:54:18,157,4216,71,86,2806.77,4994.01,0.00
2024-12-08 16:54:18,158,4215,72,86,2767.63,4994.32,0.00
2024-12-08 16:54:18,158,4216,72,86,2772.56,4995.00,0.00
2024-12-08 16:54:18,159,4216,72,87,2755.12,4995.01,0.00
2024-12-08 16:54:18,158,4216,72,86,2766.90,4995.07,0.00
2024-12-08 16:54:18,157,4216,72,85,2783.90,4995.08,0.00
2024-12-08 16:54:18,158,4215,72,86,2764.07,4995.13,0.00
2024-12-08 16:54:18,159,4214,73,86,2746.15,4995.69,0.00
2024-12-08 16:54:18,159,4215,73,86,2790.69,4996.00,0.00
2024-12-08 16:54:18,160,4215,73,87,2773.25,4996.01,0.00
2024-12-08 16:54:18,159,4215,73,86,2784.75,4996.08,0.00
2024-12-08 16:54:18,158,4215,72,86,2796.34,4996.17,0.00
2024-12-08 16:54:18,158,4216,72,86,2849.16,4997.00,0.00
2024-12-08 16:54:18,159,4216,73,86,2831.24,4997.01,0.00
2024-12-08 16:54:18,160,4215,73,87,2811.37,4997.06,0.00
2024-12-08 16:54:18,159,4215,73,86,2830.32,4997.08,0.00
2024-12-08 16:54:18,158,4215,72,86,2828.97,4997.47,0.00
2024-12-08 16:54:18,159,4214,73,86,2797.83,4997.75,0.00
2024-12-08 16:54:18,158,4214,72,86,2812.24,4997.90,0.00
2024-12-08 16:54:18,158,4215,72,86,2838.90,4998.00,0.00
2024-12-08 16:54:18,159,4215,73,86,2821.05,4998.01,0.00
2024-12-08 16:54:18,158,4215,72,86,2836.84,4998.04,0.00
2024-12-08 16:54:18,158,4216,72,86,2858.29,4999.00,0.00
2024-12-08 16:54:18,159,4216,72,87,2840.31,4999.01,0.00
2024-12-08 16:54:18,158,4216,72,86,2855.78,4999.05,0.00
2024-12-08 16:54:18,159,4215,73,86,2810.32,4999.49,0.00
2024-12-08 16:54:18,159,4216,73,86,2794.80,5000.00,0.00
2024-12-08 16:54:18,160,4216,74,86,2777.33,5000.01,0.00
2024-12-08 16:54:18,159,4216,73,86,2792.31,5000.05,0.00
2024-12-08 16:54:18,158,4216,73,85,2807.45,5000.06,0.00
2024-12-08 16:54:18,157,4216,72,85,2778.72,5000.83,0.00
2024-12-08 16:54:18,157,4217,72,85,2821.54,5001.00,0.00
2024-12-08 16:54:18,158,4217,72,86,2803.68,5001.01,0.00
2024-12-08 16:54:18,157,4217,71,86,2819.02,5001.05,0.00
2024-12-08 16:54:18,156,4217,71,85,2835.49,5001.06,0.00
2024-12-08 16:54:18,156,4218,71,85,2804.72,5002.00,0.00
2024-12-08 16:54:18,157,4218,72,85,2786.86,5002.01,0.00
2024-12-08 16:54:18,156,4218,72,84,2801.65,5002.06,0.00
2024-12-08 16:54:18,155,4218,71,84,2792.52,5002.39,0.00
2024-12-08 16:54:18,156,4217,72,84,2768.27,5002.53,0.00
2024-12-08 16:54:18,155,4217,71,84,2778.23,5002.76,0.00
2024-12-08 16:54:19,155,4218,71,84,2798.44,5003.00,0.00
2024-12-08 16:54:19,156,4218,72,84,2780.50,5003.01,0.00
2024-12-08 16:54:19,157,4217,73,84,2745.04,5003.25,0.00
2024-12-08 16:54:19,156,4217,72,84,2756.73,5003.34,0.00
2024-12-08 16:54:19,155,4217,71,84,2772.92,5003.37,0.00
2024-12-08 16:54:19,155,4218,71,84,2803.47,5004.00,0.00
2024-12-08 16:54:19,156,4218,72,84,2785.50,5004.01,0.00
2024-12-08 16:54:19,155,4218,72,83,2800.91,5004.05,0.00
2024-12-08 16:54:19,156,4217,72,84,2752.94,5004.53,0.00
2024-12-08 16:54:19,156,4218,72,84,2806.33,5005.00,0.00
2024-12-08 16:54:19,157,4218,72,85,2788.46,5005.01,0.00
2024-12-08 16:54:19,158,4217,73,85,2760.70,5005.10,0.00
2024-12-08 16:54:19,159,4216,73,86,2718.29,5005.74,0.00
2024-12-08 16:54:19,160,4215,73,87,2703.89,5005.85,0.00
2024-12-08 16:54:19,160,4216,73,87,2754.56,5006.00,0.00
2024-12-08 16:54:19,161,4216,73,88,2737.45,5006.01,0.00
2024-12-08 16:54:19,161,4217,73,88,2787.75,5007.00,0.00
2024-12-08 16:54:19,162,4217,73,89,2770.54,5007.01,0.00
2024-12-08 16:54:19,161,4217,73,88,2782.48,5007.06,0.00
2024-12-08 16:54:19,160,4217,72,88,2779.61,5007.28,0.00
2024-12-08 16:54:19,161,4216,73,88,2750.05,5007.47,0.00
2024-12-08 16:54:19,161,4217,73,88,2761.85,5008.00,0.00
2024-12-08 16:54:19,162,4217,73,89,2744.80,5008.01,0.00
2024-12-08 16:54:19,163,4216,73,90,2690.54,5008.55,0.00
2024-12-08 16:54:19,163,4217,73,90,2723.48,5009.00,0.00
2024-12-08 16:54:19,164,4217,73,91,2706.87,5009.01,0.00
2024-12-08 16:54:19,163,4217,72,91,2720.73,5009.06,0.00
2024-12-08 16:54:19,162,4217,72,90,2713.32,5009.40,0.00
2024-12-08 16:54:19,161,4217,71,90,2713.32,5009.74,0.00
2024-12-08 16:54:19,160,4217,70,90,2706.46,5009.91,0.00
2024-12-08 16:54:19,160,4218,70,90,2764.77,5010.00,0.00
2024-12-08 16:54:19,161,4218,70,91,2747.59,5010.01,0.00
2024-12-08 16:54:19,160,4218,69,91,2762.28,5010.05,0.00
2024-12-08 16:54:19,159,4218,69,90,2779.34,5010.05,0.00
2024-12-08 16:54:19,158,4218,69,89,2795.03,5010.05,0.00
2024-12-08 16:54:19,158,4219,69,89,2766.92,5011.00,0.00
2024-12-08 16:54:19,159,4219,69,90,2749.52,5011.01,0.00
2024-12-08 16:54:19,158,4219,69,89,2757.85,5011.06,0.00
2024-12-08 16:54:19,158,4220,69,89,2740.10,5012.00,0.00
2024-12-08 16:54:19,159,4220,70,89,2722.86,5012.01,0.00
2024-12-08 16:54:19,158,4220,70,88,2730.92,5012.06,0.00
2024-12-08 16:54:19,159,4219,71,88,2709.05,5012.16,0.00
2024-12-08 16:54:19,158,4219,70,88,2728.58,5012.41,0.00
2024-12-08 16:54:19,158,4220,70,88,2731.21,5013.00,0.00
2024-12-08 16:54:19,159,4220,70,89,2714.03,5013.01,0.00
2024-12-08 16:54:19,158,4220,69,89,2718.70,5013.13,0.00
2024-12-08 16:54:19,159,4219,69,90,2701.29,5013.15,0.00
2024-12-08 16:54:19,160,4218,69,91,2673.26,5013.51,0.00
2024-12-08 16:54:19,160,4219,69,91,2706.58,5014.00,0.00
2024-12-08 16:54:19,161,4219,69,92,2689.77,5014.01,0.00
2024-12-08 16:54:19,160,4219,68,92,2680.63,5014.38,0.00
2024-12-08 16:54:19,161,4218,69,92,2654.74,5014.58,0.00
2024-12-08 16:54:19,162,4217,69,93,2660.99,5014.65,0.00
2024-12-08 16:54:19,162,4218,69,93,2736.28,5015.00,0.00
2024-12-08 16:54:19,163,4218,69,94,2719.50,5015.01,0.00
2024-12-08 16:54:19,162,4218,69,93,2730.73,5015.05,0.00
2024-12-08 16:54:19,162,4219,69,93,2763.09,5016.00,0.00
2024-12-08 16:54:19,163,4219,70,93,2746.14,5016.01,0.00
2024-12-08 16:54:19,164,4218,70,94,2678.47,5016.82,0.00
2024-12-08 16:54:19,164,4219,70,94,2729.70,5017.00,0.00
2024-12-08 16:54:19,165,4219,71,94,2713.16,5017.01,0.00
2024-12-08 16:54:19,166,4218,71,95,2695.91,5017.04,0.00
2024-12-08 16:54:19,167,4217,72,95,2701.70,5017.05,0.00
2024-12-08 16:54:19,166,4217,72,94,2717.65,5017.07,0.00
2024-12-08 16:54:19,165,4217,72,93,2733.81,5017.07,0.00
2024-12-08 16:54:19,164,4217,71,93,2745.20,5017.17,0.00
2024-12-08 16:54:19,165,4216,71,94,2719.13,5017.36,0.00
2024-12-08 16:54:19,164,4216,70,94,2735.33,5017.94,0.00
2024-12-08 16:54:19,164,4217,70,94,2787.18,5018.00,0.00
2024-12-08 16:54:19,165,4217,71,94,2770.29,5018.01,0.00
2024-12-08 16:54:19,166,4216,72,94,2701.50,5018.86,0.00
2024-12-08 16:54:19,166,4217,72,94,2808.54,5019.00,0.00
2024-12-08 16:54:19,167,4217,73,94,2791.73,5019.01,0.00
2024-12-08 16:54:19,166,4217,73,93,2799.94,5019.05,0.00
2024-12-08 16:54:19,166,4218,73,93,2799.38,5020.00,0.00
2024-12-08 16:54:19,167,4218,73,94,2782.62,5020.01,0.00
2024-12-08 16:54:19,167,4219,73,94,2743.96,5021.00,0.00
2024-12-08 16:54:19,168,4219,73,95,2727.62,5021.01,0.00
2024-12-08 16:54:19,167,4219,72,95,2718.68,5021.17,0.00
2024-12-08 16:54:19,168,4218,73,95,2694.01,5021.33,0.00
2024-12-08 16:54:19,167,4218,72,95,2725.82,5021.41,0.00
2024-12-08 16:54:19,167,4219,72,95,2724.66,5022.00,0.00
2024-12-08 16:54:19,168,4219,73,95,2708.44,5022.01,0.00
2024-12-08 16:54:19,167,4219,72,95,2722.87,5022.04,0.00
2024-12-08 16:54:19,166,4219,72,94,2731.42,5022.04,0.00
2024-12-08 16:54:19,165,4219,72,93,2746.77,5022.06,0.00
2024-12-08 16:54:19,164,4219,71,93,2762.60,5022.07,0.00
2024-12-08 16:54:19,163,4219,70,93,2752.43,5022.51,0.00
2024-12-08 16:54:20,163,4220,70,93,2786.36,5023.00,0.00
2024-12-08 16:54:20,164,4220,71,93,2769.37,5023.01,0.00
2024-12-08 16:54:20,163,4220,70,93,2783.18,5023.04,0.00
2024-12-08 16:54:20,164,4219,70,94,2713.59,5023.77,0.00
2024-12-08 16:54:20,164,4220,70,94,2739.21,5024.00,0.00
2024-12-08 16:54:20,165,4220,70,95,2722.61,5024.01,0.00
2024-12-08 16:54:20,164,4220,69,95,2721.29,5024.23,0.00
2024-12-08 16:54:20,165,4219,69,96,2680.56,5024.66,0.00
2024-12-08 16:54:20,165,4220,69,96,2725.51,5025.00,0.00
2024-12-08 16:54:20,166,4220,69,97,2709.09,5025.01,0.00
2024-12-08 16:54:20,165,4220,68,97,2725.21,5025.01,0.00
2024-12-08 16:54:20,164,4220,68,96,2734.79,5025.03,0.00
2024-12-08 16:54:20,163,4220,68,95,2722.89,5025.56,0.00
2024-12-08 16:54:20,163,4221,68,95,2750.35,5026.00,0.00
2024-12-08 16:54:20,164,4221,68,96,2733.58,5026.01,0.00
2024-12-08 16:54:20,163,4221,68,95,2745.74,5026.03,0.00
2024-12-08 16:54:20,162,4221,68,94,2758.22,5026.12,0.00
2024-12-08 16:54:20,163,4220,69,94,2740.38,5026.15,0.00
2024-12-08 16:54:20,164,4219,70,94,2708.45,5026.77,0.00
2024-12-08 16:54:20,164,4220,70,94,2734.09,5027.00,0.00
2024-12-08 16:54:20,165,4220,70,95,2717.52,5027.01,0.00
2024-12-08 16:54:20,164,4220,69,95,2719.68,5027.07,0.00
2024-12-08 16:54:20,165,4219,70,95,2670.36,5027.73,0.00
2024-12-08 16:54:20,165,4220,70,95,2761.38,5028.00,0.00
2024-12-08 16:54:20,166,4220,71,95,2744.74,5028.01,0.00
2024-12-08 16:54:20,165,4220,70,95,2744.46,5028.05,0.00
2024-12-08 16:54:20,164,4220,70,94,2759.98,5028.07,0.00
2024-12-08 16:54:20,164,4221,70,94,2773.16,5029.00,0.00
2024-12-08 16:54:20,165,4221,71,94,2756.35,5029.01,0.00
2024-12-08 16:54:20,166,4220,72,94,2738.84,5029.04,0.00
2024-12-08 16:54:20,165,4220,71,94,2750.29,5029.08,0.00
2024-12-08 16:54:20,164,4220,70,94,2749.36,5029.40,0.00
2024-12-08 16:54:20,164,4221,70,94,2726.79,5030.00,0.00
2024-12-08 16:54:20,165,4221,71,94,2710.26,5030.01,0.00
2024-12-08 16:54:20,164,4221,71,93,2725.26,5030.03,0.00
2024-12-08 16:54:20,163,4221,70,93,2739.54,5030.07,0.00
2024-12-08 16:54:20,162,4221,69,93,2749.91,5030.19,0.00
2024-12-08 16:54:20,162,4222,69,93,2748.52,5031.00,0.00
2024-12-08 16:54:20,163,4222,69,94,2731.66,5031.01,0.00
2024-12-08 16:54:20,162,4222,69,93,2738.61,5031.07,0.00
2024-12-08 16:54:20,161,4222,68,93,2753.75,5031.09,0.00
2024-12-08 16:54:20,162,4221,69,93,2732.72,5031.18,0.00
2024-12-08 16:54:20,161,4221,68,93,2741.28,5031.69,0.00
2024-12-08 16:54:20,161,4222,68,93,2745.21,5032.00,0.00
2024-12-08 16:54:20,162,4222,69,93,2728.26,5032.01,0.00
2024-12-08 16:54:20,161,4222,69,92,2743.03,5032.03,0.00
2024-12-08 16:54:20,160,4222,69,91,2757.99,5032.07,0.00
2024-12-08 16:54:20,161,4221,70,91,2711.73,5032.67,0.00
2024-12-08 16:54:20,160,4221,70,90,2725.11,5032.92,0.00
2024-12-08 16:54:20,160,4222,70,90,2784.00,5033.00,0.00
2024-12-08 16:54:20,161,4222,71,90,2766.71,5033.01,0.00
2024-12-08 16:54:20,160,4222,71,89,2774.27,5033.07,0.00
2024-12-08 16:54:20,161,4221,71,90,2744.62,5033.33,0.00
2024-12-08 16:54:20,162,4220,71,91,2727.79,5033.57,0.00
2024-12-08 16:54:20,162,4221,71,91,2770.99,5034.00,0.00
2024-12-08 16:54:20,163,4221,72,91,2753.99,5034.01,0.00
2024-12-08 16:54:20,162,4221,71,91,2719.64,5034.88,0.00
2024-12-08 16:54:20,162,4222,71,91,2801.79,5035.00,0.00
2024-12-08 16:54:20,163,4222,72,91,2784.60,5035.01,0.00
2024-12-08 16:54:20,162,4222,72,90,2792.79,5035.06,0.00
2024-12-08 16:54:20,161,4222,72,89,2809.21,5035.07,0.00
2024-12-08 16:54:20,160,4222,72,88,2822.26,5035.16,0.00
2024-12-08 16:54:20,160,4223,72,88,2802.00,5036.00,0.00
2024-12-08 16:54:20,161,4223,73,88,2784.59,5036.01,0.00
2024-12-08 16:54:20,160,4223,73,87,2794.77,5036.04,0.00
2024-12-08 16:54:20,159,4223,73,86,2810.78,5036.06,0.00
2024-12-08 16:54:20,158,4223,73,85,2828.25,5036.06,0.00
2024-12-08 16:54:20,158,4224,73,85,2800.73,5037.00,0.00
2024-12-08 16:54:20,159,4224,74,85,2783.11,5037.01,0.00
2024-12-08 16:54:20,158,4224,74,84,2791.19,5037.06,0.00
2024-12-08 16:54:20,157,4224,73,84,2806.96,5037.10,0.00
2024-12-08 16:54:20,156,4224,72,84,2816.26,5037.16,0.00
2024-12-08 16:54:20,155,4224,71,84,2822.81,5037.39,0.00
2024-12-08 16:54:20,154,4224,70,84,2830.26,5037.60,0.00
2024-12-08 16:54:20,154,4225,70,84,2843.32,5038.00,0.00
2024-12-08 16:54:20,155,4225,71,84,2824.97,5038.01,0.00
2024-12-08 16:54:20,154,4225,71,83,2839.73,5038.04,0.00
2024-12-08 16:54:20,153,4225,71,82,2856.99,5038.06,0.00
2024-12-08 16:54:20,154,4224,72,82,2807.97,5038.68,0.00
2024-12-08 16:54:20,154,4225,72,82,2820.96,5039.00,0.00
2024-12-08 16:54:20,155,4225,73,82,2802.76,5039.01,0.00
2024-12-08 16:54:20,154,4225,73,81,2811.50,5039.06,0.00
2024-12-08 16:54:20,153,4225,73,80,2827.80,5039.10,0.00
2024-12-08 16:54:20,154,4224,74,80,2795.47,5039.39,0.00
2024-12-08 16:54:20,154,4225,74,80,2833.74,5040.00,0.00
2024-12-08 16:54:20,155,4225,75,80,2815.46,5040.01,0.00
2024-12-08 16:54:20,156,4224,75,81,2788.71,5040.06,0.00
2024-12-08 16:54:20,156,4225,75,81,2797.19,5041.00,0.00
2024-12-08 16:54:20,157,4225,76,81,2779.38,5041.01,0.00
2024-12-08 16:54:20,156,4225,76,80,2787.20,5041.07,0.00
2024-12-08 16:54:20,157,4224,77,80,2752.95,5041.41,0.00
2024-12-08 16:54:20,158,4223,77,81,2746.78,5041.56,0.00
2024-12-08 16:54:20,159,4222,77,82,2722.74,5041.86,0.00
2024-12-08 16:54:21,159,4223,77,82,2765.28,5042.00,0.00
2024-12-08 16:54:21,160,4223,78,82,2748.00,5042.01,0.00
2024-12-08 16:54:21,159,4223,78,81,2762.76,5042.04,0.00
2024-12-08 16:54:21,160,4222,78,82,2726.41,5042.44,0.00
2024-12-08 16:54:21,159,4222,77,82,2747.12,5042.85,0.00
2024-12-08 16:54:21,159,4223,77,82,2853.48,5043.00,0.00
2024-12-08 16:54:21,160,4223,77,83,2835.65,5043.01,0.00
2024-12-08 16:54:21,159,4223,77,82,2843.99,5043.06,0.00
2024-12-08 16:54:21,159,4224,77,82,2857.20,5044.00,0.00
2024-12-08 16:54:21,160,4224,77,83,2839.34,5044.01,0.00
2024-12-08 16:54:21,160,4225,77,83,2810.09,5045.00,0.00
2024-12-08 16:54:21,161,4225,78,83,2792.64,5045.01,0.00
2024-12-08 16:54:21,162,4224,79,83,2774.47,5045.04,0.00
2024-12-08 16:54:21,161,4224,78,83,2789.00,5045.06,0.00
2024-12-08 16:54:21,160,4224,78,82,2805.80,5045.06,0.00
2024-12-08 16:54:21,160,4225,78,82,2782.05,5046.00,0.00
2024-12-08 16:54:21,161,4225,79,82,2764.77,5046.01,0.00
2024-12-08 16:54:21,160,4225,78,82,2758.96,5046.26,0.00
2024-12-08 16:54:21,161,4224,78,83,2722.60,5046.66,0.00
2024-12-08 16:54:21,162,4223,79,83,2708.70,5046.81,0.00
2024-12-08 16:54:21,162,4224,79,83,2751.84,5047.00,0.00
2024-12-08 16:54:21,163,4224,80,83,2734.95,5047.01,0.00
2024-12-08 16:54:21,162,4224,80,82,2745.62,5047.04,0.00
2024-12-08 16:54:21,163,4223,80,83,2692.97,5047.77,0.00
2024-12-08 16:54:21,164,4222,81,83,2674.23,5047.95,0.00
2024-12-08 16:54:21,164,4223,81,83,2753.07,5048.00,0.00
2024-12-08 16:54:21,165,4223,81,84,2736.38,5048.01,0.00
2024-12-08 16:54:21,164,4223,81,83,2749.39,5048.06,0.00
2024-12-08 16:54:21,165,4222,82,83,2708.55,5048.55,0.00
2024-12-08 16:54:21,164,4222,81,83,2717.67,5048.85,0.00
2024-12-08 16:54:21,164,4223,81,83,2802.45,5049.00,0.00
2024-12-08 16:54:21,165,4223,81,84,2785.46,5049.01,0.00
2024-12-08 16:54:21,164,4223,80,84,2800.52,5049.04,0.00
2024-12-08 16:54:21,163,4223,79,84,2817.09,5049.05,0.00
2024-12-08 16:54:21,164,4222,79,85,2749.76,5049.79,0.00
2024-12-08 16:54:21,164,4223,79,85,2811.74,5050.00,0.00
2024-12-08 16:54:21,165,4223,79,86,2794.70,5050.01,0.00
2024-12-08 16:54:21,164,4223,78,86,2811.43,5050.01,0.00
2024-12-08 16:54:21,165,4222,79,86,2774.15,5050.29,0.00
2024-12-08 16:54:21,165,4223,79,86,2808.12,5051.00,0.00
2024-12-08 16:54:21,166,4223,80,86,2791.20,5051.01,0.00
2024-12-08 16:54:21,167,4222,80,87,2774.49,5051.02,0.00
2024-12-08 16:54:21,166,4222,80,86,2816.11,5051.05,0.00
2024-12-08 16:54:21,165,4222,79,86,2791.87,5051.75,0.00
2024-12-08 16:54:21,165,4223,79,86,2837.80,5052.00,0.00
2024-12-08 16:54:21,166,4223,80,86,2820.71,5052.01,0.00
2024-12-08 16:54:21,167,4222,80,87,2741.94,5052.92,0.00
2024-12-08 16:54:21,167,4223,80,87,2812.20,5053.00,0.00
2024-12-08 16:54:21,168,4223,80,88,2795.46,5053.01,0.00
2024-12-08 16:54:21,168,4224,80,88,2783.96,5054.00,0.00
2024-12-08 16:54:21,169,4224,80,89,2767.49,5054.01,0.00
2024-12-08 16:54:21,170,4223,80,90,2750.92,5054.02,0.00
2024-12-08 16:54:21,170,4224,80,90,2726.96,5055.00,0.00
2024-12-08 16:54:21,171,4224,81,90,2711.01,5055.01,0.00
2024-12-08 16:54:21,170,4224,81,89,2724.01,5055.05,0.00
2024-12-08 16:54:21,169,4224,81,88,2739.54,5055.05,0.00
2024-12-08 16:54:21,168,4224,81,87,2751.57,5055.10,0.00
2024-12-08 16:54:21,167,4224,80,87,2705.25,5055.98,0.00
2024-12-08 16:54:21,167,4225,80,87,2764.60,5056.00,0.00
2024-12-08 16:54:21,168,4225,81,87,2748.14,5056.01,0.00
2024-12-08 16:54:21,167,4225,81,86,2755.55,5056.06,0.00
2024-12-08 16:54:21,166,4225,80,86,2771.55,5056.07,0.00
2024-12-08 16:54:21,165,4225,79,86,2742.40,5056.81,0.00
2024-12-08 16:54:21,166,4224,80,86,2725.57,5056.83,0.00
2024-12-08 16:54:21,166,4225,80,86,2751.93,5057.00,0.00
2024-12-08 16:54:21,167,4225,81,86,2735.45,5057.01,0.00
2024-12-08 16:54:21,166,4225,81,85,2742.52,5057.07,0.00
2024-12-08 16:54:21,167,4224,82,85,2722.88,5057.11,0.00
2024-12-08 16:54:21,167,4225,82,85,2757.67,5058.00,0.00
2024-12-08 16:54:21,168,4225,82,86,2741.26,5058.01,0.00
2024-12-08 16:54:21,169,4224,82,87,2714.28,5058.08,0.00
2024-12-08 16:54:21,169,4225,82,87,2740.62,5059.00,0.00
2024-12-08 16:54:21,170,4225,83,87,2724.50,5059.01,0.00
2024-12-08 16:54:21,169,4225,83,86,2737.53,5059.05,0.00
2024-12-08 16:54:21,168,4225,82,86,2752.68,5059.06,0.00
2024-12-08 16:54:21,167,4225,82,85,2768.57,5059.07,0.00
2024-12-08 16:54:21,168,4224,82,86,2710.71,5059.86,0.00
2024-12-08 16:54:21,168,4225,82,86,2755.71,5060.00,0.00
2024-12-08 16:54:21,169,4225,83,86,2739.40,5060.01,0.00
2024-12-08 16:54:21,168,4225,83,85,2746.08,5060.07,0.00
2024-12-08 16:54:21,167,4225,83,84,2762.22,5060.07,0.00
2024-12-08 16:54:21,168,4224,84,84,2720.37,5060.58,0.00
2024-12-08 16:54:21,167,4224,83,84,2722.78,5060.97,0.00
2024-12-08 16:54:21,167,4225,83,84,2781.89,5061.00,0.00
2024-12-08 16:54:21,168,4225,84,84,2765.33,5061.01,0.00
2024-12-08 16:54:21,169,4224,85,84,2748.97,5061.02,0.00
2024-12-08 16:54:21,168,4224,85,83,2758.65,5061.07,0.00
2024-12-08 16:54:22,167,4224,84,83,2739.53,5061.70,0.00
2024-12-08 16:54:22,167,4225,84,83,2773.23,5062.00,0.00
2024-12-08 16:54:22,168,4225,85,83,2756.72,5062.01,0.00
2024-12-08 16:54:22,167,4225,85,82,2768.70,5062.05,0.00
2024-12-08 16:54:22,166,4225,85,81,2784.17,5062.07,0.00
2024-12-08 16:54:22,167,4224,85,82,2767.50,5062.08,0.00
2024-12-08 16:54:22,168,4223,85,83,2746.04,5062.48,0.00
2024-12-08 16:54:22,169,4222,86,83,2740.64,5062.59,0.00
2024-12-08 16:54:22,170,4221,87,83,2735.37,5062.78,0.00
2024-12-08 16:54:22,170,4222,87,83,2777.85,5063.00,0.00
2024-12-08 16:54:22,171,4222,87,84,2761.61,5063.01,0.00
2024-12-08 16:54:22,170,4222,86,84,2767.60,5063.07,0.00
2024-12-08 16:54:22,171,4221,86,85,2729.95,5063.50,0.00
2024-12-08 16:54:22,172,4220,87,85,2716.17,5063.56,0.00
2024-12-08 16:54:22,172,4221,87,85,2840.08,5064.00,0.00
2024-12-08 16:54:22,173,4221,88,85,2823.66,5064.01,0.00
2024-12-08 16:54:22,172,4221,88,84,2831.73,5064.05,0.00
2024-12-08 16:54:22,171,4221,88,83,2842.40,5064.16,0.00
2024-12-08 16:54:22,170,4221,87,83,2846.69,5064.38,0.00
2024-12-08 16:54:22,169,4221,86,83,2830.93,5064.65,0.00
2024-12-08 16:54:22,169,4222,86,83,2903.06,5065.00,0.00
2024-12-08 16:54:22,170,4222,86,84,2885.98,5065.01,0.00
2024-12-08 16:54:22,171,4221,86,85,2866.53,5065.05,0.00
2024-12-08 16:54:22,172,4220,87,85,2844.37,5065.59,0.00
2024-12-08 16:54:22,171,4220,86,85,2869.90,5065.64,0.00
2024-12-08 16:54:22,171,4221,86,85,2877.07,5066.00,0.00
2024-12-08 16:54:22,172,4221,86,86,2860.34,5066.01,0.00
2024-12-08 16:54:22,171,4221,85,86,2866.79,5066.07,0.00
2024-12-08 16:54:22,172,4220,85,87,2808.22,5066.77,0.00
2024-12-08 16:54:22,173,4219,86,87,2786.86,5066.92,0.00
2024-12-08 16:54:22,173,4220,86,87,2869.80,5067.00,0.00
2024-12-08 16:54:22,174,4220,87,87,2853.31,5067.01,0.00
2024-12-08 16:54:22,173,4220,86,87,2859.85,5067.07,0.00
2024-12-08 16:54:22,172,4220,86,86,2876.19,5067.07,0.00
2024-12-08 16:54:22,172,4220,86,86,2901.10,5068.00,0.00
2024-12-08 16:54:22,173,4220,86,87,2884.33,5068.01,0.00
2024-12-08 16:54:22,172,4220,86,86,2891.38,5068.07,0.00
2024-12-08 16:54:22,173,4219,87,86,2853.42,5068.50,0.00
2024-12-08 16:54:22,174,4218,88,86,2836.48,5068.56,0.00
2024-12-08 16:54:22,174,4219,88,86,2830.09,5069.00,0.00
2024-12-08 16:54:22,175,4219,88,87,2813.92,5069.01,0.00
2024-12-08 16:54:22,174,4219,87,87,2828.94,5069.02,0.00
2024-12-08 16:54:22,173,4219,87,86,2841.28,5069.04,0.00
2024-12-08 16:54:22,172,4219,86,86,2856.64,5069.06,0.00
2024-12-08 16:54:22,171,4219,86,85,2873.05,5069.06,0.00
2024-12-08 16:54:22,170,4219,86,84,2889.65,5069.06,0.00
2024-12-08 16:54:22,169,4219,85,84,2906.45,5069.06,0.00
2024-12-08 16:54:22,168,4219,85,83,2874.12,5069.81,0.00
2024-12-08 16:54:22,168,4220,85,83,2942.51,5070.00,0.00
2024-12-08 16:54:22,169,4220,85,84,2925.10,5070.01,0.00
2024-12-08 16:54:22,170,4219,85,85,2888.22,5070.29,0.00
2024-12-08 16:54:22,171,4218,85,86,2884.76,5070.46,0.00
2024-12-08 16:54:22,171,4219,85,86,2906.14,5071.00,0.00
2024-12-08 16:54:22,172,4219,86,86,2889.25,5071.01,0.00
2024-12-08 16:54:22,171,4219,85,86,2896.99,5071.06,0.00
2024-12-08 16:54:22,172,4218,86,86,2843.00,5071.81,0.00
2024-12-08 16:54:22,172,4219,86,86,2921.90,5072.00,0.00
2024-12-08 16:54:22,173,4219,86,87,2905.01,5072.01,0.00
2024-12-08 16:54:22,174,4218,87,87,2874.96,5072.17,0.00
2024-12-08 16:54:22,173,4218,87,86,2907.14,5072.22,0.00
2024-12-08 16:54:22,173,4219,87,86,2918.59,5073.00,0.00
2024-12-08 16:54:22,174,4219,88,86,2901.81,5073.01,0.00
2024-12-08 16:54:22,173,4219,88,85,2909.24,5073.07,0.00
2024-12-08 16:54:22,174,4218,88,86,2870.83,5073.51,0.00
2024-12-08 16:54:22,174,4219,88,86,2900.34,5074.00,0.00
2024-12-08 16:54:22,175,4219,89,86,2883.77,5074.01,0.00
2024-12-08 16:54:22,174,4219,89,85,2897.45,5074.04,0.00
2024-12-08 16:54:22,173,4219,89,84,2912.74,5074.06,0.00
2024-12-08 16:54:22,174,4218,89,85,2859.43,5074.80,0.00
2024-12-08 16:54:22,174,4219,89,85,2900.43,5075.00,0.00
2024-12-08 16:54:22,175,4219,90,85,2883.86,5075.01,0.00
2024-12-08 16:54:22,174,4219,90,84,2897.26,5075.06,0.00
2024-12-08 16:54:22,173,4219,89,84,2898.28,5075.23,0.00
2024-12-08 16:54:22,174,4218,89,85,2859.97,5075.67,0.00
2024-12-08 16:54:22,174,4219,89,85,2906.03,5076.00,0.00
2024-12-08 16:54:22,175,4219,89,86,2889.43,5076.01,0.00
2024-12-08 16:54:22,174,4219,89,85,2902.86,5076.06,0.00
2024-12-08 16:54:22,173,4219,88,85,2890.31,5076.50,0.00
2024-12-08 16:54:22,174,4218,89,85,2872.25,5076.54,0.00
2024-12-08 16:54:22,174,4219,89,85,2919.82,5077.00,0.00
2024-12-08 16:54:22,175,4219,89,86,2903.14,5077.01,0.00
2024-12-08 16:54:22,176,4218,90,86,2846.67,5077.56,0.00
2024-12-08 16:54:22,177,4217,90,87,2827.92,5077.84,0.00
2024-12-08 16:54:22,177,4218,90,87,2881.12,5078.00,0.00
2024-12-08 16:54:22,178,4218,91,87,2864.94,5078.01,0.00
2024-12-08 16:54:22,177,4218,90,87,2860.34,5078.10,0.00
2024-12-08 16:54:22,177,4219,90,87,2900.75,5079.00,0.00
2024-12-08 16:54:22,178,4219,90,88,2884.46,5079.01,0.00
2024-12-08 16:54:22,177,4219,89,88,2893.51,5079.01,0.00
2024-12-08 16:54:22,176,4219,89,87,2903.91,5079.06,0.00
2024-12-08 16:54:22,177,4218,89,88,2877.23,5079.27,0.00
2024-12-08 16:54:22,178,4217,90,88,2877.34,5079.30,0.00
2024-12-08 16:54:22,179,4216,90,89,2852.04,5079.71,0.00
2024-12-08 16:54:22,179,4217,90,89,2879.59,5080.00,0.00
2024-12-08 16:54:23,180,4217,90,90,2863.59,5080.01,0.00
2024-12-08 16:54:23,181,4216,91,90,2812.12,5080.51,0.00
2024-12-08 16:54:23,181,4217,91,90,2912.52,5081.00,0.00
2024-12-08 16:54:23,182,4217,91,91,2896.52,5081.01,0.00
2024-12-08 16:54:23,183,4216,91,92,2871.63,5081.02,0.00
2024-12-08 16:54:23,182,4216,91,91,2888.83,5081.07,0.00
2024-12-08 16:54:23,181,4216,91,90,2904.51,5081.07,0.00
2024-12-08 16:54:23,181,4217,91,90,2911.98,5082.00,0.00
2024-12-08 16:54:23,182,4217,91,91,2895.98,5082.01,0.00
2024-12-08 16:54:23,181,4217,90,91,2905.68,5082.01,0.00
2024-12-08 16:54:23,180,4217,90,90,2914.23,5082.06,0.00
2024-12-08 16:54:23,179,4217,90,89,2930.22,5082.06,0.00
2024-12-08 16:54:23,178,4217,89,89,2930.32,5082.34,0.00
2024-12-08 16:54:23,179,4216,89,90,2911.70,5082.40,0.00
2024-12-08 16:54:23,179,4217,89,90,2954.37,5083.00,0.00
2024-12-08 16:54:23,180,4217,90,90,2937.96,5083.01,0.00
2024-12-08 16:54:23,179,4217,89,90,2949.36,5083.06,0.00
2024-12-08 16:54:23,178,4217,89,89,2965.07,5083.06,0.00
2024-12-08 16:54:23,179,4216,89,90,2920.16,5083.58,0.00
2024-12-08 16:54:23,179,4217,89,90,2960.18,5084.00,0.00
2024-12-08 16:54:23,180,4217,89,91,2943.74,5084.01,0.00
2024-12-08 16:54:23,179,4217,89,90,2954.45,5084.06,0.00
2024-12-08 16:54:23,179,4218,89,90,2947.85,5085.00,0.00
2024-12-08 16:54:23,180,4218,89,91,2931.47,5085.01,0.00
2024-12-08 16:54:23,179,4218,89,90,2941.93,5085.07,0.00
2024-12-08 16:54:23,178,4218,89,89,2945.11,5085.29,0.00
2024-12-08 16:54:23,178,4219,89,89,2925.89,5086.00,0.00
2024-12-08 16:54:23,179,4219,90,89,2909.54,5086.01,0.00
2024-12-08 16:54:23,180,4218,91,89,2892.54,5086.03,0.00
2024-12-08 16:54:23,179,4218,91,88,2909.67,5086.08,0.00
2024-12-08 16:54:23,178,4218,90,88,2923.70,5086.10,0.00
2024-12-08 16:54:23,177,4218,90,87,2937.74,5086.14,0.00
2024-12-08 16:54:23,178,4217,90,88,2917.55,5086.23,0.00
2024-12-08 16:54:23,178,4218,90,88,2929.06,5087.00,0.00
2024-12-08 16:54:23,179,4218,90,89,2912.69,5087.01,0.00
2024-12-08 16:54:23,178,4218,90,88,2921.95,5087.10,0.00
2024-12-08 16:54:23,177,4218,89,88,2922.13,5087.27,0.00
2024-12-08 16:54:23,178,4217,89,89,2884.10,5087.70,0.00
2024-12-08 16:54:23,179,4216,89,90,2871.62,5087.77,0.00
2024-12-08 16:54:23,179,4217,89,90,2950.92,5088.00,0.00
2024-12-08 16:54:23,180,4217,89,91,2934.53,5088.01,0.00
2024-12-08 16:54:23,181,4216,90,91,2916.09,5088.06,0.00
2024-12-08 16:54:23,180,4216,90,90,2948.13,5088.11,0.00
2024-12-08 16:54:23,179,4216,89,90,2950.45,5088.39,0.00
2024-12-08 16:54:23,179,4217,89,90,2992.30,5089.00,0.00
2024-12-08 16:54:23,180,4217,90,90,2975.68,5089.01,0.00
2024-12-08 16:54:23,179,4217,89,90,2988.92,5089.07,0.00
2024-12-08 16:54:23,178,4217,89,89,3002.00,5089.10,0.00
2024-12-08 16:54:23,177,4217,88,89,3004.99,5089.15,0.00
2024-12-08 16:54:23,177,4218,88,89,3016.94,5090.00,0.00
2024-12-08 16:54:23,178,4218,88,90,2999.99,5090.01,0.00
2024-12-08 16:54:23,177,4218,88,89,3013.36,5090.07,0.00
2024-12-08 16:54:23,176,4218,88,88,3013.71,5090.12,0.00
2024-12-08 16:54:23,177,4217,89,88,2980.68,5090.44,0.00
2024-12-08 16:54:23,176,4217,88,88,2990.26,5090.74,0.00
2024-12-08 16:54:23,177,4216,88,89,2961.70,5090.94,0.00
2024-12-08 16:54:23,177,4217,88,89,2989.08,5091.00,0.00
2024-12-08 16:54:23,178,4217,89,89,2972.29,5091.01,0.00
2024-12-08 16:54:23,177,4217,89,88,2979.92,5091.13,0.00
2024-12-08 16:54:23,178,4216,90,88,2912.73,5091.87,0.00
2024-12-08 16:54:23,178,4217,90,88,2994.37,5092.00,0.00
2024-12-08 16:54:23,179,4217,91,88,2977.64,5092.01,0.00
2024-12-08 16:54:23,180,4216,91,89,2958.86,5092.06,0.00
2024-12-08 16:54:23,179,4216,91,88,2974.55,5092.09,0.00
2024-12-08 16:54:23,178,4216,90,88,2963.32,5092.33,0.00
2024-12-08 16:54:23,178,4217,90,88,2983.39,5093.00,0.00
2024-12-08 16:54:23,179,4217,90,89,2966.73,5093.01,0.00
2024-12-08 16:54:23,178,4217,90,88,2973.13,5093.13,0.00
2024-12-08 16:54:23,179,4216,90,89,2934.96,5093.56,0.00
2024-12-08 16:54:23,180,4215,90,90,2927.48,5093.60,0.00
2024-12-08 16:54:23,181,4214,91,90,2910.79,5093.78,0.00
2024-12-08 16:54:23,181,4215,91,90,2948.42,5094.00,0.00
2024-12-08 16:54:23,182,4215,92,90,2932.22,5094.01,0.00
2024-12-08 16:54:23,181,4215,91,90,2944.24,5094.08,0.00
2024-12-08 16:54:23,182,4214,91,91,2887.84,5094.71,0.00
2024-12-08 16:54:23,182,4215,91,91,2989.22,5095.00,0.00
2024-12-08 16:54:23,183,4215,92,91,2972.89,5095.01,0.00
2024-12-08 16:54:23,182,4215,91,91,2985.06,5095.08,0.00
2024-12-08 16:54:23,182,4216,91,91,2980.80,5096.00,0.00
2024-12-08 16:54:23,183,4216,91,92,2964.51,5096.01,0.00
2024-12-08 16:54:23,182,4216,91,91,2976.63,5096.08,0.00
2024-12-08 16:54:23,183,4215,92,91,2951.48,5096.16,0.00
2024-12-08 16:54:23,184,4214,92,92,2911.72,5096.79,0.00
2024-12-08 16:54:23,184,4215,92,92,2924.20,5097.00,0.00
2024-12-08 16:54:23,185,4215,93,92,2908.39,5097.01,0.00
2024-12-08 16:54:23,184,4215,92,92,2922.00,5097.04,0.00
2024-12-08 16:54:23,183,4215,91,92,2919.37,5097.28,0.00
2024-12-08 16:54:23,184,4214,91,93,2889.79,5097.57,0.00
2024-12-08 16:54:23,184,4215,91,93,2944.84,5098.00,0.00
2024-12-08 16:54:23,185,4215,92,93,2928.92,5098.01,0.00
2024-12-08 16:54:23,184,4215,91,93,2944.51,5098.01,0.00
2024-12-08 16:54:23,183,4215,91,92,2954.16,5098.10,0.00
2024-12-08 16:54:23,182,4215,90,92,2959.56,5098.32,0.00
2024-12-08 16:54:23,183,4214,91,92,2931.53,5098.56,0.00
2024-12-08 16:54:24,184,4213,91,93,2920.45,5098.64,0.00
2024-12-08 16:54:24,183,4213,90,93,2942.37,5098.69,0.00
2024-12-08 16:54:24,183,4214,90,93,2970.00,5099.00,0.00
2024-12-08 16:54:24,184,4214,90,94,2953.86,5099.01,0.00
2024-12-08 16:54:24,183,4214,90,93,2962.48,5099.10,0.00
2024-12-08 16:54:24,183,4215,90,93,2987.28,5100.00,0.00
2024-12-08 16:54:24,184,4215,91,93,2971.04,5100.01,0.00
2024-12-08 16:54:24,183,4215,91,92,2980.34,5100.10,0.00
2024-12-08 16:54:24,184,4214,91,93,2931.14,5100.73,0.00
2024-12-08 16:54:24,184,4215,91,93,2940.43,5101.00,0.00
2024-12-08 16:54:24,185,4215,91,94,2924.54,5101.01,0.00
2024-12-08 16:54:24,184,4215,90,94,2938.49,5101.04,0.00
2024-12-08 16:54:24,183,4215,89,94,2952.89,5101.07,0.00
2024-12-08 16:54:24,182,4215,88,94,2951.26,5101.31,0.00
2024-12-08 16:54:24,183,4214,89,94,2909.21,5101.78,0.00
2024-12-08 16:54:24,184,4213,89,95,2887.13,5101.96,0.00
2024-12-08 16:54:24,184,4214,89,95,2952.60,5102.00,0.00
2024-12-08 16:54:24,185,4214,90,95,2936.64,5102.01,0.00
2024-12-08 16:54:24,186,4213,90,96,2906.92,5102.18,0.00
2024-12-08 16:54:24,185,4213,89,96,2938.96,5102.32,0.00
2024-12-08 16:54:24,186,4212,90,96,2907.12,5102.60,0.00
2024-12-08 16:54:24,186,4213,90,96,2974.11,5103.00,0.00
2024-12-08 16:54:24,187,4213,91,96,2958.21,5103.01,0.00
2024-12-08 16:54:24,186,4213,91,95,2970.04,5103.08,0.00
2024-12-08 16:54:24,187,4212,92,95,2928.95,5103.48,0.00
2024-12-08 16:54:24,187,4213,92,95,2981.42,5104.00,0.00
2024-12-08 16:54:24,188,4213,93,95,2965.56,5104.01,0.00
2024-12-08 16:54:24,189,4212,93,96,2918.76,5104.52,0.00
2024-12-08 16:54:24,189,4213,93,96,2938.29,5105.00,0.00
2024-12-08 16:54:24,190,4213,94,96,2922.82,5105.01,0.00
2024-12-08 16:54:24,189,4213,93,96,2935.61,5105.05,0.00
2024-12-08 16:54:24,188,4213,93,95,2949.33,5105.08,0.00
2024-12-08 16:54:24,189,4212,93,96,2916.84,5105.42,0.00
2024-12-08 16:54:24,188,4212,92,96,2938.11,5105.52,0.00
2024-12-08 16:54:24,189,4211,92,97,2918.86,5105.58,0.00
2024-12-08 16:54:24,189,4212,92,97,2945.28,5106.00,0.00
2024-12-08 16:54:24,190,4212,93,97,2929.78,5106.01,0.00
2024-12-08 16:54:24,189,4212,93,96,2940.45,5106.08,0.00
2024-12-08 16:54:24,188,4212,92,96,2932.82,5106.33,0.00
2024-12-08 16:54:24,189,4211,92,97,2907.15,5106.54,0.00
2024-12-08 16:54:24,189,4212,92,97,2972.52,5107.00,0.00
2024-12-08 16:54:24,190,4212,93,97,2956.87,5107.01,0.00
2024-12-08 16:54:24,191,4211,93,98,2912.23,5107.44,0.00
2024-12-08 16:54:24,190,4211,92,98,2931.71,5107.54,0.00
2024-12-08 16:54:24,190,4212,92,98,2962.10,5108.00,0.00
2024-12-08 16:54:24,191,4212,92,99,2946.60,5108.01,0.00
2024-12-08 16:54:24,192,4211,93,99,2915.09,5108.23,0.00
2024-12-08 16:54:24,192,4212,93,99,2940.18,5109.00,0.00
2024-12-08 16:54:24,193,4212,94,99,2924.95,5109.01,0.00
2024-12-08 16:54:24,192,4212,93,99,2939.70,5109.01,0.00
2024-12-08 16:54:24,193,4211,94,99,2924.46,5109.02,0.00
2024-12-08 16:54:24,192,4211,94,98,2936.53,5109.09,0.00
2024-12-08 16:54:24,193,4210,94,99,2875.78,5109.94,0.00
2024-12-08 16:54:24,193,4211,94,99,2920.27,5110.00,0.00
2024-12-08 16:54:24,194,4211,94,100,2905.22,5110.01,0.00
2024-12-08 16:54:24,193,4211,94,99,2910.77,5110.08,0.00
2024-12-08 16:54:24,194,4210,94,100,2880.34,5110.40,0.00
2024-12-08 16:54:24,195,4209,94,101,2879.98,5110.41,0.00
2024-12-08 16:54:24,195,4210,94,101,2920.81,5111.00,0.00
2024-12-08 16:54:24,196,4210,95,101,2905.90,5111.01,0.00
2024-12-08 16:54:24,195,4210,95,100,2915.59,5111.08,0.00
2024-12-08 16:54:24,194,4210,95,99,2930.36,5111.08,0.00
2024-12-08 16:54:24,193,4210,94,99,2937.03,5111.24,0.00
2024-12-08 16:54:24,192,4210,93,99,2950.00,5111.29,0.00
2024-12-08 16:54:24,192,4211,93,99,2982.98,5112.00,0.00
2024-12-08 16:54:24,193,4211,94,99,2967.53,5112.01,0.00
2024-12-08 16:54:24,194,4210,95,99,2950.41,5112.05,0.00
2024-12-08 16:54:24,193,4210,94,99,2973.12,5112.07,0.00
2024-12-08 16:54:24,192,4210,93,99,2988.07,5112.08,0.00
2024-12-08 16:54:24,191,4210,93,98,3003.18,5112.08,0.00
2024-12-08 16:54:24,192,4209,93,99,2951.51,5112.79,0.00
2024-12-08 16:54:24,192,4210,93,99,2972.45,5113.00,0.00
2024-12-08 16:54:24,193,4210,93,100,2957.05,5113.01,0.00
2024-12-08 16:54:24,192,4210,92,100,2969.53,5113.06,0.00
2024-12-08 16:54:24,191,4210,92,99,2984.54,5113.07,0.00
2024-12-08 16:54:24,192,4209,93,99,2938.02,5113.48,0.00
2024-12-08 16:54:24,192,4210,93,99,2993.12,5114.00,0.00
2024-12-08 16:54:24,193,4210,93,100,2977.61,5114.01,0.00
2024-12-08 16:54:24,192,4210,92,100,2991.80,5114.03,0.00
2024-12-08 16:54:24,191,4210,92,99,2999.71,5114.07,0.00
2024-12-08 16:54:24,190,4210,91,99,2986.14,5114.62,0.00
2024-12-08 16:54:24,190,4211,91,99,3013.09,5115.00,0.00
2024-12-08 16:54:24,191,4211,92,99,2997.32,5115.01,0.00
2024-12-08 16:54:24,190,4211,92,98,3004.24,5115.07,0.00
2024-12-08 16:54:24,190,4212,92,98,2971.47,5116.00,0.00
2024-12-08 16:54:24,191,4212,92,99,2955.91,5116.01,0.00
2024-12-08 16:54:24,190,4212,92,98,2966.35,5116.06,0.00
2024-12-08 16:54:24,189,4212,92,97,2981.50,5116.07,0.00
2024-12-08 16:54:24,188,4212,91,97,2992.49,5116.16,0.00
2024-12-08 16:54:25,188,4213,91,97,2962.53,5117.00,0.00
2024-12-08 16:54:25,189,4213,91,98,2946.85,5117.01,0.00
2024-12-08 16:54:25,189,4214,91,98,2905.11,5118.00,0.00
2024-12-08 16:54:25,190,4214,91,99,2889.82,5118.01,0.00
2024-12-08 16:54:25,189,4214,90,99,2894.21,5118.09,0.00
2024-12-08 16:54:25,188,4214,89,99,2899.94,5118.17,0.00
2024-12-08 16:54:25,189,4213,89,100,2878.68,5118.29,0.00
2024-12-08 16:54:25,190,4212,90,100,2875.72,5118.42,0.00
2024-12-08 16:54:25,191,4211,90,101,2837.80,5118.96,0.00
2024-12-08 16:54:25,191,4212,90,101,2863.83,5119.00,0.00
2024-12-08 16:54:25,192,4212,91,101,2848.92,5119.01,0.00
2024-12-08 16:54:25,191,4212,91,100,2858.05,5119.08,0.00
2024-12-08 16:54:25,190,4212,90,100,2872.56,5119.08,0.00
2024-12-08 16:54:25,189,4212,89,100,2856.02,5119.49,0.00
2024-12-08 16:54:25,190,4211,90,100,2822.37,5119.86,0.00
2024-12-08 16:54:25,190,4212,90,100,2917.99,5120.00,0.00
2024-12-08 16:54:25,191,4212,90,101,2902.71,5120.01,0.00
2024-12-08 16:54:25,190,4212,89,101,2916.08,5120.04,0.00
2024-12-08 16:54:25,189,4212,89,100,2929.36,5120.08,0.00
2024-12-08 16:54:25,190,4211,89,101,2900.30,5120.36,0.00
2024-12-08 16:54:25,189,4211,88,101,2903.31,5120.59,0.00
2024-12-08 16:54:25,188,4211,88,100,2902.24,5120.92,0.00
2024-12-08 16:54:25,189,4210,89,100,2886.62,5120.93,0.00
2024-12-08 16:54:25,189,4211,89,100,2937.35,5121.00,0.00
2024-12-08 16:54:25,190,4211,89,101,2921.89,5121.01,0.00
2024-12-08 16:54:25,189,4211,89,100,2922.48,5121.08,0.00
2024-12-08 16:54:25,190,4210,89,101,2894.00,5121.35,0.00
2024-12-08 16:54:25,190,4211,89,101,2968.56,5122.00,0.00
2024-12-08 16:54:25,191,4211,90,101,2953.02,5122.01,0.00
2024-12-08 16:54:25,190,4211,89,101,2964.28,5122.08,0.00
2024-12-08 16:54:25,189,4211,89,100,2979.43,5122.08,0.00
2024-12-08 16:54:25,188,4211,88,100,2984.13,5122.17,0.00
2024-12-08 16:54:25,187,4211,87,100,2992.38,5122.32,0.00
2024-12-08 16:54:25,186,4211,86,100,3007.38,5122.33,0.00
2024-12-08 16:54:25,187,4210,86,101,2990.76,5122.35,0.00
2024-12-08 16:54:25,188,4209,87,101,2974.49,5122.69,0.00
2024-12-08 16:54:25,188,4210,87,101,3015.61,5123.00,0.00
2024-12-08 16:54:25,189,4210,87,102,2999.66,5123.01,0.00
2024-12-08 16:54:25,188,4210,86,102,2992.06,5123.36,0.00
2024-12-08 16:54:25,187,4210,85,102,2995.90,5123.48,0.00
2024-12-08 16:54:25,187,4210,85,102,3051.62,5124.00,0.00
2024-12-08 16:54:25,188,4210,85,103,3035.39,5124.01,0.00
2024-12-08 16:54:25,187,4210,84,103,3036.32,5124.13,0.00
2024-12-08 16:54:25,187,4211,84,103,3019.60,5125.00,0.00
2024-12-08 16:54:25,188,4211,85,103,3003.54,5125.01,0.00
2024-12-08 16:54:25,187,4211,85,102,3014.99,5125.09,0.00
2024-12-08 16:54:25,186,4211,84,102,3006.28,5125.39,0.00
2024-12-08 16:54:25,187,4210,85,102,2978.27,5125.64,0.00
2024-12-08 16:54:25,187,4211,85,102,2996.09,5126.00,0.00
2024-12-08 16:54:25,188,4211,86,102,2980.16,5126.01,0.00
2024-12-08 16:54:25,187,4211,85,102,2992.82,5126.03,0.00
2024-12-08 16:54:25,186,4211,85,101,3000.39,5126.09,0.00
2024-12-08 16:54:25,185,4211,84,101,2988.99,5126.62,0.00
2024-12-08 16:54:25,184,4211,83,101,3003.21,5126.66,0.00
2024-12-08 16:54:25,185,4210,84,101,2986.71,5126.67,0.00
2024-12-08 16:54:25,186,4209,84,102,2969.94,5126.85,0.00
2024-12-08 16:54:25,187,4208,84,103,2952.79,5126.96,0.00
2024-12-08 16:54:25,187,4209,84,103,3006.83,5127.00,0.00
2024-12-08 16:54:25,188,4209,85,103,2990.84,5127.01,0.00
2024-12-08 16:54:25,188,4210,85,103,3032.49,5128.00,0.00
2024-12-08 16:54:25,189,4210,85,104,3016.44,5128.01,0.00
2024-12-08 16:54:25,188,4210,85,103,3027.06,5128.08,0.00
2024-12-08 16:54:25,189,4209,85,104,2998.11,5128.34,0.00
2024-12-08 16:54:25,189,4210,85,104,2997.85,5129.00,0.00
2024-12-08 16:54:25,190,4210,86,104,2982.08,5129.01,0.00
2024-12-08 16:54:25,190,4211,86,104,2976.91,5130.00,0.00
2024-12-08 16:54:25,191,4211,86,105,2961.33,5130.01,0.00
2024-12-08 16:54:25,190,4211,85,105,2975.04,5130.04,0.00
2024-12-08 16:54:25,189,4211,84,105,2968.95,5130.24,0.00
2024-12-08 16:54:25,188,4211,83,105,2957.15,5130.79,0.00
2024-12-08 16:54:25,188,4211,83,105,2968.01,5131.00,0.00
2024-12-08 16:54:25,189,4211,84,105,2952.31,5131.01,0.00
2024-12-08 16:54:25,188,4211,84,104,2958.12,5131.09,0.00
2024-12-08 16:54:25,187,4211,83,104,2963.58,5131.16,0.00
2024-12-08 16:54:25,187,4212,83,104,2931.24,5132.00,0.00
2024-12-08 16:54:25,188,4212,83,105,2915.65,5132.01,0.00
2024-12-08 16:54:25,187,4212,82,105,2929.33,5132.04,0.00
2024-12-08 16:54:25,186,4212,82,104,2938.75,5132.07,0.00
2024-12-08 16:54:25,185,4212,81,104,2936.77,5132.38,0.00
2024-12-08 16:54:25,184,4212,80,104,2926.15,5132.88,0.00
2024-12-08 16:54:25,184,4213,80,104,2936.58,5133.00,0.00
2024-12-08 16:54:25,185,4213,80,105,2920.71,5133.01,0.00
2024-12-08 16:54:25,184,4213,79,105,2935.48,5133.02,0.00
2024-12-08 16:54:25,183,4213,79,104,2946.69,5133.07,0.00
2024-12-08 16:54:25,184,4212,80,104,2930.67,5133.08,0.00
2024-12-08 16:54:25,183,4212,79,104,2958.37,5133.23,0.00
2024-12-08 16:54:25,184,4211,80,104,2920.48,5133.67,0.00
2024-12-08 16:54:25,184,4212,80,104,2940.55,5134.00,0.00
2024-12-08 16:54:25,185,4212,81,104,2924.66,5134.01,0.00
2024-12-08 16:54:25,184,4212,80,104,2936.40,5134.07,0.00
2024-12-08 16:54:25,185,4211,81,104,2902.44,5134.31,0.00
2024-12-08 16:54:25,186,4210,82,104,2896.23,5134.32,0.00
2024-12-08 16:54:25,185,4210,81,104,2916.91,5134.37,0.00
2024-12-08 16:54:26,185,4211,81,104,2965.49,5135.00,0.00
2024-12-08 16:54:26,186,4211,81,105,2949.54,5135.01,0.00
2024-12-08 16:54:26,187,4210,81,106,2931.87,5135.05,0.00
2024-12-08 16:54:26,188,4209,82,106,2912.06,5135.20,0.00
2024-12-08 16:54:26,187,4209,81,106,2941.20,5135.38,0.00
2024-12-08 16:54:26,187,4210,81,106,2987.32,5136.00,0.00
2024-12-08 16:54:26,188,4210,81,107,2971.43,5136.01,0.00
2024-12-08 16:54:26,189,4209,82,107,2955.44,5136.02,0.00
2024-12-08 16:54:26,189,4210,82,107,2979.09,5137.00,0.00
2024-12-08 16:54:26,190,4210,83,107,2963.41,5137.01,0.00
2024-12-08 16:54:26,191,4209,84,107,2923.62,5137.38,0.00
2024-12-08 16:54:26,191,4210,84,107,2943.30,5138.00,0.00
2024-12-08 16:54:26,192,4210,85,107,2927.97,5138.01,0.00
2024-12-08 16:54:26,191,4210,85,106,2939.19,5138.06,0.00
2024-12-08 16:54:26,190,4210,84,106,2954.39,5138.06,0.00
2024-12-08 16:54:26,191,4209,85,106,2937.85,5138.09,0.00
2024-12-08 16:54:26,190,4209,84,106,2931.93,5138.95,0.00
2024-12-08 16:54:26,190,4210,84,106,2982.68,5139.00,0.00
2024-12-08 16:54:26,191,4210,85,106,2967.07,5139.01,0.00
2024-12-08 16:54:26,190,4210,85,105,2974.60,5139.07,0.00
2024-12-08 16:54:26,189,4210,84,105,2984.91,5139.10,0.00
2024-12-08 16:54:26,189,4211,84,105,2992.46,5140.00,0.00
2024-12-08 16:54:26,190,4211,84,106,2976.71,5140.01,0.00
2024-12-08 16:54:26,189,4211,84,105,2988.41,5140.07,0.00
2024-12-08 16:54:26,188,4211,83,105,2997.21,5140.15,0.00
2024-12-08 16:54:26,188,4212,83,105,2980.31,5141.00,0.00
2024-12-08 16:54:26,189,4212,84,105,2964.55,5141.01,0.00
2024-12-08 16:54:26,189,4213,84,105,2930.32,5142.00,0.00
2024-12-08 16:54:26,190,4213,84,106,2914.89,5142.01,0.00
2024-12-08 16:54:26,189,4213,83,106,2927.35,5142.06,0.00
2024-12-08 16:54:26,188,4213,83,105,2936.36,5142.08,0.00
2024-12-08 16:54:26,188,4214,83,105,2909.01,5143.00,0.00
2024-12-08 16:54:26,189,4214,83,106,2893.62,5143.01,0.00
2024-12-08 16:54:26,188,4214,83,105,2899.74,5143.08,0.00
2024-12-08 16:54:26,189,4213,84,105,2876.30,5143.24,0.00
2024-12-08 16:54:26,189,4214,84,105,2859.92,5144.00,0.00
2024-12-08 16:54:26,190,4214,84,106,2844.87,5144.01,0.00
2024-12-08 16:54:26,189,4214,84,105,2850.70,5144.07,0.00
2024-12-08 16:54:26,190,4213,85,105,2822.03,5144.34,0.00
2024-12-08 16:54:26,189,4213,84,105,2832.34,5144.68,0.00
2024-12-08 16:54:26,189,4214,84,105,2859.29,5145.00,0.00
2024-12-08 16:54:26,190,4214,85,105,2844.24,5145.01,0.00
2024-12-08 16:54:26,189,4214,85,104,2852.24,5145.07,0.00
2024-12-08 16:54:26,188,4214,84,104,2854.64,5145.32,0.00
2024-12-08 16:54:26,188,4215,84,104,2862.06,5146.00,0.00
2024-12-08 16:54:26,189,4215,85,104,2846.92,5146.01,0.00
2024-12-08 16:54:26,188,4215,85,103,2842.15,5146.29,0.00
2024-12-08 16:54:26,188,4216,85,103,2820.69,5147.00,0.00
2024-12-08 16:54:26,189,4216,85,104,2805.76,5147.01,0.00
2024-12-08 16:54:26,188,4216,85,103,2814.96,5147.07,0.00
2024-12-08 16:54:26,187,4216,84,103,2829.74,5147.07,0.00
2024-12-08 16:54:26,186,4216,84,102,2844.68,5147.07,0.00
2024-12-08 16:54:26,185,4216,83,102,2859.78,5147.07,0.00
2024-12-08 16:54:26,185,4217,83,102,2827.26,5148.00,0.00
2024-12-08 16:54:26,186,4217,84,102,2812.06,5148.01,0.00
2024-12-08 16:54:26,185,4217,84,101,2823.67,5148.07,0.00
2024-12-08 16:54:26,184,4217,83,101,2838.74,5148.07,0.00
2024-12-08 16:54:26,184,4218,83,101,2806.62,5149.00,0.00
2024-12-08 16:54:26,185,4218,83,102,2791.44,5149.01,0.00
2024-12-08 16:54:26,184,4218,82,102,2794.51,5149.07,0.00
2024-12-08 16:54:26,183,4218,82,101,2809.50,5149.07,0.00
2024-12-08 16:54:26,182,4218,82,100,2824.66,5149.07,0.00
2024-12-08 16:54:26,181,4218,81,100,2823.05,5149.40,0.00
2024-12-08 16:54:26,181,4219,81,100,2819.54,5150.00,0.00
2024-12-08 16:54:26,182,4219,82,100,2804.05,5150.01,0.00
2024-12-08 16:54:26,181,4219,82,99,2816.15,5150.07,0.00
2024-12-08 16:54:26,182,4218,83,99,2777.95,5150.52,0.00
2024-12-08 16:54:26,183,4217,84,99,2767.00,5150.54,0.00
2024-12-08 16:54:26,183,4218,84,99,2772.56,5151.00,0.00
2024-12-08 16:54:26,184,4218,84,100,2757.49,5151.01,0.00
2024-12-08 16:54:26,184,4219,84,100,2781.55,5152.00,0.00
2024-12-08 16:54:26,185,4219,84,101,2766.51,5152.01,0.00
2024-12-08 16:54:26,186,4218,84,102,2713.96,5152.65,0.00
2024-12-08 16:54:26,185,4218,83,102,2728.85,5152.83,0.00
2024-12-08 16:54:26,185,4219,83,102,2743.33,5153.00,0.00
2024-12-08 16:54:26,186,4219,83,103,2728.58,5153.01,0.00
2024-12-08 16:54:26,187,4218,84,103,2710.71,5153.08,0.00
2024-12-08 16:54:26,188,4217,85,103,2700.77,5153.31,0.00
2024-12-08 16:54:26,189,4216,85,104,2687.47,5153.68,0.00
2024-12-08 16:54:27,189,4217,85,104,2724.72,5154.00,0.00
2024-12-08 16:54:27,190,4217,85,105,2710.38,5154.01,0.00
2024-12-08 16:54:27,190,4218,85,105,2756.35,5155.00,0.00
2024-12-08 16:54:27,191,4218,86,105,2741.92,5155.01,0.00
2024-12-08 16:54:27,192,4217,87,105,2698.82,5155.47,0.00
2024-12-08 16:54:27,192,4218,87,105,2706.76,5156.00,0.00
2024-12-08 16:54:27,193,4218,88,105,2692.74,5156.01,0.00
2024-12-08 16:54:27,194,4217,88,106,2645.32,5156.57,0.00
2024-12-08 16:54:27,194,4218,88,106,2679.56,5157.00,0.00
2024-12-08 16:54:27,195,4218,89,106,2665.82,5157.01,0.00
2024-12-08 16:54:27,194,4218,89,105,2672.66,5157.04,0.00
2024-12-08 16:54:27,194,4219,89,105,2664.15,5158.00,0.00
2024-12-08 16:54:27,195,4219,90,105,2650.49,5158.01,0.00
2024-12-08 16:54:27,194,4219,90,104,2654.08,5158.09,0.00
2024-12-08 16:54:27,194,4220,90,104,2630.93,5159.00,0.00
2024-12-08 16:54:27,195,4220,91,104,2617.44,5159.01,0.00
2024-12-08 16:54:27,194,4220,90,104,2620.59,5159.10,0.00
2024-12-08 16:54:27,195,4219,91,104,2580.37,5159.63,0.00
2024-12-08 16:54:27,195,4220,91,104,2595.48,5160.00,0.00
2024-12-08 16:54:27,196,4220,91,105,2582.24,5160.01,0.00
2024-12-08 16:54:27,197,4219,92,105,2552.70,5160.23,0.00
2024-12-08 16:54:27,198,4218,92,106,2548.80,5160.48,0.00
2024-12-08 16:54:27,198,4219,92,106,2571.70,5161.00,0.00
2024-12-08 16:54:27,199,4219,93,106,2558.77,5161.01,0.00
2024-12-08 16:54:27,200,4218,93,107,2535.94,5161.11,0.00
2024-12-08 16:54:27,201,4217,93,108,2537.47,5161.16,0.00
2024-12-08 16:54:27,200,4217,92,108,2538.91,5161.46,0.00
2024-12-08 16:54:27,200,4218,92,108,2580.20,5162.00,0.00
2024-12-08 16:54:27,201,4218,92,109,2567.36,5162.01,0.00
2024-12-08 16:54:27,200,4218,91,109,2579.43,5162.02,0.00
2024-12-08 16:54:27,199,4218,90,109,2590.53,5162.04,0.00
2024-12-08 16:54:27,198,4218,90,108,2599.96,5162.05,0.00
2024-12-08 16:54:27,197,4218,90,107,2610.30,5162.10,0.00
2024-12-08 16:54:27,197,4219,90,107,2631.42,5163.00,0.00
2024-12-08 16:54:27,198,4219,90,108,2618.13,5163.01,0.00
2024-12-08 16:54:27,197,4219,90,107,2620.15,5163.11,0.00
2024-12-08 16:54:27,197,4220,90,107,2591.68,5164.00,0.00
2024-12-08 16:54:27,198,4220,90,108,2578.59,5164.01,0.00
2024-12-08 16:54:27,197,4220,89,108,2580.45,5164.12,0.00
2024-12-08 16:54:27,196,4220,88,108,2576.03,5164.46,0.00
2024-12-08 16:54:27,195,4220,87,108,2584.07,5164.48,0.00
2024-12-08 16:54:27,195,4221,87,108,2580.88,5165.00,0.00
2024-12-08 16:54:27,196,4221,87,109,2567.71,5165.01,0.00
2024-12-08 16:54:27,195,4221,87,108,2578.24,5165.05,0.00
2024-12-08 16:54:27,196,4220,88,108,2554.88,5165.26,0.00
2024-12-08 16:54:27,195,4220,87,108,2578.88,5165.47,0.00
2024-12-08 16:54:27,196,4219,87,109,2565.46,5165.48,0.00
2024-12-08 16:54:27,195,4219,86,109,2582.96,5165.68,0.00
2024-12-08 16:54:27,195,4220,86,109,2592.41,5166.00,0.00
2024-12-08 16:54:27,196,4220,86,110,2579.18,5166.01,0.00
2024-12-08 16:54:27,195,4220,86,109,2586.33,5166.05,0.00
2024-12-08 16:54:27,194,4220,85,109,2584.40,5166.14,0.00
2024-12-08 16:54:27,194,4221,85,109,2616.88,5167.00,0.00
2024-12-08 16:54:27,195,4221,85,110,2603.46,5167.01,0.00
2024-12-08 16:54:27,196,4220,85,111,2561.96,5167.42,0.00
2024-12-08 16:54:27,195,4220,84,111,2576.11,5167.48,0.00
2024-12-08 16:54:27,195,4221,84,111,2566.20,5168.00,0.00
2024-12-08 16:54:27,196,4221,85,111,2553.11,5168.01,0.00
2024-12-08 16:54:27,195,4221,84,111,2564.36,5168.04,0.00
2024-12-08 16:54:27,196,4220,84,112,2542.60,5168.11,0.00
2024-12-08 16:54:27,195,4220,84,111,2555.88,5168.13,0.00
2024-12-08 16:54:27,194,4220,83,111,2559.45,5168.29,0.00
2024-12-08 16:54:27,193,4220,82,111,2531.14,5168.87,0.00
2024-12-08 16:54:27,193,4221,82,111,2575.49,5169.00,0.00
2024-12-08 16:54:27,194,4221,83,111,2562.22,5169.01,0.00
2024-12-08 16:54:27,193,4221,83,110,2572.83,5169.05,0.00
2024-12-08 16:54:27,192,4221,83,109,2581.64,5169.13,0.00
2024-12-08 16:54:27,192,4222,83,109,2572.65,5170.00,0.00
2024-12-08 16:54:27,193,4222,83,110,2559.32,5170.01,0.00
2024-12-08 16:54:27,192,4222,82,110,2571.04,5170.03,0.00
2024-12-08 16:54:27,191,4222,81,110,2583.70,5170.04,0.00
2024-12-08 16:54:27,190,4222,81,109,2586.99,5170.12,0.00
2024-12-08 16:54:27,189,4222,81,108,2600.40,5170.12,0.00
2024-12-08 16:54:27,188,4222,80,108,2599.70,5170.29,0.00
2024-12-08 16:54:27,189,4221,81,108,2575.91,5170.49,0.00
2024-12-08 16:54:27,190,4220,82,108,2531.88,5170.86,0.00
2024-12-08 16:54:27,190,4221,82,108,2553.65,5171.00,0.00
2024-12-08 16:54:27,191,4221,83,108,2540.28,5171.01,0.00
2024-12-08 16:54:27,190,4221,82,108,2541.19,5171.12,0.00
2024-12-08 16:54:27,189,4221,81,108,2506.59,5171.78,0.00
2024-12-08 16:54:27,188,4221,81,107,2510.55,5171.83,0.00
2024-12-08 16:54:27,189,4220,81,108,2491.86,5171.91,0.00
2024-12-08 16:54:27,189,4221,81,108,2582.78,5172.00,0.00
2024-12-08 16:54:28,190,4221,81,109,2569.19,5172.01,0.00
2024-12-08 16:54:28,189,4221,81,108,2579.78,5172.05,0.00
2024-12-08 16:54:28,188,4221,80,108,2574.51,5172.38,0.00
2024-12-08 16:54:28,187,4221,79,108,2566.37,5172.72,0.00
2024-12-08 16:54:28,187,4222,79,108,2607.25,5173.00,0.00
2024-12-08 16:54:28,188,4222,80,108,2593.38,5173.01,0.00
2024-12-08 16:54:28,188,4223,80,108,2548.78,5174.00,0.00
2024-12-08 16:54:28,189,4223,81,108,2535.30,5174.01,0.00
2024-12-08 16:54:28,188,4223,81,107,2542.47,5174.07,0.00
2024-12-08 16:54:28,187,4223,81,106,2549.72,5174.12,0.00
2024-12-08 16:54:28,188,4222,81,107,2495.86,5174.80,0.00
2024-12-08 16:54:28,188,4223,81,107,2508.14,5175.00,0.00
2024-12-08 16:54:28,189,4223,81,108,2494.87,5175.01,0.00
2024-12-08 16:54:28,188,4223,81,107,2491.06,5175.12,0.00
2024-12-08 16:54:28,187,4223,80,107,2459.74,5175.72,0.00
2024-12-08 16:54:28,187,4224,80,107,2500.65,5176.00,0.00
2024-12-08 16:54:28,188,4224,80,108,2487.35,5176.01,0.00
2024-12-08 16:54:28,187,4224,79,108,2459.46,5176.48,0.00
2024-12-08 16:54:28,186,4224,78,108,2460.19,5176.51,0.00
2024-12-08 16:54:28,185,4224,77,108,2466.34,5176.64,0.00
2024-12-08 16:54:28,185,4225,77,108,2474.12,5177.00,0.00
2024-12-08 16:54:28,186,4225,77,109,2460.82,5177.01,0.00
2024-12-08 16:54:28,185,4225,76,109,2472.07,5177.03,0.00
2024-12-08 16:54:28,184,4225,76,108,2482.99,5177.07,0.00
2024-12-08 16:54:28,183,4225,76,107,2495.46,5177.08,0.00
2024-12-08 16:54:28,182,4225,75,107,2506.93,5177.09,0.00
2024-12-08 16:54:28,181,4225,75,106,2500.42,5177.47,0.00
2024-12-08 16:54:28,180,4225,75,105,2509.70,5177.48,0.00
2024-12-08 16:54:28,180,4226,75,105,2499.04,5178.00,0.00
2024-12-08 16:54:28,181,4226,76,105,2485.24,5178.01,0.00
2024-12-08 16:54:28,180,4226,75,105,2487.29,5178.12,0.00
2024-12-08 16:54:28,179,4226,74,105,2492.93,5178.27,0.00
2024-12-08 16:54:28,179,4227,74,105,2480.58,5179.00,0.00
2024-12-08 16:54:28,180,4227,75,105,2466.79,5179.01,0.00
2024-12-08 16:54:28,179,4227,74,105,2480.43,5179.01,0.00
2024-12-08 16:54:28,178,4227,73,105,2493.21,5179.02,0.00
2024-12-08 16:54:28,177,4227,73,104,2505.25,5179.03,0.00
2024-12-08 16:54:28,176,4227,73,103,2515.69,5179.10,0.00
2024-12-08 16:54:28,175,4227,73,102,2529.77,5179.10,0.00
2024-12-08 16:54:28,174,4227,73,101,2543.72,5179.11,0.00
2024-12-08 16:54:28,173,4227,72,101,2542.32,5179.41,0.00
2024-12-08 16:54:28,173,4228,72,101,2529.07,5180.00,0.00
2024-12-08 16:54:28,174,4228,73,101,2514.54,5180.01,0.00
2024-12-08 16:54:28,175,4227,74,101,2484.24,5180.21,0.00
2024-12-08 16:54:28,176,4226,74,102,2487.71,5180.38,0.00
2024-12-08 16:54:28,177,4225,74,103,2465.25,5180.67,0.00
2024-12-08 16:54:28,177,4226,74,103,2485.74,5181.00,0.00
2024-12-08 16:54:28,178,4226,74,104,2471.78,5181.01,0.00
2024-12-08 16:54:28,177,4226,74,103,2473.37,5181.11,0.00
2024-12-08 16:54:28,178,4225,74,104,2459.18,5181.13,0.00
2024-12-08 16:54:28,177,4225,74,103,2499.75,5181.16,0.00
2024-12-08 16:54:28,176,4225,74,102,2509.35,5181.24,0.00
2024-12-08 16:54:28,176,4226,74,102,2581.88,5182.00,0.00
2024-12-08 16:54:28,177,4226,75,102,2567.30,5182.01,0.00
2024-12-08 16:54:28,176,4226,74,102,2550.14,5182.47,0.00
2024-12-08 16:54:28,176,4227,74,102,2569.88,5183.00,0.00
2024-12-08 16:54:28,177,4227,74,103,2555.36,5183.01,0.00
2024-12-08 16:54:28,176,4227,74,102,2563.04,5183.06,0.00
2024-12-08 16:54:28,177,4226,75,102,2529.35,5183.44,0.00
2024-12-08 16:54:28,176,4226,75,101,2555.47,5183.58,0.00
2024-12-08 16:54:28,176,4227,75,101,2522.10,5184.00,0.00
2024-12-08 16:54:28,177,4227,76,101,2507.85,5184.01,0.00
2024-12-08 16:54:28,176,4227,76,100,2506.20,5184.13,0.00
2024-12-08 16:54:28,175,4227,76,99,2518.75,5184.16,0.00
2024-12-08 16:54:28,176,4226,76,100,2488.47,5184.38,0.00
2024-12-08 16:54:28,177,4225,76,101,2469.99,5184.74,0.00
2024-12-08 16:54:28,176,4225,75,101,2465.33,5184.88,0.00
2024-12-08 16:54:28,175,4225,74,101,2471.30,5184.89,0.00
2024-12-08 16:54:28,175,4226,74,101,2524.72,5185.00,0.00
2024-12-08 16:54:28,176,4226,74,102,2510.38,5185.01,0.00
2024-12-08 16:54:28,175,4226,74,101,2507.84,5185.13,0.00
2024-12-08 16:54:28,174,4226,73,101,2502.36,5185.48,0.00
2024-12-08 16:54:28,173,4226,72,101,2512.34,5185.57,0.00
2024-12-08 16:54:28,173,4227,72,101,2565.08,5186.00,0.00
2024-12-08 16:54:28,174,4227,73,101,2550.34,5186.01,0.00
2024-12-08 16:54:28,173,4227,73,100,2554.58,5186.06,0.00
2024-12-08 16:54:28,172,4227,72,100,2565.54,5186.13,0.00
2024-12-08 16:54:28,171,4227,71,100,2580.24,5186.13,0.00
2024-12-08 16:54:28,170,4227,70,100,2564.06,5186.71,0.00
2024-12-08 16:54:28,170,4228,70,100,2562.27,5187.00,0.00
2024-12-08 16:54:28,171,4228,71,100,2547.29,5187.01,0.00
2024-12-08 16:54:28,170,4228,70,100,2555.70,5187.04,0.00
2024-12-08 16:54:28,169,4228,70,99,2559.81,5187.12,0.00
2024-12-08 16:54:28,168,4228,70,98,2574.74,5187.13,0.00
2024-12-08 16:54:28,167,4228,69,98,2568.80,5187.37,0.00
2024-12-08 16:54:28,166,4228,68,98,2579.63,5187.46,0.00
2024-12-08 16:54:28,166,4229,68,98,2575.97,5188.00,0.00
2024-12-08 16:54:28,167,4229,68,99,2560.55,5188.01,0.00
2024-12-08 16:54:28,166,4229,68,98,2571.61,5188.05,0.00
2024-12-08 16:54:28,165,4229,68,97,2583.45,5188.12,0.00
2024-12-08 16:54:28,164,4229,67,97,2580.85,5188.47,0.00
2024-12-08 16:54:28,163,4229,67,96,2576.79,5188.75,0.00
2024-12-08 16:54:28,163,4230,67,96,2583.02,5189.00,0.00
2024-12-08 16:54:28,164,4230,68,96,2567.27,5189.01,0.00
2024-12-08 16:54:28,165,4229,69,96,2531.47,5189.28,0.00
2024-12-08 16:54:28,164,4229,68,96,2557.30,5189.55,0.00
2024-12-08 16:54:29,164,4230,68,96,2561.78,5190.00,0.00
2024-12-08 16:54:29,165,4230,68,97,2546.26,5190.01,0.00
2024-12-08 16:54:29,164,4230,67,97,2561.27,5190.01,0.00
2024-12-08 16:54:29,163,4230,67,96,2565.23,5190.11,0.00
2024-12-08 16:54:29,162,4230,67,95,2580.75,5190.11,0.00
2024-12-08 16:54:29,161,4230,67,94,2596.14,5190.12,0.00
2024-12-08 16:54:29,161,4231,67,94,2608.12,5191.00,0.00
2024-12-08 16:54:29,162,4231,68,94,2592.02,5191.01,0.00
2024-12-08 16:54:29,161,4231,67,94,2597.50,5191.08,0.00
2024-12-08 16:54:29,160,4231,66,94,2611.80,5191.11,0.00
2024-12-08 16:54:29,161,4230,66,95,2557.05,5191.85,0.00
2024-12-08 16:54:29,161,4231,66,95,2575.35,5192.00,0.00
2024-12-08 16:54:29,162,4231,67,95,2559.45,5192.01,0.00
2024-12-08 16:54:29,161,4231,67,94,2569.55,5192.06,0.00
2024-12-08 16:54:29,160,4231,67,93,2577.30,5192.21,0.00
2024-12-08 16:54:29,161,4230,67,94,2523.78,5192.90,0.00
2024-12-08 16:54:29,161,4231,67,94,2573.53,5193.00,0.00
2024-12-08 16:54:29,162,4231,68,94,2557.64,5193.01,0.00
2024-12-08 16:54:29,161,4231,68,93,2570.64,5193.06,0.00
2024-12-08 16:54:29,160,4231,68,92,2577.32,5193.11,0.00
2024-12-08 16:54:29,159,4231,68,91,2593.20,5193.11,0.00
2024-12-08 16:54:29,158,4231,68,90,2609.28,5193.11,0.00
2024-12-08 16:54:29,159,4230,69,90,2553.04,5193.70,0.00
2024-12-08 16:54:29,159,4231,69,90,2605.38,5194.00,0.00
2024-12-08 16:54:29,160,4231,70,90,2589.10,5194.01,0.00
2024-12-08 16:54:29,159,4231,70,89,2602.78,5194.05,0.00
2024-12-08 16:54:29,158,4231,70,88,2609.42,5194.11,0.00
2024-12-08 16:54:29,157,4231,69,88,2606.58,5194.45,0.00
2024-12-08 16:54:29,157,4232,69,88,2622.46,5195.00,0.00
2024-12-08 16:54:29,158,4232,70,88,2605.86,5195.01,0.00
2024-12-08 16:54:29,157,4232,70,87,2619.16,5195.05,0.00
2024-12-08 16:54:29,158,4231,70,88,2594.09,5195.23,0.00
2024-12-08 16:54:29,158,4232,70,88,2568.89,5196.00,0.00
2024-12-08 16:54:29,159,4232,70,89,2552.73,5196.01,0.00
2024-12-08 16:54:29,158,4232,70,88,2556.76,5196.11,0.00
2024-12-08 16:54:29,157,4232,70,87,2572.50,5196.12,0.00
2024-12-08 16:54:29,156,4232,69,87,2567.57,5196.51,0.00
2024-12-08 16:54:29,155,4232,69,86,2569.18,5196.68,0.00
2024-12-08 16:54:29,155,4233,69,86,2616.15,5197.00,0.00
2024-12-08 16:54:29,156,4233,69,87,2599.38,5197.01,0.00
2024-12-08 16:54:29,155,4233,68,87,2590.46,5197.25,0.00
2024-12-08 16:54:29,156,4232,68,88,2556.22,5197.60,0.00
2024-12-08 16:54:29,156,4233,68,88,2569.73,5198.00,0.00
2024-12-08 16:54:29,157,4233,68,89,2553.36,5198.01,0.00
2024-12-08 16:54:29,156,4233,68,88,2565.07,5198.05,0.00
2024-12-08 16:54:29,155,4233,67,88,2578.29,5198.11,0.00
2024-12-08 16:54:29,154,4233,67,87,2594.36,5198.12,0.00
2024-12-08 16:54:29,153,4233,66,87,2597.47,5198.30,0.00
2024-12-08 16:54:29,153,4234,66,87,2622.79,5199.00,0.00
2024-12-08 16:54:29,154,4234,67,87,2605.76,5199.01,0.00
2024-12-08 16:54:29,153,4234,67,86,2609.91,5199.12,0.00
2024-12-08 16:54:29,152,4234,66,86,2595.74,5199.59,0.00
2024-12-08 16:54:29,153,4233,66,87,2551.47,5199.93,0.00
2024-12-08 16:54:29,153,4234,66,87,2584.16,5200.00,0.00
2024-12-08 16:54:29,154,4234,67,87,2567.38,5200.01,0.00
2024-12-08 16:54:29,153,4234,66,87,2570.05,5200.14,0.00
2024-12-08 16:54:29,152,4234,66,86,2576.80,5200.32,0.00
2024-12-08 16:54:29,152,4234,66,86,2588.42,5201.00,0.00
2024-12-08 16:54:29,153,4234,66,87,2571.51,5201.01,0.00
2024-12-08 16:54:29,152,4234,66,86,2581.59,5201.05,0.00
2024-12-08 16:54:29,151,4234,66,85,2598.34,5201.05,0.00
2024-12-08 16:54:29,150,4234,65,85,2613.26,5201.09,0.00
2024-12-08 16:54:29,149,4234,65,84,2629.75,5201.11,0.00
2024-12-08 16:54:29,148,4234,64,84,2620.75,5201.56,0.00
2024-12-08 16:54:29,147,4234,64,83,2632.29,5201.59,0.00
2024-12-08 16:54:29,147,4235,64,83,2640.29,5202.00,0.00
2024-12-08 16:54:29,148,4235,65,83,2622.45,5202.01,0.00
2024-12-08 16:54:29,147,4235,65,82,2627.23,5202.12,0.00
2024-12-08 16:54:29,148,4234,66,82,2603.89,5202.24,0.00
2024-12-08 16:54:29,148,4235,66,82,2607.53,5203.00,0.00
2024-12-08 16:54:29,149,4235,66,83,2590.03,5203.01,0.00
2024-12-08 16:54:29,150,4234,66,84,2535.86,5203.60,0.00
2024-12-08 16:54:29,150,4235,66,84,2587.82,5204.00,0.00
2024-12-08 16:54:29,151,4235,66,85,2570.68,5204.01,0.00
2024-12-08 16:54:29,150,4235,66,84,2574.68,5204.12,0.00
2024-12-08 16:54:29,150,4236,66,84,2583.45,5205.00,0.00
2024-12-08 16:54:29,151,4236,67,84,2566.34,5205.01,0.00
2024-12-08 16:54:29,150,4236,67,83,2575.13,5205.05,0.00
2024-12-08 16:54:29,150,4237,67,83,2539.56,5206.00,0.00
2024-12-08 16:54:29,151,4237,68,83,2522.74,5206.01,0.00
2024-12-08 16:54:29,150,4237,67,83,2526.06,5206.13,0.00
2024-12-08 16:54:29,149,4237,67,82,2502.55,5206.74,0.00
2024-12-08 16:54:29,150,4236,67,83,2485.87,5206.75,0.00
2024-12-08 16:54:29,149,4236,66,83,2501.55,5206.78,0.00
2024-12-08 16:54:29,149,4237,66,83,2524.10,5207.00,0.00
2024-12-08 16:54:29,150,4237,66,84,2507.27,5207.01,0.00
2024-12-08 16:54:29,149,4237,65,84,2522.71,5207.03,0.00
2024-12-08 16:54:29,148,4237,65,83,2527.12,5207.13,0.00
2024-12-08 16:54:29,149,4236,66,83,2501.43,5207.30,0.00
2024-12-08 16:54:29,149,4237,66,83,2552.03,5208.00,0.00
2024-12-08 16:54:29,150,4237,67,83,2535.02,5208.01,0.00
2024-12-08 16:54:29,149,4237,67,82,2543.65,5208.05,0.00
2024-12-08 16:54:29,148,4237,67,81,2556.65,5208.12,0.00
2024-12-08 16:54:29,147,4237,66,81,2573.68,5208.12,0.00
2024-12-08 16:54:30,147,4238,66,81,2578.15,5209.00,0.00
2024-12-08 16:54:30,148,4238,66,82,2560.73,5209.01,0.00
2024-12-08 16:54:30,147,4238,66,81,2569.66,5209.05,0.00
2024-12-08 16:54:30,146,4238,66,80,2583.72,5209.12,0.00
2024-12-08 16:54:30,145,4238,65,80,2597.96,5209.18,0.00
2024-12-08 16:54:30,146,4237,65,81,2521.32,5209.88,0.00
2024-12-08 16:54:30,146,4238,65,81,2556.74,5210.00,0.00
2024-12-08 16:54:30,147,4238,66,81,2539.34,5210.01,0.00
2024-12-08 16:54:30,146,4238,66,80,2543.57,5210.12,0.00
2024-12-08 16:54:30,147,4237,66,81,2525.92,5210.14,0.00
2024-12-08 16:54:30,148,4236,66,82,2513.46,5210.32,0.00
2024-12-08 16:54:30,147,4236,65,82,2554.63,5210.33,0.00
2024-12-08 16:54:30,146,4236,65,81,2557.04,5210.59,0.00
2024-12-08 16:54:30,147,4235,66,81,2532.81,5210.64,0.00
2024-12-08 16:54:30,148,4234,67,81,2514.15,5210.88,0.00
2024-12-08 16:54:30,148,4235,67,81,2582.55,5211.00,0.00
2024-12-08 16:54:30,149,4235,68,81,2565.22,5211.01,0.00
2024-12-08 16:54:30,148,4235,68,80,2552.98,5211.44,0.00
2024-12-08 16:54:30,148,4236,68,80,2679.13,5212.00,0.00
2024-12-08 16:54:30,149,4236,68,81,2661.15,5212.01,0.00
2024-12-08 16:54:30,148,4236,67,81,2678.43,5212.01,0.00
2024-12-08 16:54:30,147,4236,67,80,2688.15,5212.07,0.00
2024-12-08 16:54:30,146,4236,67,79,2703.74,5212.12,0.00
2024-12-08 16:54:30,145,4236,66,79,2697.39,5212.55,0.00
2024-12-08 16:54:30,144,4236,66,78,2708.75,5212.58,0.00
2024-12-08 16:54:30,144,4237,66,78,2701.68,5213.00,0.00
2024-12-08 16:54:30,145,4237,66,79,2683.05,5213.01,0.00
2024-12-08 16:54:30,144,4237,66,78,2688.33,5213.12,0.00
2024-12-08 16:54:30,143,4237,66,77,2698.71,5213.28,0.00
2024-12-08 16:54:30,142,4237,65,77,2684.44,5213.68,0.00
2024-12-08 16:54:30,143,4236,66,77,2662.06,5213.76,0.00
2024-12-08 16:54:30,143,4237,66,77,2686.78,5214.00,0.00
2024-12-08 16:54:30,144,4237,67,77,2668.12,5214.01,0.00
2024-12-08 16:54:30,143,4237,66,77,2659.18,5214.32,0.00
2024-12-08 16:54:30,143,4238,66,77,2686.49,5215.00,0.00
2024-12-08 16:54:30,144,4238,66,78,2667.83,5215.01,0.00
2024-12-08 16:54:30,143,4238,66,77,2678.49,5215.08,0.00
2024-12-08 16:54:30,144,4237,67,77,2644.05,5215.40,0.00
2024-12-08 16:54:30,143,4237,67,76,2677.57,5215.59,0.00
2024-12-08 16:54:30,143,4238,67,76,2671.00,5216.00,0.00
2024-12-08 16:54:30,144,4238,68,76,2652.45,5216.01,0.00
2024-12-08 16:54:30,145,4237,69,76,2616.18,5216.09,0.00
2024-12-08 16:54:30,144,4237,69,75,2642.33,5216.09,0.00
2024-12-08 16:54:30,143,4237,68,75,2627.00,5216.74,0.00
2024-12-08 16:54:30,144,4236,68,76,2605.91,5216.81,0.00
2024-12-08 16:54:30,143,4236,67,76,2628.03,5216.83,0.00
2024-12-08 16:54:30,143,4237,67,76,2684.56,5217.00,0.00
2024-12-08 16:54:30,144,4237,68,76,2665.91,5217.01,0.00
2024-12-08 16:54:30,143,4237,67,76,2680.69,5217.04,0.00
2024-12-08 16:54:30,143,4238,67,76,2723.69,5218.00,0.00
2024-12-08 16:54:30,144,4238,68,76,2704.78,5218.01,0.00
2024-12-08 16:54:30,143,4238,67,76,2722.96,5218.01,0.00
2024-12-08 16:54:30,142,4238,67,75,2729.68,5218.11,0.00
2024-12-08 16:54:30,141,4238,67,74,2707.57,5218.83,0.00
2024-12-08 16:54:30,141,4239,67,74,2726.49,5219.00,0.00
2024-12-08 16:54:30,142,4239,67,75,2707.29,5219.01,0.00
2024-12-08 16:54:30,143,4238,68,75,2653.08,5219.55,0.00
2024-12-08 16:54:30,143,4239,68,75,2656.47,5220.00,0.00
2024-12-08 16:54:30,144,4239,68,76,2638.02,5220.01,0.00
2024-12-08 16:54:30,143,4239,67,76,2655.37,5220.02,0.00
2024-12-08 16:54:30,142,4239,67,75,2668.97,5220.06,0.00
2024-12-08 16:54:30,141,4239,67,74,2685.70,5220.10,0.00
2024-12-08 16:54:30,140,4239,67,73,2704.51,5220.10,0.00
2024-12-08 16:54:30,140,4240,67,73,2716.83,5221.00,0.00
2024-12-08 16:54:30,141,4240,67,74,2697.56,5221.01,0.00
2024-12-08 16:54:30,140,4240,66,74,2716.08,5221.01,0.00
2024-12-08 16:54:30,139,4240,66,73,2723.64,5221.09,0.00
2024-12-08 16:54:30,140,4239,66,74,2680.77,5221.54,0.00
2024-12-08 16:54:30,140,4240,66,74,2709.26,5222.00,0.00
2024-12-08 16:54:30,141,4240,66,75,2690.04,5222.01,0.00
2024-12-08 16:54:30,140,4240,65,75,2708.51,5222.01,0.00
2024-12-08 16:54:30,139,4240,64,75,2727.62,5222.01,0.00
2024-12-08 16:54:30,138,4240,64,74,2735.69,5222.09,0.00
2024-12-08 16:54:30,137,4240,63,74,2755.28,5222.09,0.00
2024-12-08 16:54:30,138,4239,63,75,2701.74,5222.72,0.00
2024-12-08 16:54:30,138,4240,63,75,2757.81,5223.00,0.00
2024-12-08 16:54:30,139,4240,63,76,2737.97,5223.01,0.00
2024-12-08 16:54:30,138,4240,63,75,2745.73,5223.09,0.00
2024-12-08 16:54:30,137,4240,62,75,2765.69,5223.09,0.00
2024-12-08 16:54:30,138,4239,63,75,2739.62,5223.22,0.00
2024-12-08 16:54:30,138,4240,63,75,2789.18,5224.00,0.00
2024-12-08 16:54:30,139,4240,63,76,2769.11,5224.01,0.00
2024-12-08 16:54:30,140,4239,64,76,2748.96,5224.03,0.00
2024-12-08 16:54:30,139,4239,64,75,2803.71,5224.05,0.00
2024-12-08 16:54:30,140,4238,64,76,2781.06,5224.11,0.00
2024-12-08 16:54:30,139,4238,63,76,2770.40,5224.71,0.00
2024-12-08 16:54:30,139,4239,63,76,2830.77,5225.00,0.00
2024-12-08 16:54:30,140,4239,63,77,2810.55,5225.01,0.00
2024-12-08 16:54:30,139,4239,62,77,2788.54,5225.53,0.00
2024-12-08 16:54:30,139,4240,62,77,2877.22,5226.00,0.00
2024-12-08 16:54:30,140,4240,62,78,2856.67,5226.01,0.00
2024-12-08 16:54:30,139,4240,61,78,2873.09,5226.01,0.00
2024-12-08 16:54:30,138,4240,61,77,2886.74,5226.04,0.00
2024-12-08 16:54:30,137,4240,61,76,2906.60,5226.06,0.00
2024-12-08 16:54:30,136,4240,61,75,2927.59,5226.06,0.00
2024-12-08 16:54:30,135,4240,61,74,2948.89,5226.06,0.00
2024-12-08 16:54:30,134,4240,60,74,2969.81,5226.08,0.00
2024-12-08 16:54:30,133,4240,59,74,2970.86,5226.47,0.00
2024-12-08 16:54:30,133,4241,59,74,2983.03,5227.00,0.00
2024-12-08 16:54:30,134,4241,60,74,2960.77,5227.01,0.00
2024-12-08 16:54:30,134,4242,60,74,2935.58,5228.00,0.00
2024-12-08 16:54:30,135,4242,60,75,2913.84,5228.01,0.00
2024-12-08 16:54:30,134,4242,60,74,2924.31,5228.07,0.00
2024-12-08 16:54:31,135,4241,61,74,2868.74,5228.73,0.00
2024-12-08 16:54:31,135,4242,61,74,2893.56,5229.00,0.00
2024-12-08 16:54:31,136,4242,61,75,2872.29,5229.01,0.00
2024-12-08 16:54:31,137,4241,61,76,2791.08,5229.79,0.00
2024-12-08 16:54:31,137,4242,61,76,2863.40,5230.00,0.00
2024-12-08 16:54:31,138,4242,62,76,2842.65,5230.01,0.00
2024-12-08 16:54:31,137,4242,62,75,2856.55,5230.04,0.00
2024-12-08 16:54:31,136,4242,62,74,2876.41,5230.06,0.00
2024-12-08 16:54:31,135,4242,61,74,2856.12,5230.66,0.00
2024-12-08 16:54:31,136,4241,61,75,2831.70,5230.74,0.00
2024-12-08 16:54:31,137,4240,61,76,2828.38,5230.76,0.00
2024-12-08 16:54:31,137,4241,61,76,2899.59,5231.00,0.00
2024-12-08 16:54:31,138,4241,61,77,2878.58,5231.01,0.00
2024-12-08 16:54:31,137,4241,60,77,2877.69,5231.10,0.00
2024-12-08 16:54:31,137,4242,60,77,2945.80,5232.00,0.00
2024-12-08 16:54:31,138,4242,60,78,2924.46,5232.01,0.00
2024-12-08 16:54:31,137,4242,60,77,2935.50,5232.06,0.00
2024-12-08 16:54:31,138,4241,60,78,2892.44,5232.21,0.00
2024-12-08 16:54:31,139,4240,61,78,2907.27,5232.23,0.00
2024-12-08 16:54:31,139,4241,61,78,2927.50,5233.00,0.00
2024-12-08 16:54:31,140,4241,62,78,2906.59,5233.01,0.00
2024-12-08 16:54:31,139,4241,62,77,2923.36,5233.04,0.00
2024-12-08 16:54:31,138,4241,62,76,2943.80,5233.05,0.00
2024-12-08 16:54:31,137,4241,61,76,2964.90,5233.05,0.00
2024-12-08 16:54:31,136,4241,60,76,2980.16,5233.07,0.00
2024-12-08 16:54:31,135,4241,60,75,2994.90,5233.21,0.00
2024-12-08 16:54:31,135,4242,60,75,3068.66,5234.00,0.00
2024-12-08 16:54:31,136,4242,61,75,3046.10,5234.01,0.00
2024-12-08 16:54:31,135,4242,60,75,3065.98,5234.05,0.00
2024-12-08 16:54:31,134,4242,60,74,3088.08,5234.05,0.00
2024-12-08 16:54:31,133,4242,59,74,3088.11,5234.30,0.00
2024-12-08 16:54:31,132,4242,58,74,3110.32,5234.33,0.00
2024-12-08 16:54:31,133,4241,58,75,3085.38,5234.37,0.00
2024-12-08 16:54:31,133,4242,58,75,3094.64,5235.00,0.00
2024-12-08 16:54:31,134,4242,58,76,3071.54,5235.01,0.00
2024-12-08 16:54:31,133,4242,58,75,3088.24,5235.06,0.00
2024-12-08 16:54:31,132,4242,57,75,3079.70,5235.52,0.00
2024-12-08 16:54:31,132,4243,57,75,3131.56,5236.00,0.00
2024-12-08 16:54:31,133,4243,57,76,3108.01,5236.01,0.00
2024-12-08 16:54:31,134,4242,58,76,3082.89,5236.06,0.00
2024-12-08 16:54:31,133,4242,58,75,3107.26,5236.07,0.00
2024-12-08 16:54:31,132,4242,57,75,3111.66,5236.43,0.00
2024-12-08 16:54:31,132,4243,57,75,3105.31,5237.00,0.00
2024-12-08 16:54:31,133,4243,58,75,3081.96,5237.01,0.00
2024-12-08 16:54:31,132,4243,57,75,3071.80,5237.43,0.00
2024-12-08 16:54:31,132,4244,57,75,3118.48,5238.00,0.00
2024-12-08 16:54:31,133,4244,58,75,3095.04,5238.01,0.00
2024-12-08 16:54:31,134,4243,58,76,3055.59,5238.19,0.00
2024-12-08 16:54:31,134,4244,58,76,3057.29,5239.00,0.00
2024-12-08 16:54:31,135,4244,59,76,3034.64,5239.01,0.00
2024-12-08 16:54:31,134,4244,59,75,3020.82,5239.40,0.00
2024-12-08 16:54:31,135,4243,60,75,2978.88,5239.79,0.00
2024-12-08 16:54:31,135,4244,60,75,3043.91,5240.00,0.00
2024-12-08 16:54:31,136,4244,61,75,3021.53,5240.01,0.00
2024-12-08 16:54:31,137,4243,61,76,2966.02,5240.52,0.00
2024-12-08 16:54:31,136,4243,60,76,3000.98,5240.56,0.00
2024-12-08 16:54:31,136,4244,60,76,3042.17,5241.00,0.00
2024-12-08 16:54:31,137,4244,60,77,3019.97,5241.01,0.00
2024-12-08 16:54:31,136,4244,60,76,3034.10,5241.04,0.00
2024-12-08 16:54:31,137,4243,61,76,3004.73,5241.20,0.00
2024-12-08 16:54:31,137,4244,61,76,3034.37,5242.00,0.00
2024-12-08 16:54:31,138,4244,61,77,3012.38,5242.01,0.00
2024-12-08 16:54:31,137,4244,60,77,3001.53,5242.42,0.00
2024-12-08 16:54:31,136,4244,59,77,2975.79,5242.89,0.00
2024-12-08 16:54:31,136,4245,59,77,3047.19,5243.00,0.00
2024-12-08 16:54:31,137,4245,60,77,3024.95,5243.01,0.00
2024-12-08 16:54:31,136,4245,59,77,3009.55,5243.58,0.00
2024-12-08 16:54:31,137,4244,59,78,2965.06,5243.86,0.00
2024-12-08 16:54:31,137,4245,59,78,3000.30,5244.00,0.00
2024-12-08 16:54:31,138,4245,59,79,2978.56,5244.01,0.00
2024-12-08 16:54:31,139,4244,60,79,2956.00,5244.04,0.00
2024-12-08 16:54:31,138,4244,60,78,2979.94,5244.07,0.00
2024-12-08 16:54:31,137,4244,59,78,2968.19,5244.69,0.00
2024-12-08 16:54:31,137,4245,59,78,3005.65,5245.00,0.00
2024-12-08 16:54:31,138,4245,60,78,2983.87,5245.01,0.00
2024-12-08 16:54:31,137,4245,60,77,2995.23,5245.05,0.00
2024-12-08 16:54:31,136,4245,59,77,3016.87,5245.05,0.00
2024-12-08 16:54:31,136,4246,59,77,3017.11,5246.00,0.00
2024-12-08 16:54:31,137,4246,60,77,2995.09,5246.01,0.00
2024-12-08 16:54:31,136,4246,60,76,3012.46,5246.05,0.00
2024-12-08 16:54:31,135,4246,59,76,3014.24,5246.25,0.00
2024-12-08 16:54:31,135,4247,59,76,3000.56,5247.00,0.00
2024-12-08 16:54:31,136,4247,60,76,2978.50,5247.01,0.00
2024-12-08 16:54:31,135,4247,59,76,2996.31,5247.05,0.00
2024-12-08 16:54:31,134,4247,59,75,3017.50,5247.05,0.00
2024-12-08 16:54:31,134,4248,59,75,2992.94,5248.00,0.00
2024-12-08 16:54:31,135,4248,60,75,2970.77,5248.01,0.00
2024-12-08 16:54:31,134,4248,60,74,2987.11,5248.08,0.00
2024-12-08 16:54:31,133,4248,59,74,3003.68,5248.19,0.00
2024-12-08 16:54:31,132,4248,59,73,2991.73,5248.49,0.00
2024-12-08 16:54:31,132,4249,59,73,2982.11,5249.00,0.00
2024-12-08 16:54:31,133,4249,59,74,2959.69,5249.01,0.00
2024-12-08 16:54:31,132,4249,58,74,2927.43,5249.74,0.00
2024-12-08 16:54:32,132,4250,58,74,2934.29,5250.00,0.00
2024-12-08 16:54:32,133,4250,58,75,2912.22,5250.01,0.00
2024-12-08 16:54:32,132,4250,57,75,2930.78,5250.05,0.00
2024-12-08 16:54:32,131,4250,56,75,2952.76,5250.05,0.00
2024-12-08 16:54:32,130,4250,55,75,2975.07,5250.05,0.00
2024-12-08 16:54:32,129,4250,55,74,2996.09,5250.05,0.00
2024-12-08 16:54:32,129,4251,55,74,2962.10,5251.00,0.00
2024-12-08 16:54:32,130,4251,56,74,2939.31,5251.01,0.00
2024-12-08 16:54:32,129,4251,55,74,2936.90,5251.26,0.00
2024-12-08 16:54:32,129,4252,55,74,2926.22,5252.00,0.00
2024-12-08 16:54:32,130,4252,55,75,2903.71,5252.01,0.00
2024-12-08 16:54:32,130,4253,55,75,2865.29,5253.00,0.00
2024-12-08 16:54:32,131,4253,56,75,2843.42,5253.01,0.00
2024-12-08 16:54:32,130,4253,56,74,2815.68,5253.70,0.00
2024-12-08 16:54:32,130,4254,56,74,2820.96,5254.00,0.00
2024-12-08 16:54:32,131,4254,56,75,2799.42,5254.01,0.00
2024-12-08 16:54:32,130,4254,56,74,2809.81,5254.05,0.00
2024-12-08 16:54:32,130,4255,56,74,2778.13,5255.00,0.00
2024-12-08 16:54:32,131,4255,56,75,2756.92,5255.01,0.00
2024-12-08 16:54:32,130,4255,55,75,2777.32,5255.02,0.00
2024-12-08 16:54:32,129,4255,54,75,2786.96,5255.06,0.00
2024-12-08 16:54:32,129,4256,54,75,2766.98,5256.00,0.00
2024-12-08 16:54:32,130,4256,54,76,2745.70,5256.01,0.00
2024-12-08 16:54:32,131,4255,54,77,2671.30,5256.74,0.00
2024-12-08 16:54:32,131,4256,54,77,2716.92,5257.00,0.00
2024-12-08 16:54:32,132,4256,55,77,2696.34,5257.01,0.00
2024-12-08 16:54:32,133,4255,55,78,2644.56,5257.44,0.00
2024-12-08 16:54:32,134,4254,56,78,2642.11,5257.49,0.00
2024-12-08 16:54:32,134,4255,56,78,2688.12,5258.00,0.00
2024-12-08 16:54:32,135,4255,56,79,2668.20,5258.01,0.00
2024-12-08 16:54:32,134,4255,56,78,2677.55,5258.05,0.00
2024-12-08 16:54:32,133,4255,55,78,2658.59,5258.69,0.00
2024-12-08 16:54:32,133,4256,55,78,2748.16,5259.00,0.00
2024-12-08 16:54:32,134,4256,55,79,2727.65,5259.01,0.00
2024-12-08 16:54:32,133,4256,54,79,2738.88,5259.06,0.00
2024-12-08 16:54:32,132,4256,53,79,2759.23,5259.06,0.00
2024-12-08 16:54:32,132,4257,53,79,2728.30,5260.00,0.00
2024-12-08 16:54:32,133,4257,54,79,2707.79,5260.01,0.00
2024-12-08 16:54:32,132,4257,53,79,2727.51,5260.02,0.00
2024-12-08 16:54:32,131,4257,52,79,2731.65,5260.06,0.00
2024-12-08 16:54:32,132,4256,53,79,2702.53,5260.24,0.00
2024-12-08 16:54:32,133,4255,53,80,2693.22,5260.59,0.00
2024-12-08 16:54:32,132,4255,53,79,2706.25,5260.85,0.00
2024-12-08 16:54:32,131,4255,53,78,2709.82,5260.90,0.00
2024-12-08 16:54:32,131,4256,53,78,2744.84,5261.00,0.00
2024-12-08 16:54:32,132,4256,54,78,2724.04,5261.01,0.00
2024-12-08 16:54:32,131,4256,54,77,2722.18,5261.07,0.00
2024-12-08 16:54:32,130,4256,54,76,2741.30,5261.10,0.00
2024-12-08 16:54:32,131,4255,55,76,2709.20,5261.33,0.00
2024-12-08 16:54:32,131,4256,55,76,2813.89,5262.00,0.00
2024-12-08 16:54:32,132,4256,56,76,2792.57,5262.01,0.00
2024-12-08 16:54:32,133,4255,57,76,2770.01,5262.05,0.00
2024-12-08 16:54:32,132,4255,57,75,2800.97,5262.06,0.00
2024-12-08 16:54:32,132,4256,57,75,2815.14,5263.00,0.00
2024-12-08 16:54:32,133,4256,57,76,2793.98,5263.01,0.00
2024-12-08 16:54:32,133,4257,57,76,2801.53,5264.00,0.00
2024-12-08 16:54:32,134,4257,58,76,2780.62,5264.01,0.00
2024-12-08 16:54:32,133,4257,58,75,2790.57,5264.06,0.00
2024-12-08 16:54:32,132,4257,58,74,2811.31,5264.06,0.00
2024-12-08 16:54:32,131,4257,57,74,2800.32,5264.47,0.00
2024-12-08 16:54:32,131,4258,57,74,2812.67,5265.00,0.00
2024-12-08 16:54:32,132,4258,57,75,2791.36,5265.01,0.00
2024-12-08 16:54:32,131,4258,57,74,2806.92,5265.06,0.00
2024-12-08 16:54:32,130,4258,57,73,2828.11,5265.06,0.00
2024-12-08 16:54:32,131,4257,57,74,2800.91,5265.18,0.00
2024-12-08 16:54:32,130,4257,56,74,2809.12,5265.25,0.00
2024-12-08 16:54:32,129,4257,55,74,2826.03,5265.33,0.00
2024-12-08 16:54:32,128,4257,54,74,2817.69,5265.84,0.00
2024-12-08 16:54:32,128,4258,54,74,2830.21,5266.00,0.00
2024-12-08 16:54:32,129,4258,55,74,2808.27,5266.01,0.00
2024-12-08 16:54:32,128,4258,55,73,2824.11,5266.06,0.00
2024-12-08 16:54:32,127,4258,54,73,2805.81,5266.72,0.00
2024-12-08 16:54:32,126,4258,54,72,2803.39,5266.87,0.00
2024-12-08 16:54:32,126,4259,54,72,2863.27,5267.00,0.00
2024-12-08 16:54:32,127,4259,55,72,2840.73,5267.01,0.00
2024-12-08 16:54:32,126,4259,55,71,2858.29,5267.06,0.00
2024-12-08 16:54:32,125,4259,54,71,2855.67,5267.39,0.00
2024-12-08 16:54:32,125,4260,54,71,2865.03,5268.00,0.00
2024-12-08 16:54:32,126,4260,54,72,2842.29,5268.01,0.00
2024-12-08 16:54:32,125,4260,54,71,2860.42,5268.06,0.00
2024-12-08 16:54:32,124,4260,53,71,2875.85,5268.11,0.00
2024-12-08 16:54:32,123,4260,52,71,2855.87,5268.81,0.00
2024-12-08 16:54:32,123,4261,52,71,2888.24,5269.00,0.00
2024-12-08 16:54:32,124,4261,53,71,2864.95,5269.01,0.00
2024-12-08 16:54:32,123,4261,53,70,2883.98,5269.07,0.00
2024-12-08 16:54:32,122,4261,53,69,2889.53,5269.34,0.00
2024-12-08 16:54:32,122,4262,53,69,2879.59,5270.00,0.00
2024-12-08 16:54:32,123,4262,54,69,2856.18,5270.01,0.00
2024-12-08 16:54:32,122,4262,53,69,2836.51,5270.39,0.00
2024-12-08 16:54:32,122,4263,53,69,2846.77,5271.00,0.00
2024-12-08 16:54:32,123,4263,54,69,2823.62,5271.01,0.00
2024-12-08 16:54:32,122,4263,54,68,2842.90,5271.07,0.00
2024-12-08 16:54:33,122,4264,54,68,2802.51,5272.00,0.00
2024-12-08 16:54:33,123,4264,55,68,2779.72,5272.01,0.00
2024-12-08 16:54:33,122,4264,55,67,2797.34,5272.07,0.00
2024-12-08 16:54:33,121,4264,54,67,2785.24,5272.73,0.00
2024-12-08 16:54:33,121,4265,54,67,2782.47,5273.00,0.00
2024-12-08 16:54:33,122,4265,55,67,2759.67,5273.01,0.00
2024-12-08 16:54:33,121,4265,55,66,2776.83,5273.07,0.00
2024-12-08 16:54:33,120,4265,55,65,2733.52,5273.84,0.00
2024-12-08 16:54:33,120,4266,55,65,2769.24,5274.00,0.00
2024-12-08 16:54:33,121,4266,55,66,2746.35,5274.01,0.00
2024-12-08 16:54:33,120,4266,54,66,2743.36,5274.18,0.00
2024-12-08 16:54:33,120,4267,54,66,2742.63,5275.00,0.00
2024-12-08 16:54:33,121,4267,55,66,2719.97,5275.01,0.00
2024-12-08 16:54:33,120,4267,55,65,2733.43,5275.08,0.00
2024-12-08 16:54:33,119,4267,54,65,2742.31,5275.35,0.00
2024-12-08 16:54:33,119,4268,54,65,2732.85,5276.00,0.00
2024-12-08 16:54:33,120,4268,54,66,2710.08,5276.01,0.00
2024-12-08 16:54:33,119,4268,54,65,2726.23,5276.08,0.00
2024-12-08 16:54:33,120,4267,55,65,2697.82,5276.21,0.00
2024-12-08 16:54:33,120,4268,55,65,2702.98,5277.00,0.00
2024-12-08 16:54:33,121,4268,56,65,2680.64,5277.01,0.00
2024-12-08 16:54:33,120,4268,55,65,2702.16,5277.02,0.00
2024-12-08 16:54:33,119,4268,55,64,2719.56,5277.08,0.00
2024-12-08 16:54:33,118,4268,54,64,2700.44,5277.80,0.00
2024-12-08 16:54:33,118,4269,54,64,2761.42,5278.00,0.00
2024-12-08 16:54:33,119,4269,54,65,2738.22,5278.01,0.00
2024-12-08 16:54:33,118,4269,54,64,2755.19,5278.08,0.00
2024-12-08 16:54:33,117,4269,53,64,2755.30,5278.36,0.00
2024-12-08 16:54:33,117,4270,53,64,2762.55,5279.00,0.00
2024-12-08 16:54:33,118,4270,53,65,2739.14,5279.01,0.00
2024-12-08 16:54:33,118,4271,53,65,2712.67,5280.00,0.00
2024-12-08 16:54:33,119,4271,53,66,2689.87,5280.01,0.00
2024-12-08 16:54:33,118,4271,52,66,2711.33,5280.03,0.00
2024-12-08 16:54:33,117,4271,52,65,2718.00,5280.15,0.00
2024-12-08 16:54:33,118,4270,53,65,2643.87,5280.91,0.00
2024-12-08 16:54:33,118,4271,53,65,2688.26,5281.00,0.00
2024-12-08 16:54:33,119,4271,54,65,2665.67,5281.01,0.00
2024-12-08 16:54:33,118,4271,53,65,2622.85,5281.78,0.00
2024-12-08 16:54:33,118,4272,53,65,2700.90,5282.00,0.00
2024-12-08 16:54:33,119,4272,53,66,2678.21,5282.01,0.00
2024-12-08 16:54:33,118,4272,53,65,2668.60,5282.44,0.00
2024-12-08 16:54:33,117,4272,53,64,2672.37,5282.73,0.00
2024-12-08 16:54:33,117,4273,53,64,2685.40,5283.00,0.00
2024-12-08 16:54:33,118,4273,53,65,2662.65,5283.01,0.00
2024-12-08 16:54:33,117,4273,53,64,2680.91,5283.07,0.00
2024-12-08 16:54:33,118,4272,53,65,2648.15,5283.26,0.00
2024-12-08 16:54:33,117,4272,52,65,2682.48,5283.66,0.00
2024-12-08 16:54:33,117,4273,52,65,2691.76,5284.00,0.00
2024-12-08 16:54:33,118,4273,52,66,2668.95,5284.01,0.00
2024-12-08 16:54:33,117,4273,52,65,2687.72,5284.07,0.00
2024-12-08 16:54:33,116,4273,51,65,2709.52,5284.07,0.00
2024-12-08 16:54:33,116,4274,51,65,2751.86,5285.00,0.00
2024-12-08 16:54:33,117,4274,52,65,2728.34,5285.01,0.00
2024-12-08 16:54:33,116,4274,52,64,2728.64,5285.07,0.00
2024-12-08 16:54:33,116,4275,52,64,2725.37,5286.00,0.00
2024-12-08 16:54:33,117,4275,52,65,2702.08,5286.01,0.00
2024-12-08 16:54:33,116,4275,52,64,2719.47,5286.08,0.00
2024-12-08 16:54:33,116,4276,52,64,2698.46,5287.00,0.00
2024-12-08 16:54:33,117,4276,52,65,2675.39,5287.01,0.00
2024-12-08 16:54:33,116,4276,51,65,2696.95,5287.04,0.00
2024-12-08 16:54:33,115,4276,51,64,2715.35,5287.08,0.00
2024-12-08 16:54:33,114,4276,50,64,2707.27,5287.36,0.00
2024-12-08 16:54:33,114,4277,50,64,2719.13,5288.00,0.00
2024-12-08 16:54:33,115,4277,51,64,2695.48,5288.01,0.00
2024-12-08 16:54:33,114,4277,51,63,2710.80,5288.09,0.00
2024-12-08 16:54:33,114,4278,51,63,2684.93,5289.00,0.00
2024-12-08 16:54:33,115,4278,52,63,2661.58,5289.01,0.00
2024-12-08 16:54:33,114,4278,51,63,2681.70,5289.06,0.00
2024-12-08 16:54:33,113,4278,51,62,2693.76,5289.10,0.00
2024-12-08 16:54:33,112,4278,51,61,2684.84,5289.37,0.00
2024-12-08 16:54:33,111,4278,50,61,2676.53,5289.78,0.00
2024-12-08 16:54:33,111,4279,50,61,2708.53,5290.00,0.00
2024-12-08 16:54:33,112,4279,50,62,2684.35,5290.01,0.00
2024-12-08 16:54:33,112,4280,50,62,2664.02,5291.00,0.00
2024-12-08 16:54:33,113,4280,51,62,2640.44,5291.01,0.00
2024-12-08 16:54:33,114,4279,52,62,2574.44,5291.66,0.00
2024-12-08 16:54:33,114,4280,52,62,2607.64,5292.00,0.00
2024-12-08 16:54:33,115,4280,52,63,2584.96,5292.01,0.00
2024-12-08 16:54:33,115,4281,52,63,2597.93,5293.00,0.00
2024-12-08 16:54:33,116,4281,53,63,2575.54,5293.01,0.00
2024-12-08 16:54:33,115,4281,52,63,2596.10,5293.04,0.00
2024-12-08 16:54:33,114,4281,52,62,2615.17,5293.07,0.00
2024-12-08 16:54:33,115,4280,53,62,2591.51,5293.10,0.00
2024-12-08 16:54:33,116,4279,53,63,2592.57,5293.47,0.00
2024-12-08 16:54:33,115,4279,52,63,2612.99,5293.97,0.00
2024-12-08 16:54:33,115,4280,52,63,2657.21,5294.00,0.00
2024-12-08 16:54:33,116,4280,53,63,2634.30,5294.01,0.00
2024-12-08 16:54:33,115,4280,52,63,2654.00,5294.06,0.00
2024-12-08 16:54:34,115,4281,52,63,2726.95,5295.00,0.00
2024-12-08 16:54:34,116,4281,53,63,2703.44,5295.01,0.00
2024-12-08 16:54:34,117,4280,53,64,2613.10,5295.96,0.00
2024-12-08 16:54:34,117,4281,53,64,2647.14,5296.00,0.00
2024-12-08 16:54:34,118,4281,53,65,2624.70,5296.01,0.00
2024-12-08 16:54:34,119,4280,54,65,2581.35,5296.26,0.00
2024-12-08 16:54:34,120,4279,54,66,2592.95,5296.28,0.00
2024-12-08 16:54:34,120,4280,54,66,2643.37,5297.00,0.00
2024-12-08 16:54:34,121,4280,55,66,2621.53,5297.01,0.00
2024-12-08 16:54:34,120,4280,55,65,2638.53,5297.06,0.00
2024-12-08 16:54:34,119,4280,55,64,2603.33,5297.83,0.00
2024-12-08 16:54:34,118,4280,54,64,2602.02,5297.96,0.00
2024-12-08 16:54:34,118,4281,54,64,2734.49,5298.00,0.00
2024-12-08 16:54:34,119,4281,55,64,2711.51,5298.01,0.00
2024-12-08 16:54:34,119,4282,55,64,2682.52,5299.00,0.00
2024-12-08 16:54:34,120,4282,56,64,2660.17,5299.01,0.00
2024-12-08 16:54:34,119,4282,56,63,2673.63,5299.05,0.00
2024-12-08 16:54:34,120,4281,57,63,2624.89,5299.57,0.00
2024-12-08 16:54:34,120,4282,57,63,2653.90,5300.00,0.00
2024-12-08 16:54:34,121,4282,57,64,2631.96,5300.01,0.00
2024-12-08 16:54:34,120,4282,57,63,2642.42,5300.05,0.00
2024-12-08 16:54:34,121,4281,58,63,2589.75,5300.65,0.00
2024-12-08 16:54:34,121,4282,58,63,2656.79,5301.00,0.00
2024-12-08 16:54:34,122,4282,58,64,2635.01,5301.01,0.00
2024-12-08 16:54:34,121,4282,58,63,2636.21,5301.06,0.00
2024-12-08 16:54:34,121,4283,58,63,2672.46,5302.00,0.00
2024-12-08 16:54:34,122,4283,58,64,2650.55,5302.01,0.00
2024-12-08 16:54:34,121,4283,58,63,2668.97,5302.06,0.00
2024-12-08 16:54:34,120,4283,58,62,2681.73,5302.23,0.00
2024-12-08 16:54:34,121,4282,59,62,2647.80,5302.46,0.00
2024-12-08 16:54:34,120,4282,58,62,2677.19,5302.78,0.00
2024-12-08 16:54:34,120,4283,58,62,2710.07,5303.00,0.00
2024-12-08 16:54:34,121,4283,59,62,2687.68,5303.01,0.00
2024-12-08 16:54:34,120,4283,59,61,2706.99,5303.06,0.00
2024-12-08 16:54:34,120,4284,59,61,2725.03,5304.00,0.00
2024-12-08 16:54:34,121,4284,59,62,2702.50,5304.01,0.00
2024-12-08 16:54:34,122,4283,60,62,2667.33,5304.11,0.00
2024-12-08 16:54:34,121,4283,59,62,2677.56,5304.27,0.00
2024-12-08 16:54:34,121,4284,59,62,2680.58,5305.00,0.00
2024-12-08 16:54:34,122,4284,60,62,2658.61,5305.01,0.00
2024-12-08 16:54:34,121,4284,60,61,2674.46,5305.08,0.00
2024-12-08 16:54:34,122,4283,61,61,2623.86,5305.62,0.00
2024-12-08 16:54:34,121,4283,60,61,2652.78,5305.62,0.00
2024-12-08 16:54:34,121,4284,60,61,2717.90,5306.00,0.00
2024-12-08 16:54:34,122,4284,60,62,2695.62,5306.01,0.00
2024-12-08 16:54:34,121,4284,59,62,2683.99,5306.45,0.00
2024-12-08 16:54:34,121,4285,59,62,2735.93,5307.00,0.00
2024-12-08 16:54:34,122,4285,60,62,2713.51,5307.01,0.00
2024-12-08 16:54:34,121,4285,60,61,2715.47,5307.22,0.00
2024-12-08 16:54:34,121,4286,60,61,2710.14,5308.00,0.00
2024-12-08 16:54:34,122,4286,61,61,2687.92,5308.01,0.00
2024-12-08 16:54:34,121,4286,61,60,2707.08,5308.06,0.00
2024-12-08 16:54:34,120,4286,60,60,2728.75,5308.07,0.00
2024-12-08 16:54:34,120,4287,60,60,2703.22,5309.00,0.00
2024-12-08 16:54:34,121,4287,61,60,2680.88,5309.01,0.00
2024-12-08 16:54:34,121,4288,61,60,2646.56,5310.00,0.00
2024-12-08 16:54:34,122,4288,62,60,2624.86,5310.01,0.00
2024-12-08 16:54:34,121,4288,61,60,2645.68,5310.02,0.00
2024-12-08 16:54:34,120,4288,61,59,2658.89,5310.06,0.00
2024-12-08 16:54:34,121,4287,61,60,2631.67,5310.17,0.00
2024-12-08 16:54:34,120,4287,60,60,2618.76,5310.88,0.00
2024-12-08 16:54:34,120,4288,60,60,2638.78,5311.00,0.00
2024-12-08 16:54:34,121,4288,61,60,2616.98,5311.01,0.00
2024-12-08 16:54:34,120,4288,61,59,2627.29,5311.06,0.00
2024-12-08 16:54:34,121,4287,61,60,2603.82,5311.11,0.00
2024-12-08 16:54:34,120,4287,60,60,2649.03,5311.27,0.00
2024-12-08 16:54:34,120,4288,60,60,2698.45,5312.00,0.00
2024-12-08 16:54:34,121,4288,60,61,2676.15,5312.01,0.00
2024-12-08 16:54:34,120,4288,60,60,2694.49,5312.08,0.00
2024-12-08 16:54:34,121,4287,61,60,2668.25,5312.16,0.00
2024-12-08 16:54:34,121,4288,61,60,2693.29,5313.00,0.00
2024-12-08 16:54:34,122,4288,61,61,2671.21,5313.01,0.00
2024-12-08 16:54:34,121,4288,61,60,2671.79,5313.07,0.00
2024-12-08 16:54:34,120,4288,61,59,2691.43,5313.10,0.00
2024-12-08 16:54:34,120,4289,61,59,2730.64,5314.00,0.00
2024-12-08 16:54:34,121,4289,61,60,2708.07,5314.01,0.00
2024-12-08 16:54:34,122,4288,61,61,2663.23,5314.22,0.00
2024-12-08 16:54:34,122,4289,61,61,2701.49,5315.00,0.00
2024-12-08 16:54:34,123,4289,62,61,2679.53,5315.01,0.00
2024-12-08 16:54:34,122,4289,61,61,2694.99,5315.03,0.00
2024-12-08 16:54:34,122,4290,61,61,2720.47,5316.00,0.00
2024-12-08 16:54:34,123,4290,61,62,2698.35,5316.01,0.00
2024-12-08 16:54:34,122,4290,60,62,2707.84,5316.07,0.00
2024-12-08 16:54:34,121,4290,59,62,2729.78,5316.07,0.00
2024-12-08 16:54:34,122,4289,60,62,2689.37,5316.43,0.00
2024-12-08 16:54:35,122,4290,60,62,2717.37,5317.00,0.00
2024-12-08 16:54:35,123,4290,61,62,2695.27,5317.01,0.00
2024-12-08 16:54:35,122,4290,60,62,2714.76,5317.05,0.00
2024-12-08 16:54:35,123,4289,61,62,2669.98,5317.33,0.00
2024-12-08 16:54:35,124,4288,61,63,2654.29,5317.77,0.00
2024-12-08 16:54:35,124,4289,61,63,2723.58,5318.00,0.00
2024-12-08 16:54:35,125,4289,61,64,2701.79,5318.01,0.00
2024-12-08 16:54:35,124,4289,61,63,2715.01,5318.06,0.00
2024-12-08 16:54:35,123,4289,60,63,2711.34,5318.49,0.00
2024-12-08 16:54:35,124,4288,60,64,2685.23,5318.58,0.00
2024-12-08 16:54:35,124,4289,60,64,2790.23,5319.00,0.00
2024-12-08 16:54:35,125,4289,60,65,2767.91,5319.01,0.00
2024-12-08 16:54:35,124,4289,59,65,2788.95,5319.02,0.00
2024-12-08 16:54:35,123,4289,59,64,2809.90,5319.05,0.00
2024-12-08 16:54:35,122,4289,58,64,2832.50,5319.05,0.00
2024-12-08 16:54:35,121,4289,57,64,2846.51,5319.22,0.00
2024-12-08 16:54:35,122,4288,57,65,2802.66,5319.55,0.00
2024-12-08 16:54:35,122,4289,57,65,2865.31,5320.00,0.00
2024-12-08 16:54:35,123,4289,58,65,2842.02,5320.01,0.00
2024-12-08 16:54:35,124,4288,58,66,2789.56,5320.40,0.00
2024-12-08 16:54:35,123,4288,57,66,2847.76,5320.41,0.00
2024-12-08 16:54:35,122,4288,56,66,2861.46,5320.55,0.00
2024-12-08 16:54:35,122,4289,56,66,2924.52,5321.00,0.00
2024-12-08 16:54:35,123,4289,57,66,2900.74,5321.01,0.00
2024-12-08 16:54:35,122,4289,57,65,2912.32,5321.07,0.00
2024-12-08 16:54:35,122,4290,57,65,2935.46,5322.00,0.00
2024-12-08 16:54:35,123,4290,58,65,2911.60,5322.01,0.00
2024-12-08 16:54:35,122,4290,57,65,2934.59,5322.02,0.00
2024-12-08 16:54:35,121,4290,57,64,2940.06,5322.20,0.00
2024-12-08 16:54:35,120,4290,56,64,2954.46,5322.36,0.00
2024-12-08 16:54:35,120,4291,56,64,2948.04,5323.00,0.00
2024-12-08 16:54:35,121,4291,56,65,2923.67,5323.01,0.00
2024-12-08 16:54:35,120,4291,56,64,2940.06,5323.04,0.00
2024-12-08 16:54:35,119,4291,56,63,2963.43,5323.06,0.00
2024-12-08 16:54:35,119,4292,56,63,2936.95,5324.00,0.00
2024-12-08 16:54:35,120,4292,57,63,2912.48,5324.01,0.00
2024-12-08 16:54:35,119,4292,56,63,2936.51,5324.01,0.00
2024-12-08 16:54:35,118,4292,55,63,2949.67,5324.05,0.00
2024-12-08 16:54:35,117,4292,55,62,2974.43,5324.05,0.00
2024-12-08 16:54:35,117,4293,55,62,2960.71,5325.00,0.00
2024-12-08 16:54:35,118,4293,56,62,2935.62,5325.01,0.00
2024-12-08 16:54:35,118,4294,56,62,2907.64,5326.00,0.00
2024-12-08 16:54:35,119,4294,56,63,2883.21,5326.01,0.00
2024-12-08 16:54:35,119,4295,56,63,2844.09,5327.00,0.00
2024-12-08 16:54:35,120,4295,56,64,2820.39,5327.01,0.00
2024-12-08 16:54:35,120,4296,56,64,2768.20,5328.00,0.00
2024-12-08 16:54:35,121,4296,56,65,2745.32,5328.01,0.00
2024-12-08 16:54:35,120,4296,56,64,2764.65,5328.03,0.00
2024-12-08 16:54:35,119,4296,55,64,2776.53,5328.24,0.00
2024-12-08 16:54:35,118,4296,54,64,2721.84,5328.98,0.00
2024-12-08 16:54:35,118,4297,54,64,2766.10,5329.00,0.00
2024-12-08 16:54:35,119,4297,55,64,2742.86,5329.01,0.00
2024-12-08 16:54:35,118,4297,54,64,2764.75,5329.03,0.00
2024-12-08 16:54:35,117,4297,54,63,2778.36,5329.03,0.00
2024-12-08 16:54:35,116,4297,54,62,2801.86,5329.04,0.00
2024-12-08 16:54:35,115,4297,53,62,2793.92,5329.30,0.00
2024-12-08 16:54:35,116,4296,54,62,2763.46,5329.43,0.00
2024-12-08 16:54:35,115,4296,54,61,2774.15,5329.92,0.00
2024-12-08 16:54:35,115,4297,54,61,2816.38,5330.00,0.00
2024-12-08 16:54:35,116,4297,54,62,2792.10,5330.01,0.00
2024-12-08 16:54:35,115,4297,54,61,2810.36,5330.03,0.00
2024-12-08 16:54:35,114,4297,54,60,2834.55,5330.03,0.00
2024-12-08 16:54:35,113,4297,54,59,2829.77,5330.48,0.00
2024-12-08 16:54:35,113,4298,54,59,2877.59,5331.00,0.00
2024-12-08 16:54:35,114,4298,54,60,2852.35,5331.01,0.00
2024-12-08 16:54:35,115,4297,54,61,2827.54,5331.03,0.00
2024-12-08 16:54:35,114,4297,54,60,2884.97,5331.04,0.00
2024-12-08 16:54:35,115,4296,55,60,2805.20,5331.69,0.00
2024-12-08 16:54:35,115,4297,55,60,2855.87,5332.00,0.00
2024-12-08 16:54:35,116,4297,55,61,2831.25,5332.01,0.00
2024-12-08 16:54:35,115,4297,55,60,2843.72,5332.04,0.00
2024-12-08 16:54:35,114,4297,55,59,2868.20,5332.04,0.00
2024-12-08 16:54:35,113,4297,55,58,2882.66,5332.19,0.00
2024-12-08 16:54:35,113,4298,55,58,2974.54,5333.00,0.00
2024-12-08 16:54:35,114,4298,56,58,2948.45,5333.01,0.00
2024-12-08 16:54:35,113,4298,55,58,2945.86,5333.32,0.00
2024-12-08 16:54:35,113,4299,55,58,2944.44,5334.00,0.00
2024-12-08 16:54:35,114,4299,56,58,2918.62,5334.01,0.00
2024-12-08 16:54:35,113,4299,55,58,2931.47,5334.04,0.00
2024-12-08 16:54:35,112,4299,55,57,2957.16,5334.04,0.00
2024-12-08 16:54:35,111,4299,54,57,2958.44,5334.47,0.00
2024-12-08 16:54:35,111,4300,54,57,2959.06,5335.00,0.00
2024-12-08 16:54:35,112,4300,54,58,2932.64,5335.01,0.00
2024-12-08 16:54:35,111,4300,54,57,2955.00,5335.03,0.00
2024-12-08 16:54:35,110,4300,54,56,2981.38,5335.03,0.00
2024-12-08 16:54:35,109,4300,54,55,3005.23,5335.07,0.00
2024-12-08 16:54:35,108,4300,54,54,3026.75,5335.15,0.00
2024-12-08 16:54:35,108,4301,54,54,3007.49,5336.00,0.00
2024-12-08 16:54:35,109,4301,54,55,2979.90,5336.01,0.00
2024-12-08 16:54:35,108,4301,54,54,3006.02,5336.03,0.00
2024-12-08 16:54:36,108,4302,54,54,2976.21,5337.00,0.00
2024-12-08 16:54:36,109,4302,54,55,2948.91,5337.01,0.00
2024-12-08 16:54:36,108,4302,53,55,2974.25,5337.04,0.00
2024-12-08 16:54:36,107,4302,52,55,2999.55,5337.05,0.00
2024-12-08 16:54:36,106,4302,52,54,3025.33,5337.05,0.00
2024-12-08 16:54:36,107,4301,52,55,2992.17,5337.15,0.00
2024-12-08 16:54:36,107,4302,52,55,3032.45,5338.00,0.00
2024-12-08 16:54:36,108,4302,52,56,3004.37,5338.01,0.00
2024-12-08 16:54:36,107,4302,52,55,3027.48,5338.06,0.00
2024-12-08 16:54:36,106,4302,51,55,3051.52,5338.07,0.00
2024-12-08 16:54:36,106,4303,51,55,3100.33,5339.00,0.00
2024-12-08 16:54:36,107,4303,52,55,3071.35,5339.01,0.00
2024-12-08 16:54:36,106,4303,51,55,3098.33,5339.04,0.00
2024-12-08 16:54:36,105,4303,50,55,3087.60,5339.60,0.00
2024-12-08 16:54:36,105,4304,50,55,3108.10,5340.00,0.00
2024-12-08 16:54:36,106,4304,51,55,3078.78,5340.01,0.00
2024-12-08 16:54:36,106,4305,51,55,3050.52,5341.00,0.00
2024-12-08 16:54:36,107,4305,52,55,3022.01,5341.01,0.00
2024-12-08 16:54:36,106,4305,51,55,2984.64,5341.73,0.00
2024-12-08 16:54:36,106,4306,51,55,3020.58,5342.00,0.00
2024-12-08 16:54:36,107,4306,51,56,2992.35,5342.01,0.00
2024-12-08 16:54:36,106,4306,51,55,3015.69,5342.05,0.00
2024-12-08 16:54:36,106,4307,51,55,2994.99,5343.00,0.00
2024-12-08 16:54:36,107,4307,52,55,2967.00,5343.01,0.00
2024-12-08 16:54:36,106,4307,52,54,2988.46,5343.06,0.00
2024-12-08 16:54:36,106,4308,52,54,2966.64,5344.00,0.00
2024-12-08 16:54:36,107,4308,52,55,2938.92,5344.01,0.00
2024-12-08 16:54:36,106,4308,52,54,2943.35,5344.06,0.00
2024-12-08 16:54:36,106,4309,52,54,2942.27,5345.00,0.00
2024-12-08 16:54:36,107,4309,52,55,2914.77,5345.01,0.00
2024-12-08 16:54:36,106,4309,51,55,2935.22,5345.02,0.00
2024-12-08 16:54:36,105,4309,51,54,2954.53,5345.06,0.00
2024-12-08 16:54:36,106,4308,52,54,2887.08,5345.80,0.00
2024-12-08 16:54:36,106,4309,52,54,2934.55,5346.00,0.00
2024-12-08 16:54:36,107,4309,53,54,2907.13,5346.01,0.00
2024-12-08 16:54:36,106,4309,52,54,2910.45,5346.27,0.00
2024-12-08 16:54:36,107,4308,52,55,2839.84,5346.98,0.00
2024-12-08 16:54:36,107,4309,52,55,2939.29,5347.00,0.00
2024-12-08 16:54:36,108,4309,53,55,2912.08,5347.01,0.00
2024-12-08 16:54:36,107,4309,52,55,2937.31,5347.04,0.00
2024-12-08 16:54:36,108,4308,53,55,2868.00,5347.52,0.00
2024-12-08 16:54:36,108,4309,53,55,2960.57,5348.00,0.00
2024-12-08 16:54:36,109,4309,53,56,2933.41,5348.01,0.00
2024-12-08 16:54:36,109,4310,53,56,2954.78,5349.00,0.00
2024-12-08 16:54:36,110,4310,53,57,2927.92,5349.01,0.00
2024-12-08 16:54:36,110,4311,53,57,2889.94,5350.00,0.00
2024-12-08 16:54:36,111,4311,53,58,2863.91,5350.01,0.00
2024-12-08 16:54:36,110,4311,53,57,2884.12,5350.05,0.00
2024-12-08 16:54:36,109,4311,52,57,2839.89,5350.97,0.00
2024-12-08 16:54:36,109,4312,52,57,2887.52,5351.00,0.00
2024-12-08 16:54:36,110,4312,53,57,2861.27,5351.01,0.00
2024-12-08 16:54:36,109,4312,53,56,2880.18,5351.06,0.00
2024-12-08 16:54:36,108,4312,52,56,2849.68,5351.75,0.00
2024-12-08 16:54:36,108,4313,52,56,2880.17,5352.00,0.00
2024-12-08 16:54:36,109,4313,52,57,2853.75,5352.01,0.00
2024-12-08 16:54:36,108,4313,51,57,2860.38,5352.07,0.00
2024-12-08 16:54:36,109,4312,51,58,2809.35,5352.53,0.00
2024-12-08 16:54:36,109,4313,51,58,2863.68,5353.00,0.00
2024-12-08 16:54:36,110,4313,52,58,2837.65,5353.01,0.00
2024-12-08 16:54:36,109,4313,51,58,2800.10,5353.68,0.00
2024-12-08 16:54:36,109,4314,51,58,2871.63,5354.00,0.00
2024-12-08 16:54:36,110,4314,52,58,2845.53,5354.01,0.00
2024-12-08 16:54:36,109,4314,52,57,2865.27,5354.06,0.00
2024-12-08 16:54:36,109,4315,52,57,2828.13,5355.00,0.00
2024-12-08 16:54:36,110,4315,53,57,2802.42,5355.01,0.00
2024-12-08 16:54:36,109,4315,53,56,2800.14,5355.06,0.00
2024-12-08 16:54:36,108,4315,52,56,2811.53,5355.32,0.00
2024-12-08 16:54:36,108,4316,52,56,2809.57,5356.00,0.00
2024-12-08 16:54:36,109,4316,52,57,2783.79,5356.01,0.00
2024-12-08 16:54:36,108,4316,51,57,2726.13,5356.86,0.00
2024-12-08 16:54:36,108,4317,51,57,2768.18,5357.00,0.00
2024-12-08 16:54:36,109,4317,52,57,2742.78,5357.01,0.00
2024-12-08 16:54:36,108,4317,51,57,2724.94,5357.44,0.00
2024-12-08 16:54:36,109,4316,52,57,2682.54,5357.77,0.00
2024-12-08 16:54:36,109,4317,52,57,2753.74,5358.00,0.00
2024-12-08 16:54:36,110,4317,52,58,2728.71,5358.01,0.00
2024-12-08 16:54:36,109,4317,51,58,2751.51,5358.03,0.00
2024-12-08 16:54:36,108,4317,51,57,2771.55,5358.06,0.00
2024-12-08 16:54:36,107,4317,51,56,2764.78,5358.28,0.00
2024-12-08 16:54:36,107,4318,51,56,2795.41,5359.00,0.00
2024-12-08 16:54:36,108,4318,51,57,2769.52,5359.01,0.00
2024-12-08 16:54:36,107,4318,51,56,2787.91,5359.06,0.00
2024-12-08 16:54:36,106,4318,50,56,2796.51,5359.30,0.00
2024-12-08 16:54:36,105,4318,49,56,2796.91,5359.54,0.00
2024-12-08 16:54:37,105,4319,49,56,2814.03,5360.00,0.00
2024-12-08 16:54:37,106,4319,49,57,2787.48,5360.01,0.00
2024-12-08 16:54:37,105,4319,49,56,2802.31,5360.09,0.00
2024-12-08 16:54:37,104,4319,48,56,2819.24,5360.21,0.00
2024-12-08 16:54:37,104,4320,48,56,2796.88,5361.00,0.00
2024-12-08 16:54:37,105,4320,48,57,2770.24,5361.01,0.00
2024-12-08 16:54:37,104,4320,48,56,2784.01,5361.10,0.00
2024-12-08 16:54:37,103,4320,47,56,2789.53,5361.37,0.00
2024-12-08 16:54:37,104,4319,48,56,2750.45,5361.48,0.00
2024-12-08 16:54:37,104,4320,48,56,2793.57,5362.00,0.00
2024-12-08 16:54:37,105,4320,48,57,2766.96,5362.01,0.00
2024-12-08 16:54:37,104,4320,48,56,2750.17,5362.43,0.00
2024-12-08 16:54:37,104,4321,48,56,2809.11,5363.00,0.00
2024-12-08 16:54:37,105,4321,49,56,2782.35,5363.01,0.00
2024-12-08 16:54:37,104,4321,48,56,2804.54,5363.09,0.00
2024-12-08 16:54:37,103,4321,47,56,2831.20,5363.10,0.00
2024-12-08 16:54:37,102,4321,46,56,2833.50,5363.32,0.00
2024-12-08 16:54:37,101,4321,45,56,2831.54,5363.74,0.00
2024-12-08 16:54:37,101,4322,45,56,2863.50,5364.00,0.00
2024-12-08 16:54:37,102,4322,46,56,2835.43,5364.01,0.00
2024-12-08 16:54:37,101,4322,45,56,2859.39,5364.08,0.00
2024-12-08 16:54:37,100,4322,45,55,2883.97,5364.09,0.00
2024-12-08 16:54:37,100,4323,45,55,2860.15,5365.00,0.00
2024-12-08 16:54:37,101,4323,45,56,2831.83,5365.01,0.00
2024-12-08 16:54:37,100,4323,44,56,2805.33,5365.65,0.00
2024-12-08 16:54:37,100,4324,44,56,2834.45,5366.00,0.00
2024-12-08 16:54:37,101,4324,45,56,2806.38,5366.01,0.00
2024-12-08 16:54:37,100,4324,44,56,2787.61,5366.40,0.00
2024-12-08 16:54:37,100,4325,44,56,2804.55,5367.00,0.00
2024-12-08 16:54:37,101,4325,44,57,2776.79,5367.01,0.00
2024-12-08 16:54:37,100,4325,44,56,2793.30,5367.09,0.00
2024-12-08 16:54:37,100,4326,44,56,2766.68,5368.00,0.00
2024-12-08 16:54:37,101,4326,45,56,2739.29,5368.01,0.00
2024-12-08 16:54:37,101,4327,45,56,2707.98,5369.00,0.00
2024-12-08 16:54:37,102,4327,46,56,2681.43,5369.01,0.00
2024-12-08 16:54:37,101,4327,45,56,2675.63,5369.42,0.00
2024-12-08 16:54:37,101,4328,45,56,2672.86,5370.00,0.00
2024-12-08 16:54:37,102,4328,46,56,2646.66,5370.01,0.00
2024-12-08 16:54:37,101,4328,46,55,2663.84,5370.09,0.00
2024-12-08 16:54:37,101,4329,46,55,2639.04,5371.00,0.00
2024-12-08 16:54:37,102,4329,47,55,2613.17,5371.01,0.00
2024-12-08 16:54:37,101,4329,46,55,2635.34,5371.07,0.00
2024-12-08 16:54:37,100,4329,46,54,2654.17,5371.08,0.00
2024-12-08 16:54:37,99,4329,45,54,2656.20,5371.50,0.00
2024-12-08 16:54:37,98,4329,44,54,2639.79,5371.85,0.00
2024-12-08 16:54:37,98,4330,44,54,2682.54,5372.00,0.00
2024-12-08 16:54:37,99,4330,44,55,2655.44,5372.01,0.00
2024-12-08 16:54:37,98,4330,44,54,2672.14,5372.08,0.00
2024-12-08 16:54:37,99,4329,45,54,2636.50,5372.26,0.00
2024-12-08 16:54:37,98,4329,44,54,2674.92,5372.32,0.00
2024-12-08 16:54:37,97,4329,43,54,2659.07,5372.92,0.00
2024-12-08 16:54:37,97,4330,43,54,2705.19,5373.00,0.00
2024-12-08 16:54:37,98,4330,44,54,2677.59,5373.01,0.00
2024-12-08 16:54:37,97,4330,44,53,2694.68,5373.08,0.00
2024-12-08 16:54:37,98,4329,44,54,2665.00,5373.14,0.00
2024-12-08 16:54:37,98,4330,44,54,2735.53,5374.00,0.00
2024-12-08 16:54:37,99,4330,45,54,2707.89,5374.01,0.00
2024-12-08 16:54:37,98,4330,44,54,2728.96,5374.06,0.00
2024-12-08 16:54:37,97,4330,44,53,2749.33,5374.07,0.00
2024-12-08 16:54:37,98,4329,45,53,2684.90,5374.68,0.00
2024-12-08 16:54:37,98,4330,45,53,2788.13,5375.00,0.00
2024-12-08 16:54:37,99,4330,45,54,2759.97,5375.01,0.00
2024-12-08 16:54:37,98,4330,44,54,2784.31,5375.06,0.00
2024-12-08 16:54:37,97,4330,44,53,2803.59,5375.07,0.00
2024-12-08 16:54:37,96,4330,44,52,2819.09,5375.32,0.00
2024-12-08 16:54:37,95,4330,43,52,2820.92,5375.75,0.00
2024-12-08 16:54:37,95,4331,43,52,2920.48,5376.00,0.00
2024-12-08 16:54:37,96,4331,44,52,2890.06,5376.01,0.00
2024-12-08 16:54:37,95,4331,43,52,2911.43,5376.01,0.00
2024-12-08 16:54:37,94,4331,43,51,2924.70,5376.12,0.00
2024-12-08 16:54:37,94,4332,43,51,2928.78,5377.00,0.00
2024-12-08 16:54:37,95,4332,43,52,2897.95,5377.01,0.00
2024-12-08 16:54:37,94,4332,43,51,2911.64,5377.12,0.00
2024-12-08 16:54:37,94,4333,43,51,2891.66,5378.00,0.00
2024-12-08 16:54:37,95,4333,43,52,2861.22,5378.01,0.00
2024-12-08 16:54:37,94,4333,42,52,2876.24,5378.11,0.00
2024-12-08 16:54:37,93,4333,41,52,2876.48,5378.43,0.00
2024-12-08 16:54:37,94,4332,41,53,2844.74,5378.47,0.00
2024-12-08 16:54:37,93,4332,41,52,2892.34,5378.58,0.00
2024-12-08 16:54:37,93,4333,41,52,2923.39,5379.00,0.00
2024-12-08 16:54:37,94,4333,42,52,2892.29,5379.01,0.00
2024-12-08 16:54:37,93,4333,42,51,2915.90,5379.13,0.00
2024-12-08 16:54:37,94,4332,42,52,2882.04,5379.20,0.00
2024-12-08 16:54:37,95,4331,43,52,2848.50,5379.70,0.00
2024-12-08 16:54:37,95,4332,43,52,2936.21,5380.00,0.00
2024-12-08 16:54:37,96,4332,44,52,2905.62,5380.01,0.00
2024-12-08 16:54:37,96,4333,44,52,2981.64,5381.00,0.00
2024-12-08 16:54:37,97,4333,44,53,2950.90,5381.01,0.00
2024-12-08 16:54:37,96,4333,44,52,2974.38,5381.14,0.00
2024-12-08 16:54:37,95,4333,43,52,2949.08,5381.93,0.00
2024-12-08 16:54:37,95,4334,43,52,3001.83,5382.00,0.00
2024-12-08 16:54:37,96,4334,44,52,2970.56,5382.01,0.00
2024-12-08 16:54:38,96,4335,44,52,2952.95,5383.00,0.00
2024-12-08 16:54:38,97,4335,44,53,2922.51,5383.01,0.00
2024-12-08 16:54:38,97,4336,44,53,2902.97,5384.00,0.00
2024-12-08 16:54:38,98,4336,44,54,2873.35,5384.01,0.00
2024-12-08 16:54:38,98,4337,44,54,2848.36,5385.00,0.00
2024-12-08 16:54:38,99,4337,44,55,2819.59,5385.01,0.00
2024-12-08 16:54:38,99,4338,44,55,2787.17,5386.00,0.00
2024-12-08 16:54:38,100,4338,45,55,2759.30,5386.01,0.00
2024-12-08 16:54:38,99,4338,45,54,2776.86,5386.13,0.00
2024-12-08 16:54:38,98,4338,44,54,2804.67,5386.13,0.00
2024-12-08 16:54:38,97,4338,43,54,2771.36,5386.97,0.00
2024-12-08 16:54:38,97,4339,43,54,2825.25,5387.00,0.00
2024-12-08 16:54:38,98,4339,44,54,2796.42,5387.01,0.00
2024-12-08 16:54:38,97,4339,43,54,2821.36,5387.01,0.00
2024-12-08 16:54:38,97,4340,43,54,2806.85,5388.00,0.00
2024-12-08 16:54:38,98,4340,43,55,2778.21,5388.01,0.00
2024-12-08 16:54:38,97,4340,42,55,2804.63,5388.04,0.00
2024-12-08 16:54:38,97,4341,42,55,2775.85,5389.00,0.00
2024-12-08 16:54:38,98,4341,42,56,2747.52,5389.01,0.00
2024-12-08 16:54:38,97,4341,41,56,2774.33,5389.01,0.00
2024-12-08 16:54:38,96,4341,41,55,2786.42,5389.13,0.00
2024-12-08 16:54:38,95,4341,40,55,2806.91,5389.28,0.00
2024-12-08 16:54:38,96,4340,40,56,2767.95,5389.47,0.00
2024-12-08 16:54:38,95,4340,40,55,2846.29,5389.47,0.00
2024-12-08 16:54:38,95,4341,40,55,2850.40,5390.00,0.00
2024-12-08 16:54:38,96,4341,40,56,2820.71,5390.01,0.00
2024-12-08 16:54:38,95,4341,40,55,2831.14,5390.15,0.00
2024-12-08 16:54:38,94,4341,39,55,2827.28,5390.73,0.00
2024-12-08 16:54:38,94,4342,39,55,2927.85,5391.00,0.00
2024-12-08 16:54:38,95,4342,40,55,2897.03,5391.01,0.00
2024-12-08 16:54:38,94,4342,39,55,2923.84,5391.03,0.00
2024-12-08 16:54:38,93,4342,38,55,2950.45,5391.12,0.00
2024-12-08 16:54:38,93,4343,38,55,2939.20,5392.00,0.00
2024-12-08 16:54:38,94,4343,38,56,2907.94,5392.01,0.00
2024-12-08 16:54:38,94,4344,38,56,2881.91,5393.00,0.00
2024-12-08 16:54:38,95,4344,39,56,2851.58,5393.01,0.00
2024-12-08 16:54:38,94,4344,38,56,2879.63,5393.04,0.00
2024-12-08 16:54:38,93,4344,38,55,2910.01,5393.04,0.00
2024-12-08 16:54:38,93,4345,38,55,2876.20,5394.00,0.00
2024-12-08 16:54:38,94,4345,39,55,2845.60,5394.01,0.00
2024-12-08 16:54:38,93,4345,39,54,2864.64,5394.14,0.00
2024-12-08 16:54:38,94,4344,40,54,2813.68,5394.47,0.00
2024-12-08 16:54:38,93,4344,39,54,2859.52,5394.65,0.00
2024-12-08 16:54:38,93,4345,39,54,2875.45,5395.00,0.00
2024-12-08 16:54:38,94,4345,39,55,2844.86,5395.01,0.00
2024-12-08 16:54:38,93,4345,38,55,2842.59,5395.39,0.00
2024-12-08 16:54:38,92,4345,37,55,2845.83,5395.61,0.00
2024-12-08 16:54:38,92,4346,37,55,2942.30,5396.00,0.00
2024-12-08 16:54:38,93,4346,37,56,2910.67,5396.01,0.00
2024-12-08 16:54:38,92,4346,37,55,2934.71,5396.14,0.00
2024-12-08 16:54:38,92,4347,37,55,2922.99,5397.00,0.00
2024-12-08 16:54:38,93,4347,37,56,2891.56,5397.01,0.00
2024-12-08 16:54:38,92,4347,36,56,2918.41,5397.02,0.00
2024-12-08 16:54:38,91,4347,36,55,2933.25,5397.14,0.00
2024-12-08 16:54:38,91,4348,36,55,2945.21,5398.00,0.00
2024-12-08 16:54:38,92,4348,37,55,2913.20,5398.01,0.00
2024-12-08 16:54:38,91,4348,37,54,2925.67,5398.14,0.00
2024-12-08 16:54:38,90,4348,36,54,2905.72,5398.68,0.00
2024-12-08 16:54:38,90,4349,36,54,2948.56,5399.00,0.00
2024-12-08 16:54:38,91,4349,36,55,2916.16,5399.01,0.00
2024-12-08 16:54:38,90,4349,35,55,2946.38,5399.04,0.00
2024-12-08 16:54:38,89,4349,35,54,2962.52,5399.14,0.00
2024-12-08 16:54:38,88,4349,34,54,2973.73,5399.51,0.00
2024-12-08 16:54:38,87,4349,33,54,2980.97,5399.61,0.00
2024-12-08 16:54:38,87,4350,33,54,3022.24,5400.00,0.00
2024-12-08 16:54:38,88,4350,33,55,2987.89,5400.01,0.00
2024-12-08 16:54:38,87,4350,32,55,3019.77,5400.05,0.00
2024-12-08 16:54:38,86,4350,32,54,3037.95,5400.13,0.00
2024-12-08 16:54:38,86,4351,32,54,3027.54,5401.00,0.00
2024-12-08 16:54:38,87,4351,33,54,2992.74,5401.01,0.00
2024-12-08 16:54:38,86,4351,32,54,3020.74,5401.13,0.00
2024-12-08 16:54:38,85,4351,32,53,3047.55,5401.13,0.00
2024-12-08 16:54:38,84,4351,31,53,3044.12,5401.56,0.00
2024-12-08 16:54:38,84,4352,31,53,3084.97,5402.00,0.00
2024-12-08 16:54:38,85,4352,32,53,3048.67,5402.01,0.00
2024-12-08 16:54:38,84,4352,31,53,3020.34,5402.45,0.00
2024-12-08 16:54:38,84,4353,31,53,3055.46,5403.00,0.00
2024-12-08 16:54:38,85,4353,31,54,3019.52,5403.01,0.00
2024-12-08 16:54:38,84,4353,31,53,3048.42,5403.13,0.00
2024-12-08 16:54:38,85,4352,32,53,3000.44,5403.38,0.00
2024-12-08 16:54:38,85,4353,32,53,3007.63,5404.00,0.00
2024-12-08 16:54:38,86,4353,32,54,2972.66,5404.01,0.00
2024-12-08 16:54:38,85,4353,32,53,3005.10,5404.05,0.00
2024-12-08 16:54:38,85,4354,32,53,3039.52,5405.00,0.00
2024-12-08 16:54:38,86,4354,32,54,3004.18,5405.01,0.00
2024-12-08 16:54:38,85,4354,32,53,3032.55,5405.12,0.00
2024-12-08 16:54:38,86,4353,32,54,2983.57,5405.40,0.00
2024-12-08 16:54:38,86,4354,32,54,3039.51,5406.00,0.00
2024-12-08 16:54:38,87,4354,33,54,3004.58,5406.01,0.00
2024-12-08 16:54:38,86,4354,32,54,3016.37,5406.20,0.00
2024-12-08 16:54:38,86,4355,32,54,3074.95,5407.00,0.00
2024-12-08 16:54:38,87,4355,32,55,3039.61,5407.01,0.00
2024-12-08 16:54:39,86,4355,32,54,3057.38,5407.12,0.00
2024-12-08 16:54:39,87,4354,33,54,3004.98,5407.46,0.00
2024-12-08 16:54:39,86,4354,32,54,3032.84,5407.51,0.00
2024-12-08 16:54:39,86,4355,32,54,3065.57,5408.00,0.00
2024-12-08 16:54:39,87,4355,32,55,3030.33,5408.01,0.00
2024-12-08 16:54:39,86,4355,31,55,3059.98,5408.10,0.00
2024-12-08 16:54:39,85,4355,31,54,3082.62,5408.11,0.00
2024-12-08 16:54:39,85,4356,31,54,3109.55,5409.00,0.00
2024-12-08 16:54:39,86,4356,31,55,3073.39,5409.01,0.00
2024-12-08 16:54:39,85,4356,31,54,3046.18,5409.45,0.00
2024-12-08 16:54:39,85,4357,31,54,3076.70,5410.00,0.00
2024-12-08 16:54:39,86,4357,32,54,3040.92,5410.01,0.00
2024-12-08 16:54:39,85,4357,31,54,3073.53,5410.06,0.00
2024-12-08 16:54:39,84,4357,31,53,3107.55,5410.10,0.00
2024-12-08 16:54:39,84,4358,31,53,3095.36,5411.00,0.00
2024-12-08 16:54:39,85,4358,31,54,3058.94,5411.01,0.00
2024-12-08 16:54:39,84,4358,31,53,3091.51,5411.07,0.00
2024-12-08 16:54:39,83,4358,31,52,3114.42,5411.08,0.00
2024-12-08 16:54:39,84,4357,32,52,3059.30,5411.44,0.00
2024-12-08 16:54:39,84,4358,32,52,3092.19,5412.00,0.00
2024-12-08 16:54:39,85,4358,33,52,3055.81,5412.01,0.00
2024-12-08 16:54:39,84,4358,32,52,3087.04,5412.04,0.00
2024-12-08 16:54:39,84,4359,32,52,3149.62,5413.00,0.00
2024-12-08 16:54:39,85,4359,32,53,3112.56,5413.01,0.00
2024-12-08 16:54:39,84,4359,32,52,3146.41,5413.06,0.00
2024-12-08 16:54:39,84,4360,32,52,3128.17,5414.00,0.00
2024-12-08 16:54:39,85,4360,32,53,3091.36,5414.01,0.00
2024-12-08 16:54:39,85,4361,32,53,3063.04,5415.00,0.00
2024-12-08 16:54:39,86,4361,33,53,3027.43,5415.01,0.00
2024-12-08 16:54:39,85,4361,33,52,3057.97,5415.06,0.00
2024-12-08 16:54:39,86,4360,33,53,3017.40,5415.17,0.00
2024-12-08 16:54:39,85,4360,32,53,3034.61,5415.98,0.00
2024-12-08 16:54:39,85,4361,32,53,3097.06,5416.00,0.00
2024-12-08 16:54:39,86,4361,32,54,3061.05,5416.01,0.00
2024-12-08 16:54:39,85,4361,31,54,3096.43,5416.01,0.00
2024-12-08 16:54:39,84,4361,30,54,3108.16,5416.04,0.00
2024-12-08 16:54:39,83,4361,30,53,3134.59,5416.05,0.00
2024-12-08 16:54:39,83,4362,30,53,3214.13,5417.00,0.00
2024-12-08 16:54:39,84,4362,31,53,3175.86,5417.01,0.00
2024-12-08 16:54:39,83,4362,31,52,3202.79,5417.05,0.00
2024-12-08 16:54:39,82,4362,30,52,3203.08,5417.49,0.00
2024-12-08 16:54:39,82,4363,30,52,3241.77,5418.00,0.00
2024-12-08 16:54:39,83,4363,30,53,3202.71,5418.01,0.00
2024-12-08 16:54:39,82,4363,30,52,3227.25,5418.05,0.00
2024-12-08 16:54:39,82,4364,30,52,3215.93,5419.00,0.00
2024-12-08 16:54:39,83,4364,30,53,3177.18,5419.01,0.00
2024-12-08 16:54:39,84,4363,31,53,3137.44,5419.07,0.00
2024-12-08 16:54:39,83,4363,31,52,3215.73,5419.07,0.00
2024-12-08 16:54:39,83,4364,31,52,3205.20,5420.00,0.00
2024-12-08 16:54:39,84,4364,32,52,3167.04,5420.01,0.00
2024-12-08 16:54:39,83,4364,31,52,3164.07,5420.53,0.00
2024-12-08 16:54:39,83,4365,31,52,3262.61,5421.00,0.00
2024-12-08 16:54:39,84,4365,32,52,3223.77,5421.01,0.00
2024-12-08 16:54:39,83,4365,31,52,3211.37,5421.71,0.00
2024-12-08 16:54:39,83,4366,31,52,3245.64,5422.00,0.00
2024-12-08 16:54:39,84,4366,31,53,3207.00,5422.01,0.00
2024-12-08 16:54:39,84,4367,31,53,3173.06,5423.00,0.00
2024-12-08 16:54:39,85,4367,31,54,3135.73,5423.01,0.00
2024-12-08 16:54:39,85,4368,31,54,3080.35,5424.00,0.00
2024-12-08 16:54:39,86,4368,32,54,3044.53,5424.01,0.00
2024-12-08 16:54:39,85,4368,32,53,3068.24,5424.05,0.00
2024-12-08 16:54:39,84,4368,31,53,3098.31,5424.17,0.00
2024-12-08 16:54:39,83,4368,31,52,3072.21,5424.94,0.00
2024-12-08 16:54:39,83,4369,31,52,3108.19,5425.00,0.00
2024-12-08 16:54:39,84,4369,32,52,3071.19,5425.01,0.00
2024-12-08 16:54:39,83,4369,32,51,3097.10,5425.05,0.00
2024-12-08 16:54:39,82,4369,31,51,3057.18,5425.96,0.00
2024-12-08 16:54:39,82,4370,31,51,3121.39,5426.00,0.00
2024-12-08 16:54:39,83,4370,31,52,3083.78,5426.01,0.00
2024-12-08 16:54:39,82,4370,30,52,3104.88,5426.07,0.00
2024-12-08 16:54:39,81,4370,30,51,3128.48,5426.09,0.00
2024-12-08 16:54:39,81,4371,30,51,3143.99,5427.00,0.00
2024-12-08 16:54:39,82,4371,31,51,3105.65,5427.01,0.00
2024-12-08 16:54:39,81,4371,30,51,3103.18,5427.16,0.00
2024-12-08 16:54:39,81,4372,30,51,3121.72,5428.00,0.00
2024-12-08 16:54:39,82,4372,31,51,3083.65,5428.01,0.00
2024-12-08 16:54:39,81,4372,31,50,3116.41,5428.10,0.00
2024-12-08 16:54:39,81,4373,31,50,3103.19,5429.00,0.00
2024-12-08 16:54:39,82,4373,31,51,3065.35,5429.01,0.00
2024-12-08 16:54:39,81,4373,31,50,3084.47,5429.10,0.00
2024-12-08 16:54:39,80,4373,30,50,3102.09,5429.35,0.00
2024-12-08 16:54:39,80,4374,30,50,3128.66,5430.00,0.00
2024-12-08 16:54:39,81,4374,30,51,3090.03,5430.01,0.00
2024-12-08 16:54:39,80,4374,30,50,3109.70,5430.10,0.00
2024-12-08 16:54:39,80,4375,30,50,3094.30,5431.00,0.00
2024-12-08 16:54:39,81,4375,31,50,3056.10,5431.01,0.00
2024-12-08 16:54:39,80,4375,30,50,3092.27,5431.04,0.00
2024-12-08 16:54:39,79,4375,29,50,3094.31,5431.41,0.00
2024-12-08 16:54:39,78,4375,28,50,3113.83,5431.49,0.00
2024-12-08 16:54:40,78,4376,28,50,3150.45,5432.00,0.00
2024-12-08 16:54:40,79,4376,28,51,3110.58,5432.01,0.00
2024-12-08 16:54:40,78,4376,28,50,3145.62,5432.09,0.00
2024-12-08 16:54:40,78,4377,28,50,3132.95,5433.00,0.00
2024-12-08 16:54:40,79,4377,29,50,3093.29,5433.01,0.00
2024-12-08 16:54:40,78,4377,28,50,3095.50,5433.45,0.00
2024-12-08 16:54:40,78,4378,28,50,3110.66,5434.00,0.00
2024-12-08 16:54:40,79,4378,28,51,3071.28,5434.01,0.00
2024-12-08 16:54:40,79,4379,28,51,3040.00,5435.00,0.00
2024-12-08 16:54:40,80,4379,28,52,3002.00,5435.01,0.00
2024-12-08 16:54:40,79,4379,28,51,3032.47,5435.09,0.00
2024-12-08 16:54:40,79,4380,28,51,3018.39,5436.00,0.00
2024-12-08 16:54:40,80,4380,29,51,2980.66,5436.01,0.00
2024-12-08 16:54:40,79,4380,29,50,2999.85,5436.09,0.00
2024-12-08 16:54:40,78,4380,28,50,3006.46,5436.62,0.00
2024-12-08 16:54:40,78,4381,28,50,3049.19,5437.00,0.00
2024-12-08 16:54:40,79,4381,29,50,3010.59,5437.01,0.00
2024-12-08 16:54:40,79,4382,29,50,2978.70,5438.00,0.00
2024-12-08 16:54:40,80,4382,29,51,2941.47,5438.01,0.00
2024-12-08 16:54:40,79,4382,29,50,2973.92,5438.09,0.00
2024-12-08 16:54:40,80,4381,30,50,2895.18,5438.78,0.00
2024-12-08 16:54:40,81,4380,30,51,2861.04,5438.99,0.00
2024-12-08 16:54:40,81,4381,30,51,2928.20,5439.00,0.00
2024-12-08 16:54:40,82,4381,31,51,2892.49,5439.01,0.00
2024-12-08 16:54:40,81,4381,31,50,2910.10,5439.09,0.00
2024-12-08 16:54:40,81,4382,31,50,3026.20,5440.00,0.00
2024-12-08 16:54:40,82,4382,32,50,2989.29,5440.01,0.00
2024-12-08 16:54:40,82,4383,32,50,2952.76,5441.00,0.00
2024-12-08 16:54:40,83,4383,32,51,2917.19,5441.01,0.00
2024-12-08 16:54:40,82,4383,32,50,2944.14,5441.01,0.00
2024-12-08 16:54:40,82,4384,32,50,2915.56,5442.00,0.00
2024-12-08 16:54:40,83,4384,33,50,2880.43,5442.01,0.00
2024-12-08 16:54:40,82,4384,32,50,2891.69,5442.05,0.00
2024-12-08 16:54:40,81,4384,32,49,2913.96,5442.06,0.00
2024-12-08 16:54:40,80,4384,31,49,2946.90,5442.13,0.00
2024-12-08 16:54:40,80,4385,31,49,2949.88,5443.00,0.00
2024-12-08 16:54:40,81,4385,32,49,2913.46,5443.01,0.00
2024-12-08 16:54:40,81,4386,32,49,2886.67,5444.00,0.00
2024-12-08 16:54:40,82,4386,33,49,2851.46,5444.01,0.00
2024-12-08 16:54:40,81,4386,32,49,2840.36,5444.57,0.00
2024-12-08 16:54:40,81,4387,32,49,2856.64,5445.00,0.00
2024-12-08 16:54:40,82,4387,33,49,2821.81,5445.01,0.00
2024-12-08 16:54:40,81,4387,32,49,2800.59,5445.74,0.00
2024-12-08 16:54:40,81,4388,32,49,2827.00,5446.00,0.00
2024-12-08 16:54:40,82,4388,33,49,2792.52,5446.01,0.00
2024-12-08 16:54:40,81,4388,33,48,2822.81,5446.06,0.00
2024-12-08 16:54:40,81,4389,33,48,2810.86,5447.00,0.00
2024-12-08 16:54:40,82,4389,34,48,2776.58,5447.01,0.00
2024-12-08 16:54:40,81,4389,34,47,2797.43,5447.06,0.00
2024-12-08 16:54:40,80,4389,33,47,2802.00,5447.43,0.00
2024-12-08 16:54:40,79,4389,32,47,2819.66,5447.73,0.00
2024-12-08 16:54:40,79,4390,32,47,2874.33,5448.00,0.00
2024-12-08 16:54:40,80,4390,32,48,2838.40,5448.01,0.00
2024-12-08 16:54:40,80,4391,32,48,2811.81,5449.00,0.00
2024-12-08 16:54:40,81,4391,33,48,2777.09,5449.01,0.00
2024-12-08 16:54:40,80,4391,33,47,2803.67,5449.10,0.00
2024-12-08 16:54:40,79,4391,33,46,2836.14,5449.15,0.00
2024-12-08 16:54:40,78,4391,32,46,2823.82,5449.90,0.00
2024-12-08 16:54:40,78,4392,32,46,2888.18,5450.00,0.00
2024-12-08 16:54:40,79,4392,32,47,2851.62,5450.01,0.00
2024-12-08 16:54:40,79,4393,32,47,2827.06,5451.00,0.00
2024-12-08 16:54:40,80,4393,32,48,2791.72,5451.01,0.00
2024-12-08 16:54:40,79,4393,32,47,2815.37,5451.14,0.00
2024-12-08 16:54:40,79,4394,32,47,2810.33,5452.00,0.00
2024-12-08 16:54:40,80,4394,33,47,2775.20,5452.01,0.00
2024-12-08 16:54:40,80,4395,33,47,2749.02,5453.00,0.00
2024-12-08 16:54:40,81,4395,34,47,2715.08,5453.01,0.00
2024-12-08 16:54:40,80,4395,34,46,2736.14,5453.14,0.00
2024-12-08 16:54:40,79,4395,33,46,2744.46,5453.58,0.00
2024-12-08 16:54:40,80,4394,33,47,2710.16,5453.60,0.00
2024-12-08 16:54:40,79,4394,32,47,2745.95,5453.75,0.00
2024-12-08 16:54:40,79,4395,32,47,2773.42,5454.00,0.00
2024-12-08 16:54:40,80,4395,33,47,2738.75,5454.01,0.00
2024-12-08 16:54:40,79,4395,32,47,2755.47,5454.01,0.00
2024-12-08 16:54:40,78,4395,31,47,2750.27,5454.45,0.00
2024-12-08 16:54:40,78,4396,31,47,2859.32,5455.00,0.00
2024-12-08 16:54:40,79,4396,32,47,2823.12,5455.01,0.00
2024-12-08 16:54:40,78,4396,32,46,2849.56,5455.13,0.00
2024-12-08 16:54:40,77,4396,31,46,2879.52,5455.26,0.00
2024-12-08 16:54:40,77,4397,31,46,2876.83,5456.00,0.00
2024-12-08 16:54:40,78,4397,32,46,2839.95,5456.01,0.00
2024-12-08 16:54:40,77,4397,31,46,2852.78,5456.13,0.00
2024-12-08 16:54:40,77,4398,31,46,2849.74,5457.00,0.00
2024-12-08 16:54:40,78,4398,32,46,2813.21,5457.01,0.00
2024-12-08 16:54:40,77,4398,32,45,2839.85,5457.13,0.00
2024-12-08 16:54:40,77,4399,32,45,2817.17,5458.00,0.00
2024-12-08 16:54:40,78,4399,32,46,2781.05,5458.01,0.00
2024-12-08 16:54:41,77,4399,32,45,2773.95,5458.13,0.00
2024-12-08 16:54:41,76,4399,31,45,2801.88,5458.28,0.00
2024-12-08 16:54:41,76,4400,31,45,2814.18,5459.00,0.00
2024-12-08 16:54:41,77,4400,31,46,2777.63,5459.01,0.00
2024-12-08 16:54:41,76,4400,30,46,2801.98,5459.07,0.00
2024-12-08 16:54:41,76,4401,30,46,2786.38,5460.00,0.00
2024-12-08 16:54:41,77,4401,30,47,2750.19,5460.01,0.00
2024-12-08 16:54:41,76,4401,29,47,2736.13,5460.21,0.00
2024-12-08 16:54:41,75,4401,29,46,2749.36,5460.59,0.00
2024-12-08 16:54:41,74,4401,28,46,2781.17,5460.66,0.00
2024-12-08 16:54:41,74,4402,28,46,2829.16,5461.00,0.00
2024-12-08 16:54:41,75,4402,29,46,2791.43,5461.01,0.00
2024-12-08 16:54:41,74,4402,28,46,2814.51,5461.01,0.00
2024-12-08 16:54:41,73,4402,28,45,2830.12,5461.17,0.00
2024-12-08 16:54:41,73,4403,28,45,2850.70,5462.00,0.00
2024-12-08 16:54:41,74,4403,29,45,2812.17,5462.01,0.00
2024-12-08 16:54:41,73,4403,29,44,2843.23,5462.11,0.00
2024-12-08 16:54:41,72,4403,29,43,2864.44,5462.44,0.00
2024-12-08 16:54:41,71,4403,28,43,2856.60,5462.75,0.00
2024-12-08 16:54:41,71,4404,28,43,2916.19,5463.00,0.00
2024-12-08 16:54:41,72,4404,29,43,2875.69,5463.01,0.00
2024-12-08 16:54:41,71,4404,28,43,2851.76,5463.55,0.00
2024-12-08 16:54:41,72,4403,28,44,2801.65,5463.76,0.00
2024-12-08 16:54:41,72,4404,28,44,2872.48,5464.00,0.00
2024-12-08 16:54:41,73,4404,29,44,2833.13,5464.01,0.00
2024-12-08 16:54:41,72,4404,29,43,2865.67,5464.11,0.00
2024-12-08 16:54:41,72,4405,29,43,2935.17,5465.00,0.00
2024-12-08 16:54:41,73,4405,29,44,2894.96,5465.01,0.00
2024-12-08 16:54:41,72,4405,29,43,2925.32,5465.13,0.00
2024-12-08 16:54:41,71,4405,28,43,2930.39,5465.24,0.00
2024-12-08 16:54:41,71,4406,28,43,2962.09,5466.00,0.00
2024-12-08 16:54:41,72,4406,28,44,2920.95,5466.01,0.00
2024-12-08 16:54:41,71,4406,28,43,2959.02,5466.04,0.00
2024-12-08 16:54:41,71,4407,28,43,2946.76,5467.00,0.00
2024-12-08 16:54:41,72,4407,28,44,2905.83,5467.01,0.00
2024-12-08 16:54:41,72,4408,28,44,2873.41,5468.00,0.00
2024-12-08 16:54:41,73,4408,29,44,2834.05,5468.01,0.00
2024-12-08 16:54:41,72,4408,29,43,2865.83,5468.11,0.00
2024-12-08 16:54:41,73,4407,29,44,2742.29,5468.93,0.00
2024-12-08 16:54:41,73,4408,29,44,2846.49,5469.00,0.00
2024-12-08 16:54:41,74,4408,30,44,2808.02,5469.01,0.00
2024-12-08 16:54:41,73,4408,29,44,2787.36,5469.48,0.00
2024-12-08 16:54:41,73,4409,29,44,2901.59,5470.00,0.00
2024-12-08 16:54:41,74,4409,30,44,2862.38,5470.01,0.00
2024-12-08 16:54:41,73,4409,30,43,2894.12,5470.11,0.00
2024-12-08 16:54:41,72,4409,29,43,2903.51,5470.61,0.00
2024-12-08 16:54:41,72,4410,29,43,2925.10,5471.00,0.00
2024-12-08 16:54:41,73,4410,30,43,2885.03,5471.01,0.00
2024-12-08 16:54:41,72,4410,29,43,2888.71,5471.29,0.00
2024-12-08 16:54:41,72,4411,29,43,2892.69,5472.00,0.00
2024-12-08 16:54:41,73,4411,29,44,2853.06,5472.01,0.00
2024-12-08 16:54:41,72,4411,29,43,2890.42,5472.04,0.00
2024-12-08 16:54:41,71,4411,29,42,2924.97,5472.10,0.00
2024-12-08 16:54:41,70,4411,28,42,2912.33,5472.54,0.00
2024-12-08 16:54:41,70,4412,28,42,2961.78,5473.00,0.00
2024-12-08 16:54:41,71,4412,28,43,2920.07,5473.01,0.00
2024-12-08 16:54:41,70,4412,27,43,2891.78,5473.49,0.00
2024-12-08 16:54:41,69,4412,26,43,2922.70,5473.68,0.00
2024-12-08 16:54:41,69,4413,26,43,2979.55,5474.00,0.00
2024-12-08 16:54:41,70,4413,26,44,2936.99,5474.01,0.00
2024-12-08 16:54:41,69,4413,25,44,2977.18,5474.04,0.00
2024-12-08 16:54:41,68,4413,24,44,3020.16,5474.04,0.00
2024-12-08 16:54:41,67,4413,24,43,3059.52,5474.09,0.00
2024-12-08 16:54:41,66,4413,24,42,3095.40,5474.14,0.00
2024-12-08 16:54:41,65,4413,23,42,3132.55,5474.26,0.00
2024-12-08 16:54:41,66,4412,24,42,3062.93,5474.70,0.00
2024-12-08 16:54:41,66,4413,24,42,3137.30,5475.00,0.00
2024-12-08 16:54:41,67,4413,24,43,3090.47,5475.02,0.00
2024-12-08 16:54:41,66,4413,24,42,3134.82,5475.05,0.00
2024-12-08 16:54:41,65,4413,24,41,3172.12,5475.08,0.00
2024-12-08 16:54:41,65,4414,24,41,3248.02,5476.00,0.00
2024-12-08 16:54:41,66,4414,24,42,3198.81,5476.02,0.00
2024-12-08 16:54:41,67,4413,24,43,3126.58,5476.19,0.00
2024-12-08 16:54:41,67,4414,24,43,3197.78,5477.00,0.00
2024-12-08 16:54:41,68,4414,24,44,3150.75,5477.02,0.00
2024-12-08 16:54:41,67,4414,24,43,3191.26,5477.08,0.00
2024-12-08 16:54:41,67,4415,24,43,3258.10,5478.00,0.00
2024-12-08 16:54:41,68,4415,25,43,3210.19,5478.02,0.00
2024-12-08 16:54:41,68,4416,25,43,3169.47,5479.00,0.00
2024-12-08 16:54:41,69,4416,25,44,3123.54,5479.02,0.00
2024-12-08 16:54:41,68,4416,25,43,3163.38,5479.07,0.00
2024-12-08 16:54:41,67,4416,24,43,3188.30,5479.48,0.00
2024-12-08 16:54:41,68,4415,24,44,3131.86,5479.68,0.00
2024-12-08 16:54:41,67,4415,23,44,3190.51,5479.69,0.00
2024-12-08 16:54:41,67,4416,23,44,3247.76,5480.00,0.00
2024-12-08 16:54:41,68,4416,23,45,3200.00,5480.02,0.00
2024-12-08 16:54:41,67,4416,22,45,3176.02,5480.54,0.00
2024-12-08 16:54:41,67,4417,22,45,3299.96,5481.00,0.00
2024-12-08 16:54:41,68,4417,22,46,3251.43,5481.02,0.00
2024-12-08 16:54:41,68,4418,22,46,3197.55,5482.00,0.00
2024-12-08 16:54:41,69,4418,22,47,3151.21,5482.02,0.00
2024-12-08 16:54:41,68,4418,22,46,3191.68,5482.09,0.00
2024-12-08 16:54:42,67,4418,21,46,3204.28,5482.42,0.00
2024-12-08 16:54:42,67,4419,21,46,3196.35,5483.00,0.00
2024-12-08 16:54:42,68,4419,21,47,3149.35,5483.02,0.00
2024-12-08 16:54:42,67,4419,21,46,3097.42,5483.82,0.00
2024-12-08 16:54:42,66,4419,21,45,3119.01,5483.83,0.00
2024-12-08 16:54:42,66,4420,21,45,3193.11,5484.00,0.00
2024-12-08 16:54:42,67,4420,21,46,3145.45,5484.02,0.00
2024-12-08 16:54:42,66,4420,21,45,3189.31,5484.08,0.00
2024-12-08 16:54:42,67,4419,21,46,3099.37,5484.58,0.00
2024-12-08 16:54:42,67,4420,21,46,3184.65,5485.00,0.00
2024-12-08 16:54:42,68,4420,22,46,3137.82,5485.02,0.00
2024-12-08 16:54:42,68,4421,22,46,3206.79,5486.00,0.00
2024-12-08 16:54:42,69,4421,23,46,3160.32,5486.02,0.00
2024-12-08 16:54:42,69,4422,23,46,3132.10,5487.00,0.00
2024-12-08 16:54:42,70,4422,23,47,3087.35,5487.01,0.00
2024-12-08 16:54:42,69,4422,23,46,3119.39,5487.10,0.00
2024-12-08 16:54:42,68,4422,22,46,3112.82,5487.53,0.00
2024-12-08 16:54:42,68,4423,22,46,3157.89,5488.00,0.00
2024-12-08 16:54:42,69,4423,23,46,3112.12,5488.02,0.00
2024-12-08 16:54:42,68,4423,23,45,3155.47,5488.04,0.00
2024-12-08 16:54:42,67,4423,22,45,3111.04,5488.67,0.00
2024-12-08 16:54:42,67,4424,22,45,3175.21,5489.00,0.00
2024-12-08 16:54:42,68,4424,22,46,3128.51,5489.02,0.00
2024-12-08 16:54:42,67,4424,22,45,3166.21,5489.10,0.00
2024-12-08 16:54:42,67,4425,22,45,3163.17,5490.00,0.00
2024-12-08 16:54:42,68,4425,22,46,3116.66,5490.02,0.00
2024-12-08 16:54:42,69,4424,22,47,3042.11,5490.29,0.00
2024-12-08 16:54:42,69,4425,22,47,3113.20,5491.00,0.00
2024-12-08 16:54:42,70,4425,22,48,3068.73,5491.01,0.00
2024-12-08 16:54:42,69,4425,21,48,3036.71,5491.68,0.00
2024-12-08 16:54:42,69,4426,21,48,3178.64,5492.00,0.00
2024-12-08 16:54:42,70,4426,22,48,3133.23,5492.01,0.00
2024-12-08 16:54:42,69,4426,21,48,3144.85,5492.30,0.00
2024-12-08 16:54:42,70,4425,22,48,3085.23,5492.59,0.00
2024-12-08 16:54:42,70,4426,22,48,3171.17,5493.00,0.00
2024-12-08 16:54:42,71,4426,22,49,3126.51,5493.01,0.00
2024-12-08 16:54:42,70,4426,22,48,3164.13,5493.13,0.00
2024-12-08 16:54:42,70,4427,22,48,3239.45,5494.00,0.00
2024-12-08 16:54:42,71,4427,22,49,3193.82,5494.01,0.00
2024-12-08 16:54:42,70,4427,21,49,3220.33,5494.14,0.00
2024-12-08 16:54:42,70,4428,21,49,3231.04,5495.00,0.00
2024-12-08 16:54:42,71,4428,22,49,3185.53,5495.01,0.00
2024-12-08 16:54:42,70,4428,22,48,3217.71,5495.14,0.00
2024-12-08 16:54:42,69,4428,21,48,3239.66,5495.16,0.00
2024-12-08 16:54:42,69,4429,21,48,3265.23,5496.00,0.00
2024-12-08 16:54:42,70,4429,21,49,3218.59,5496.01,0.00
2024-12-08 16:54:42,69,4429,21,48,3262.85,5496.04,0.00
2024-12-08 16:54:42,68,4429,20,48,3293.95,5496.12,0.00
2024-12-08 16:54:42,67,4429,20,47,3302.92,5496.48,0.00
2024-12-08 16:54:42,67,4430,20,47,3355.51,5497.00,0.00
2024-12-08 16:54:42,68,4430,21,47,3306.16,5497.02,0.00
2024-12-08 16:54:42,67,4430,21,46,3344.03,5497.12,0.00
2024-12-08 16:54:42,67,4431,21,46,3343.95,5498.00,0.00
2024-12-08 16:54:42,68,4431,22,46,3294.78,5498.02,0.00
2024-12-08 16:54:42,69,4430,22,47,3175.89,5498.49,0.00
2024-12-08 16:54:42,69,4431,22,47,3252.19,5499.00,0.00
2024-12-08 16:54:42,70,4431,22,48,3205.73,5499.01,0.00
2024-12-08 16:54:42,69,4431,22,47,3236.27,5499.13,0.00
2024-12-08 16:54:42,69,4432,22,47,3314.27,5500.00,0.00
2024-12-08 16:54:42,70,4432,22,48,3266.92,5500.01,0.00
2024-12-08 16:54:42,70,4433,22,48,3243.66,5501.00,0.00
2024-12-08 16:54:42,71,4433,23,48,3197.98,5501.01,0.00
2024-12-08 16:54:42,70,4433,23,47,3227.96,5501.13,0.00
2024-12-08 16:54:42,69,4433,22,47,3227.19,5501.51,0.00
2024-12-08 16:54:42,70,4432,22,48,3174.84,5501.64,0.00
2024-12-08 16:54:42,70,4433,22,48,3248.75,5502.00,0.00
2024-12-08 16:54:42,71,4433,23,48,3202.99,5502.01,0.00
2024-12-08 16:54:42,71,4434,23,48,3261.06,5503.00,0.00
2024-12-08 16:54:42,72,4434,24,48,3215.77,5503.01,0.00
2024-12-08 16:54:42,71,4434,23,48,3259.51,5503.03,0.00
2024-12-08 16:54:42,70,4434,23,47,3283.32,5503.17,0.00
2024-12-08 16:54:42,69,4434,22,47,3316.27,5503.22,0.00
2024-12-08 16:54:42,70,4433,23,47,3228.24,5503.93,0.00
2024-12-08 16:54:42,70,4434,23,47,3306.16,5504.00,0.00
2024-12-08 16:54:42,71,4434,23,48,3259.59,5504.01,0.00
2024-12-08 16:54:42,71,4435,23,48,3321.20,5505.00,0.00
2024-12-08 16:54:42,72,4435,23,49,3275.08,5505.01,0.00
2024-12-08 16:54:42,71,4435,22,49,3244.00,5505.77,0.00
2024-12-08 16:54:42,71,4436,22,49,3306.89,5506.00,0.00
2024-12-08 16:54:42,72,4436,23,49,3260.96,5506.01,0.00
2024-12-08 16:54:42,71,4436,22,49,3298.39,5506.17,0.00
2024-12-08 16:54:42,70,4436,22,48,3325.84,5506.29,0.00
2024-12-08 16:54:42,70,4437,22,48,3326.94,5507.00,0.00
2024-12-08 16:54:42,71,4437,23,48,3280.08,5507.01,0.00
2024-12-08 16:54:42,70,4437,23,47,3325.37,5507.03,0.00
2024-12-08 16:54:42,69,4437,22,47,3324.16,5507.32,0.00
2024-12-08 16:54:42,69,4438,22,47,3359.40,5508.00,0.00
2024-12-08 16:54:42,70,4438,22,48,3311.41,5508.01,0.00
2024-12-08 16:54:42,69,4438,22,47,3357.81,5508.03,0.00
2024-12-08 16:54:43,70,4437,23,47,3271.31,5508.47,0.00
2024-12-08 16:54:43,70,4438,23,47,3323.36,5509.00,0.00
2024-12-08 16:54:43,71,4438,23,48,3276.55,5509.01,0.00
2024-12-08 16:54:43,70,4438,23,47,3301.39,5509.26,0.00
2024-12-08 16:54:43,70,4439,23,47,3374.17,5510.00,0.00
2024-12-08 16:54:43,71,4439,23,48,3326.64,5510.01,0.00
2024-12-08 16:54:43,71,4440,23,48,3312.21,5511.00,0.00
2024-12-08 16:54:43,72,4440,24,48,3266.21,5511.01,0.00
2024-12-08 16:54:43,71,4440,24,47,3310.66,5511.03,0.00
2024-12-08 16:54:43,71,4441,24,47,3291.28,5512.00,0.00
2024-12-08 16:54:43,72,4441,25,47,3245.57,5512.01,0.00
2024-12-08 16:54:43,72,4442,25,47,3216.47,5513.00,0.00
2024-12-08 16:54:43,73,4442,26,47,3172.41,5513.01,0.00
2024-12-08 16:54:43,72,4442,26,46,3206.56,5513.18,0.00
2024-12-08 16:54:43,71,4442,26,45,3243.97,5513.23,0.00
2024-12-08 16:54:43,71,4443,26,45,3241.94,5514.00,0.00
2024-12-08 16:54:43,72,4443,27,45,3196.91,5514.01,0.00
2024-12-08 16:54:43,71,4443,27,44,3240.39,5514.03,0.00
2024-12-08 16:54:43,71,4444,27,44,3233.48,5515.00,0.00
2024-12-08 16:54:43,72,4444,28,44,3188.57,5515.01,0.00
2024-12-08 16:54:43,71,4444,28,43,3232.71,5515.01,0.00
2024-12-08 16:54:43,70,4444,28,42,3278.10,5515.01,0.00
2024-12-08 16:54:43,69,4444,27,42,3318.46,5515.15,0.00
2024-12-08 16:54:43,69,4445,27,42,3310.97,5516.00,0.00
2024-12-08 16:54:43,70,4445,27,43,3263.67,5516.01,0.00
2024-12-08 16:54:43,69,4445,26,43,3219.35,5516.81,0.00
2024-12-08 16:54:43,69,4446,26,43,3289.05,5517.00,0.00
2024-12-08 16:54:43,70,4446,27,43,3242.06,5517.01,0.00
2024-12-08 16:54:43,69,4446,26,43,3281.10,5517.16,0.00
2024-12-08 16:54:43,69,4447,26,43,3244.97,5518.00,0.00
2024-12-08 16:54:43,70,4447,26,44,3198.61,5518.01,0.00
2024-12-08 16:54:43,69,4447,26,43,3225.78,5518.06,0.00
2024-12-08 16:54:43,68,4447,26,42,3263.93,5518.18,0.00
2024-12-08 16:54:43,68,4448,26,42,3242.54,5519.00,0.00
2024-12-08 16:54:43,69,4448,26,43,3195.55,5519.02,0.00
2024-12-08 16:54:43,68,4448,25,43,3230.70,5519.15,0.00
2024-12-08 16:54:43,67,4448,24,43,3204.79,5519.66,0.00
2024-12-08 16:54:43,67,4449,24,43,3268.13,5520.00,0.00
2024-12-08 16:54:43,68,4449,25,43,3220.07,5520.02,0.00
2024-12-08 16:54:43,67,4449,25,42,3211.67,5520.37,0.00
2024-12-08 16:54:43,67,4450,25,42,3216.35,5521.00,0.00
2024-12-08 16:54:43,68,4450,26,42,3169.05,5521.02,0.00
2024-12-08 16:54:43,69,4449,26,43,3119.14,5521.12,0.00
2024-12-08 16:54:43,68,4449,26,42,3208.05,5521.21,0.00
2024-12-08 16:54:43,68,4450,26,42,3194.38,5522.00,0.00
2024-12-08 16:54:43,69,4450,27,42,3148.08,5522.02,0.00
2024-12-08 16:54:43,68,4450,27,41,3155.41,5522.27,0.00
2024-12-08 16:54:43,68,4451,27,41,3246.08,5523.00,0.00
2024-12-08 16:54:43,69,4451,27,42,3199.03,5523.02,0.00
2024-12-08 16:54:43,68,4451,27,41,3199.58,5523.49,0.00
2024-12-08 16:54:43,68,4452,27,41,3211.39,5524.00,0.00
2024-12-08 16:54:43,69,4452,27,42,3164.85,5524.02,0.00
2024-12-08 16:54:43,68,4452,27,41,3209.32,5524.04,0.00
2024-12-08 16:54:43,67,4452,27,40,3237.06,5524.22,0.00
2024-12-08 16:54:43,67,4453,27,40,3232.05,5525.00,0.00
2024-12-08 16:54:43,68,4453,27,41,3184.52,5525.02,0.00
2024-12-08 16:54:43,68,4454,27,41,3156.52,5526.00,0.00
2024-12-08 16:54:43,69,4454,27,42,3110.77,5526.02,0.00
2024-12-08 16:54:43,68,4454,27,41,3155.70,5526.02,0.00
2024-12-08 16:54:43,67,4454,27,40,3199.24,5526.03,0.00
2024-12-08 16:54:43,67,4455,27,40,3168.39,5527.00,0.00
2024-12-08 16:54:43,68,4455,28,40,3121.80,5527.02,0.00
2024-12-08 16:54:43,67,4455,28,39,3145.94,5527.24,0.00
2024-12-08 16:54:43,66,4455,27,39,3156.22,5527.58,0.00
2024-12-08 16:54:43,66,4456,27,39,3215.11,5528.00,0.00
2024-12-08 16:54:43,67,4456,27,40,3167.12,5528.02,0.00
2024-12-08 16:54:43,66,4456,26,40,3152.10,5528.44,0.00
2024-12-08 16:54:43,66,4457,26,40,3202.16,5529.00,0.00
2024-12-08 16:54:43,67,4457,27,40,3154.37,5529.02,0.00
2024-12-08 16:54:43,66,4457,27,39,3133.89,5529.42,0.00
2024-12-08 16:54:43,65,4457,26,39,3168.20,5529.65,0.00
2024-12-08 16:54:43,65,4458,26,39,3230.38,5530.00,0.00
2024-12-08 16:54:43,66,4458,26,40,3181.44,5530.02,0.00
2024-12-08 16:54:43,65,4458,25,40,3222.78,5530.15,0.00
2024-12-08 16:54:43,65,4459,25,40,3201.58,5531.00,0.00
2024-12-08 16:54:43,66,4459,26,40,3153.07,5531.02,0.00
2024-12-08 16:54:43,65,4459,26,39,3180.39,5531.23,0.00
2024-12-08 16:54:43,64,4459,25,39,3199.22,5531.69,0.00
2024-12-08 16:54:43,63,4459,24,39,3236.14,5531.87,0.00
2024-12-08 16:54:43,63,4460,24,39,3281.44,5532.00,0.00
2024-12-08 16:54:43,64,4460,25,39,3230.17,5532.02,0.00
2024-12-08 16:54:43,64,4461,25,39,3217.38,5533.00,0.00
2024-12-08 16:54:43,65,4461,25,40,3167.89,5533.02,0.00
2024-12-08 16:54:43,65,4462,25,40,3141.03,5534.00,0.00
2024-12-08 16:54:43,66,4462,25,41,3093.44,5534.02,0.00
2024-12-08 16:54:43,65,4462,25,40,3120.68,5534.25,0.00
2024-12-08 16:54:43,65,4463,25,40,3121.65,5535.00,0.00
2024-12-08 16:54:43,66,4463,26,40,3074.35,5535.02,0.00
2024-12-08 16:54:44,66,4464,26,40,3052.12,5536.00,0.00
2024-12-08 16:54:44,67,4464,26,41,3006.56,5536.02,0.00
2024-12-08 16:54:44,66,4464,26,40,3014.90,5536.32,0.00
2024-12-08 16:54:44,66,4465,26,40,3019.37,5537.00,0.00
2024-12-08 16:54:44,67,4465,27,40,2974.30,5537.02,0.00
2024-12-08 16:54:44,66,4465,27,39,2999.59,5537.24,0.00
2024-12-08 16:54:44,66,4466,27,39,3000.32,5538.00,0.00
2024-12-08 16:54:44,67,4466,28,39,2955.54,5538.02,0.00
2024-12-08 16:54:44,66,4466,27,39,2940.84,5538.74,0.00
2024-12-08 16:54:44,65,4466,26,39,2957.74,5538.97,0.00
2024-12-08 16:54:44,65,4467,26,39,3041.27,5539.00,0.00
2024-12-08 16:54:44,66,4467,27,39,2995.19,5539.02,0.00
2024-12-08 16:54:44,65,4467,26,39,3029.84,5539.17,0.00
2024-12-08 16:54:44,64,4467,26,38,3056.49,5539.23,0.00
2024-12-08 16:54:44,64,4468,26,38,3066.49,5540.00,0.00
2024-12-08 16:54:44,65,4468,26,39,3019.31,5540.02,0.00
2024-12-08 16:54:44,64,4468,26,38,3049.61,5540.14,0.00
2024-12-08 16:54:44,65,4467,26,39,2941.56,5540.66,0.00
2024-12-08 16:54:44,65,4468,26,39,3025.11,5541.00,0.00
2024-12-08 16:54:44,66,4468,27,39,2979.27,5541.02,0.00
2024-12-08 16:54:44,65,4468,26,39,3001.34,5541.26,0.00
2024-12-08 16:54:44,65,4469,26,39,3104.38,5542.00,0.00
2024-12-08 16:54:44,66,4469,27,39,3057.35,5542.02,0.00
2024-12-08 16:54:44,66,4470,27,39,3025.41,5543.00,0.00
2024-12-08 16:54:44,67,4470,28,39,2980.25,5543.02,0.00
2024-12-08 16:54:44,66,4470,27,39,3017.84,5543.11,0.00
2024-12-08 16:54:44,65,4470,27,38,3050.67,5543.25,0.00
2024-12-08 16:54:44,65,4471,27,38,3053.43,5544.00,0.00
2024-12-08 16:54:44,66,4471,27,39,3007.17,5544.02,0.00
2024-12-08 16:54:44,65,4471,26,39,3035.53,5544.03,0.00
2024-12-08 16:54:44,65,4472,26,39,3043.55,5545.00,0.00
2024-12-08 16:54:44,66,4472,27,39,2997.43,5545.02,0.00
2024-12-08 16:54:44,65,4472,26,39,2999.54,5545.28,0.00
2024-12-08 16:54:44,65,4473,26,39,3032.47,5546.00,0.00
2024-12-08 16:54:44,66,4473,26,40,2986.52,5546.02,0.00
2024-12-08 16:54:44,66,4474,26,40,2936.93,5547.00,0.00
2024-12-08 16:54:44,67,4474,27,40,2893.09,5547.02,0.00
2024-12-08 16:54:44,68,4473,28,40,2849.74,5547.06,0.00
2024-12-08 16:54:44,67,4473,28,39,2890.61,5547.27,0.00
2024-12-08 16:54:44,67,4474,28,39,2873.01,5548.00,0.00
2024-12-08 16:54:44,68,4474,28,40,2830.76,5548.02,0.00
2024-12-08 16:54:44,68,4475,28,40,2885.17,5549.00,0.00
2024-12-08 16:54:44,69,4475,29,40,2843.36,5549.02,0.00
2024-12-08 16:54:44,68,4475,29,39,2844.88,5549.37,0.00
2024-12-08 16:54:44,68,4476,29,39,2856.10,5550.00,0.00
2024-12-08 16:54:44,69,4476,29,40,2814.71,5550.02,0.00
2024-12-08 16:54:44,68,4476,29,39,2855.28,5550.02,0.00
2024-12-08 16:54:44,67,4476,29,38,2896.26,5550.03,0.00
2024-12-08 16:54:44,67,4477,29,38,2887.38,5551.00,0.00
2024-12-08 16:54:44,68,4477,29,39,2844.91,5551.02,0.00
2024-12-08 16:54:44,67,4477,29,38,2869.16,5551.03,0.00
2024-12-08 16:54:44,66,4477,28,38,2871.22,5551.67,0.00
2024-12-08 16:54:44,66,4478,28,38,2927.79,5552.00,0.00
2024-12-08 16:54:44,67,4478,28,39,2884.09,5552.02,0.00
2024-12-08 16:54:44,66,4478,28,38,2872.22,5552.62,0.00
2024-12-08 16:54:44,65,4478,27,38,2912.19,5552.69,0.00
2024-12-08 16:54:44,65,4479,27,38,2971.28,5553.00,0.00
2024-12-08 16:54:44,66,4479,27,39,2926.26,5553.02,0.00
2024-12-08 16:54:44,65,4479,26,39,2933.48,5553.39,0.00
2024-12-08 16:54:44,64,4479,25,39,2938.02,5553.92,0.00
2024-12-08 16:54:44,64,4480,25,39,3020.51,5554.00,0.00
2024-12-08 16:54:44,65,4480,25,40,2974.04,5554.02,0.00
2024-12-08 16:54:44,65,4481,25,40,2957.23,5555.00,0.00
2024-12-08 16:54:44,66,4481,26,40,2912.42,5555.02,0.00
2024-12-08 16:54:44,65,4481,26,39,2946.12,5555.02,0.00
2024-12-08 16:54:44,64,4481,25,39,2921.34,5555.92,0.00
2024-12-08 16:54:44,64,4482,25,39,3003.87,5556.00,0.00
2024-12-08 16:54:44,65,4482,25,40,2957.66,5556.02,0.00
2024-12-08 16:54:44,64,4482,24,40,2927.01,5556.86,0.00
2024-12-08 16:54:44,64,4483,24,40,3006.14,5557.00,0.00
2024-12-08 16:54:44,65,4483,25,40,2959.89,5557.02,0.00
2024-12-08 16:54:44,64,4483,25,39,2978.39,5557.20,0.00
2024-12-08 16:54:44,63,4483,24,39,2989.50,5557.21,0.00
2024-12-08 16:54:44,63,4484,24,39,3031.30,5558.00,0.00
2024-12-08 16:54:44,64,4484,24,40,2983.93,5558.02,0.00
2024-12-08 16:54:44,63,4484,23,40,2974.70,5558.41,0.00
2024-12-08 16:54:44,63,4485,23,40,3028.88,5559.00,0.00
2024-12-08 16:54:44,64,4485,24,40,2981.56,5559.02,0.00
2024-12-08 16:54:44,64,4486,24,40,2954.73,5560.00,0.00
2024-12-08 16:54:44,65,4486,24,41,2909.27,5560.02,0.00
2024-12-08 16:54:44,64,4486,24,40,2940.85,5560.20,0.00
2024-12-08 16:54:44,63,4486,24,39,2981.25,5560.29,0.00
2024-12-08 16:54:44,64,4485,24,40,2929.49,5560.41,0.00
2024-12-08 16:54:44,65,4484,25,40,2896.45,5560.51,0.00
2024-12-08 16:54:44,65,4485,25,40,2949.56,5561.00,0.00
2024-12-08 16:54:44,66,4485,26,40,2904.87,5561.02,0.00
2024-12-08 16:54:44,65,4485,25,40,2942.54,5561.14,0.00
2024-12-08 16:54:44,64,4485,24,40,2988.27,5561.14,0.00
2024-12-08 16:54:45,64,4486,24,40,3153.20,5562.00,0.00
2024-12-08 16:54:45,65,4486,24,41,3104.69,5562.02,0.00
2024-12-08 16:54:45,64,4486,24,40,3128.89,5562.17,0.00
2024-12-08 16:54:45,64,4487,24,40,3131.15,5563.00,0.00
2024-12-08 16:54:45,65,4487,24,41,3082.98,5563.02,0.00
2024-12-08 16:54:45,65,4488,24,41,3068.34,5564.00,0.00
2024-12-08 16:54:45,66,4488,25,41,3021.85,5564.02,0.00
2024-12-08 16:54:45,65,4488,25,40,3043.54,5564.19,0.00
2024-12-08 16:54:45,64,4488,24,40,3040.52,5564.52,0.00
2024-12-08 16:54:45,65,4487,24,41,2973.40,5564.88,0.00
2024-12-08 16:54:45,65,4488,24,41,3057.41,5565.00,0.00
2024-12-08 16:54:45,66,4488,24,42,3011.09,5565.02,0.00
2024-12-08 16:54:45,65,4488,23,42,3043.92,5565.22,0.00
2024-12-08 16:54:45,66,4487,24,42,2950.27,5565.79,0.00
2024-12-08 16:54:45,66,4488,24,42,3116.58,5566.00,0.00
2024-12-08 16:54:45,67,4488,24,43,3070.06,5566.02,0.00
2024-12-08 16:54:45,66,4488,24,42,3114.89,5566.03,0.00
2024-12-08 16:54:45,65,4488,23,42,3098.78,5566.35,0.00
2024-12-08 16:54:45,65,4489,23,42,3233.89,5567.00,0.00
2024-12-08 16:54:45,66,4489,24,42,3184.89,5567.02,0.00
2024-12-08 16:54:45,66,4490,24,42,3173.55,5568.00,0.00
2024-12-08 16:54:45,67,4490,24,43,3126.19,5568.02,0.00
2024-12-08 16:54:45,66,4490,24,42,3165.72,5568.14,0.00
2024-12-08 16:54:45,65,4490,24,41,3211.02,5568.19,0.00
2024-12-08 16:54:45,64,4490,23,41,3219.58,5568.28,0.00
2024-12-08 16:54:45,64,4491,23,41,3266.11,5569.00,0.00
2024-12-08 16:54:45,65,4491,23,42,3215.87,5569.02,0.00
2024-12-08 16:54:45,64,4491,23,41,3253.96,5569.20,0.00
2024-12-08 16:54:45,65,4490,23,42,3176.43,5569.71,0.00
2024-12-08 16:54:45,65,4491,23,42,3214.39,5570.00,0.00
2024-12-08 16:54:45,66,4491,24,42,3165.69,5570.02,0.00
2024-12-08 16:54:45,67,4490,25,42,3118.44,5570.05,0.00
2024-12-08 16:54:45,66,4490,25,41,3240.16,5570.14,0.00
2024-12-08 16:54:45,65,4490,24,41,3283.26,5570.20,0.00
2024-12-08 16:54:45,65,4491,24,41,3392.26,5571.00,0.00
2024-12-08 16:54:45,66,4491,24,42,3340.87,5571.02,0.00
2024-12-08 16:54:45,66,4492,24,42,3401.66,5572.00,0.00
2024-12-08 16:54:45,67,4492,24,43,3350.89,5572.02,0.00
2024-12-08 16:54:45,66,4492,24,42,3399.99,5572.03,0.00
2024-12-08 16:54:45,65,4492,24,41,3438.62,5572.20,0.00
2024-12-08 16:54:45,65,4493,24,41,3396.25,5573.00,0.00
2024-12-08 16:54:45,66,4493,24,42,3344.79,5573.02,0.00
2024-12-08 16:54:45,65,4493,24,41,3326.31,5573.58,0.00
2024-12-08 16:54:45,65,4494,24,41,3380.26,5574.00,0.00
2024-12-08 16:54:45,66,4494,25,41,3329.04,5574.02,0.00
2024-12-08 16:54:45,67,4493,25,42,3279.35,5574.05,0.00
2024-12-08 16:54:45,66,4493,24,42,3288.47,5574.49,0.00
2024-12-08 16:54:45,66,4494,24,42,3330.08,5575.00,0.00
2024-12-08 16:54:45,67,4494,25,42,3280.38,5575.02,0.00
2024-12-08 16:54:45,67,4495,25,42,3350.61,5576.00,0.00
2024-12-08 16:54:45,68,4495,26,42,3301.34,5576.02,0.00
2024-12-08 16:54:45,67,4495,26,41,3348.96,5576.03,0.00
2024-12-08 16:54:45,67,4496,26,41,3327.96,5577.00,0.00
2024-12-08 16:54:45,68,4496,26,42,3279.02,5577.02,0.00
2024-12-08 16:54:45,67,4496,26,41,3326.31,5577.03,0.00
2024-12-08 16:54:45,66,4496,26,40,3364.08,5577.20,0.00
2024-12-08 16:54:45,66,4497,26,40,3369.58,5578.00,0.00
2024-12-08 16:54:45,67,4497,26,41,3319.28,5578.02,0.00
2024-12-08 16:54:45,66,4497,25,41,3367.90,5578.03,0.00
2024-12-08 16:54:45,66,4498,25,41,3359.16,5579.00,0.00
2024-12-08 16:54:45,67,4498,26,41,3309.03,5579.02,0.00
2024-12-08 16:54:45,67,4499,26,41,3286.90,5580.00,0.00
2024-12-08 16:54:45,68,4499,26,42,3238.56,5580.02,0.00
2024-12-08 16:54:45,67,4499,26,41,3285.25,5580.03,0.00
2024-12-08 16:54:45,66,4499,26,40,3315.15,5580.23,0.00
2024-12-08 16:54:45,66,4500,26,40,3322.25,5581.00,0.00
2024-12-08 16:54:45,67,4500,26,41,3272.66,5581.02,0.00
2024-12-08 16:54:45,67,4501,26,41,3259.35,5582.00,0.00
2024-12-08 16:54:45,68,4501,27,41,3211.42,5582.02,0.00
2024-12-08 16:54:45,67,4501,26,41,3158.67,5582.97,0.00
2024-12-08 16:54:45,67,4502,26,41,3240.35,5583.00,0.00
2024-12-08 16:54:45,68,4502,27,41,3192.70,5583.02,0.00
2024-12-08 16:54:45,67,4502,27,40,3219.40,5583.22,0.00
2024-12-08 16:54:45,67,4503,27,40,3224.00,5584.00,0.00
2024-12-08 16:54:45,68,4503,28,40,3176.59,5584.02,0.00
2024-12-08 16:54:45,67,4503,28,39,3222.35,5584.03,0.00
2024-12-08 16:54:45,66,4503,27,39,3225.94,5584.27,0.00
2024-12-08 16:54:45,66,4504,27,39,3267.39,5585.00,0.00
2024-12-08 16:54:45,67,4504,27,40,3218.62,5585.02,0.00
2024-12-08 16:54:45,67,4505,27,40,3193.79,5586.00,0.00
2024-12-08 16:54:45,68,4505,27,41,3146.83,5586.02,0.00
2024-12-08 16:54:45,67,4505,27,40,3170.63,5586.24,0.00
2024-12-08 16:54:45,67,4506,27,40,3175.87,5587.00,0.00
2024-12-08 16:54:45,68,4506,28,40,3129.16,5587.02,0.00
2024-12-08 16:54:45,68,4507,28,40,3117.80,5588.00,0.00
2024-12-08 16:54:46,69,4507,29,40,3072.62,5588.02,0.00
2024-12-08 16:54:46,69,4508,29,40,3047.34,5589.00,0.00
2024-12-08 16:54:46,70,4508,30,40,3003.81,5589.01,0.00
2024-12-08 16:54:46,69,4508,30,39,3023.20,5589.28,0.00
2024-12-08 16:54:46,68,4508,30,38,3065.91,5589.31,0.00
2024-12-08 16:54:46,68,4509,30,38,3072.76,5590.00,0.00
2024-12-08 16:54:46,69,4509,31,38,3028.23,5590.02,0.00
2024-12-08 16:54:46,68,4509,30,38,2999.53,5590.71,0.00
2024-12-08 16:54:46,67,4509,29,38,2995.74,5590.82,0.00
2024-12-08 16:54:46,67,4510,29,38,3067.11,5591.00,0.00
2024-12-08 16:54:46,68,4510,29,39,3022.01,5591.02,0.00
2024-12-08 16:54:46,68,4511,29,39,2995.80,5592.00,0.00
2024-12-08 16:54:46,69,4511,30,39,2952.38,5592.02,0.00
2024-12-08 16:54:46,68,4511,30,38,2961.97,5592.31,0.00
2024-12-08 16:54:46,68,4512,30,38,2965.21,5593.00,0.00
2024-12-08 16:54:46,69,4512,31,38,2922.23,5593.02,0.00
2024-12-08 16:54:46,68,4512,31,37,2957.82,5593.03,0.00
2024-12-08 16:54:46,69,4511,32,37,2837.32,5593.55,0.00
2024-12-08 16:54:46,69,4512,32,37,2913.06,5594.00,0.00
2024-12-08 16:54:46,70,4512,32,38,2871.44,5594.01,0.00
2024-12-08 16:54:46,69,4512,32,37,2902.38,5594.13,0.00
2024-12-08 16:54:46,69,4513,32,37,2945.14,5595.00,0.00
2024-12-08 16:54:46,70,4513,32,38,2903.07,5595.01,0.00
2024-12-08 16:54:46,69,4513,31,38,2937.51,5595.09,0.00
2024-12-08 16:54:46,68,4513,30,38,2939.37,5595.25,0.00
2024-12-08 16:54:46,67,4513,29,38,2926.47,5595.46,0.00
2024-12-08 16:54:46,67,4514,29,38,2975.43,5596.00,0.00
2024-12-08 16:54:46,68,4514,30,38,2931.67,5596.02,0.00
2024-12-08 16:54:46,67,4514,30,37,2949.55,5596.27,0.00
2024-12-08 16:54:46,66,4514,29,37,2932.56,5596.71,0.00
2024-12-08 16:54:46,66,4515,29,37,2996.03,5597.00,0.00
2024-12-08 16:54:46,67,4515,30,37,2951.31,5597.02,0.00
2024-12-08 16:54:46,66,4515,29,37,2985.46,5597.20,0.00
2024-12-08 16:54:46,65,4515,29,36,3011.63,5597.28,0.00
2024-12-08 16:54:46,65,4516,29,36,3017.77,5598.00,0.00
2024-12-08 16:54:46,66,4516,29,37,2972.05,5598.02,0.00
2024-12-08 16:54:46,66,4517,29,37,2966.47,5599.00,0.00
2024-12-08 16:54:46,67,4517,30,37,2922.19,5599.02,0.00
2024-12-08 16:54:46,66,4517,29,37,2951.95,5599.20,0.00
2024-12-08 16:54:46,65,4517,28,37,2966.38,5599.45,0.00
2024-12-08 16:54:46,64,4517,27,37,2966.53,5599.83,0.00
2024-12-08 16:54:46,64,4518,27,37,3044.53,5600.00,0.00
2024-12-08 16:54:46,65,4518,27,38,2997.69,5600.02,0.00
2024-12-08 16:54:46,65,4519,27,38,2974.56,5601.00,0.00
2024-12-08 16:54:46,66,4519,27,39,2929.49,5601.02,0.00
2024-12-08 16:54:46,65,4519,27,38,2964.79,5601.14,0.00
2024-12-08 16:54:46,64,4519,27,37,2997.14,5601.25,0.00
2024-12-08 16:54:46,63,4519,26,37,3016.67,5601.75,0.00
2024-12-08 16:54:46,63,4520,26,37,3055.98,5602.00,0.00
2024-12-08 16:54:46,64,4520,27,37,3008.23,5602.02,0.00
2024-12-08 16:54:46,63,4520,26,37,3054.22,5602.03,0.00
2024-12-08 16:54:46,63,4521,26,37,3053.40,5603.00,0.00
2024-12-08 16:54:46,64,4521,27,37,3005.69,5603.02,0.00
2024-12-08 16:54:46,63,4521,26,37,3051.63,5603.03,0.00
2024-12-08 16:54:46,62,4521,25,37,3092.69,5603.18,0.00
2024-12-08 16:54:46,62,4522,25,37,3086.91,5604.00,0.00
2024-12-08 16:54:46,63,4522,25,38,3037.91,5604.02,0.00
2024-12-08 16:54:46,62,4522,25,37,3081.51,5604.10,0.00
2024-12-08 16:54:46,61,4522,25,36,3116.43,5604.20,0.00
2024-12-08 16:54:46,61,4523,25,36,3125.30,5605.00,0.00
2024-12-08 16:54:46,62,4523,26,36,3074.89,5605.02,0.00
2024-12-08 16:54:46,61,4523,25,36,3068.76,5605.31,0.00
2024-12-08 16:54:46,62,4522,25,37,3007.64,5605.55,0.00
2024-12-08 16:54:46,62,4523,25,37,3099.44,5606.00,0.00
2024-12-08 16:54:46,63,4523,26,37,3050.24,5606.02,0.00
2024-12-08 16:54:46,63,4524,26,37,3121.45,5607.00,0.00
2024-12-08 16:54:46,64,4524,26,38,3072.68,5607.02,0.00
2024-12-08 16:54:46,63,4524,25,38,3112.77,5607.16,0.00
2024-12-08 16:54:46,62,4524,25,37,3152.14,5607.19,0.00
2024-12-08 16:54:46,62,4525,25,37,3158.77,5608.00,0.00
2024-12-08 16:54:46,63,4525,26,37,3108.63,5608.02,0.00
2024-12-08 16:54:46,62,4525,25,37,3102.82,5608.37,0.00
2024-12-08 16:54:46,62,4526,25,37,3155.62,5609.00,0.00
2024-12-08 16:54:46,63,4526,25,38,3105.53,5609.02,0.00
2024-12-08 16:54:46,62,4526,25,37,3153.82,5609.03,0.00
2024-12-08 16:54:46,62,4527,25,37,3135.74,5610.00,0.00
2024-12-08 16:54:46,63,4527,26,37,3085.97,5610.02,0.00
2024-12-08 16:54:46,62,4527,26,36,3117.69,5610.19,0.00
2024-12-08 16:54:46,63,4526,27,36,3055.85,5610.44,0.00
2024-12-08 16:54:46,63,4527,27,36,3082.65,5611.00,0.00
2024-12-08 16:54:46,64,4527,28,36,3034.49,5611.02,0.00
2024-12-08 16:54:46,63,4527,27,36,3064.88,5611.19,0.00
2024-12-08 16:54:46,63,4528,27,36,3125.75,5612.00,0.00
2024-12-08 16:54:46,64,4528,28,36,3076.91,5612.02,0.00
2024-12-08 16:54:46,63,4528,28,35,3044.53,5612.70,0.00
2024-12-08 16:54:47,64,4527,29,35,2967.09,5612.81,0.00
2024-12-08 16:54:47,64,4528,29,35,3019.98,5613.00,0.00
2024-12-08 16:54:47,65,4528,30,35,2973.52,5613.02,0.00
2024-12-08 16:54:47,64,4528,29,35,3018.23,5613.03,0.00
2024-12-08 16:54:47,63,4528,29,34,3051.03,5613.18,0.00
2024-12-08 16:54:47,62,4528,28,34,3041.63,5613.71,0.00
2024-12-08 16:54:47,62,4529,28,34,3170.40,5614.00,0.00
2024-12-08 16:54:47,63,4529,29,34,3120.08,5614.02,0.00
2024-12-08 16:54:47,63,4530,29,34,3095.67,5615.00,0.00
2024-12-08 16:54:47,64,4530,29,35,3047.30,5615.02,0.00
2024-12-08 16:54:47,65,4529,30,35,3000.42,5615.05,0.00
2024-12-08 16:54:47,64,4529,30,34,3067.91,5615.19,0.00
2024-12-08 16:54:47,63,4529,29,34,3093.20,5615.56,0.00
2024-12-08 16:54:47,63,4530,29,34,3078.54,5616.00,0.00
2024-12-08 16:54:47,64,4530,29,35,3030.44,5616.02,0.00
2024-12-08 16:54:47,63,4530,29,34,2984.16,5616.67,0.00
2024-12-08 16:54:47,63,4531,29,34,3143.96,5617.00,0.00
2024-12-08 16:54:47,64,4531,29,35,3094.84,5617.02,0.00
2024-12-08 16:54:47,64,4532,29,35,3093.83,5618.00,0.00
2024-12-08 16:54:47,65,4532,30,35,3046.23,5618.02,0.00
2024-12-08 16:54:47,64,4532,30,34,3092.09,5618.03,0.00
2024-12-08 16:54:47,63,4532,29,34,3094.93,5618.54,0.00
2024-12-08 16:54:47,63,4533,29,34,3129.76,5619.00,0.00
2024-12-08 16:54:47,64,4533,29,35,3080.86,5619.02,0.00
2024-12-08 16:54:47,63,4533,29,34,3128.00,5619.03,0.00
2024-12-08 16:54:47,62,4533,29,33,3157.63,5619.16,0.00
2024-12-08 16:54:47,61,4533,28,33,3174.27,5619.57,0.00
2024-12-08 16:54:47,61,4534,28,33,3242.74,5620.00,0.00
2024-12-08 16:54:47,62,4534,29,33,3190.44,5620.02,0.00
2024-12-08 16:54:47,63,4533,29,34,3131.81,5620.19,0.00
2024-12-08 16:54:47,63,4534,29,34,3199.02,5621.00,0.00
2024-12-08 16:54:47,64,4534,30,34,3149.04,5621.02,0.00
2024-12-08 16:54:47,64,4535,30,34,3217.78,5622.00,0.00
2024-12-08 16:54:47,65,4535,30,35,3168.28,5622.02,0.00
2024-12-08 16:54:47,64,4535,30,34,3205.51,5622.09,0.00
2024-12-08 16:54:47,65,4534,31,34,3112.70,5622.86,0.00
2024-12-08 16:54:47,65,4535,31,34,3197.61,5623.00,0.00
2024-12-08 16:54:47,66,4535,32,34,3149.16,5623.02,0.00
2024-12-08 16:54:47,66,4536,32,34,3237.60,5624.00,0.00
2024-12-08 16:54:47,67,4536,32,35,3189.28,5624.02,0.00
2024-12-08 16:54:47,66,4536,31,35,3187.09,5624.55,0.00
2024-12-08 16:54:47,66,4537,31,35,3236.83,5625.00,0.00
2024-12-08 16:54:47,67,4537,32,35,3188.52,5625.02,0.00
2024-12-08 16:54:47,66,4537,31,35,3235.67,5625.03,0.00
2024-12-08 16:54:47,66,4538,31,35,3228.67,5626.00,0.00
2024-12-08 16:54:47,67,4538,32,35,3180.48,5626.02,0.00
2024-12-08 16:54:47,67,4539,32,35,3158.82,5627.00,0.00
2024-12-08 16:54:47,68,4539,33,35,3112.37,5627.02,0.00
2024-12-08 16:54:47,67,4539,33,34,3141.21,5627.12,0.00
2024-12-08 16:54:47,68,4538,34,34,3085.16,5627.32,0.00
2024-12-08 16:54:47,67,4538,33,34,3131.30,5627.51,0.00
2024-12-08 16:54:47,67,4539,33,34,3154.33,5628.00,0.00
2024-12-08 16:54:47,68,4539,33,35,3107.94,5628.02,0.00
2024-12-08 16:54:47,68,4540,33,35,3170.84,5629.00,0.00
2024-12-08 16:54:47,69,4540,33,36,3124.89,5629.02,0.00
2024-12-08 16:54:47,68,4540,33,35,3146.05,5629.16,0.00
2024-12-08 16:54:47,67,4540,32,35,3143.58,5629.69,0.00
2024-12-08 16:54:47,67,4541,32,35,3210.22,5630.00,0.00
2024-12-08 16:54:47,68,4541,33,35,3163.01,5630.02,0.00
2024-12-08 16:54:47,68,4542,33,35,3140.06,5631.00,0.00
2024-12-08 16:54:47,69,4542,34,35,3094.55,5631.02,0.00
2024-12-08 16:54:47,68,4542,34,34,3116.08,5631.16,0.00
2024-12-08 16:54:47,67,4542,33,34,3141.92,5631.39,0.00
2024-12-08 16:54:47,66,4542,32,34,3184.26,5631.49,0.00
2024-12-08 16:54:47,65,4542,31,34,3227.98,5631.58,0.00
2024-12-08 16:54:47,64,4542,30,34,3262.63,5631.64,0.00
2024-12-08 16:54:47,64,4543,30,34,3330.69,5632.00,0.00
2024-12-08 16:54:47,65,4543,31,34,3279.44,5632.02,0.00
2024-12-08 16:54:47,64,4543,30,34,3291.32,5632.25,0.00
2024-12-08 16:54:47,64,4544,30,34,3334.60,5633.00,0.00
2024-12-08 16:54:47,65,4544,31,34,3283.30,5633.02,0.00
2024-12-08 16:54:47,64,4544,31,33,3332.86,5633.03,0.00
2024-12-08 16:54:47,63,4544,31,32,3363.43,5633.16,0.00
2024-12-08 16:54:47,63,4545,31,32,3367.63,5634.00,0.00
2024-12-08 16:54:47,64,4545,31,33,3315.02,5634.02,0.00
2024-12-08 16:54:47,63,4545,31,32,3365.86,5634.03,0.00
2024-12-08 16:54:47,64,4544,32,32,3260.87,5634.66,0.00
2024-12-08 16:54:47,64,4545,32,32,3315.41,5635.00,0.00
2024-12-08 16:54:47,65,4545,32,33,3264.41,5635.02,0.00
2024-12-08 16:54:47,64,4545,31,33,3313.19,5635.05,0.00
2024-12-08 16:54:47,63,4545,31,32,3345.24,5635.14,0.00
2024-12-08 16:54:47,63,4546,31,32,3440.12,5636.00,0.00
2024-12-08 16:54:47,64,4546,31,33,3386.37,5636.02,0.00
2024-12-08 16:54:47,64,4547,31,33,3389.72,5637.00,0.00
2024-12-08 16:54:47,65,4547,31,34,3337.57,5637.02,0.00
2024-12-08 16:54:47,65,4548,31,34,3330.27,5638.00,0.00
2024-12-08 16:54:47,66,4548,31,35,3279.81,5638.02,0.00
2024-12-08 16:54:47,67,4547,32,35,3206.49,5638.18,0.00
2024-12-08 16:54:48,67,4548,32,35,3238.59,5639.00,0.00
2024-12-08 16:54:48,68,4548,32,36,3190.96,5639.02,0.00
2024-12-08 16:54:48,67,4548,32,35,3221.79,5639.13,0.00
2024-12-08 16:54:48,66,4548,31,35,3245.69,5639.53,0.00
2024-12-08 16:54:48,66,4549,31,35,3389.33,5640.00,0.00
2024-12-08 16:54:48,67,4549,31,36,3338.74,5640.02,0.00
2024-12-08 16:54:48,66,4549,31,35,3387.63,5640.03,0.00
2024-12-08 16:54:48,67,4548,32,35,3296.00,5640.49,0.00
2024-12-08 16:54:48,67,4549,32,35,3319.90,5641.00,0.00
2024-12-08 16:54:48,68,4549,32,36,3271.08,5641.02,0.00
2024-12-08 16:54:48,67,4549,31,36,3253.75,5641.49,0.00
2024-12-08 16:54:48,67,4550,31,36,3380.43,5642.00,0.00
2024-12-08 16:54:48,68,4550,31,37,3330.72,5642.02,0.00
2024-12-08 16:54:48,68,4551,31,37,3314.74,5643.00,0.00
2024-12-08 16:54:48,69,4551,31,38,3266.70,5643.02,0.00
2024-12-08 16:54:48,68,4551,30,38,3287.42,5643.21,0.00
2024-12-08 16:54:48,68,4552,30,38,3286.06,5644.00,0.00
2024-12-08 16:54:48,69,4552,31,38,3238.44,5644.02,0.00
2024-12-08 16:54:48,70,4551,31,39,3192.17,5644.04,0.00
2024-12-08 16:54:48,69,4551,31,38,3244.19,5644.13,0.00
2024-12-08 16:54:48,68,4551,30,38,3219.36,5644.91,0.00
2024-12-08 16:54:48,68,4552,30,38,3297.47,5645.00,0.00
2024-12-08 16:54:48,69,4552,30,39,3249.68,5645.02,0.00
2024-12-08 16:54:48,68,4552,29,39,3238.39,5645.19,0.00
2024-12-08 16:54:48,68,4553,29,39,3344.04,5646.00,0.00
2024-12-08 16:54:48,69,4553,30,39,3295.58,5646.02,0.00
2024-12-08 16:54:48,68,4553,30,38,3299.05,5646.12,0.00
2024-12-08 16:54:48,69,4552,30,39,3197.51,5646.81,0.00
2024-12-08 16:54:48,69,4553,30,39,3277.89,5647.00,0.00
2024-12-08 16:54:48,70,4553,31,39,3231.06,5647.01,0.00
2024-12-08 16:54:48,70,4554,31,39,3297.66,5648.00,0.00
2024-12-08 16:54:48,71,4554,32,39,3251.21,5648.01,0.00
2024-12-08 16:54:48,70,4554,31,39,3258.97,5648.40,0.00
2024-12-08 16:54:48,70,4555,31,39,3279.96,5649.00,0.00
2024-12-08 16:54:48,71,4555,32,39,3233.76,5649.01,0.00
2024-12-08 16:54:48,71,4556,32,39,3205.20,5650.00,0.00
2024-12-08 16:54:48,72,4556,33,39,3160.68,5650.01,0.00
2024-12-08 16:54:48,71,4556,33,38,3185.32,5650.11,0.00
2024-12-08 16:54:48,71,4557,33,38,3173.27,5651.00,0.00
2024-12-08 16:54:48,72,4557,33,39,3129.20,5651.01,0.00
2024-12-08 16:54:48,71,4557,32,39,3167.99,5651.10,0.00
2024-12-08 16:54:48,72,4556,33,39,3120.86,5651.18,0.00
2024-12-08 16:54:48,72,4557,33,39,3155.39,5652.00,0.00
2024-12-08 16:54:48,73,4557,33,40,3112.16,5652.01,0.00
2024-12-08 16:54:48,72,4557,33,39,3142.04,5652.06,0.00
2024-12-08 16:54:48,72,4558,33,39,3201.14,5653.00,0.00
2024-12-08 16:54:48,73,4558,34,39,3157.29,5653.01,0.00
2024-12-08 16:54:48,72,4558,34,38,3187.01,5653.07,0.00
2024-12-08 16:54:48,73,4557,35,38,3096.93,5653.77,0.00
2024-12-08 16:54:48,73,4558,35,38,3134.75,5654.00,0.00
2024-12-08 16:54:48,74,4558,35,39,3092.39,5654.01,0.00
2024-12-08 16:54:48,73,4558,34,39,3037.17,5654.96,0.00
2024-12-08 16:54:48,73,4559,34,39,3189.79,5655.00,0.00
2024-12-08 16:54:48,74,4559,35,39,3146.69,5655.01,0.00
2024-12-08 16:54:48,73,4559,35,38,3179.18,5655.11,0.00
2024-12-08 16:54:48,73,4560,35,38,3160.24,5656.00,0.00
2024-12-08 16:54:48,74,4560,36,38,3117.54,5656.01,0.00
2024-12-08 16:54:48,73,4560,35,38,3159.08,5656.03,0.00
2024-12-08 16:54:48,72,4560,35,37,3166.35,5656.32,0.00
2024-12-08 16:54:48,73,4559,35,38,3107.45,5656.62,0.00
2024-12-08 16:54:48,73,4560,35,38,3196.65,5657.00,0.00
2024-12-08 16:54:48,74,4560,35,39,3153.45,5657.01,0.00
2024-12-08 16:54:48,73,4560,34,39,3144.42,5657.58,0.00
2024-12-08 16:54:48,73,4561,34,39,3257.57,5658.00,0.00
2024-12-08 16:54:48,74,4561,35,39,3213.55,5658.01,0.00
2024-12-08 16:54:48,74,4562,35,39,3190.88,5659.00,0.00
2024-12-08 16:54:48,75,4562,36,39,3148.33,5659.01,0.00
2024-12-08 16:54:48,75,4563,36,39,3116.44,5660.00,0.00
2024-12-08 16:54:48,76,4563,36,40,3075.44,5660.01,0.00
2024-12-08 16:54:48,75,4563,36,39,3102.87,5660.09,0.00
2024-12-08 16:54:48,75,4564,36,39,3088.80,5661.00,0.00
2024-12-08 16:54:48,76,4564,37,39,3048.16,5661.01,0.00
2024-12-08 16:54:48,77,4563,38,39,3008.57,5661.04,0.00
2024-12-08 16:54:48,76,4563,38,38,3107.06,5661.11,0.00
2024-12-08 16:54:48,75,4563,37,38,3145.64,5661.11,0.00
2024-12-08 16:54:48,74,4563,36,38,3177.17,5661.27,0.00
2024-12-08 16:54:48,74,4564,36,38,3207.94,5662.00,0.00
2024-12-08 16:54:48,75,4564,37,38,3165.16,5662.01,0.00
2024-12-08 16:54:48,74,4564,37,37,3206.42,5662.03,0.00
2024-12-08 16:54:48,73,4564,36,37,3247.24,5662.03,0.00
2024-12-08 16:54:48,73,4565,36,37,3328.44,5663.00,0.00
2024-12-08 16:54:48,74,4565,36,38,3283.46,5663.01,0.00
2024-12-08 16:54:48,73,4565,36,37,3309.85,5663.10,0.00
2024-12-08 16:54:48,73,4566,36,37,3301.98,5664.00,0.00
2024-12-08 16:54:48,74,4566,36,38,3257.36,5664.01,0.00
2024-12-08 16:54:48,73,4566,35,38,3281.07,5664.11,0.00
2024-12-08 16:54:48,72,4566,35,37,3270.85,5664.72,0.00
2024-12-08 16:54:49,72,4567,35,37,3333.88,5665.00,0.00
2024-12-08 16:54:49,73,4567,35,38,3288.21,5665.01,0.00
2024-12-08 16:54:49,72,4567,35,37,3332.68,5665.03,0.00
2024-12-08 16:54:49,73,4566,36,37,3196.84,5665.82,0.00
2024-12-08 16:54:49,73,4567,36,37,3272.59,5666.00,0.00
2024-12-08 16:54:49,74,4567,37,37,3228.36,5666.01,0.00
2024-12-08 16:54:49,73,4567,37,36,3263.30,5666.08,0.00
2024-12-08 16:54:49,72,4567,36,36,3266.53,5666.64,0.00
2024-12-08 16:54:49,72,4568,36,36,3402.95,5667.00,0.00
2024-12-08 16:54:49,73,4568,36,37,3356.33,5667.01,0.00
2024-12-08 16:54:49,72,4568,35,37,3380.94,5667.13,0.00
2024-12-08 16:54:49,72,4569,35,37,3381.09,5668.00,0.00
2024-12-08 16:54:49,73,4569,35,38,3334.78,5668.01,0.00
2024-12-08 16:54:49,72,4569,35,37,3363.80,5668.08,0.00
2024-12-08 16:54:49,71,4569,34,37,3356.83,5668.66,0.00
2024-12-08 16:54:49,71,4570,34,37,3416.59,5669.00,0.00
2024-12-08 16:54:49,72,4570,34,38,3369.14,5669.01,0.00
2024-12-08 16:54:49,72,4571,34,38,3345.76,5670.00,0.00
2024-12-08 16:54:49,73,4571,34,39,3299.92,5670.01,0.00
2024-12-08 16:54:49,72,4571,33,39,3341.77,5670.08,0.00
2024-12-08 16:54:49,71,4571,33,38,3376.06,5670.08,0.00
2024-12-08 16:54:49,70,4571,32,38,3381.65,5670.41,0.00
2024-12-08 16:54:49,70,4572,32,38,3428.49,5671.00,0.00
2024-12-08 16:54:49,71,4572,33,38,3380.20,5671.01,0.00
2024-12-08 16:54:49,70,4572,32,38,3377.60,5671.30,0.00
2024-12-08 16:54:49,70,4573,32,38,3418.38,5672.00,0.00
2024-12-08 16:54:49,71,4573,33,38,3370.23,5672.01,0.00
2024-12-08 16:54:49,70,4573,33,37,3401.39,5672.09,0.00
2024-12-08 16:54:49,71,4572,34,37,3329.03,5672.49,0.00
2024-12-08 16:54:49,71,4573,34,37,3362.52,5673.00,0.00
2024-12-08 16:54:49,72,4573,35,37,3315.82,5673.01,0.00
2024-12-08 16:54:49,71,4573,34,37,3305.25,5673.24,0.00
2024-12-08 16:54:49,71,4574,34,37,3421.13,5674.00,0.00
2024-12-08 16:54:49,72,4574,34,38,3373.61,5674.01,0.00
2024-12-08 16:54:49,71,4574,34,37,3404.37,5674.08,0.00
2024-12-08 16:54:49,72,4573,34,38,3356.30,5674.13,0.00
2024-12-08 16:54:49,73,4572,35,38,3331.61,5674.56,0.00
2024-12-08 16:54:49,73,4573,35,38,3374.52,5675.00,0.00
2024-12-08 16:54:49,74,4573,35,39,3328.92,5675.01,0.00
2024-12-08 16:54:49,74,4574,35,39,3462.05,5676.00,0.00
2024-12-08 16:54:49,75,4574,35,40,3415.89,5676.01,0.00
2024-12-08 16:54:49,74,4574,35,39,3440.61,5676.11,0.00
2024-12-08 16:54:49,73,4574,34,39,3478.10,5676.12,0.00
2024-12-08 16:54:49,73,4575,34,39,3503.84,5677.00,0.00
2024-12-08 16:54:49,74,4575,34,40,3456.49,5677.01,0.00
2024-12-08 16:54:49,74,4576,34,40,3434.76,5678.00,0.00
2024-12-08 16:54:49,75,4576,34,41,3388.96,5678.01,0.00
2024-12-08 16:54:49,74,4576,33,41,3349.14,5678.88,0.00
2024-12-08 16:54:49,74,4577,33,41,3419.04,5679.00,0.00
2024-12-08 16:54:49,75,4577,34,41,3373.46,5679.01,0.00
2024-12-08 16:54:49,74,4577,34,40,3409.06,5679.15,0.00
2024-12-08 16:54:49,75,4576,34,41,3320.49,5679.36,0.00
2024-12-08 16:54:49,75,4577,34,41,3389.67,5680.00,0.00
2024-12-08 16:54:49,76,4577,35,41,3345.06,5680.01,0.00
2024-12-08 16:54:49,75,4577,35,40,3388.16,5680.03,0.00
2024-12-08 16:54:49,75,4578,35,40,3440.75,5681.00,0.00
2024-12-08 16:54:49,76,4578,36,40,3395.48,5681.01,0.00
2024-12-08 16:54:49,75,4578,36,39,3439.25,5681.03,0.00
2024-12-08 16:54:49,75,4579,36,39,3408.49,5682.00,0.00
2024-12-08 16:54:49,76,4579,37,39,3363.64,5682.01,0.00
2024-12-08 16:54:49,75,4579,36,39,3402.47,5682.12,0.00
2024-12-08 16:54:49,74,4579,36,38,3447.68,5682.12,0.00
2024-12-08 16:54:49,74,4580,36,38,3437.02,5683.00,0.00
2024-12-08 16:54:49,75,4580,37,38,3391.20,5683.01,0.00
2024-12-08 16:54:49,76,4579,37,39,3286.56,5683.68,0.00
2024-12-08 16:54:49,77,4578,38,39,3286.72,5683.73,0.00
2024-12-08 16:54:49,77,4579,38,39,3334.36,5684.00,0.00
2024-12-08 16:54:49,78,4579,38,40,3291.62,5684.01,0.00
2024-12-08 16:54:49,77,4579,38,39,3312.26,5684.13,0.00
2024-12-08 16:54:49,76,4579,37,39,3352.10,5684.15,0.00
2024-12-08 16:54:49,75,4579,36,39,3390.55,5684.23,0.00
2024-12-08 16:54:49,76,4578,36,40,3332.85,5684.40,0.00
2024-12-08 16:54:49,76,4579,36,40,3527.60,5685.00,0.00
2024-12-08 16:54:49,77,4579,37,40,3481.79,5685.01,0.00
2024-12-08 16:54:49,77,4580,37,40,3527.38,5686.00,0.00
2024-12-08 16:54:49,78,4580,38,40,3482.16,5686.01,0.00
2024-12-08 16:54:49,77,4580,37,40,3519.68,5686.14,0.00
2024-12-08 16:54:49,77,4581,37,40,3490.67,5687.00,0.00
2024-12-08 16:54:49,78,4581,37,41,3445.91,5687.01,0.00
2024-12-08 16:54:49,77,4581,36,41,3484.05,5687.13,0.00
2024-12-08 16:54:49,76,4581,36,40,3528.40,5687.13,0.00
2024-12-08 16:54:49,75,4581,35,40,3550.52,5687.48,0.00
2024-12-08 16:54:49,75,4582,35,40,3559.50,5688.00,0.00
2024-12-08 16:54:49,76,4582,35,41,3512.66,5688.01,0.00
2024-12-08 16:54:49,77,4581,36,41,3432.09,5688.33,0.00
2024-12-08 16:54:49,77,4582,36,41,3467.11,5689.00,0.00
2024-12-08 16:54:49,78,4582,37,41,3422.66,5689.01,0.00
2024-12-08 16:54:49,79,4581,38,41,3379.33,5689.04,0.00
2024-12-08 16:54:49,78,4581,38,40,3421.23,5689.14,0.00
2024-12-08 16:54:49,77,4581,37,40,3390.36,5689.96,0.00
2024-12-08 16:54:50,77,4582,37,40,3535.95,5690.00,0.00
2024-12-08 16:54:50,78,4582,38,40,3490.62,5690.01,0.00
2024-12-08 16:54:50,78,4583,38,40,3532.17,5691.00,0.00
2024-12-08 16:54:50,79,4583,39,40,3487.46,5691.01,0.00
2024-12-08 16:54:50,78,4583,38,40,3526.84,5691.10,0.00
2024-12-08 16:54:50,77,4583,37,40,3572.27,5691.10,0.00
2024-12-08 16:54:50,77,4584,37,40,3538.30,5692.00,0.00
2024-12-08 16:54:50,78,4584,38,40,3492.94,5692.01,0.00
2024-12-08 16:54:50,77,4584,38,39,3529.47,5692.13,0.00
2024-12-08 16:54:50,76,4584,38,38,3555.64,5692.43,0.00
2024-12-08 16:54:50,76,4585,38,38,3561.93,5693.00,0.00
2024-12-08 16:54:50,77,4585,38,39,3515.67,5693.01,0.00
2024-12-08 16:54:50,76,4585,37,39,3560.44,5693.03,0.00
2024-12-08 16:54:50,76,4586,37,39,3528.21,5694.00,0.00
2024-12-08 16:54:50,77,4586,37,40,3482.39,5694.01,0.00
2024-12-08 16:54:50,76,4586,36,40,3429.17,5694.96,0.00
2024-12-08 16:54:50,76,4587,36,40,3501.88,5695.00,0.00
2024-12-08 16:54:50,77,4587,37,40,3456.40,5695.01,0.00
2024-12-08 16:54:50,76,4587,37,39,3500.39,5695.03,0.00
2024-12-08 16:54:50,75,4587,36,39,3538.75,5695.03,0.00
2024-12-08 16:54:50,74,4587,36,38,3581.58,5695.10,0.00
2024-12-08 16:54:50,74,4588,36,38,3593.93,5696.00,0.00
2024-12-08 16:54:50,75,4588,37,38,3546.01,5696.01,0.00
2024-12-08 16:54:50,74,4588,37,37,3567.15,5696.14,0.00
2024-12-08 16:54:50,74,4589,37,37,3575.69,5697.00,0.00
2024-12-08 16:54:50,75,4589,38,37,3528.02,5697.01,0.00
2024-12-08 16:54:50,75,4590,38,37,3508.15,5698.00,0.00
2024-12-08 16:54:50,76,4590,38,38,3461.99,5698.01,0.00
2024-12-08 16:54:50,76,4591,38,38,3432.44,5699.00,0.00
2024-12-08 16:54:50,77,4591,38,39,3387.86,5699.01,0.00
2024-12-08 16:54:50,78,4590,38,40,3336.92,5699.08,0.00
2024-12-08 16:54:50,77,4590,38,39,3421.72,5699.10,0.00
2024-12-08 16:54:50,78,4589,38,40,3369.16,5699.28,0.00
2024-12-08 16:54:50,77,4589,38,39,3419.05,5699.66,0.00
2024-12-08 16:54:50,77,4590,38,39,3444.47,5700.00,0.00
2024-12-08 16:54:50,78,4590,38,40,3400.31,5700.01,0.00
2024-12-08 16:54:50,77,4590,38,39,3438.66,5700.04,0.00
2024-12-08 16:54:50,76,4590,37,39,3483.04,5700.05,0.00
2024-12-08 16:54:50,75,4590,36,39,3473.74,5700.68,0.00
2024-12-08 16:54:50,75,4591,36,39,3683.77,5701.00,0.00
2024-12-08 16:54:50,76,4591,36,40,3635.30,5701.01,0.00
2024-12-08 16:54:50,75,4591,36,39,3667.85,5701.07,0.00
2024-12-08 16:54:50,75,4592,36,39,3656.63,5702.00,0.00
2024-12-08 16:54:50,76,4592,36,40,3608.52,5702.01,0.00
2024-12-08 16:54:50,75,4592,35,40,3578.91,5702.53,0.00
2024-12-08 16:54:50,74,4592,34,40,3626.74,5702.54,0.00
2024-12-08 16:54:50,74,4593,34,40,3677.56,5703.00,0.00
2024-12-08 16:54:50,75,4593,34,41,3628.53,5703.01,0.00
2024-12-08 16:54:50,74,4593,34,40,3663.16,5703.07,0.00
2024-12-08 16:54:50,73,4593,33,40,3684.52,5703.26,0.00
2024-12-08 16:54:50,74,4592,34,40,3628.94,5703.38,0.00
2024-12-08 16:54:50,74,4593,34,40,3700.86,5704.00,0.00
2024-12-08 16:54:50,75,4593,35,40,3651.51,5704.01,0.00
2024-12-08 16:54:50,75,4594,35,40,3698.96,5705.00,0.00
2024-12-08 16:54:50,76,4594,35,41,3650.29,5705.01,0.00
2024-12-08 16:54:50,75,4594,35,40,3683.79,5705.07,0.00
2024-12-08 16:54:50,76,4593,35,41,3630.85,5705.17,0.00
2024-12-08 16:54:50,76,4594,35,41,3668.22,5706.00,0.00
2024-12-08 16:54:50,77,4594,36,41,3620.58,5706.01,0.00
2024-12-08 16:54:50,78,4593,37,41,3540.18,5706.36,0.00
2024-12-08 16:54:50,77,4593,36,41,3557.44,5706.65,0.00
2024-12-08 16:54:50,77,4594,36,41,3683.80,5707.00,0.00
2024-12-08 16:54:50,78,4594,36,42,3636.57,5707.01,0.00
2024-12-08 16:54:50,77,4594,36,41,3669.01,5707.08,0.00
2024-12-08 16:54:50,77,4595,36,41,3733.03,5708.00,0.00
2024-12-08 16:54:50,78,4595,36,42,3685.17,5708.01,0.00
2024-12-08 16:54:50,78,4596,36,42,3657.39,5709.00,0.00
2024-12-08 16:54:50,79,4596,37,42,3611.09,5709.01,0.00
2024-12-08 16:54:50,78,4596,37,41,3643.52,5709.08,0.00
2024-12-08 16:54:50,77,4596,36,41,3630.02,5709.92,0.00
2024-12-08 16:54:50,77,4597,36,41,3699.78,5710.00,0.00
2024-12-08 16:54:50,78,4597,37,41,3652.35,5710.01,0.00
2024-12-08 16:54:50,77,4597,36,41,3677.61,5710.14,0.00
2024-12-08 16:54:50,77,4598,36,41,3692.56,5711.00,0.00
2024-12-08 16:54:50,78,4598,36,42,3645.22,5711.01,0.00
2024-12-08 16:54:50,78,4599,36,42,3628.48,5712.00,0.00
2024-12-08 16:54:50,79,4599,36,43,3582.55,5712.01,0.00
2024-12-08 16:54:50,79,4600,36,43,3553.82,5713.00,0.00
2024-12-08 16:54:50,80,4600,36,44,3509.40,5713.01,0.00
2024-12-08 16:54:50,79,4600,36,43,3538.67,5713.08,0.00
2024-12-08 16:54:50,79,4601,36,43,3527.48,5714.00,0.00
2024-12-08 16:54:50,80,4601,37,43,3483.38,5714.01,0.00
2024-12-08 16:54:50,79,4601,36,43,3504.41,5714.17,0.00
2024-12-08 16:54:50,79,4602,36,43,3516.34,5715.00,0.00
2024-12-08 16:54:50,80,4602,36,44,3472.39,5715.01,0.00
2024-12-08 16:54:50,81,4601,36,45,3425.32,5715.11,0.00
2024-12-08 16:54:50,80,4601,35,45,3499.28,5715.19,0.00
2024-12-08 16:54:51,80,4602,35,45,3503.89,5716.00,0.00
2024-12-08 16:54:51,81,4602,35,46,3460.63,5716.01,0.00
2024-12-08 16:54:51,80,4602,34,46,3483.34,5716.11,0.00
2024-12-08 16:54:51,80,4603,34,46,3568.98,5717.00,0.00
2024-12-08 16:54:51,81,4603,35,46,3524.92,5717.01,0.00
2024-12-08 16:54:51,81,4604,35,46,3515.11,5718.00,0.00
2024-12-08 16:54:51,82,4604,35,47,3472.24,5718.01,0.00
2024-12-08 16:54:51,82,4605,35,47,3453.73,5719.00,0.00
2024-12-08 16:54:51,83,4605,36,47,3412.12,5719.01,0.00
2024-12-08 16:54:51,84,4604,36,48,3320.78,5719.69,0.00
2024-12-08 16:54:51,84,4605,36,48,3379.00,5720.00,0.00
2024-12-08 16:54:51,85,4605,37,48,3339.24,5720.01,0.00
2024-12-08 16:54:51,84,4605,37,47,3364.05,5720.08,0.00
2024-12-08 16:54:51,83,4605,36,47,3399.80,5720.17,0.00
2024-12-08 16:54:51,82,4605,35,47,3366.54,5720.96,0.00
2024-12-08 16:54:51,82,4606,35,47,3503.99,5721.00,0.00
2024-12-08 16:54:51,83,4606,36,47,3461.77,5721.01,0.00
2024-12-08 16:54:51,83,4607,36,47,3429.26,5722.00,0.00
2024-12-08 16:54:51,84,4607,37,47,3388.43,5722.01,0.00
2024-12-08 16:54:51,83,4607,37,46,3416.90,5722.11,0.00
2024-12-08 16:54:51,82,4607,36,46,3438.52,5722.32,0.00
2024-12-08 16:54:51,82,4608,36,46,3465.04,5723.00,0.00
2024-12-08 16:54:51,83,4608,37,46,3423.30,5723.01,0.00
2024-12-08 16:54:51,82,4608,36,46,3418.34,5723.15,0.00
2024-12-08 16:54:51,82,4609,36,46,3434.55,5724.00,0.00
2024-12-08 16:54:51,83,4609,37,46,3393.17,5724.01,0.00
2024-12-08 16:54:51,82,4609,37,45,3422.74,5724.11,0.00
2024-12-08 16:54:51,83,4608,38,45,3379.34,5724.17,0.00
2024-12-08 16:54:51,83,4609,38,45,3411.93,5725.00,0.00
2024-12-08 16:54:51,84,4609,38,46,3371.32,5725.01,0.00
2024-12-08 16:54:51,84,4610,38,46,3405.57,5726.00,0.00
2024-12-08 16:54:51,85,4610,39,46,3365.50,5726.01,0.00
2024-12-08 16:54:51,84,4610,39,45,3391.98,5726.12,0.00
2024-12-08 16:54:51,83,4610,38,45,3362.61,5726.75,0.00
2024-12-08 16:54:51,83,4611,38,45,3417.32,5727.00,0.00
2024-12-08 16:54:51,84,4611,39,45,3376.64,5727.01,0.00
2024-12-08 16:54:51,85,4610,39,46,3335.58,5727.06,0.00
2024-12-08 16:54:51,86,4609,40,46,3287.59,5727.33,0.00
2024-12-08 16:54:51,86,4610,40,46,3316.75,5728.00,0.00
2024-12-08 16:54:51,87,4610,41,46,3278.62,5728.01,0.00
2024-12-08 16:54:51,86,4610,41,45,3304.46,5728.12,0.00
2024-12-08 16:54:51,85,4610,41,44,3306.07,5728.65,0.00
2024-12-08 16:54:51,85,4611,41,44,3461.34,5729.00,0.00
2024-12-08 16:54:51,86,4611,42,44,3421.09,5729.01,0.00
2024-12-08 16:54:51,86,4612,42,44,3386.03,5730.00,0.00
2024-12-08 16:54:51,87,4612,43,44,3347.11,5730.01,0.00
2024-12-08 16:54:51,86,4612,43,43,3380.55,5730.10,0.00
2024-12-08 16:54:51,85,4612,42,43,3394.44,5730.54,0.00
2024-12-08 16:54:51,85,4613,42,43,3403.60,5731.00,0.00
2024-12-08 16:54:51,86,4613,42,44,3364.02,5731.01,0.00
2024-12-08 16:54:51,85,4613,41,44,3362.15,5731.34,0.00
2024-12-08 16:54:51,84,4613,40,44,3375.38,5731.71,0.00
2024-12-08 16:54:51,84,4614,40,44,3409.76,5732.00,0.00
2024-12-08 16:54:51,85,4614,41,44,3369.65,5732.01,0.00
2024-12-08 16:54:51,84,4614,41,43,3392.78,5732.16,0.00
2024-12-08 16:54:51,83,4614,40,43,3374.25,5732.66,0.00
2024-12-08 16:54:51,83,4615,40,43,3404.89,5733.00,0.00
2024-12-08 16:54:51,84,4615,41,43,3364.35,5733.01,0.00
2024-12-08 16:54:51,83,4615,41,42,3308.10,5733.89,0.00
2024-12-08 16:54:51,83,4616,41,42,3352.92,5734.00,0.00
2024-12-08 16:54:51,84,4616,41,43,3313.01,5734.01,0.00
2024-12-08 16:54:51,84,4617,41,43,3276.99,5735.00,0.00
2024-12-08 16:54:51,85,4617,42,43,3238.44,5735.01,0.00
2024-12-08 16:54:51,84,4617,42,42,3262.72,5735.16,0.00
2024-12-08 16:54:51,85,4616,43,42,3177.11,5735.81,0.00
2024-12-08 16:54:51,85,4617,43,42,3215.04,5736.00,0.00
2024-12-08 16:54:51,86,4617,43,43,3177.65,5736.01,0.00
2024-12-08 16:54:51,86,4618,43,43,3203.36,5737.00,0.00
2024-12-08 16:54:51,87,4618,44,43,3166.54,5737.01,0.00
2024-12-08 16:54:51,86,4618,44,42,3186.76,5737.17,0.00
2024-12-08 16:54:51,85,4618,43,42,3211.47,5737.31,0.00
2024-12-08 16:54:51,85,4619,43,42,3227.45,5738.00,0.00
2024-12-08 16:54:51,86,4619,44,42,3189.92,5738.01,0.00
2024-12-08 16:54:51,85,4619,43,42,3199.17,5738.17,0.00
2024-12-08 16:54:51,85,4620,43,42,3190.27,5739.00,0.00
2024-12-08 16:54:51,86,4620,43,43,3153.18,5739.01,0.00
2024-12-08 16:54:51,85,4620,43,42,3173.47,5739.18,0.00
2024-12-08 16:54:51,85,4621,43,42,3144.00,5740.00,0.00
2024-12-08 16:54:52,86,4621,44,42,3107.44,5740.01,0.00
2024-12-08 16:54:52,85,4621,43,42,3140.65,5740.06,0.00
2024-12-08 16:54:52,84,4621,43,41,3094.33,5740.57,0.00
2024-12-08 16:54:52,84,4622,43,41,3111.43,5741.00,0.00
2024-12-08 16:54:52,85,4622,43,42,3074.83,5741.01,0.00
2024-12-08 16:54:52,84,4622,43,41,3095.78,5741.17,0.00
2024-12-08 16:54:52,84,4623,43,41,3052.08,5742.00,0.00
2024-12-08 16:54:52,85,4623,44,41,3016.17,5742.01,0.00
2024-12-08 16:54:52,84,4623,43,41,3008.95,5742.39,0.00
2024-12-08 16:54:52,83,4623,43,40,3039.69,5742.45,0.00
2024-12-08 16:54:52,82,4623,42,40,3035.97,5742.78,0.00
2024-12-08 16:54:52,82,4624,42,40,3085.59,5743.00,0.00
2024-12-08 16:54:52,83,4624,43,40,3048.42,5743.01,0.00
2024-12-08 16:54:52,83,4625,43,40,3026.31,5744.00,0.00
2024-12-08 16:54:52,84,4625,43,41,2990.29,5744.01,0.00
2024-12-08 16:54:52,83,4625,43,40,3009.03,5744.06,0.00
2024-12-08 16:54:52,84,4624,43,41,2969.14,5744.16,0.00
2024-12-08 16:54:52,83,4624,43,40,3040.92,5744.45,0.00
2024-12-08 16:54:52,83,4625,43,40,3060.63,5745.00,0.00
2024-12-08 16:54:52,84,4625,43,41,3024.19,5745.01,0.00
2024-12-08 16:54:52,84,4626,43,41,3066.09,5746.00,0.00
2024-12-08 16:54:52,85,4626,43,42,3030.02,5746.01,0.00
2024-12-08 16:54:52,84,4626,42,42,3035.64,5746.30,0.00
2024-12-08 16:54:52,83,4626,41,42,3020.68,5746.76,0.00
2024-12-08 16:54:52,83,4627,41,42,3075.42,5747.00,0.00
2024-12-08 16:54:52,84,4627,42,42,3038.81,5747.01,0.00
2024-12-08 16:54:52,83,4627,42,41,3073.35,5747.04,0.00
2024-12-08 16:54:52,82,4627,42,40,3082.64,5747.46,0.00
2024-12-08 16:54:52,82,4628,42,40,3092.88,5748.00,0.00
2024-12-08 16:54:52,83,4628,42,41,3055.62,5748.01,0.00
2024-12-08 16:54:52,82,4628,42,40,3080.32,5748.15,0.00
2024-12-08 16:54:52,81,4628,41,40,3114.66,5748.21,0.00
2024-12-08 16:54:52,81,4629,41,40,3107.83,5749.00,0.00
2024-12-08 16:54:52,82,4629,42,40,3069.93,5749.01,0.00
2024-12-08 16:54:52,81,4629,41,40,3047.61,5749.31,0.00
2024-12-08 16:54:52,81,4630,41,40,3041.86,5750.00,0.00
2024-12-08 16:54:52,82,4630,42,40,3004.76,5750.01,0.00
2024-12-08 16:54:52,81,4630,42,39,3030.55,5750.15,0.00
2024-12-08 16:54:52,80,4630,42,38,2995.14,5750.89,0.00
2024-12-08 16:54:52,80,4631,42,38,3031.89,5751.00,0.00
2024-12-08 16:54:52,81,4631,42,39,2994.46,5751.01,0.00
2024-12-08 16:54:52,80,4631,41,39,2946.07,5751.74,0.00
2024-12-08 16:54:52,80,4632,41,39,3003.06,5752.00,0.00
2024-12-08 16:54:52,81,4632,41,40,2965.99,5752.01,0.00
2024-12-08 16:54:52,80,4632,41,39,2964.45,5752.16,0.00
2024-12-08 16:54:52,79,4632,40,39,2994.01,5752.30,0.00
2024-12-08 16:54:52,79,4633,40,39,3027.21,5753.00,0.00
2024-12-08 16:54:52,80,4633,41,39,2989.37,5753.01,0.00
2024-12-08 16:54:52,79,4633,40,39,2940.86,5753.75,0.00
2024-12-08 16:54:52,79,4634,40,39,2999.33,5754.00,0.00
2024-12-08 16:54:52,80,4634,40,40,2961.83,5754.01,0.00
2024-12-08 16:54:52,79,4634,40,39,2987.72,5754.17,0.00
2024-12-08 16:54:52,79,4635,40,39,2983.82,5755.00,0.00
2024-12-08 16:54:52,80,4635,40,40,2946.52,5755.01,0.00
2024-12-08 16:54:52,81,4634,40,41,2902.36,5755.17,0.00
2024-12-08 16:54:52,81,4635,40,41,2902.83,5756.00,0.00
2024-12-08 16:54:52,82,4635,41,41,2867.43,5756.01,0.00
2024-12-08 16:54:52,81,4635,40,41,2900.71,5756.04,0.00
2024-12-08 16:54:52,80,4635,40,40,2928.37,5756.15,0.00
2024-12-08 16:54:52,79,4635,39,40,2906.14,5756.96,0.00
2024-12-08 16:54:52,79,4636,39,40,3049.72,5757.00,0.00
2024-12-08 16:54:52,80,4636,39,41,3011.59,5757.01,0.00
2024-12-08 16:54:52,79,4636,39,40,3031.22,5757.15,0.00
2024-12-08 16:54:52,79,4637,39,40,3026.60,5758.00,0.00
2024-12-08 16:54:52,80,4637,40,40,2988.77,5758.01,0.00
2024-12-08 16:54:52,79,4637,39,40,3013.71,5758.09,0.00
2024-12-08 16:54:52,79,4638,39,40,3020.04,5759.00,0.00
2024-12-08 16:54:52,80,4638,40,40,2982.29,5759.01,0.00
2024-12-08 16:54:52,79,4638,40,39,3008.42,5759.15,0.00
2024-12-08 16:54:52,79,4639,40,39,3003.79,5760.00,0.00
2024-12-08 16:54:52,80,4639,40,40,2966.24,5760.01,0.00
2024-12-08 16:54:52,81,4638,40,41,2929.62,5760.04,0.00
2024-12-08 16:54:52,81,4639,40,41,2953.45,5761.00,0.00
2024-12-08 16:54:52,82,4639,40,42,2917.44,5761.01,0.00
2024-12-08 16:54:52,81,4639,40,41,2942.83,5761.15,0.00
2024-12-08 16:54:52,82,4638,41,41,2871.40,5761.79,0.00
2024-12-08 16:54:52,82,4639,41,41,2983.29,5762.00,0.00
2024-12-08 16:54:52,83,4639,42,41,2947.35,5762.01,0.00
2024-12-08 16:54:52,83,4640,42,41,2988.72,5763.00,0.00
2024-12-08 16:54:52,84,4640,42,42,2953.14,5763.01,0.00
2024-12-08 16:54:52,83,4640,42,41,2983.89,5763.08,0.00
2024-12-08 16:54:52,82,4640,42,40,3016.08,5763.13,0.00
2024-12-08 16:54:52,83,4639,42,41,2945.97,5763.75,0.00
2024-12-08 16:54:52,83,4640,42,41,2970.40,5764.00,0.00
2024-12-08 16:54:52,84,4640,42,42,2935.04,5764.01,0.00
2024-12-08 16:54:52,83,4640,41,42,2965.57,5764.08,0.00
2024-12-08 16:54:52,83,4641,41,42,2995.37,5765.00,0.00
2024-12-08 16:54:52,84,4641,41,43,2959.71,5765.01,0.00
2024-12-08 16:54:53,83,4641,40,43,2993.30,5765.04,0.00
2024-12-08 16:54:53,82,4641,40,42,3023.50,5765.11,0.00
2024-12-08 16:54:53,81,4641,39,42,2999.13,5765.68,0.00
2024-12-08 16:54:53,80,4641,38,42,3019.28,5765.89,0.00
2024-12-08 16:54:53,80,4642,38,42,3070.81,5766.00,0.00
2024-12-08 16:54:53,81,4642,38,43,3032.90,5766.01,0.00
2024-12-08 16:54:53,80,4642,37,43,3025.46,5766.18,0.00
2024-12-08 16:54:53,80,4643,37,43,3031.62,5767.00,0.00
2024-12-08 16:54:53,81,4643,37,44,2994.19,5767.01,0.00
2024-12-08 16:54:53,80,4643,36,44,2998.54,5767.34,0.00
2024-12-08 16:54:53,80,4644,36,44,2983.87,5768.00,0.00
2024-12-08 16:54:53,81,4644,36,45,2947.04,5768.01,0.00
2024-12-08 16:54:53,80,4644,36,44,2979.58,5768.08,0.00
2024-12-08 16:54:53,79,4644,36,43,3002.72,5768.18,0.00
2024-12-08 16:54:53,78,4644,35,43,2962.09,5768.86,0.00
2024-12-08 16:54:53,78,4645,35,43,3028.03,5769.00,0.00
2024-12-08 16:54:53,79,4645,35,44,2989.71,5769.01,0.00
2024-12-08 16:54:53,80,4644,35,45,2948.75,5769.10,0.00
2024-12-08 16:54:53,81,4643,36,45,2896.74,5769.31,0.00
2024-12-08 16:54:53,80,4643,35,45,2934.54,5769.63,0.00
2024-12-08 16:54:53,80,4644,35,45,2982.43,5770.00,0.00
2024-12-08 16:54:53,81,4644,35,46,2945.61,5770.01,0.00
2024-12-08 16:54:53,82,4643,36,46,2906.20,5770.10,0.00
2024-12-08 16:54:53,81,4643,36,45,2929.99,5770.19,0.00
2024-12-08 16:54:53,81,4644,36,45,3063.82,5771.00,0.00
2024-12-08 16:54:53,82,4644,36,46,3026.46,5771.01,0.00
2024-12-08 16:54:53,83,4643,37,46,2956.05,5771.39,0.00
2024-12-08 16:54:53,84,4642,38,46,2931.27,5771.64,0.00
2024-12-08 16:54:53,84,4643,38,46,3031.24,5772.00,0.00
2024-12-08 16:54:53,85,4643,38,47,2995.57,5772.01,0.00
2024-12-08 16:54:53,84,4643,38,46,3015.27,5772.17,0.00
2024-12-08 16:54:53,85,4642,39,46,2973.05,5772.31,0.00
2024-12-08 16:54:53,85,4643,39,46,3135.64,5773.00,0.00
2024-12-08 16:54:53,86,4643,40,46,3099.18,5773.01,0.00
2024-12-08 16:54:53,85,4643,40,45,3128.21,5773.13,0.00
2024-12-08 16:54:53,84,4643,39,45,3161.98,5773.14,0.00
2024-12-08 16:54:53,83,4643,38,45,3129.06,5773.78,0.00
2024-12-08 16:54:53,83,4644,38,45,3250.77,5774.00,0.00
2024-12-08 16:54:53,84,4644,39,45,3212.07,5774.01,0.00
2024-12-08 16:54:53,83,4644,38,45,3249.39,5774.02,0.00
2024-12-08 16:54:53,82,4644,38,44,3277.08,5774.13,0.00
2024-12-08 16:54:53,82,4645,38,44,3253.10,5775.00,0.00
2024-12-08 16:54:53,83,4645,38,45,3213.91,5775.01,0.00
2024-12-08 16:54:53,82,4645,38,44,3232.72,5775.12,0.00
2024-12-08 16:54:53,81,4645,37,44,3236.77,5775.59,0.00
2024-12-08 16:54:53,81,4646,37,44,3247.67,5776.00,0.00
2024-12-08 16:54:53,82,4646,38,44,3208.07,5776.01,0.00
2024-12-08 16:54:53,81,4646,37,44,3199.94,5776.17,0.00
2024-12-08 16:54:53,81,4647,37,44,3207.74,5777.00,0.00
2024-12-08 16:54:53,82,4647,37,45,3168.63,5777.01,0.00
2024-12-08 16:54:53,81,4647,37,44,3194.23,5777.14,0.00
2024-12-08 16:54:53,80,4647,36,44,3219.29,5777.39,0.00
2024-12-08 16:54:53,79,4647,35,44,3233.23,5777.67,0.00
2024-12-08 16:54:53,79,4648,35,44,3253.53,5778.00,0.00
2024-12-08 16:54:53,80,4648,35,45,3212.86,5778.01,0.00
2024-12-08 16:54:53,81,4647,35,46,3170.37,5778.09,0.00
2024-12-08 16:54:53,80,4647,34,46,3161.17,5778.41,0.00
2024-12-08 16:54:53,81,4646,35,46,3103.67,5778.57,0.00
2024-12-08 16:54:53,81,4647,35,46,3170.73,5779.00,0.00
2024-12-08 16:54:53,82,4647,36,46,3132.06,5779.01,0.00
2024-12-08 16:54:53,81,4647,36,45,3157.21,5779.14,0.00
2024-12-08 16:54:53,80,4647,35,45,3169.33,5779.40,0.00
2024-12-08 16:54:53,79,4647,35,44,3201.01,5779.49,0.00
2024-12-08 16:54:53,79,4648,35,44,3391.27,5780.00,0.00
2024-12-08 16:54:53,80,4648,36,44,3348.88,5780.01,0.00
2024-12-08 16:54:53,79,4648,35,44,3362.93,5780.24,0.00
2024-12-08 16:54:53,79,4649,35,44,3364.01,5781.00,0.00
2024-12-08 16:54:53,80,4649,35,45,3321.96,5781.01,0.00
2024-12-08 16:54:53,79,4649,35,44,3350.88,5781.14,0.00
2024-12-08 16:54:53,78,4649,34,44,3386.49,5781.26,0.00
2024-12-08 16:54:53,78,4650,34,44,3385.66,5782.00,0.00
2024-12-08 16:54:53,79,4650,34,45,3342.80,5782.01,0.00
2024-12-08 16:54:53,79,4651,34,45,3331.65,5783.00,0.00
2024-12-08 16:54:53,80,4651,34,46,3290.00,5783.01,0.00
2024-12-08 16:54:53,79,4651,33,46,3325.85,5783.03,0.00
2024-12-08 16:54:53,78,4651,32,46,3365.55,5783.06,0.00
2024-12-08 16:54:53,78,4652,32,46,3360.09,5784.00,0.00
2024-12-08 16:54:53,79,4652,32,47,3317.56,5784.01,0.00
2024-12-08 16:54:53,78,4652,31,47,3332.00,5784.24,0.00
2024-12-08 16:54:53,77,4652,30,47,3373.08,5784.27,0.00
2024-12-08 16:54:53,77,4653,30,47,3373.85,5785.00,0.00
2024-12-08 16:54:53,78,4653,31,47,3330.60,5785.01,0.00
2024-12-08 16:54:53,77,4653,30,47,3345.38,5785.25,0.00
2024-12-08 16:54:53,77,4654,30,47,3331.69,5786.00,0.00
2024-12-08 16:54:53,78,4654,31,47,3288.98,5786.01,0.00
2024-12-08 16:54:53,77,4654,31,46,3322.71,5786.12,0.00
2024-12-08 16:54:53,76,4654,30,46,3309.40,5786.71,0.00
2024-12-08 16:54:53,76,4655,30,46,3362.80,5787.00,0.00
2024-12-08 16:54:53,77,4655,31,46,3319.13,5787.01,0.00
2024-12-08 16:54:53,78,4654,31,47,3275.10,5787.06,0.00
2024-12-08 16:54:53,77,4654,30,47,3278.69,5787.77,0.00
2024-12-08 16:54:53,77,4655,30,47,3340.50,5788.00,0.00
2024-12-08 16:54:53,78,4655,30,48,3297.68,5788.01,0.00
2024-12-08 16:54:53,77,4655,30,47,3336.78,5788.07,0.00
2024-12-08 16:54:53,76,4655,29,47,3379.93,5788.07,0.00
2024-12-08 16:54:53,75,4655,29,46,3419.59,5788.09,0.00
2024-12-08 16:54:53,75,4656,29,46,3477.11,5789.00,0.00
2024-12-08 16:54:53,76,4656,30,46,3431.36,5789.01,0.00
2024-12-08 16:54:53,75,4656,29,46,3473.29,5789.07,0.00
2024-12-08 16:54:54,74,4656,28,46,3519.81,5789.07,0.00
2024-12-08 16:54:54,73,4656,27,46,3543.24,5789.21,0.00
2024-12-08 16:54:54,72,4656,26,46,3582.03,5789.26,0.00
2024-12-08 16:54:54,73,4655,26,47,3527.46,5789.38,0.00
2024-12-08 16:54:54,72,4655,26,46,3624.58,5789.47,0.00
2024-12-08 16:54:54,72,4656,26,46,3674.83,5790.00,0.00
2024-12-08 16:54:54,73,4656,27,46,3624.49,5790.01,0.00
2024-12-08 16:54:54,72,4656,27,45,3668.43,5790.07,0.00
2024-12-08 16:54:54,71,4656,27,44,3691.95,5790.38,0.00
2024-12-08 16:54:54,71,4657,27,44,3787.02,5791.00,0.00
2024-12-08 16:54:54,72,4657,28,44,3734.42,5791.01,0.00
2024-12-08 16:54:54,71,4657,27,44,3715.40,5791.48,0.00
2024-12-08 16:54:54,71,4658,27,44,3767.19,5792.00,0.00
2024-12-08 16:54:54,72,4658,27,45,3714.87,5792.01,0.00
2024-12-08 16:54:54,71,4658,27,44,3760.70,5792.07,0.00
2024-12-08 16:54:54,72,4657,27,45,3668.86,5792.78,0.00
2024-12-08 16:54:54,72,4658,27,45,3714.91,5793.00,0.00
2024-12-08 16:54:54,73,4658,28,45,3664.02,5793.01,0.00
2024-12-08 16:54:54,74,4657,28,46,3611.41,5793.10,0.00
2024-12-08 16:54:54,74,4658,28,46,3720.10,5794.00,0.00
2024-12-08 16:54:54,75,4658,29,46,3670.49,5794.01,0.00
2024-12-08 16:54:54,75,4659,29,46,3743.63,5795.00,0.00
2024-12-08 16:54:54,76,4659,29,47,3694.37,5795.01,0.00
2024-12-08 16:54:54,76,4660,29,47,3683.25,5796.00,0.00
2024-12-08 16:54:54,77,4660,30,47,3635.42,5796.01,0.00
2024-12-08 16:54:54,77,4661,30,47,3612.21,5797.00,0.00
2024-12-08 16:54:54,78,4661,30,48,3565.90,5797.01,0.00
2024-12-08 16:54:54,78,4662,30,48,3529.62,5798.00,0.00
2024-12-08 16:54:54,79,4662,31,48,3484.94,5798.01,0.00
2024-12-08 16:54:54,78,4662,31,47,3514.79,5798.06,0.00
2024-12-08 16:54:54,77,4662,31,46,3556.79,5798.09,0.00
2024-12-08 16:54:54,76,4662,30,46,3533.16,5798.96,0.00
2024-12-08 16:54:54,76,4663,30,46,3607.20,5799.00,0.00
2024-12-08 16:54:54,77,4663,31,46,3560.36,5799.01,0.00
2024-12-08 16:54:54,76,4663,31,45,3590.45,5799.07,0.00
2024-12-08 16:54:54,76,4664,31,45,3579.85,5800.00,0.00
2024-12-08 16:54:54,77,4664,31,46,3533.35,5800.01,0.00
2024-12-08 16:54:54,76,4664,31,45,3562.33,5800.07,0.00
2024-12-08 16:54:54,76,4665,31,45,3552.11,5801.00,0.00
2024-12-08 16:54:54,77,4665,32,45,3505.98,5801.01,0.00
2024-12-08 16:54:54,78,4664,32,46,3459.55,5801.06,0.00
2024-12-08 16:54:54,77,4664,31,46,3491.74,5801.20,0.00
2024-12-08 16:54:54,77,4665,31,46,3489.38,5802.00,0.00
2024-12-08 16:54:54,78,4665,32,46,3444.65,5802.01,0.00
2024-12-08 16:54:54,77,4665,32,45,3479.64,5802.10,0.00
2024-12-08 16:54:54,76,4665,31,45,3521.54,5802.17,0.00
2024-12-08 16:54:54,76,4666,31,45,3590.76,5803.00,0.00
2024-12-08 16:54:54,77,4666,32,45,3544.13,5803.01,0.00
2024-12-08 16:54:54,77,4667,32,45,3514.19,5804.00,0.00
2024-12-08 16:54:54,78,4667,33,45,3469.14,5804.01,0.00
2024-12-08 16:54:54,77,4667,33,44,3502.93,5804.10,0.00
2024-12-08 16:54:54,76,4667,32,44,3503.45,5804.78,0.00
2024-12-08 16:54:54,77,4666,33,44,3457.95,5804.79,0.00
2024-12-08 16:54:54,77,4667,33,44,3530.32,5805.00,0.00
2024-12-08 16:54:54,78,4667,34,44,3485.06,5805.01,0.00
2024-12-08 16:54:54,77,4667,33,44,3446.90,5805.64,0.00
2024-12-08 16:54:54,77,4668,33,44,3575.50,5806.00,0.00
2024-12-08 16:54:54,78,4668,34,44,3529.66,5806.01,0.00
2024-12-08 16:54:54,77,4668,34,43,3563.48,5806.10,0.00
2024-12-08 16:54:54,77,4669,34,43,3552.64,5807.00,0.00
2024-12-08 16:54:54,78,4669,35,43,3507.10,5807.01,0.00
2024-12-08 16:54:54,78,4670,35,43,3478.93,5808.00,0.00
2024-12-08 16:54:54,79,4670,35,44,3434.89,5808.01,0.00
2024-12-08 16:54:54,78,4670,35,43,3466.32,5808.12,0.00
2024-12-08 16:54:54,78,4671,35,43,3460.07,5809.00,0.00
2024-12-08 16:54:54,79,4671,36,43,3416.27,5809.01,0.00
2024-12-08 16:54:54,78,4671,35,43,3387.41,5809.59,0.00
2024-12-08 16:54:54,78,4672,35,43,3438.37,5810.00,0.00
2024-12-08 16:54:54,79,4672,35,44,3394.84,5810.01,0.00
2024-12-08 16:54:54,78,4672,35,43,3425.00,5810.12,0.00
2024-12-08 16:54:54,77,4672,34,43,3464.99,5810.18,0.00
2024-12-08 16:54:54,77,4673,34,43,3463.17,5811.00,0.00
2024-12-08 16:54:54,78,4673,35,43,3418.77,5811.01,0.00
2024-12-08 16:54:54,79,4672,35,44,3347.64,5811.27,0.00
2024-12-08 16:54:54,78,4672,34,44,3389.67,5811.56,0.00
2024-12-08 16:54:54,79,4671,35,44,3332.96,5811.82,0.00
2024-12-08 16:54:54,79,4672,35,44,3405.20,5812.00,0.00
2024-12-08 16:54:54,80,4672,35,45,3362.64,5812.01,0.00
2024-12-08 16:54:54,79,4672,35,44,3388.32,5812.13,0.00
2024-12-08 16:54:54,78,4672,34,44,3397.08,5812.68,0.00
2024-12-08 16:54:54,78,4673,34,44,3572.45,5813.00,0.00
2024-12-08 16:54:54,79,4673,34,45,3527.23,5813.01,0.00
2024-12-08 16:54:54,79,4674,34,45,3515.75,5814.00,0.00
2024-12-08 16:54:54,80,4674,35,45,3471.80,5814.01,0.00
2024-12-08 16:54:55,79,4674,34,45,3427.08,5814.80,0.00
2024-12-08 16:54:55,79,4675,34,45,3489.07,5815.00,0.00
2024-12-08 16:54:55,80,4675,34,46,3445.46,5815.01,0.00
2024-12-08 16:54:55,81,4674,34,47,3400.07,5815.09,0.00
2024-12-08 16:54:55,82,4673,35,47,3353.92,5815.54,0.00
2024-12-08 16:54:55,82,4674,35,47,3381.75,5816.00,0.00
2024-12-08 16:54:55,83,4674,35,48,3341.01,5816.01,0.00
2024-12-08 16:54:55,82,4674,35,47,3373.29,5816.12,0.00
2024-12-08 16:54:55,82,4675,35,47,3493.83,5817.00,0.00
2024-12-08 16:54:55,83,4675,35,48,3451.73,5817.01,0.00
2024-12-08 16:54:55,84,4674,35,49,3377.44,5817.37,0.00
2024-12-08 16:54:55,83,4674,34,49,3433.49,5817.43,0.00
2024-12-08 16:54:55,83,4675,34,49,3468.85,5818.00,0.00
2024-12-08 16:54:55,84,4675,34,50,3427.56,5818.01,0.00
2024-12-08 16:54:55,83,4675,33,50,3419.92,5818.41,0.00
2024-12-08 16:54:55,83,4676,33,50,3526.08,5819.00,0.00
2024-12-08 16:54:55,84,4676,33,51,3484.10,5819.01,0.00
2024-12-08 16:54:55,83,4676,32,51,3521.18,5819.02,0.00
2024-12-08 16:54:55,83,4677,32,51,3518.98,5820.00,0.00
2024-12-08 16:54:55,84,4677,32,52,3477.09,5820.01,0.00
2024-12-08 16:54:55,84,4678,32,52,3448.68,5821.00,0.00
2024-12-08 16:54:55,85,4678,33,52,3408.10,5821.01,0.00
2024-12-08 16:54:55,84,4678,32,52,3444.55,5821.06,0.00
2024-12-08 16:54:55,83,4678,32,51,3466.65,5821.15,0.00
2024-12-08 16:54:55,83,4679,32,51,3481.39,5822.00,0.00
2024-12-08 16:54:55,84,4679,33,51,3439.95,5822.01,0.00
2024-12-08 16:54:55,84,4680,33,51,3392.43,5823.00,0.00
2024-12-08 16:54:55,85,4680,34,51,3352.52,5823.01,0.00
2024-12-08 16:54:55,84,4680,34,50,3377.23,5823.13,0.00
2024-12-08 16:54:55,84,4681,34,50,3351.88,5824.00,0.00
2024-12-08 16:54:55,85,4681,34,51,3312.44,5824.01,0.00
2024-12-08 16:54:55,84,4681,33,51,3348.44,5824.06,0.00
2024-12-08 16:54:55,83,4681,33,50,3376.20,5824.12,0.00
2024-12-08 16:54:55,82,4681,32,50,3360.33,5824.85,0.00
2024-12-08 16:54:55,82,4682,32,50,3418.64,5825.00,0.00
2024-12-08 16:54:55,83,4682,33,50,3377.45,5825.01,0.00
2024-12-08 16:54:55,82,4682,32,50,3414.93,5825.06,0.00
2024-12-08 16:54:55,82,4683,32,50,3379.51,5826.00,0.00
2024-12-08 16:54:55,83,4683,33,50,3338.79,5826.01,0.00
2024-12-08 16:54:55,82,4683,33,49,3363.21,5826.11,0.00
2024-12-08 16:54:55,81,4683,32,49,3331.63,5826.95,0.00
2024-12-08 16:54:55,81,4684,32,49,3400.72,5827.00,0.00
2024-12-08 16:54:55,82,4684,32,50,3359.25,5827.01,0.00
2024-12-08 16:54:55,82,4685,32,50,3345.77,5828.00,0.00
2024-12-08 16:54:55,83,4685,32,51,3305.46,5828.01,0.00
2024-12-08 16:54:55,84,4684,33,51,3263.04,5828.08,0.00
2024-12-08 16:54:55,83,4684,33,50,3361.34,5828.08,0.00
2024-12-08 16:54:55,83,4685,33,50,3345.42,5829.00,0.00
2024-12-08 16:54:55,84,4685,34,50,3305.59,5829.01,0.00
2024-12-08 16:54:55,84,4686,34,50,3354.88,5830.00,0.00
2024-12-08 16:54:55,85,4686,35,50,3315.41,5830.01,0.00
2024-12-08 16:54:55,84,4686,35,49,3276.01,5830.38,0.00
2024-12-08 16:54:55,85,4685,36,49,3226.40,5830.55,0.00
2024-12-08 16:54:55,85,4686,36,49,3281.86,5831.00,0.00
2024-12-08 16:54:55,86,4686,36,50,3243.70,5831.01,0.00
2024-12-08 16:54:55,86,4687,36,50,3281.95,5832.00,0.00
2024-12-08 16:54:55,87,4687,36,51,3244.23,5832.01,0.00
2024-12-08 16:54:55,86,4687,36,50,3263.56,5832.08,0.00
2024-12-08 16:54:55,85,4687,35,50,3291.13,5832.25,0.00
2024-12-08 16:54:55,85,4688,35,50,3283.40,5833.00,0.00
2024-12-08 16:54:55,86,4688,36,50,3245.22,5833.01,0.00
2024-12-08 16:54:55,85,4688,36,49,3269.70,5833.06,0.00
2024-12-08 16:54:55,85,4689,36,49,3246.73,5834.00,0.00
2024-12-08 16:54:55,86,4689,36,50,3208.98,5834.01,0.00
2024-12-08 16:54:55,85,4689,35,50,3220.84,5834.06,0.00
2024-12-08 16:54:55,85,4690,35,50,3211.59,5835.00,0.00
2024-12-08 16:54:55,86,4690,35,51,3174.25,5835.01,0.00
2024-12-08 16:54:55,85,4690,35,50,3199.12,5835.06,0.00
2024-12-08 16:54:55,86,4689,36,50,3140.44,5835.38,0.00
2024-12-08 16:54:55,86,4690,36,50,3168.09,5836.00,0.00
2024-12-08 16:54:55,87,4690,37,50,3131.67,5836.01,0.00
2024-12-08 16:54:55,88,4689,38,50,3094.11,5836.07,0.00
2024-12-08 16:54:55,88,4690,38,50,3136.56,5837.00,0.00
2024-12-08 16:54:55,89,4690,39,50,3101.31,5837.01,0.00
2024-12-08 16:54:55,90,4689,39,51,3064.92,5837.07,0.00
2024-12-08 16:54:55,89,4689,39,50,3096.38,5837.07,0.00
2024-12-08 16:54:55,88,4689,39,49,3127.73,5837.13,0.00
2024-12-08 16:54:55,87,4689,38,49,3157.68,5837.23,0.00
2024-12-08 16:54:55,86,4689,37,49,3180.95,5837.41,0.00
2024-12-08 16:54:55,87,4688,38,49,3143.72,5837.44,0.00
2024-12-08 16:54:55,87,4689,38,49,3229.36,5838.00,0.00
2024-12-08 16:54:55,88,4689,38,50,3192.67,5838.01,0.00
2024-12-08 16:54:55,89,4688,38,51,3129.88,5838.26,0.00
2024-12-08 16:54:55,88,4688,37,51,3165.89,5838.68,0.00
2024-12-08 16:54:55,87,4688,36,51,3186.32,5838.86,0.00
2024-12-08 16:54:55,87,4689,36,51,3378.09,5839.00,0.00
2024-12-08 16:54:55,88,4689,37,51,3339.70,5839.01,0.00
2024-12-08 16:54:55,87,4689,37,50,3370.79,5839.07,0.00
2024-12-08 16:54:56,87,4690,37,50,3410.13,5840.00,0.00
2024-12-08 16:54:56,88,4690,37,51,3371.38,5840.01,0.00
2024-12-08 16:54:56,88,4691,37,51,3333.42,5841.00,0.00
2024-12-08 16:54:56,89,4691,37,52,3295.97,5841.01,0.00
2024-12-08 16:54:56,88,4691,37,51,3322.03,5841.10,0.00
2024-12-08 16:54:56,88,4692,37,51,3302.21,5842.00,0.00
2024-12-08 16:54:56,89,4692,37,52,3265.11,5842.01,0.00
2024-12-08 16:54:56,89,4693,37,52,3218.31,5843.00,0.00
2024-12-08 16:54:56,90,4693,38,52,3182.55,5843.01,0.00
2024-12-08 16:54:56,89,4693,38,51,3206.24,5843.10,0.00
2024-12-08 16:54:56,88,4693,37,51,3199.84,5843.46,0.00
2024-12-08 16:54:56,88,4694,37,51,3227.99,5844.00,0.00
2024-12-08 16:54:56,89,4694,37,52,3191.72,5844.01,0.00
2024-12-08 16:54:56,88,4694,36,52,3200.83,5844.16,0.00
2024-12-08 16:54:56,89,4693,37,52,3151.46,5844.34,0.00
2024-12-08 16:54:56,89,4694,37,52,3203.84,5845.00,0.00
2024-12-08 16:54:56,90,4694,37,53,3168.24,5845.01,0.00
2024-12-08 16:54:56,89,4694,37,52,3188.54,5845.06,0.00
2024-12-08 16:54:56,89,4695,37,52,3224.38,5846.00,0.00
2024-12-08 16:54:56,90,4695,37,53,3188.56,5846.01,0.00
2024-12-08 16:54:56,89,4695,37,52,3217.18,5846.09,0.00
2024-12-08 16:54:56,90,4694,37,53,3165.95,5846.38,0.00
2024-12-08 16:54:56,89,4694,36,53,3202.50,5846.70,0.00
2024-12-08 16:54:56,89,4695,36,53,3222.37,5847.00,0.00
2024-12-08 16:54:56,90,4695,37,53,3186.57,5847.01,0.00
2024-12-08 16:54:56,89,4695,36,53,3187.27,5847.28,0.00
2024-12-08 16:54:56,90,4694,37,53,3149.28,5847.34,0.00
2024-12-08 16:54:56,91,4693,38,53,3168.69,5847.53,0.00
2024-12-08 16:54:56,91,4694,38,53,3285.11,5848.00,0.00
2024-12-08 16:54:56,92,4694,38,54,3249.40,5848.01,0.00
2024-12-08 16:54:56,91,4694,38,53,3266.40,5848.14,0.00
2024-12-08 16:54:56,90,4694,37,53,3298.17,5848.22,0.00
2024-12-08 16:54:56,90,4695,37,53,3410.39,5849.00,0.00
2024-12-08 16:54:56,91,4695,37,54,3372.91,5849.01,0.00
2024-12-08 16:54:56,90,4695,36,54,3355.33,5849.44,0.00
2024-12-08 16:54:56,90,4696,36,54,3373.76,5850.00,0.00
2024-12-08 16:54:56,91,4696,37,54,3336.69,5850.01,0.00
2024-12-08 16:54:56,90,4696,37,53,3358.87,5850.15,0.00
2024-12-08 16:54:56,90,4697,37,53,3336.51,5851.00,0.00
2024-12-08 16:54:56,91,4697,37,54,3299.85,5851.01,0.00
2024-12-08 16:54:56,91,4698,37,54,3259.93,5852.00,0.00
2024-12-08 16:54:56,92,4698,37,55,3224.50,5852.01,0.00
2024-12-08 16:54:56,92,4699,37,55,3159.80,5853.00,0.00
2024-12-08 16:54:56,93,4699,38,55,3125.83,5853.01,0.00
2024-12-08 16:54:56,92,4699,38,54,3143.58,5853.14,0.00
2024-12-08 16:54:56,91,4699,38,53,3166.67,5853.29,0.00
2024-12-08 16:54:56,90,4699,37,53,3198.91,5853.29,0.00
2024-12-08 16:54:56,91,4698,38,53,3146.73,5853.54,0.00
2024-12-08 16:54:56,92,4697,38,54,3144.68,5853.82,0.00
2024-12-08 16:54:56,92,4698,38,54,3251.07,5854.00,0.00
2024-12-08 16:54:56,93,4698,39,54,3216.12,5854.01,0.00
2024-12-08 16:54:56,92,4698,39,53,3227.29,5854.12,0.00
2024-12-08 16:54:56,91,4698,39,52,3239.85,5854.46,0.00
2024-12-08 16:54:56,91,4699,39,52,3349.25,5855.00,0.00
2024-12-08 16:54:56,92,4699,40,52,3312.84,5855.01,0.00
2024-12-08 16:54:56,91,4699,39,52,3307.12,5855.34,0.00
2024-12-08 16:54:56,91,4700,39,52,3303.01,5856.00,0.00
2024-12-08 16:54:56,92,4700,39,53,3267.11,5856.01,0.00
2024-12-08 16:54:56,91,4700,39,52,3290.99,5856.13,0.00
2024-12-08 16:54:56,92,4699,39,53,3222.92,5856.60,0.00
2024-12-08 16:54:56,92,4700,39,53,3252.40,5857.00,0.00
2024-12-08 16:54:56,93,4700,39,54,3217.42,5857.01,0.00
2024-12-08 16:54:56,92,4700,39,53,3236.47,5857.11,0.00
2024-12-08 16:54:56,92,4701,39,53,3257.69,5858.00,0.00
2024-12-08 16:54:56,93,4701,40,53,3222.66,5858.01,0.00
2024-12-08 16:54:56,92,4701,39,53,3219.51,5858.14,0.00
2024-12-08 16:54:56,92,4702,39,53,3201.19,5859.00,0.00
2024-12-08 16:54:56,93,4702,39,54,3166.76,5859.01,0.00
2024-12-08 16:54:56,92,4702,39,53,3192.29,5859.12,0.00
2024-12-08 16:54:56,91,4702,38,53,3220.34,5859.23,0.00
2024-12-08 16:54:56,90,4702,38,52,3215.60,5859.70,0.00
2024-12-08 16:54:56,90,4703,38,52,3215.58,5860.00,0.00
2024-12-08 16:54:56,91,4703,38,53,3180.24,5860.01,0.00
2024-12-08 16:54:56,90,4703,37,53,3214.93,5860.01,0.00
2024-12-08 16:54:56,89,4703,36,53,3213.54,5860.12,0.00
2024-12-08 16:54:56,90,4702,37,53,3139.17,5860.62,0.00
2024-12-08 16:54:56,89,4702,36,53,3151.76,5860.93,0.00
2024-12-08 16:54:56,89,4703,36,53,3208.85,5861.00,0.00
2024-12-08 16:54:56,90,4703,37,53,3173.20,5861.01,0.00
2024-12-08 16:54:56,91,4702,38,53,3082.61,5861.59,0.00
2024-12-08 16:54:56,91,4703,38,53,3175.18,5862.00,0.00
2024-12-08 16:54:56,92,4703,39,53,3140.67,5862.01,0.00
2024-12-08 16:54:57,91,4703,39,52,3135.97,5862.41,0.00
2024-12-08 16:54:57,91,4704,39,52,3181.28,5863.00,0.00
2024-12-08 16:54:57,92,4704,39,53,3146.70,5863.01,0.00
2024-12-08 16:54:57,92,4705,39,53,3084.28,5864.00,0.00
2024-12-08 16:54:57,93,4705,39,54,3051.11,5864.01,0.00
2024-12-08 16:54:57,92,4705,39,53,3081.73,5864.04,0.00
2024-12-08 16:54:57,91,4705,39,52,3111.74,5864.10,0.00
2024-12-08 16:54:57,90,4705,39,51,3138.50,5864.10,0.00
2024-12-08 16:54:57,89,4705,38,51,3140.94,5864.58,0.00
2024-12-08 16:54:57,88,4705,37,51,3147.54,5864.85,0.00
2024-12-08 16:54:57,88,4706,37,51,3174.89,5865.00,0.00
2024-12-08 16:54:57,89,4706,38,51,3139.22,5865.01,0.00
2024-12-08 16:54:57,88,4706,38,50,3172.23,5865.05,0.00
2024-12-08 16:54:57,87,4706,38,49,3189.33,5865.14,0.00
2024-12-08 16:54:57,86,4706,38,48,3179.60,5865.73,0.00
2024-12-08 16:54:57,86,4707,38,48,3195.52,5866.00,0.00
2024-12-08 16:54:57,87,4707,39,48,3158.79,5866.01,0.00
2024-12-08 16:54:57,86,4707,39,47,3192.80,5866.05,0.00
2024-12-08 16:54:57,85,4707,39,46,3226.23,5866.08,0.00
2024-12-08 16:54:57,86,4706,40,46,3183.98,5866.19,0.00
2024-12-08 16:54:57,86,4707,40,46,3206.70,5867.00,0.00
2024-12-08 16:54:57,87,4707,41,46,3169.84,5867.01,0.00
2024-12-08 16:54:57,86,4707,40,46,3197.84,5867.02,0.00
2024-12-08 16:54:57,85,4707,39,46,3172.10,5867.71,0.00
2024-12-08 16:54:57,85,4708,39,46,3285.43,5868.00,0.00
2024-12-08 16:54:57,86,4708,40,46,3247.23,5868.01,0.00
2024-12-08 16:54:57,85,4708,40,45,3270.26,5868.07,0.00
2024-12-08 16:54:57,84,4708,39,45,3302.27,5868.19,0.00
2024-12-08 16:54:57,83,4708,39,44,3298.42,5868.76,0.00
2024-12-08 16:54:57,83,4709,39,44,3323.76,5869.00,0.00
2024-12-08 16:54:57,84,4709,40,44,3284.19,5869.01,0.00
2024-12-08 16:54:57,85,4708,41,44,3245.55,5869.04,0.00
2024-12-08 16:54:57,85,4709,41,44,3270.66,5870.00,0.00
2024-12-08 16:54:57,86,4709,41,45,3232.63,5870.01,0.00
2024-12-08 16:54:57,85,4709,41,44,3268.60,5870.04,0.00
2024-12-08 16:54:57,84,4709,40,44,3244.52,5870.73,0.00
2024-12-08 16:54:57,84,4710,40,44,3347.78,5871.00,0.00
2024-12-08 16:54:57,85,4710,40,45,3308.40,5871.01,0.00
2024-12-08 16:54:57,86,4709,40,46,3244.74,5871.23,0.00
2024-12-08 16:54:57,87,4708,40,47,3212.47,5871.40,0.00
2024-12-08 16:54:57,87,4709,40,47,3250.79,5872.00,0.00
2024-12-08 16:54:57,88,4709,41,47,3213.85,5872.01,0.00
2024-12-08 16:54:57,87,4709,41,46,3239.33,5872.06,0.00
2024-12-08 16:54:57,86,4709,40,46,3269.54,5872.19,0.00
2024-12-08 16:54:57,85,4709,40,45,3264.59,5872.69,0.00
2024-12-08 16:54:57,85,4710,40,45,3426.04,5873.00,0.00
2024-12-08 16:54:57,86,4710,41,45,3386.20,5873.01,0.00
2024-12-08 16:54:57,85,4710,40,45,3398.39,5873.04,0.00
2024-12-08 16:54:57,84,4710,40,44,3424.17,5873.05,0.00
2024-12-08 16:54:57,83,4710,39,44,3403.33,5873.93,0.00
2024-12-08 16:54:57,83,4711,39,44,3469.92,5874.00,0.00
2024-12-08 16:54:57,84,4711,40,44,3428.61,5874.01,0.00
2024-12-08 16:54:57,84,4712,40,44,3403.87,5875.00,0.00
2024-12-08 16:54:57,85,4712,41,44,3363.82,5875.01,0.00
2024-12-08 16:54:57,84,4712,41,43,3401.78,5875.04,0.00
2024-12-08 16:54:57,83,4712,41,42,3409.86,5875.24,0.00
2024-12-08 16:54:57,83,4713,41,42,3408.35,5876.00,0.00
2024-12-08 16:54:57,84,4713,42,42,3367.77,5876.01,0.00
2024-12-08 16:54:57,83,4713,42,41,3371.81,5876.33,0.00
2024-12-08 16:54:57,84,4712,43,41,3308.90,5876.68,0.00
2024-12-08 16:54:57,84,4713,43,41,3346.83,5877.00,0.00
2024-12-08 16:54:57,85,4713,44,41,3307.46,5877.01,0.00
2024-12-08 16:54:57,84,4713,43,41,3344.00,5877.02,0.00
2024-12-08 16:54:57,83,4713,43,40,3383.58,5877.02,0.00
2024-12-08 16:54:57,82,4713,42,40,3386.09,5877.60,0.00
2024-12-08 16:54:57,82,4714,42,40,3476.68,5878.00,0.00
2024-12-08 16:54:57,83,4714,43,40,3434.79,5878.01,0.00
2024-12-08 16:54:57,82,4714,42,40,3436.40,5878.45,0.00
2024-12-08 16:54:57,81,4714,41,40,3462.50,5878.54,0.00
2024-12-08 16:54:57,81,4715,41,40,3507.93,5879.00,0.00
2024-12-08 16:54:57,82,4715,41,41,3465.15,5879.01,0.00
2024-12-08 16:54:57,81,4715,41,40,3505.04,5879.04,0.00
2024-12-08 16:54:57,80,4715,40,40,3542.81,5879.14,0.00
2024-12-08 16:54:57,80,4716,40,40,3535.94,5880.00,0.00
2024-12-08 16:54:57,81,4716,40,41,3492.29,5880.01,0.00
2024-12-08 16:54:57,80,4716,39,41,3511.72,5880.09,0.00
2024-12-08 16:54:57,80,4717,39,41,3515.93,5881.00,0.00
2024-12-08 16:54:57,81,4717,39,42,3472.52,5881.01,0.00
2024-12-08 16:54:57,80,4717,39,41,3505.67,5881.09,0.00
2024-12-08 16:54:57,81,4716,40,41,3449.09,5881.27,0.00
2024-12-08 16:54:57,80,4716,39,41,3454.18,5881.60,0.00
2024-12-08 16:54:57,81,4715,40,41,3404.35,5881.74,0.00
2024-12-08 16:54:57,81,4716,40,41,3471.98,5882.00,0.00
2024-12-08 16:54:57,82,4716,41,41,3429.64,5882.01,0.00
2024-12-08 16:54:57,82,4717,41,41,3537.07,5883.00,0.00
2024-12-08 16:54:57,83,4717,42,41,3494.45,5883.01,0.00
2024-12-08 16:54:57,82,4717,42,40,3527.06,5883.09,0.00
2024-12-08 16:54:57,81,4717,41,40,3562.05,5883.19,0.00
2024-12-08 16:54:57,81,4718,41,40,3556.50,5884.00,0.00
2024-12-08 16:54:57,82,4718,42,40,3513.13,5884.01,0.00
2024-12-08 16:54:58,82,4719,42,40,3500.42,5885.00,0.00
2024-12-08 16:54:58,83,4719,42,41,3458.25,5885.01,0.00
2024-12-08 16:54:58,83,4720,42,41,3430.84,5886.00,0.00
2024-12-08 16:54:58,84,4720,43,41,3390.00,5886.01,0.00
2024-12-08 16:54:58,83,4720,42,41,3349.82,5886.83,0.00
2024-12-08 16:54:58,83,4721,42,41,3409.11,5887.00,0.00
2024-12-08 16:54:58,84,4721,43,41,3368.53,5887.01,0.00
2024-12-08 16:54:58,83,4721,43,40,3400.85,5887.08,0.00
2024-12-08 16:54:58,82,4721,43,39,3432.61,5887.12,0.00
2024-12-08 16:54:58,82,4722,43,39,3419.05,5888.00,0.00
2024-12-08 16:54:58,83,4722,44,39,3377.85,5888.01,0.00
2024-12-08 16:54:58,83,4723,44,39,3301.36,5889.00,0.00
2024-12-08 16:54:58,84,4723,44,40,3262.06,5889.01,0.00
2024-12-08 16:54:58,83,4723,44,39,3292.88,5889.10,0.00
2024-12-08 16:54:58,84,4722,45,39,3247.41,5889.23,0.00
2024-12-08 16:54:58,83,4722,45,38,3293.63,5889.58,0.00
2024-12-08 16:54:58,82,4722,44,38,3331.63,5889.62,0.00
2024-12-08 16:54:58,82,4723,44,38,3346.02,5890.00,0.00
2024-12-08 16:54:58,83,4723,45,38,3305.70,5890.01,0.00
2024-12-08 16:54:58,82,4723,45,37,3309.32,5890.10,0.00
2024-12-08 16:54:58,82,4724,45,37,3392.58,5891.00,0.00
2024-12-08 16:54:58,83,4724,46,37,3351.71,5891.01,0.00
2024-12-08 16:54:58,82,4724,45,37,3343.36,5891.16,0.00
2024-12-08 16:54:58,82,4725,45,37,3359.04,5892.00,0.00
2024-12-08 16:54:58,83,4725,45,38,3318.57,5892.01,0.00
2024-12-08 16:54:58,82,4725,45,37,3347.57,5892.11,0.00
2024-12-08 16:54:58,82,4726,45,37,3333.70,5893.00,0.00
2024-12-08 16:54:58,83,4726,45,38,3293.54,5893.01,0.00
2024-12-08 16:54:58,83,4727,45,38,3252.15,5894.00,0.00
2024-12-08 16:54:58,84,4727,45,39,3213.43,5894.01,0.00
2024-12-08 16:54:58,83,4727,45,38,3241.53,5894.11,0.00
2024-12-08 16:54:58,82,4727,44,38,3252.62,5894.40,0.00
2024-12-08 16:54:58,83,4726,44,39,3172.26,5894.90,0.00
2024-12-08 16:54:58,83,4727,44,39,3269.10,5895.00,0.00
2024-12-08 16:54:58,84,4727,44,40,3230.18,5895.01,0.00
2024-12-08 16:54:58,83,4727,43,40,3200.09,5895.51,0.00
2024-12-08 16:54:58,83,4728,43,40,3301.00,5896.00,0.00
2024-12-08 16:54:58,84,4728,44,40,3261.70,5896.01,0.00
2024-12-08 16:54:58,83,4728,44,39,3288.24,5896.12,0.00
2024-12-08 16:54:58,83,4729,44,39,3275.01,5897.00,0.00
2024-12-08 16:54:58,84,4729,45,39,3236.03,5897.01,0.00
2024-12-08 16:54:58,84,4730,45,39,3213.62,5898.00,0.00
2024-12-08 16:54:58,85,4730,46,39,3175.81,5898.01,0.00
2024-12-08 16:54:58,85,4731,46,39,3135.99,5899.00,0.00
2024-12-08 16:54:58,86,4731,47,39,3099.53,5899.01,0.00
2024-12-08 16:54:58,85,4731,47,38,3076.18,5899.62,0.00
2024-12-08 16:54:58,85,4732,47,38,3079.95,5900.00,0.00
2024-12-08 16:54:58,86,4732,48,38,3044.14,5900.01,0.00
2024-12-08 16:54:58,86,4733,48,38,2980.91,5901.00,0.00
2024-12-08 16:54:58,87,4733,48,39,2946.65,5901.01,0.00
2024-12-08 16:54:58,86,4733,48,38,2978.86,5901.04,0.00
2024-12-08 16:54:58,85,4733,48,37,3009.06,5901.11,0.00
2024-12-08 16:54:58,84,4733,47,37,3038.63,5901.13,0.00
2024-12-08 16:54:58,84,4734,47,37,3002.91,5902.00,0.00
2024-12-08 16:54:58,85,4734,48,37,2967.58,5902.01,0.00
2024-12-08 16:54:58,84,4734,47,37,2957.98,5902.16,0.00
2024-12-08 16:54:58,84,4735,47,37,2957.46,5903.00,0.00
2024-12-08 16:54:58,85,4735,47,38,2922.66,5903.01,0.00
2024-12-08 16:54:58,84,4735,47,37,2942.51,5903.13,0.00
2024-12-08 16:54:58,84,4736,47,37,2920.56,5904.00,0.00
2024-12-08 16:54:58,85,4736,47,38,2886.21,5904.01,0.00
2024-12-08 16:54:58,84,4736,46,38,2917.77,5904.05,0.00
2024-12-08 16:54:58,83,4736,45,38,2952.21,5904.05,0.00
2024-12-08 16:54:58,82,4736,44,38,2973.66,5904.09,0.00
2024-12-08 16:54:58,83,4735,44,39,2916.53,5904.23,0.00
2024-12-08 16:54:58,84,4734,45,39,2889.70,5904.79,0.00
2024-12-08 16:54:58,84,4735,45,39,3009.35,5905.00,0.00
2024-12-08 16:54:58,85,4735,46,39,2973.94,5905.01,0.00
2024-12-08 16:54:58,84,4735,46,38,2998.83,5905.10,0.00
2024-12-08 16:54:58,83,4735,46,37,2990.72,5905.34,0.00
2024-12-08 16:54:58,83,4736,46,37,3156.75,5906.00,0.00
2024-12-08 16:54:58,84,4736,47,37,3119.17,5906.01,0.00
2024-12-08 16:54:58,84,4737,47,37,3095.61,5907.00,0.00
2024-12-08 16:54:58,85,4737,48,37,3059.20,5907.01,0.00
2024-12-08 16:54:58,84,4737,47,37,3094.54,5907.02,0.00
2024-12-08 16:54:58,83,4737,46,37,3108.28,5907.17,0.00
2024-12-08 16:54:58,82,4737,45,37,3109.53,5907.71,0.00
2024-12-08 16:54:58,82,4738,45,37,3141.35,5908.00,0.00
2024-12-08 16:54:58,83,4738,45,38,3103.50,5908.01,0.00
2024-12-08 16:54:58,82,4738,45,37,3126.07,5908.09,0.00
2024-12-08 16:54:58,82,4739,45,37,3113.77,5909.00,0.00
2024-12-08 16:54:58,83,4739,46,37,3076.25,5909.01,0.00
2024-12-08 16:54:58,82,4739,46,36,3098.44,5909.09,0.00
2024-12-08 16:54:59,83,4738,47,36,3017.96,5909.81,0.00
2024-12-08 16:54:59,83,4739,47,36,3078.48,5910.00,0.00
2024-12-08 16:54:59,84,4739,47,37,3041.83,5910.01,0.00
2024-12-08 16:54:59,83,4739,47,36,3061.12,5910.12,0.00
2024-12-08 16:54:59,83,4740,47,36,3114.64,5911.00,0.00
2024-12-08 16:54:59,84,4740,48,36,3077.56,5911.01,0.00
2024-12-08 16:54:59,84,4741,48,36,3031.03,5912.00,0.00
2024-12-08 16:54:59,85,4741,49,36,2995.37,5912.01,0.00
2024-12-08 16:54:59,84,4741,49,35,3028.93,5912.04,0.00
2024-12-08 16:54:59,83,4741,49,34,3059.79,5912.11,0.00
2024-12-08 16:54:59,83,4742,49,34,3036.23,5913.00,0.00
2024-12-08 16:54:59,84,4742,50,34,3000.09,5913.01,0.00
2024-12-08 16:54:59,84,4743,50,34,2978.14,5914.00,0.00
2024-12-08 16:54:59,85,4743,50,35,2943.10,5914.01,0.00
2024-12-08 16:54:59,85,4744,50,35,2924.50,5915.00,0.00
2024-12-08 16:54:59,86,4744,50,36,2890.50,5915.01,0.00
2024-12-08 16:54:59,85,4744,49,36,2861.59,5915.64,0.00
2024-12-08 16:54:59,86,4743,50,36,2817.85,5915.80,0.00
2024-12-08 16:54:59,86,4744,50,36,2880.50,5916.00,0.00
2024-12-08 16:54:59,87,4744,51,36,2847.39,5916.01,0.00
2024-12-08 16:54:59,87,4745,51,36,2878.63,5917.00,0.00
2024-12-08 16:54:59,88,4745,51,37,2845.92,5917.01,0.00
2024-12-08 16:54:59,87,4745,51,36,2876.60,5917.04,0.00
2024-12-08 16:54:59,86,4745,51,35,2900.41,5917.10,0.00
2024-12-08 16:54:59,85,4745,51,34,2932.76,5917.13,0.00
2024-12-08 16:54:59,85,4746,51,34,2913.33,5918.00,0.00
2024-12-08 16:54:59,86,4746,51,35,2879.46,5918.01,0.00
2024-12-08 16:54:59,87,4745,51,36,2841.35,5918.08,0.00
2024-12-08 16:54:59,86,4745,50,36,2879.23,5918.13,0.00
2024-12-08 16:54:59,86,4746,50,36,2888.17,5919.00,0.00
2024-12-08 16:54:59,87,4746,50,37,2854.97,5919.01,0.00
2024-12-08 16:54:59,88,4745,51,37,2821.19,5919.06,0.00
2024-12-08 16:54:59,87,4745,50,37,2892.13,5919.22,0.00
2024-12-08 16:54:59,86,4745,49,37,2893.00,5919.72,0.00
2024-12-08 16:54:59,86,4746,49,37,2984.92,5920.00,0.00
2024-12-08 16:54:59,87,4746,50,37,2950.61,5920.01,0.00
2024-12-08 16:54:59,86,4746,50,36,2975.89,5920.09,0.00
2024-12-08 16:54:59,85,4746,49,36,2933.61,5920.94,0.00
2024-12-08 16:54:59,85,4747,49,36,3069.48,5921.00,0.00
2024-12-08 16:54:59,86,4747,50,36,3033.79,5921.01,0.00
2024-12-08 16:54:59,85,4747,49,36,3041.37,5921.21,0.00
2024-12-08 16:54:59,84,4747,48,36,3065.13,5921.42,0.00
2024-12-08 16:54:59,83,4747,47,36,3094.03,5921.52,0.00
2024-12-08 16:54:59,83,4748,47,36,3128.53,5922.00,0.00
2024-12-08 16:54:59,84,4748,48,36,3091.28,5922.01,0.00
2024-12-08 16:54:59,83,4748,48,35,3122.56,5922.10,0.00
2024-12-08 16:54:59,82,4748,48,34,3157.75,5922.10,0.00
2024-12-08 16:54:59,82,4749,48,34,3134.92,5923.00,0.00
2024-12-08 16:54:59,83,4749,49,34,3097.15,5923.01,0.00
2024-12-08 16:54:59,82,4749,48,34,3090.26,5923.37,0.00
2024-12-08 16:54:59,81,4749,47,34,3097.35,5923.82,0.00
2024-12-08 16:54:59,81,4750,47,34,3158.25,5924.00,0.00
2024-12-08 16:54:59,82,4750,48,34,3119.74,5924.01,0.00
2024-12-08 16:54:59,81,4750,48,33,3150.98,5924.10,0.00
2024-12-08 16:54:59,82,4749,49,33,3064.01,5924.87,0.00
2024-12-08 16:54:59,82,4750,49,33,3105.77,5925.00,0.00
2024-12-08 16:54:59,83,4750,50,33,3068.36,5925.01,0.00
2024-12-08 16:54:59,82,4750,49,33,3084.53,5925.12,0.00
2024-12-08 16:54:59,81,4750,48,33,3116.79,5925.21,0.00
2024-12-08 16:54:59,81,4751,48,33,3182.28,5926.00,0.00
2024-12-08 16:54:59,82,4751,48,34,3143.47,5926.01,0.00
2024-12-08 16:54:59,81,4751,48,33,3174.69,5926.10,0.00
2024-12-08 16:54:59,80,4751,47,33,3206.94,5926.20,0.00
2024-12-08 16:54:59,81,4750,48,33,3145.75,5926.57,0.00
2024-12-08 16:54:59,81,4751,48,33,3199.68,5927.00,0.00
2024-12-08 16:54:59,82,4751,48,34,3160.66,5927.01,0.00
2024-12-08 16:54:59,81,4751,47,34,3149.43,5927.41,0.00
2024-12-08 16:54:59,82,4750,48,34,3092.74,5927.67,0.00
2024-12-08 16:54:59,81,4750,47,34,3138.92,5927.72,0.00
2024-12-08 16:54:59,81,4751,47,34,3267.82,5928.00,0.00
2024-12-08 16:54:59,82,4751,47,35,3227.97,5928.01,0.00
2024-12-08 16:54:59,81,4751,47,34,3260.39,5928.10,0.00
2024-12-08 16:54:59,80,4751,46,34,3295.25,5928.20,0.00
2024-12-08 16:54:59,80,4752,46,34,3351.14,5929.00,0.00
2024-12-08 16:54:59,81,4752,47,34,3309.77,5929.01,0.00
2024-12-08 16:54:59,81,4753,47,34,3272.62,5930.00,0.00
2024-12-08 16:54:59,82,4753,48,34,3232.71,5930.01,0.00
2024-12-08 16:54:59,82,4754,48,34,3185.02,5931.00,0.00
2024-12-08 16:54:59,83,4754,49,34,3146.65,5931.01,0.00
2024-12-08 16:54:59,82,4754,49,33,3170.70,5931.10,0.00
2024-12-08 16:54:59,82,4755,49,33,3143.35,5932.00,0.00
2024-12-08 16:54:59,83,4755,50,33,3105.48,5932.01,0.00
2024-12-08 16:54:59,82,4755,49,33,3099.00,5932.39,0.00
2024-12-08 16:54:59,82,4756,49,33,3103.82,5933.00,0.00
2024-12-08 16:54:59,83,4756,50,33,3066.43,5933.01,0.00
2024-12-08 16:54:59,83,4757,50,33,3019.41,5934.00,0.00
2024-12-08 16:54:59,84,4757,50,34,2983.47,5934.01,0.00
2024-12-08 16:54:59,85,4756,50,35,2939.25,5934.11,0.00
2024-12-08 16:55:00,84,4756,50,34,3033.61,5934.16,0.00
2024-12-08 16:55:00,83,4756,49,34,3031.02,5934.60,0.00
2024-12-08 16:55:00,83,4757,49,34,3050.12,5935.00,0.00
2024-12-08 16:55:00,84,4757,49,35,3013.80,5935.01,0.00
2024-12-08 16:55:00,85,4756,49,36,2872.29,5935.94,0.00
2024-12-08 16:55:00,85,4757,49,36,3039.23,5936.00,0.00
2024-12-08 16:55:00,86,4757,49,37,3003.89,5936.01,0.00
2024-12-08 16:55:00,85,4757,48,37,3036.99,5936.02,0.00
2024-12-08 16:55:00,84,4757,47,37,3069.90,5936.06,0.00
2024-12-08 16:55:00,83,4757,47,36,3096.89,5936.12,0.00
2024-12-08 16:55:00,82,4757,46,36,3124.50,5936.23,0.00
2024-12-08 16:55:00,81,4757,45,36,3154.93,5936.35,0.00
2024-12-08 16:55:00,80,4757,44,36,3168.75,5936.44,0.00
2024-12-08 16:55:00,80,4758,44,36,3273.80,5937.00,0.00
2024-12-08 16:55:00,81,4758,44,37,3233.38,5937.01,0.00
2024-12-08 16:55:00,80,4758,43,37,3262.92,5937.13,0.00
2024-12-08 16:55:00,79,4758,42,37,3283.96,5937.22,0.00
2024-12-08 16:55:00,78,4758,41,37,3324.54,5937.22,0.00
2024-12-08 16:55:00,78,4759,41,37,3343.24,5938.00,0.00
2024-12-08 16:55:00,79,4759,41,38,3300.92,5938.01,0.00
2024-12-08 16:55:00,78,4759,41,37,3325.02,5938.15,0.00
2024-12-08 16:55:00,77,4759,40,37,3339.68,5938.18,0.00
2024-12-08 16:55:00,77,4760,40,37,3352.72,5939.00,0.00
2024-12-08 16:55:00,78,4760,41,37,3309.74,5939.01,0.00
2024-12-08 16:55:00,79,4759,42,37,3232.62,5939.38,0.00
2024-12-08 16:55:00,79,4760,42,37,3234.97,5940.00,0.00
2024-12-08 16:55:00,80,4760,42,38,3194.54,5940.01,0.00
2024-12-08 16:55:00,79,4760,42,37,3217.73,5940.15,0.00
2024-12-08 16:55:00,78,4760,41,37,3237.72,5940.40,0.00
2024-12-08 16:55:00,77,4760,40,37,3230.68,5940.70,0.00
2024-12-08 16:55:00,77,4761,40,37,3364.10,5941.00,0.00
2024-12-08 16:55:00,78,4761,41,37,3320.97,5941.01,0.00
2024-12-08 16:55:00,77,4761,40,37,3361.89,5941.04,0.00
2024-12-08 16:55:00,76,4761,39,37,3369.87,5941.21,0.00
2024-12-08 16:55:00,75,4761,38,37,3387.19,5941.45,0.00
2024-12-08 16:55:00,75,4762,38,37,3428.03,5942.00,0.00
2024-12-08 16:55:00,76,4762,39,37,3382.93,5942.01,0.00
2024-12-08 16:55:00,75,4762,38,37,3422.28,5942.11,0.00
2024-12-08 16:55:00,74,4762,38,36,3458.90,5942.14,0.00
2024-12-08 16:55:00,73,4762,37,36,3492.06,5942.36,0.00
2024-12-08 16:55:00,73,4763,37,36,3489.33,5943.00,0.00
2024-12-08 16:55:00,74,4763,37,37,3442.17,5943.01,0.00
2024-12-08 16:55:00,73,4763,36,37,3460.90,5943.21,0.00
2024-12-08 16:55:00,73,4764,36,37,3448.71,5944.00,0.00
2024-12-08 16:55:00,74,4764,37,37,3402.11,5944.01,0.00
2024-12-08 16:55:00,75,4763,37,38,3356.74,5944.04,0.00
2024-12-08 16:55:00,74,4763,37,37,3441.52,5944.16,0.00
2024-12-08 16:55:00,74,4764,37,37,3417.22,5945.00,0.00
2024-12-08 16:55:00,75,4764,38,37,3371.66,5945.01,0.00
2024-12-08 16:55:00,74,4764,38,36,3391.25,5945.19,0.00
2024-12-08 16:55:00,73,4764,38,35,3424.79,5945.32,0.00
2024-12-08 16:55:00,72,4764,37,35,3443.52,5945.43,0.00
2024-12-08 16:55:00,72,4765,37,35,3566.29,5946.00,0.00
2024-12-08 16:55:00,73,4765,37,36,3517.44,5946.01,0.00
2024-12-08 16:55:00,72,4765,36,36,3549.03,5946.22,0.00
2024-12-08 16:55:00,72,4766,36,36,3561.41,5947.00,0.00
2024-12-08 16:55:00,73,4766,36,37,3512.63,5947.01,0.00
2024-12-08 16:55:00,73,4767,36,37,3473.26,5948.00,0.00
2024-12-08 16:55:00,74,4767,36,38,3426.32,5948.01,0.00
2024-12-08 16:55:00,73,4767,36,37,3457.04,5948.22,0.00
2024-12-08 16:55:00,72,4767,35,37,3453.91,5948.53,0.00
2024-12-08 16:55:00,72,4768,35,37,3492.94,5949.00,0.00
2024-12-08 16:55:00,73,4768,36,37,3445.09,5949.01,0.00
2024-12-08 16:55:00,72,4768,35,37,3393.70,5949.63,0.00
2024-12-08 16:55:00,72,4769,35,37,3451.02,5950.00,0.00
2024-12-08 16:55:00,73,4769,36,37,3403.74,5950.01,0.00
2024-12-08 16:55:00,72,4769,35,37,3443.26,5950.14,0.00
2024-12-08 16:55:00,71,4769,34,37,3444.21,5950.45,0.00
2024-12-08 16:55:00,71,4770,34,37,3456.89,5951.00,0.00
2024-12-08 16:55:00,72,4770,34,38,3408.88,5951.01,0.00
2024-12-08 16:55:00,71,4770,34,37,3442.71,5951.21,0.00
2024-12-08 16:55:00,71,4771,34,37,3440.32,5952.00,0.00
2024-12-08 16:55:00,72,4771,35,37,3392.54,5952.01,0.00
2024-12-08 16:55:00,71,4771,34,37,3426.49,5952.20,0.00
2024-12-08 16:55:00,72,4770,35,37,3347.13,5952.47,0.00
2024-12-08 16:55:00,72,4771,35,37,3419.42,5953.00,0.00
2024-12-08 16:55:00,73,4771,36,37,3372.58,5953.01,0.00
2024-12-08 16:55:00,72,4771,36,36,3414.74,5953.08,0.00
2024-12-08 16:55:00,72,4772,36,36,3469.00,5954.00,0.00
2024-12-08 16:55:00,73,4772,36,37,3421.48,5954.01,0.00
2024-12-08 16:55:00,72,4772,36,36,3458.32,5954.18,0.00
2024-12-08 16:55:00,73,4771,37,36,3376.72,5954.78,0.00
2024-12-08 16:55:00,73,4772,37,36,3443.70,5955.00,0.00
2024-12-08 16:55:00,74,4772,38,36,3397.16,5955.01,0.00
2024-12-08 16:55:00,74,4773,38,36,3462.94,5956.00,0.00
2024-12-08 16:55:00,75,4773,39,36,3416.76,5956.01,0.00
2024-12-08 16:55:00,74,4773,39,35,3458.95,5956.07,0.00
2024-12-08 16:55:00,74,4774,39,35,3433.92,5957.00,0.00
2024-12-08 16:55:00,75,4774,39,36,3388.13,5957.01,0.00
2024-12-08 16:55:00,75,4775,39,36,3347.89,5958.00,0.00
2024-12-08 16:55:00,76,4775,40,36,3303.84,5958.01,0.00
2024-12-08 16:55:01,75,4775,40,35,3335.33,5958.16,0.00
2024-12-08 16:55:01,76,4774,40,36,3277.44,5958.42,0.00
2024-12-08 16:55:01,76,4775,40,36,3307.16,5959.00,0.00
2024-12-08 16:55:01,77,4775,40,37,3264.21,5959.01,0.00
2024-12-08 16:55:01,76,4775,40,36,3303.28,5959.07,0.00
2024-12-08 16:55:01,75,4775,39,36,3298.57,5959.28,0.00
2024-12-08 16:55:01,75,4776,39,36,3401.70,5960.00,0.00
2024-12-08 16:55:01,76,4776,39,37,3356.94,5960.01,0.00
2024-12-08 16:55:01,75,4776,39,36,3381.09,5960.15,0.00
2024-12-08 16:55:01,74,4776,38,36,3426.77,5960.15,0.00
2024-12-08 16:55:01,73,4776,37,36,3469.78,5960.21,0.00
2024-12-08 16:55:01,72,4776,36,36,3486.24,5960.69,0.00
2024-12-08 16:55:01,72,4777,36,36,3505.14,5961.00,0.00
2024-12-08 16:55:01,73,4777,36,37,3457.12,5961.01,0.00
2024-12-08 16:55:01,74,4776,37,37,3406.42,5961.11,0.00
2024-12-08 16:55:01,74,4777,37,37,3462.09,5962.00,0.00
2024-12-08 16:55:01,75,4777,38,37,3415.93,5962.01,0.00
2024-12-08 16:55:01,75,4778,38,37,3459.48,5963.00,0.00
2024-12-08 16:55:01,76,4778,38,38,3413.96,5963.01,0.00
2024-12-08 16:55:01,75,4778,37,38,3451.59,5963.15,0.00
2024-12-08 16:55:01,75,4779,37,38,3412.49,5964.00,0.00
2024-12-08 16:55:01,76,4779,37,39,3367.59,5964.01,0.00
2024-12-08 16:55:01,75,4779,37,38,3399.83,5964.17,0.00
2024-12-08 16:55:01,74,4779,36,38,3430.28,5964.42,0.00
2024-12-08 16:55:01,73,4779,35,38,3437.04,5964.82,0.00
2024-12-08 16:55:01,73,4780,35,38,3498.42,5965.00,0.00
2024-12-08 16:55:01,74,4780,35,39,3451.15,5965.01,0.00
2024-12-08 16:55:01,73,4780,34,39,3446.57,5965.60,0.00
2024-12-08 16:55:01,73,4781,34,39,3457.05,5966.00,0.00
2024-12-08 16:55:01,74,4781,35,39,3410.33,5966.01,0.00
2024-12-08 16:55:01,73,4781,35,38,3431.97,5966.18,0.00
2024-12-08 16:55:01,72,4781,34,38,3415.80,5966.63,0.00
2024-12-08 16:55:01,71,4781,33,38,3440.35,5966.85,0.00
2024-12-08 16:55:01,71,4782,33,38,3510.22,5967.00,0.00
2024-12-08 16:55:01,72,4782,33,39,3461.46,5967.01,0.00
2024-12-08 16:55:01,72,4783,33,39,3417.91,5968.00,0.00
2024-12-08 16:55:01,73,4783,33,40,3371.09,5968.01,0.00
2024-12-08 16:55:01,72,4783,32,40,3413.80,5968.07,0.00
2024-12-08 16:55:01,71,4783,32,39,3444.26,5968.18,0.00
2024-12-08 16:55:01,70,4783,31,39,3468.49,5968.33,0.00
2024-12-08 16:55:01,70,4784,31,39,3493.32,5969.00,0.00
2024-12-08 16:55:01,71,4784,32,39,3444.12,5969.01,0.00
2024-12-08 16:55:01,71,4785,32,39,3416.82,5970.00,0.00
2024-12-08 16:55:01,72,4785,33,39,3369.37,5970.01,0.00
2024-12-08 16:55:01,73,4784,33,40,3281.69,5970.47,0.00
2024-12-08 16:55:01,72,4784,32,40,3371.53,5970.69,0.00
2024-12-08 16:55:01,72,4785,32,40,3395.31,5971.00,0.00
2024-12-08 16:55:01,73,4785,33,40,3348.80,5971.01,0.00
2024-12-08 16:55:01,72,4785,33,39,3372.99,5971.19,0.00
2024-12-08 16:55:01,73,4784,33,40,3324.35,5971.26,0.00
2024-12-08 16:55:01,72,4784,32,40,3346.07,5971.75,0.00
2024-12-08 16:55:01,71,4784,31,40,3389.42,5971.76,0.00
2024-12-08 16:55:01,71,4785,31,40,3505.33,5972.00,0.00
2024-12-08 16:55:01,72,4785,31,41,3456.65,5972.01,0.00
2024-12-08 16:55:01,73,4784,31,42,3344.89,5972.44,0.00
2024-12-08 16:55:01,73,4785,31,42,3517.78,5973.00,0.00
2024-12-08 16:55:01,74,4785,31,43,3470.24,5973.01,0.00
2024-12-08 16:55:01,73,4785,30,43,3454.89,5973.40,0.00
2024-12-08 16:55:01,73,4786,30,43,3568.99,5974.00,0.00
2024-12-08 16:55:01,74,4786,31,43,3520.76,5974.01,0.00
2024-12-08 16:55:01,73,4786,31,42,3556.78,5974.19,0.00
2024-12-08 16:55:01,72,4786,30,42,3550.76,5974.51,0.00
2024-12-08 16:55:01,72,4787,30,42,3598.67,5975.00,0.00
2024-12-08 16:55:01,73,4787,31,42,3549.37,5975.01,0.00
2024-12-08 16:55:01,72,4787,30,42,3513.05,5975.71,0.00
2024-12-08 16:55:01,72,4788,30,42,3578.86,5976.00,0.00
2024-12-08 16:55:01,73,4788,31,42,3529.83,5976.01,0.00
2024-12-08 16:55:01,73,4789,31,42,3504.22,5977.00,0.00
2024-12-08 16:55:01,74,4789,32,42,3456.87,5977.01,0.00
2024-12-08 16:55:01,73,4789,32,41,3492.82,5977.19,0.00
2024-12-08 16:55:01,72,4789,31,41,3514.31,5977.24,0.00
2024-12-08 16:55:01,73,4788,32,41,3435.38,5977.77,0.00
2024-12-08 16:55:01,73,4789,32,41,3547.76,5978.00,0.00
2024-12-08 16:55:01,74,4789,33,41,3499.82,5978.01,0.00
2024-12-08 16:55:01,74,4790,33,41,3557.33,5979.00,0.00
2024-12-08 16:55:01,75,4790,33,42,3509.89,5979.01,0.00
2024-12-08 16:55:01,74,4790,33,41,3551.71,5979.08,0.00
2024-12-08 16:55:01,75,4789,33,42,3500.37,5979.17,0.00
2024-12-08 16:55:01,74,4789,32,42,3584.33,5979.53,0.00
2024-12-08 16:55:01,74,4790,32,42,3604.90,5980.00,0.00
2024-12-08 16:55:01,75,4790,32,43,3556.83,5980.01,0.00
2024-12-08 16:55:01,74,4790,32,42,3579.91,5980.18,0.00
2024-12-08 16:55:01,74,4791,32,42,3658.63,5981.00,0.00
2024-12-08 16:55:01,75,4791,33,42,3609.85,5981.01,0.00
2024-12-08 16:55:01,74,4791,33,41,3645.87,5981.08,0.00
2024-12-08 16:55:01,73,4791,32,41,3694.99,5981.08,0.00
2024-12-08 16:55:01,73,4792,32,41,3704.27,5982.00,0.00
2024-12-08 16:55:01,74,4792,32,42,3654.21,5982.01,0.00
2024-12-08 16:55:01,73,4792,31,42,3678.12,5982.18,0.00
2024-12-08 16:55:01,73,4793,31,42,3696.51,5983.00,0.00
2024-12-08 16:55:01,74,4793,32,42,3646.56,5983.01,0.00
2024-12-08 16:55:01,75,4792,33,42,3596.36,5983.07,0.00
2024-12-08 16:55:02,75,4793,33,42,3636.88,5984.00,0.00
2024-12-08 16:55:02,76,4793,33,43,3589.02,5984.01,0.00
2024-12-08 16:55:02,75,4793,32,43,3611.42,5984.17,0.00
2024-12-08 16:55:02,75,4794,32,43,3684.63,5985.00,0.00
2024-12-08 16:55:02,76,4794,32,44,3636.15,5985.01,0.00
2024-12-08 16:55:02,75,4794,32,43,3671.13,5985.15,0.00
2024-12-08 16:55:02,75,4795,32,43,3663.13,5986.00,0.00
2024-12-08 16:55:02,76,4795,33,43,3614.93,5986.01,0.00
2024-12-08 16:55:02,75,4795,32,43,3600.94,5986.47,0.00
2024-12-08 16:55:02,75,4796,32,43,3644.65,5987.00,0.00
2024-12-08 16:55:02,76,4796,33,43,3596.69,5987.01,0.00
2024-12-08 16:55:02,75,4796,33,42,3625.63,5987.15,0.00
2024-12-08 16:55:02,75,4797,33,42,3618.91,5988.00,0.00
2024-12-08 16:55:02,76,4797,34,42,3571.29,5988.01,0.00
2024-12-08 16:55:02,75,4797,33,42,3603.03,5988.16,0.00
2024-12-08 16:55:02,74,4797,32,42,3616.96,5988.46,0.00
2024-12-08 16:55:02,74,4798,32,42,3664.01,5989.00,0.00
2024-12-08 16:55:02,75,4798,32,43,3615.15,5989.01,0.00
2024-12-08 16:55:02,74,4798,32,42,3659.19,5989.08,0.00
2024-12-08 16:55:02,73,4798,32,41,3687.08,5989.15,0.00
2024-12-08 16:55:02,73,4799,32,41,3685.49,5990.00,0.00
2024-12-08 16:55:02,74,4799,32,42,3635.69,5990.01,0.00
2024-12-08 16:55:02,73,4799,31,42,3610.05,5990.82,0.00
2024-12-08 16:55:02,73,4800,31,42,3681.58,5991.00,0.00
2024-12-08 16:55:02,74,4800,32,42,3631.83,5991.01,0.00
2024-12-08 16:55:02,73,4800,31,42,3651.44,5991.12,0.00
2024-12-08 16:55:02,73,4801,31,42,3664.77,5992.00,0.00
2024-12-08 16:55:02,74,4801,32,42,3615.25,5992.01,0.00
2024-12-08 16:55:02,74,4802,32,42,3585.10,5993.00,0.00
2024-12-08 16:55:02,75,4802,32,43,3537.30,5993.01,0.00
2024-12-08 16:55:02,74,4802,32,42,3566.58,5993.22,0.00
2024-12-08 16:55:02,74,4803,32,42,3568.11,5994.00,0.00
2024-12-08 16:55:02,75,4803,32,43,3520.53,5994.01,0.00
2024-12-08 16:55:02,74,4803,31,43,3546.25,5994.03,0.00
2024-12-08 16:55:02,73,4803,30,43,3586.10,5994.17,0.00
2024-12-08 16:55:02,73,4804,30,43,3601.48,5995.00,0.00
2024-12-08 16:55:02,74,4804,30,44,3552.81,5995.01,0.00
2024-12-08 16:55:02,73,4804,30,43,3589.20,5995.08,0.00
2024-12-08 16:55:02,73,4805,30,43,3583.46,5996.00,0.00
2024-12-08 16:55:02,74,4805,31,43,3535.04,5996.01,0.00
2024-12-08 16:55:02,73,4805,30,43,3549.81,5996.04,0.00
2024-12-08 16:55:02,72,4805,30,42,3575.84,5996.17,0.00
2024-12-08 16:55:02,72,4806,30,42,3609.68,5997.00,0.00
2024-12-08 16:55:02,73,4806,30,43,3560.24,5997.01,0.00
2024-12-08 16:55:02,73,4807,30,43,3532.24,5998.00,0.00
2024-12-08 16:55:02,74,4807,30,44,3484.51,5998.01,0.00
2024-12-08 16:55:02,73,4807,30,43,3508.48,5998.17,0.00
2024-12-08 16:55:02,72,4807,29,43,3543.92,5998.25,0.00
2024-12-08 16:55:02,72,4808,29,43,3576.28,5999.00,0.00
2024-12-08 16:55:02,73,4808,30,43,3527.29,5999.01,0.00
2024-12-08 16:55:02,74,4807,30,44,3424.22,5999.55,0.00
2024-12-08 16:55:02,73,4807,29,44,3493.78,5999.64,0.00
2024-12-08 16:55:02,73,4808,29,44,3553.03,6000.00,0.00
2024-12-08 16:55:02,74,4808,30,44,3505.01,6000.01,0.00
2024-12-08 16:55:02,73,4808,30,43,3530.90,6000.17,0.00
2024-12-08 16:55:02,73,4809,30,43,3600.60,6001.00,0.00
2024-12-08 16:55:02,74,4809,31,43,3551.95,6001.01,0.00
2024-12-08 16:55:02,74,4810,31,43,3514.74,6002.00,0.00
2024-12-08 16:55:02,75,4810,32,43,3467.88,6002.01,0.00
2024-12-08 16:55:02,74,4810,31,43,3492.06,6002.08,0.00
2024-12-08 16:55:02,74,4811,31,43,3495.87,6003.00,0.00
2024-12-08 16:55:02,75,4811,32,43,3449.25,6003.01,0.00
2024-12-08 16:55:02,74,4811,32,42,3492.65,6003.05,0.00
2024-12-08 16:55:02,73,4811,32,41,3522.43,6003.15,0.00
2024-12-08 16:55:02,74,4810,33,41,3441.95,6003.64,0.00
2024-12-08 16:55:02,73,4810,32,41,3505.24,6003.71,0.00
2024-12-08 16:55:02,73,4811,32,41,3537.53,6004.00,0.00
2024-12-08 16:55:02,74,4811,32,42,3489.73,6004.01,0.00
2024-12-08 16:55:02,75,4810,33,42,3393.01,6004.51,0.00
2024-12-08 16:55:02,75,4811,33,42,3519.73,6005.00,0.00
2024-12-08 16:55:02,76,4811,34,42,3473.42,6005.01,0.00
2024-12-08 16:55:02,75,4811,34,41,3500.56,6005.15,0.00
2024-12-08 16:55:02,74,4811,33,41,3477.90,6005.95,0.00
2024-12-08 16:55:02,74,4812,33,41,3637.01,6006.00,0.00
2024-12-08 16:55:02,75,4812,34,41,3588.52,6006.01,0.00
2024-12-08 16:55:02,74,4812,34,40,3619.54,6006.14,0.00
2024-12-08 16:55:02,74,4813,34,40,3608.91,6007.00,0.00
2024-12-08 16:55:02,75,4813,34,41,3560.79,6007.01,0.00
2024-12-08 16:55:02,76,4812,35,41,3460.87,6007.50,0.00
2024-12-08 16:55:02,77,4811,35,42,3432.70,6007.68,0.00
2024-12-08 16:55:02,77,4812,35,42,3478.62,6008.00,0.00
2024-12-08 16:55:02,78,4812,36,42,3434.02,6008.01,0.00
2024-12-08 16:55:02,77,4812,36,41,3473.96,6008.08,0.00
2024-12-08 16:55:02,76,4812,36,40,3507.04,6008.12,0.00
2024-12-08 16:55:02,75,4812,36,39,3545.88,6008.21,0.00
2024-12-08 16:55:02,74,4812,35,39,3583.30,6008.30,0.00
2024-12-08 16:55:02,74,4813,35,39,3750.97,6009.00,0.00
2024-12-08 16:55:02,75,4813,35,40,3700.96,6009.01,0.00
2024-12-08 16:55:03,75,4814,35,40,3668.57,6010.00,0.00
2024-12-08 16:55:03,76,4814,36,40,3620.30,6010.01,0.00
2024-12-08 16:55:03,75,4814,36,39,3650.98,6010.12,0.00
2024-12-08 16:55:03,75,4815,36,39,3641.41,6011.00,0.00
2024-12-08 16:55:03,76,4815,37,39,3593.50,6011.01,0.00
2024-12-08 16:55:03,76,4816,37,39,3562.25,6012.00,0.00
2024-12-08 16:55:03,77,4816,37,40,3515.98,6012.01,0.00
2024-12-08 16:55:03,76,4816,37,39,3543.31,6012.13,0.00
2024-12-08 16:55:03,76,4817,37,39,3531.15,6013.00,0.00
2024-12-08 16:55:03,77,4817,37,40,3485.29,6013.01,0.00
2024-12-08 16:55:03,76,4817,37,39,3497.85,6013.18,0.00
2024-12-08 16:55:03,76,4818,37,39,3497.09,6014.00,0.00
2024-12-08 16:55:03,77,4818,37,40,3451.68,6014.01,0.00
2024-12-08 16:55:03,76,4818,37,39,3478.93,6014.13,0.00
2024-12-08 16:55:03,76,4819,37,39,3473.33,6015.00,0.00
2024-12-08 16:55:03,77,4819,37,40,3428.22,6015.01,0.00
2024-12-08 16:55:03,78,4818,37,41,3341.30,6015.50,0.00
2024-12-08 16:55:03,77,4818,36,41,3382.99,6015.96,0.00
2024-12-08 16:55:03,77,4819,36,41,3458.80,6016.00,0.00
2024-12-08 16:55:03,78,4819,37,41,3414.46,6016.01,0.00
2024-12-08 16:55:03,77,4819,37,40,3441.65,6016.13,0.00
2024-12-08 16:55:03,76,4819,36,40,3450.77,6016.70,0.00
2024-12-08 16:55:03,76,4820,36,40,3591.12,6017.00,0.00
2024-12-08 16:55:03,77,4820,36,41,3544.48,6017.01,0.00
2024-12-08 16:55:03,76,4820,35,41,3518.55,6017.57,0.00
2024-12-08 16:55:03,76,4821,35,41,3570.66,6018.00,0.00
2024-12-08 16:55:03,77,4821,36,41,3524.29,6018.01,0.00
2024-12-08 16:55:03,76,4821,36,40,3552.49,6018.13,0.00
2024-12-08 16:55:03,76,4822,36,40,3546.37,6019.00,0.00
2024-12-08 16:55:03,77,4822,36,41,3500.31,6019.01,0.00
2024-12-08 16:55:03,77,4823,36,41,3476.87,6020.00,0.00
2024-12-08 16:55:03,78,4823,37,41,3432.30,6020.01,0.00
2024-12-08 16:55:03,77,4823,37,40,3454.24,6020.14,0.00
2024-12-08 16:55:03,77,4824,37,40,3448.48,6021.00,0.00
2024-12-08 16:55:03,78,4824,38,40,3404.27,6021.01,0.00
2024-12-08 16:55:03,78,4825,38,40,3379.31,6022.00,0.00
2024-12-08 16:55:03,79,4825,38,41,3336.53,6022.01,0.00
2024-12-08 16:55:03,78,4825,38,40,3357.73,6022.14,0.00
2024-12-08 16:55:03,77,4825,37,40,3363.33,6022.70,0.00
2024-12-08 16:55:03,77,4826,37,40,3392.51,6023.00,0.00
2024-12-08 16:55:03,78,4826,37,41,3349.01,6023.01,0.00
2024-12-08 16:55:03,78,4827,37,41,3323.36,6024.00,0.00
2024-12-08 16:55:03,79,4827,37,42,3281.29,6024.01,0.00
2024-12-08 16:55:03,78,4827,37,41,3302.54,6024.14,0.00
2024-12-08 16:55:03,77,4827,36,41,3271.47,6024.94,0.00
2024-12-08 16:55:03,77,4828,36,41,3345.85,6025.00,0.00
2024-12-08 16:55:03,78,4828,36,42,3302.95,6025.01,0.00
2024-12-08 16:55:03,78,4829,36,42,3278.81,6026.00,0.00
2024-12-08 16:55:03,79,4829,37,42,3237.31,6026.01,0.00
2024-12-08 16:55:03,78,4829,37,41,3258.81,6026.14,0.00
2024-12-08 16:55:03,77,4829,36,41,3264.89,6026.73,0.00
2024-12-08 16:55:03,77,4830,36,41,3295.63,6027.00,0.00
2024-12-08 16:55:03,78,4830,37,41,3253.38,6027.01,0.00
2024-12-08 16:55:03,77,4830,37,40,3291.74,6027.07,0.00
2024-12-08 16:55:03,76,4830,36,40,3303.19,6027.22,0.00
2024-12-08 16:55:03,75,4830,35,40,3347.07,6027.23,0.00
2024-12-08 16:55:03,75,4831,35,40,3380.30,6028.00,0.00
2024-12-08 16:55:03,76,4831,36,40,3335.82,6028.01,0.00
2024-12-08 16:55:03,75,4831,36,39,3359.83,6028.15,0.00
2024-12-08 16:55:03,75,4832,36,39,3355.60,6029.00,0.00
2024-12-08 16:55:03,76,4832,37,39,3311.44,6029.01,0.00
2024-12-08 16:55:03,75,4832,36,39,3351.59,6029.07,0.00
2024-12-08 16:55:03,75,4833,36,39,3330.62,6030.00,0.00
2024-12-08 16:55:03,76,4833,37,39,3286.80,6030.01,0.00
2024-12-08 16:55:03,75,4833,37,38,3311.35,6030.13,0.00
2024-12-08 16:55:03,75,4834,37,38,3301.25,6031.00,0.00
2024-12-08 16:55:03,76,4834,38,38,3257.82,6031.01,0.00
2024-12-08 16:55:03,75,4834,37,38,3258.91,6031.15,0.00
2024-12-08 16:55:03,75,4835,37,38,3279.31,6032.00,0.00
2024-12-08 16:55:03,76,4835,38,38,3236.16,6032.01,0.00
2024-12-08 16:55:03,75,4835,38,37,3268.59,6032.13,0.00
2024-12-08 16:55:03,75,4836,38,37,3256.64,6033.00,0.00
2024-12-08 16:55:03,76,4836,38,38,3213.79,6033.01,0.00
2024-12-08 16:55:03,76,4837,38,38,3186.12,6034.00,0.00
2024-12-08 16:55:03,77,4837,38,39,3144.74,6034.01,0.00
2024-12-08 16:55:03,76,4837,37,39,3182.62,6034.07,0.00
2024-12-08 16:55:03,75,4837,37,38,3210.59,6034.12,0.00
2024-12-08 16:55:03,74,4837,36,38,3206.90,6034.34,0.00
2024-12-08 16:55:03,74,4838,36,38,3245.12,6035.00,0.00
2024-12-08 16:55:03,75,4838,37,38,3201.85,6035.01,0.00
2024-12-08 16:55:04,75,4839,37,38,3175.98,6036.00,0.00
2024-12-08 16:55:04,76,4839,37,39,3134.19,6036.01,0.00
2024-12-08 16:55:04,75,4839,37,38,3159.09,6036.12,0.00
2024-12-08 16:55:04,74,4839,36,38,3196.93,6036.20,0.00
2024-12-08 16:55:04,74,4840,36,38,3195.07,6037.00,0.00
2024-12-08 16:55:04,75,4840,37,38,3152.47,6037.01,0.00
2024-12-08 16:55:04,75,4841,37,38,3143.58,6038.00,0.00
2024-12-08 16:55:04,76,4841,38,38,3102.21,6038.01,0.00
2024-12-08 16:55:04,77,4840,39,38,3036.87,6038.20,0.00
2024-12-08 16:55:04,76,4840,38,38,3120.68,6038.29,0.00
2024-12-08 16:55:04,77,4839,38,39,3055.27,6038.73,0.00
2024-12-08 16:55:04,77,4840,38,39,3117.83,6039.00,0.00
2024-12-08 16:55:04,78,4840,38,40,3077.85,6039.01,0.00
2024-12-08 16:55:04,78,4841,38,40,3199.85,6040.00,0.00
2024-12-08 16:55:04,79,4841,38,41,3159.34,6040.01,0.00
2024-12-08 16:55:04,78,4841,38,40,3189.80,6040.12,0.00
2024-12-08 16:55:04,78,4842,38,40,3174.69,6041.00,0.00
2024-12-08 16:55:04,79,4842,38,41,3134.50,6041.01,0.00
2024-12-08 16:55:04,80,4841,38,42,3068.07,6041.23,0.00
2024-12-08 16:55:04,80,4842,38,42,3125.75,6042.00,0.00
2024-12-08 16:55:04,81,4842,38,43,3087.16,6042.01,0.00
2024-12-08 16:55:04,80,4842,38,42,3104.75,6042.14,0.00
2024-12-08 16:55:04,79,4842,37,42,3096.29,6042.79,0.00
2024-12-08 16:55:04,79,4843,37,42,3228.09,6043.00,0.00
2024-12-08 16:55:04,80,4843,37,43,3187.74,6043.01,0.00
2024-12-08 16:55:04,79,4843,36,43,3196.11,6043.17,0.00
2024-12-08 16:55:04,79,4844,36,43,3202.20,6044.00,0.00
2024-12-08 16:55:04,80,4844,37,43,3162.17,6044.01,0.00
2024-12-08 16:55:04,79,4844,36,43,3201.44,6044.01,0.00
2024-12-08 16:55:04,78,4844,36,42,3238.61,6044.06,0.00
2024-12-08 16:55:04,78,4845,36,42,3213.22,6045.00,0.00
2024-12-08 16:55:04,79,4845,36,43,3172.55,6045.01,0.00
2024-12-08 16:55:04,79,4846,36,43,3137.02,6046.00,0.00
2024-12-08 16:55:04,80,4846,36,44,3097.80,6046.01,0.00
2024-12-08 16:55:04,79,4846,35,44,3135.25,6046.04,0.00
2024-12-08 16:55:04,79,4847,35,44,3093.95,6047.00,0.00
2024-12-08 16:55:04,80,4847,36,44,3055.28,6047.01,0.00
2024-12-08 16:55:04,79,4847,36,43,3072.25,6047.10,0.00
2024-12-08 16:55:04,78,4847,35,43,3099.12,6047.22,0.00
2024-12-08 16:55:04,78,4848,35,43,3093.39,6048.00,0.00
2024-12-08 16:55:04,79,4848,35,44,3054.23,6048.01,0.00
2024-12-08 16:55:04,78,4848,34,44,3081.76,6048.03,0.00
2024-12-08 16:55:04,77,4848,34,43,3117.96,6048.08,0.00
2024-12-08 16:55:04,76,4848,33,43,3120.87,6048.62,0.00
2024-12-08 16:55:04,76,4849,33,43,3174.85,6049.00,0.00
2024-12-08 16:55:04,77,4849,34,43,3133.62,6049.01,0.00
2024-12-08 16:55:04,76,4849,34,42,3156.58,6049.08,0.00
2024-12-08 16:55:04,75,4849,33,42,3187.76,6049.19,0.00
2024-12-08 16:55:04,75,4850,33,42,3178.04,6050.00,0.00
2024-12-08 16:55:04,76,4850,34,42,3136.22,6050.01,0.00
2024-12-08 16:55:04,75,4850,33,42,3177.75,6050.01,0.00
2024-12-08 16:55:04,74,4850,32,42,3160.46,6050.69,0.00
2024-12-08 16:55:04,74,4851,32,42,3205.73,6051.00,0.00
2024-12-08 16:55:04,75,4851,33,42,3162.99,6051.01,0.00
2024-12-08 16:55:04,75,4852,33,42,3140.64,6052.00,0.00
2024-12-08 16:55:04,76,4852,33,43,3099.31,6052.01,0.00
2024-12-08 16:55:04,75,4852,32,43,3139.02,6052.03,0.00
2024-12-08 16:55:04,74,4852,31,43,3152.32,6052.19,0.00
2024-12-08 16:55:04,75,4851,31,44,3078.29,6052.75,0.00
2024-12-08 16:55:04,75,4852,31,44,3165.45,6053.00,0.00
2024-12-08 16:55:04,76,4852,31,45,3123.80,6053.01,0.00
2024-12-08 16:55:04,75,4852,31,44,3151.24,6053.09,0.00
2024-12-08 16:55:04,74,4852,30,44,3188.94,6053.18,0.00
2024-12-08 16:55:04,73,4852,29,44,3188.60,6053.88,0.00
2024-12-08 16:55:04,72,4852,28,44,3200.45,6053.96,0.00
2024-12-08 16:55:04,72,4853,28,44,3366.10,6054.00,0.00
2024-12-08 16:55:04,73,4853,28,45,3319.99,6054.01,0.00
2024-12-08 16:55:04,72,4853,27,45,3362.15,6054.03,0.00
2024-12-08 16:55:04,73,4852,27,46,3305.81,6054.14,0.00
2024-12-08 16:55:04,73,4853,27,46,3360.31,6055.00,0.00
2024-12-08 16:55:04,74,4853,28,46,3314.90,6055.01,0.00
2024-12-08 16:55:04,74,4854,28,46,3385.35,6056.00,0.00
2024-12-08 16:55:04,75,4854,29,46,3340.21,6056.01,0.00
2024-12-08 16:55:04,75,4855,29,46,3324.47,6057.00,0.00
2024-12-08 16:55:04,76,4855,30,46,3280.73,6057.01,0.00
2024-12-08 16:55:04,75,4855,29,46,3321.86,6057.05,0.00
2024-12-08 16:55:04,75,4856,29,46,3309.81,6058.00,0.00
2024-12-08 16:55:04,76,4856,30,46,3266.26,6058.01,0.00
2024-12-08 16:55:04,76,4857,30,46,3239.35,6059.00,0.00
2024-12-08 16:55:04,77,4857,31,46,3197.28,6059.01,0.00
2024-12-08 16:55:04,76,4857,31,45,3221.82,6059.09,0.00
2024-12-08 16:55:04,76,4858,31,45,3208.54,6060.00,0.00
2024-12-08 16:55:04,77,4858,31,46,3166.87,6060.01,0.00
2024-12-08 16:55:04,76,4858,30,46,3194.33,6060.04,0.00
2024-12-08 16:55:04,75,4858,29,46,3211.91,6060.19,0.00
2024-12-08 16:55:05,75,4859,29,46,3233.83,6061.00,0.00
2024-12-08 16:55:05,76,4859,30,46,3191.28,6061.01,0.00
2024-12-08 16:55:05,75,4859,30,45,3224.17,6061.15,0.00
2024-12-08 16:55:05,74,4859,29,45,3243.67,6061.54,0.00
2024-12-08 16:55:05,75,4858,30,45,3131.44,6061.92,0.00
2024-12-08 16:55:05,75,4859,30,45,3212.33,6062.00,0.00
2024-12-08 16:55:05,76,4859,31,45,3170.06,6062.01,0.00
2024-12-08 16:55:05,75,4859,30,45,3132.57,6062.64,0.00
2024-12-08 16:55:05,76,4858,30,46,3078.05,6062.79,0.00
2024-12-08 16:55:05,76,4859,30,46,3225.48,6063.00,0.00
2024-12-08 16:55:05,77,4859,31,46,3183.59,6063.01,0.00
2024-12-08 16:55:05,76,4859,31,45,3205.56,6063.15,0.00
2024-12-08 16:55:05,75,4859,30,45,3240.99,6063.27,0.00
2024-12-08 16:55:05,75,4860,30,45,3308.87,6064.00,0.00
2024-12-08 16:55:05,76,4860,30,46,3265.33,6064.01,0.00
2024-12-08 16:55:05,75,4860,30,45,3224.23,6064.63,0.00
2024-12-08 16:55:05,75,4861,30,45,3268.39,6065.00,0.00
2024-12-08 16:55:05,76,4861,30,46,3225.39,6065.01,0.00
2024-12-08 16:55:05,75,4861,30,45,3250.61,6065.07,0.00
2024-12-08 16:55:05,74,4861,30,44,3250.92,6065.74,0.00
2024-12-08 16:55:05,74,4862,30,44,3282.72,6066.00,0.00
2024-12-08 16:55:05,75,4862,31,44,3238.95,6066.01,0.00
2024-12-08 16:55:05,74,4862,31,43,3264.70,6066.14,0.00
2024-12-08 16:55:05,73,4862,30,43,3303.86,6066.17,0.00
2024-12-08 16:55:05,73,4863,30,43,3331.86,6067.00,0.00
2024-12-08 16:55:05,74,4863,31,43,3286.84,6067.01,0.00
2024-12-08 16:55:05,73,4863,30,43,3328.30,6067.03,0.00
2024-12-08 16:55:05,72,4863,29,43,3347.60,6067.19,0.00
2024-12-08 16:55:05,73,4862,30,43,3271.20,6067.67,0.00
2024-12-08 16:55:05,73,4863,30,43,3351.68,6068.00,0.00
2024-12-08 16:55:05,74,4863,31,43,3306.39,6068.01,0.00
2024-12-08 16:55:05,73,4863,31,42,3335.07,6068.12,0.00
2024-12-08 16:55:05,73,4864,31,42,3409.17,6069.00,0.00
2024-12-08 16:55:05,74,4864,32,42,3363.10,6069.01,0.00
2024-12-08 16:55:05,74,4865,32,42,3334.32,6070.00,0.00
2024-12-08 16:55:05,75,4865,32,43,3289.86,6070.01,0.00
2024-12-08 16:55:05,74,4865,31,43,3333.50,6070.01,0.00
2024-12-08 16:55:05,73,4865,31,42,3359.23,6070.14,0.00
2024-12-08 16:55:05,73,4866,31,42,3349.35,6071.00,0.00
2024-12-08 16:55:05,74,4866,32,42,3304.09,6071.01,0.00
2024-12-08 16:55:05,74,4867,32,42,3275.56,6072.00,0.00
2024-12-08 16:55:05,75,4867,32,43,3231.88,6072.01,0.00
2024-12-08 16:55:05,74,4867,32,42,3252.75,6072.16,0.00
2024-12-08 16:55:05,74,4868,32,42,3242.15,6073.00,0.00
2024-12-08 16:55:05,75,4868,33,42,3198.92,6073.01,0.00
2024-12-08 16:55:05,74,4868,33,41,3237.23,6073.08,0.00
2024-12-08 16:55:05,73,4868,32,41,3276.71,6073.12,0.00
2024-12-08 16:55:05,73,4869,32,41,3254.03,6074.00,0.00
2024-12-08 16:55:05,74,4869,33,41,3210.06,6074.01,0.00
2024-12-08 16:55:05,73,4869,33,40,3229.54,6074.15,0.00
2024-12-08 16:55:05,72,4869,33,39,3240.35,6074.53,0.00
2024-12-08 16:55:05,72,4870,33,39,3262.63,6075.00,0.00
2024-12-08 16:55:05,73,4870,34,39,3217.94,6075.01,0.00
2024-12-08 16:55:05,73,4871,34,39,3199.99,6076.00,0.00
2024-12-08 16:55:05,74,4871,34,40,3156.75,6076.01,0.00
2024-12-08 16:55:05,73,4871,33,40,3156.46,6076.38,0.00
2024-12-08 16:55:05,73,4872,33,40,3175.57,6077.00,0.00
2024-12-08 16:55:05,74,4872,33,41,3132.66,6077.01,0.00
2024-12-08 16:55:05,74,4873,33,41,3096.16,6078.00,0.00
2024-12-08 16:55:05,75,4873,33,42,3054.88,6078.01,0.00
2024-12-08 16:55:05,74,4873,33,41,3080.52,6078.22,0.00
2024-12-08 16:55:05,73,4873,32,41,3045.51,6078.97,0.00
2024-12-08 16:55:05,73,4874,32,41,3127.14,6079.00,0.00
2024-12-08 16:55:05,74,4874,32,42,3084.88,6079.01,0.00
2024-12-08 16:55:05,73,4874,32,41,3126.30,6079.01,0.00
2024-12-08 16:55:05,72,4874,31,41,3164.28,6079.10,0.00
2024-12-08 16:55:05,71,4874,30,41,3180.64,6079.24,0.00
2024-12-08 16:55:05,71,4875,30,41,3215.82,6080.00,0.00
2024-12-08 16:55:05,72,4875,30,42,3171.16,6080.01,0.00
2024-12-08 16:55:05,71,4875,30,41,3214.96,6080.01,0.00
2024-12-08 16:55:05,70,4875,29,41,3222.10,6080.36,0.00
2024-12-08 16:55:05,71,4874,29,42,3168.24,6080.52,0.00
2024-12-08 16:55:05,71,4875,29,42,3212.96,6081.00,0.00
2024-12-08 16:55:05,72,4875,29,43,3168.34,6081.01,0.00
2024-12-08 16:55:05,72,4876,29,43,3223.87,6082.00,0.00
2024-12-08 16:55:05,73,4876,30,43,3179.71,6082.01,0.00
2024-12-08 16:55:05,72,4876,30,42,3210.40,6082.22,0.00
2024-12-08 16:55:05,71,4876,29,42,3188.11,6082.90,0.00
2024-12-08 16:55:05,71,4877,29,42,3266.27,6083.00,0.00
2024-12-08 16:55:05,72,4877,29,43,3220.90,6083.01,0.00
2024-12-08 16:55:05,71,4877,29,42,3242.32,6083.20,0.00
2024-12-08 16:55:05,71,4878,29,42,3236.76,6084.00,0.00
2024-12-08 16:55:05,72,4878,29,43,3191.81,6084.01,0.00
2024-12-08 16:55:05,71,4878,28,43,3202.91,6084.28,0.00
2024-12-08 16:55:05,71,4879,28,43,3206.24,6085.00,0.00
2024-12-08 16:55:05,72,4879,29,43,3161.71,6085.01,0.00
2024-12-08 16:55:05,71,4879,29,42,3205.38,6085.01,0.00
2024-12-08 16:55:05,70,4879,29,41,3227.74,6085.19,0.00
2024-12-08 16:55:05,69,4879,28,41,3188.94,6085.97,0.00
2024-12-08 16:55:06,69,4880,28,41,3275.39,6086.00,0.00
2024-12-08 16:55:06,70,4880,28,42,3228.60,6086.01,0.00
2024-12-08 16:55:06,69,4880,27,42,3217.82,6086.58,0.00
2024-12-08 16:55:06,69,4881,27,42,3243.53,6087.00,0.00
2024-12-08 16:55:06,70,4881,28,42,3197.19,6087.01,0.00
2024-12-08 16:55:06,69,4881,28,41,3216.22,6087.20,0.00
2024-12-08 16:55:06,69,4882,28,41,3204.68,6088.00,0.00
2024-12-08 16:55:06,70,4882,28,42,3158.89,6088.01,0.00
2024-12-08 16:55:06,71,4881,28,43,3042.99,6088.52,0.00
2024-12-08 16:55:06,71,4882,28,43,3114.32,6089.00,0.00
2024-12-08 16:55:06,72,4882,29,43,3071.07,6089.01,0.00
2024-12-08 16:55:06,71,4882,29,42,3113.46,6089.01,0.00
2024-12-08 16:55:06,70,4882,29,41,3132.75,6089.19,0.00
2024-12-08 16:55:06,69,4882,28,41,3166.23,6089.20,0.00
2024-12-08 16:55:06,69,4883,28,41,3279.20,6090.00,0.00
2024-12-08 16:55:06,70,4883,29,41,3232.35,6090.01,0.00
2024-12-08 16:55:06,69,4883,29,40,3278.31,6090.02,0.00
2024-12-08 16:55:06,68,4883,28,40,3275.11,6090.49,0.00
2024-12-08 16:55:06,68,4884,28,40,3300.31,6091.00,0.00
2024-12-08 16:55:06,69,4884,29,40,3252.48,6091.02,0.00
2024-12-08 16:55:06,69,4885,29,40,3221.55,6092.00,0.00
2024-12-08 16:55:06,70,4885,29,41,3175.53,6092.01,0.00
2024-12-08 16:55:06,69,4885,29,40,3209.22,6092.19,0.00
2024-12-08 16:55:06,69,4886,29,40,3210.53,6093.00,0.00
2024-12-08 16:55:06,70,4886,30,40,3164.66,6093.01,0.00
2024-12-08 16:55:06,69,4886,29,40,3162.89,6093.48,0.00
2024-12-08 16:55:06,69,4887,29,40,3184.55,6094.00,0.00
2024-12-08 16:55:06,70,4887,30,40,3139.06,6094.01,0.00
2024-12-08 16:55:06,69,4887,30,39,3183.67,6094.02,0.00
2024-12-08 16:55:06,68,4887,30,38,3201.83,6094.18,0.00
2024-12-08 16:55:06,67,4887,29,38,3222.20,6094.63,0.00
2024-12-08 16:55:06,67,4888,29,38,3231.16,6095.00,0.00
2024-12-08 16:55:06,68,4888,29,39,3183.64,6095.02,0.00
2024-12-08 16:55:06,68,4889,29,39,3144.53,6096.00,0.00
2024-12-08 16:55:06,69,4889,30,39,3098.95,6096.02,0.00
2024-12-08 16:55:06,68,4889,29,39,3142.54,6096.04,0.00
2024-12-08 16:55:06,67,4889,28,39,3182.71,6096.15,0.00
2024-12-08 16:55:06,66,4889,28,38,3211.53,6096.15,0.00
2024-12-08 16:55:06,66,4890,28,38,3184.87,6097.00,0.00
2024-12-08 16:55:06,67,4890,28,39,3137.34,6097.02,0.00
2024-12-08 16:55:06,66,4890,27,39,3160.06,6097.15,0.00
2024-12-08 16:55:06,65,4890,27,38,3156.49,6097.68,0.00
2024-12-08 16:55:06,65,4891,27,38,3198.42,6098.00,0.00
2024-12-08 16:55:06,66,4891,28,38,3149.96,6098.02,0.00
2024-12-08 16:55:06,65,4891,27,38,3151.60,6098.29,0.00
2024-12-08 16:55:06,64,4891,27,37,3176.93,6098.67,0.00
2024-12-08 16:55:06,64,4892,27,37,3227.81,6099.00,0.00
2024-12-08 16:55:06,65,4892,27,38,3178.15,6099.02,0.00
2024-12-08 16:55:06,64,4892,27,37,3148.38,6099.84,0.00
2024-12-08 16:55:06,64,4893,27,37,3196.14,6100.00,0.00
2024-12-08 16:55:06,65,4893,28,37,3146.97,6100.02,0.00
2024-12-08 16:55:06,64,4893,27,37,3195.18,6100.02,0.00
2024-12-08 16:55:06,63,4893,27,36,3233.34,6100.19,0.00
2024-12-08 16:55:06,63,4894,27,36,3242.56,6101.00,0.00
2024-12-08 16:55:06,64,4894,28,36,3191.90,6101.02,0.00
2024-12-08 16:55:06,64,4895,28,36,3182.69,6102.00,0.00
2024-12-08 16:55:06,65,4895,29,36,3133.72,6102.02,0.00
2024-12-08 16:55:06,64,4895,29,35,3152.20,6102.19,0.00
2024-12-08 16:55:06,64,4896,29,35,3160.10,6103.00,0.00
2024-12-08 16:55:06,65,4896,30,35,3111.48,6103.02,0.00
2024-12-08 16:55:06,66,4895,30,36,3032.03,6103.27,0.00
2024-12-08 16:55:06,67,4894,30,37,3029.00,6103.64,0.00
2024-12-08 16:55:06,67,4895,30,37,3120.35,6104.00,0.00
2024-12-08 16:55:06,68,4895,31,37,3074.46,6104.02,0.00
2024-12-08 16:55:06,69,4894,32,37,2969.20,6104.75,0.00
2024-12-08 16:55:06,69,4895,32,37,3211.67,6105.00,0.00
2024-12-08 16:55:06,70,4895,33,37,3165.79,6105.01,0.00
2024-12-08 16:55:06,70,4896,33,37,3229.60,6106.00,0.00
2024-12-08 16:55:06,71,4896,33,38,3184.11,6106.01,0.00
2024-12-08 16:55:06,70,4896,33,37,3218.28,6106.17,0.00
2024-12-08 16:55:06,71,4895,34,37,3147.15,6106.62,0.00
2024-12-08 16:55:06,71,4896,34,37,3197.31,6107.00,0.00
2024-12-08 16:55:06,72,4896,34,38,3152.90,6107.01,0.00
2024-12-08 16:55:06,71,4896,34,37,3196.45,6107.01,0.00
2024-12-08 16:55:06,72,4895,34,38,3147.82,6107.11,0.00
2024-12-08 16:55:06,71,4895,33,38,3213.82,6107.45,0.00
2024-12-08 16:55:06,72,4894,34,38,3144.01,6107.89,0.00
2024-12-08 16:55:06,72,4895,34,38,3310.36,6108.00,0.00
2024-12-08 16:55:06,73,4895,34,39,3265.01,6108.01,0.00
2024-12-08 16:55:06,74,4894,35,39,3214.31,6108.15,0.00
2024-12-08 16:55:06,73,4894,35,38,3314.42,6108.18,0.00
2024-12-08 16:55:06,73,4895,35,38,3482.29,6109.00,0.00
2024-12-08 16:55:06,74,4895,36,38,3435.23,6109.01,0.00
2024-12-08 16:55:06,74,4896,36,38,3517.06,6110.00,0.00
2024-12-08 16:55:06,75,4896,36,39,3470.17,6110.01,0.00
2024-12-08 16:55:06,74,4896,35,39,3516.24,6110.01,0.00
2024-12-08 16:55:06,74,4897,35,39,3512.81,6111.00,0.00
2024-12-08 16:55:06,75,4897,36,39,3465.97,6111.01,0.00
2024-12-08 16:55:06,75,4898,36,39,3455.76,6112.00,0.00
2024-12-08 16:55:07,76,4898,37,39,3410.29,6112.01,0.00
2024-12-08 16:55:07,75,4898,37,38,3454.95,6112.01,0.00
2024-12-08 16:55:07,75,4899,37,38,3432.87,6113.00,0.00
2024-12-08 16:55:07,76,4899,38,38,3387.70,6113.01,0.00
2024-12-08 16:55:07,75,4899,38,37,3432.05,6113.01,0.00
2024-12-08 16:55:07,74,4899,38,36,3458.16,6113.08,0.00
2024-12-08 16:55:07,75,4898,38,37,3402.35,6113.27,0.00
2024-12-08 16:55:07,74,4898,37,37,3454.20,6113.95,0.00
2024-12-08 16:55:07,74,4899,37,37,3533.55,6114.00,0.00
2024-12-08 16:55:07,75,4899,38,37,3486.44,6114.01,0.00
2024-12-08 16:55:07,74,4899,38,36,3532.73,6114.01,0.00
2024-12-08 16:55:07,73,4899,38,35,3575.18,6114.04,0.00
2024-12-08 16:55:07,72,4899,37,35,3557.97,6114.38,0.00
2024-12-08 16:55:07,73,4898,38,35,3497.62,6114.59,0.00
2024-12-08 16:55:07,73,4899,38,35,3690.82,6115.00,0.00
2024-12-08 16:55:07,74,4899,39,35,3640.94,6115.01,0.00
2024-12-08 16:55:07,73,4899,39,34,3689.98,6115.01,0.00
2024-12-08 16:55:07,73,4900,39,34,3740.30,6116.00,0.00
2024-12-08 16:55:07,74,4900,40,34,3689.76,6116.01,0.00
2024-12-08 16:55:07,73,4900,40,33,3734.45,6116.04,0.00
2024-12-08 16:55:07,72,4900,39,33,3752.81,6116.47,0.00
2024-12-08 16:55:07,72,4901,39,33,3769.73,6117.00,0.00
2024-12-08 16:55:07,73,4901,40,33,3718.09,6117.01,0.00
2024-12-08 16:55:07,72,4901,40,32,3751.93,6117.08,0.00
2024-12-08 16:55:07,72,4902,40,32,3741.11,6118.00,0.00
2024-12-08 16:55:07,73,4902,40,33,3689.86,6118.01,0.00
2024-12-08 16:55:07,72,4902,39,33,3650.46,6118.63,0.00
2024-12-08 16:55:07,72,4903,39,33,3712.52,6119.00,0.00
2024-12-08 16:55:07,73,4903,40,33,3661.67,6119.01,0.00
2024-12-08 16:55:07,72,4903,39,33,3711.34,6119.03,0.00
2024-12-08 16:55:07,71,4903,39,32,3748.99,6119.07,0.00
2024-12-08 16:55:07,70,4903,38,32,3798.33,6119.13,0.00
2024-12-08 16:55:07,70,4904,38,32,3792.73,6120.00,0.00
2024-12-08 16:55:07,71,4904,38,33,3739.31,6120.01,0.00
2024-12-08 16:55:07,70,4904,37,33,3702.98,6120.57,0.00
2024-12-08 16:55:07,70,4905,37,33,3764.52,6121.00,0.00
2024-12-08 16:55:07,71,4905,37,34,3711.50,6121.01,0.00
2024-12-08 16:55:07,70,4905,37,33,3714.71,6121.07,0.00
2024-12-08 16:55:07,70,4906,37,33,3742.44,6122.00,0.00
2024-12-08 16:55:07,71,4906,37,34,3689.73,6122.01,0.00
2024-12-08 16:55:07,71,4907,37,34,3664.81,6123.00,0.00
2024-12-08 16:55:07,72,4907,37,35,3613.91,6123.01,0.00
2024-12-08 16:55:07,71,4907,37,34,3642.47,6123.08,0.00
2024-12-08 16:55:07,70,4907,36,34,3690.57,6123.14,0.00
2024-12-08 16:55:07,70,4908,36,34,3686.96,6124.00,0.00
2024-12-08 16:55:07,71,4908,37,34,3635.03,6124.01,0.00
2024-12-08 16:55:07,71,4909,37,34,3608.50,6125.00,0.00
2024-12-08 16:55:07,72,4909,38,34,3558.38,6125.01,0.00
2024-12-08 16:55:07,71,4909,37,34,3605.67,6125.06,0.00
2024-12-08 16:55:07,70,4909,37,33,3639.95,6125.09,0.00
2024-12-08 16:55:07,69,4909,36,33,3671.21,6125.44,0.00
2024-12-08 16:55:07,69,4910,36,33,3687.67,6126.00,0.00
2024-12-08 16:55:07,70,4910,37,33,3634.99,6126.01,0.00
2024-12-08 16:55:07,69,4910,36,33,3630.16,6126.20,0.00
2024-12-08 16:55:07,69,4911,36,33,3669.05,6127.00,0.00
2024-12-08 16:55:07,70,4911,37,33,3616.63,6127.01,0.00
2024-12-08 16:55:07,69,4911,37,32,3648.22,6127.12,0.00
2024-12-08 16:55:07,68,4911,36,32,3681.37,6127.44,0.00
2024-12-08 16:55:07,68,4912,36,32,3701.03,6128.00,0.00
2024-12-08 16:55:07,69,4912,37,32,3647.39,6128.02,0.00
2024-12-08 16:55:07,68,4912,36,32,3665.06,6128.22,0.00
2024-12-08 16:55:07,69,4911,37,32,3592.38,6128.57,0.00
2024-12-08 16:55:07,69,4912,37,32,3674.41,6129.00,0.00
2024-12-08 16:55:07,70,4912,38,32,3621.92,6129.01,0.00
2024-12-08 16:55:07,69,4912,38,31,3653.13,6129.13,0.00
2024-12-08 16:55:07,69,4913,38,31,3735.93,6130.00,0.00
2024-12-08 16:55:07,70,4913,38,32,3682.56,6130.01,0.00
2024-12-08 16:55:07,69,4913,37,32,3669.07,6130.67,0.00
2024-12-08 16:55:07,69,4914,37,32,3734.65,6131.00,0.00
2024-12-08 16:55:07,70,4914,37,33,3681.29,6131.01,0.00
2024-12-08 16:55:07,69,4914,37,32,3714.25,6131.13,0.00
2024-12-08 16:55:07,69,4915,37,32,3708.35,6132.00,0.00
2024-12-08 16:55:07,70,4915,37,33,3655.37,6132.01,0.00
2024-12-08 16:55:07,70,4916,37,33,3628.50,6133.00,0.00
2024-12-08 16:55:07,71,4916,38,33,3577.40,6133.01,0.00
2024-12-08 16:55:07,70,4916,37,33,3620.10,6133.14,0.00
2024-12-08 16:55:07,69,4916,37,32,3656.57,6133.15,0.00
2024-12-08 16:55:07,70,4915,37,33,3593.04,6133.36,0.00
2024-12-08 16:55:07,69,4915,36,33,3676.45,6133.42,0.00
2024-12-08 16:55:07,68,4915,35,33,3690.26,6133.53,0.00
2024-12-08 16:55:07,68,4916,35,33,3747.35,6134.00,0.00
2024-12-08 16:55:07,69,4916,35,34,3693.04,6134.02,0.00
2024-12-08 16:55:07,70,4915,35,35,3587.14,6134.63,0.00
2024-12-08 16:55:07,70,4916,35,35,3755.68,6135.00,0.00
2024-12-08 16:55:07,71,4916,35,36,3702.78,6135.01,0.00
2024-12-08 16:55:07,70,4916,35,35,3732.01,6135.14,0.00
2024-12-08 16:55:07,69,4916,34,35,3751.50,6135.65,0.00
2024-12-08 16:55:07,69,4917,34,35,3897.58,6136.00,0.00
2024-12-08 16:55:07,70,4917,34,36,3841.90,6136.01,0.00
2024-12-08 16:55:07,71,4916,35,36,3786.93,6136.06,0.00
2024-12-08 16:55:07,71,4917,35,36,3847.79,6137.00,0.00
2024-12-08 16:55:07,72,4917,35,37,3794.35,6137.01,0.00
2024-12-08 16:55:08,72,4918,35,37,3863.32,6138.00,0.00
2024-12-08 16:55:08,73,4918,36,37,3810.40,6138.01,0.00
2024-12-08 16:55:08,73,4919,36,37,3790.18,6139.00,0.00
2024-12-08 16:55:08,74,4919,37,37,3738.96,6139.01,0.00
2024-12-08 16:55:08,73,4919,36,37,3769.73,6139.07,0.00
2024-12-08 16:55:08,72,4919,35,37,3801.47,6139.39,0.00
2024-12-08 16:55:08,72,4920,35,37,3818.09,6140.00,0.00
2024-12-08 16:55:08,73,4920,35,38,3765.79,6140.01,0.00
2024-12-08 16:55:08,73,4921,35,38,3732.17,6141.00,0.00
2024-12-08 16:55:08,74,4921,36,38,3681.74,6141.01,0.00
2024-12-08 16:55:08,73,4921,36,37,3717.88,6141.03,0.00
2024-12-08 16:55:08,72,4921,35,37,3675.04,6141.97,0.00
2024-12-08 16:55:08,72,4922,35,37,3758.66,6142.00,0.00
2024-12-08 16:55:08,73,4922,35,38,3707.17,6142.01,0.00
2024-12-08 16:55:08,72,4922,34,38,3714.41,6142.29,0.00
2024-12-08 16:55:08,72,4923,34,38,3750.27,6143.00,0.00
2024-12-08 16:55:08,73,4923,35,38,3698.90,6143.01,0.00
2024-12-08 16:55:08,72,4923,34,38,3691.72,6143.60,0.00
2024-12-08 16:55:08,72,4924,34,38,3717.81,6144.00,0.00
2024-12-08 16:55:08,73,4924,34,39,3666.88,6144.01,0.00
2024-12-08 16:55:08,72,4924,34,38,3694.80,6144.11,0.00
2024-12-08 16:55:08,72,4925,34,38,3684.32,6145.00,0.00
2024-12-08 16:55:08,73,4925,35,38,3633.85,6145.01,0.00
2024-12-08 16:55:08,72,4925,34,38,3663.85,6145.08,0.00
2024-12-08 16:55:08,72,4926,34,38,3672.82,6146.00,0.00
2024-12-08 16:55:08,73,4926,35,38,3622.50,6146.01,0.00
2024-12-08 16:55:08,72,4926,35,37,3655.77,6146.10,0.00
2024-12-08 16:55:08,72,4927,35,37,3649.31,6147.00,0.00
2024-12-08 16:55:08,73,4927,35,38,3599.32,6147.01,0.00
2024-12-08 16:55:08,72,4927,34,38,3627.99,6147.08,0.00
2024-12-08 16:55:08,71,4927,33,38,3655.74,6147.17,0.00
2024-12-08 16:55:08,71,4928,33,38,3688.62,6148.00,0.00
2024-12-08 16:55:08,72,4928,34,38,3637.39,6148.01,0.00
2024-12-08 16:55:08,71,4928,34,37,3673.05,6148.08,0.00
2024-12-08 16:55:08,72,4927,35,37,3535.53,6148.92,0.00
2024-12-08 16:55:08,72,4928,35,37,3621.00,6149.00,0.00
2024-12-08 16:55:08,73,4928,36,37,3571.40,6149.01,0.00
2024-12-08 16:55:08,73,4929,36,37,3643.61,6150.00,0.00
2024-12-08 16:55:08,74,4929,37,37,3594.38,6150.01,0.00
2024-12-08 16:55:08,74,4930,37,37,3570.47,6151.00,0.00
2024-12-08 16:55:08,75,4930,38,37,3522.86,6151.01,0.00
2024-12-08 16:55:08,74,4930,38,36,3561.03,6151.04,0.00
2024-12-08 16:55:08,73,4930,38,35,3598.12,6151.22,0.00
2024-12-08 16:55:08,73,4931,38,35,3600.08,6152.00,0.00
2024-12-08 16:55:08,74,4931,38,36,3551.43,6152.01,0.00
2024-12-08 16:55:08,73,4931,38,35,3583.99,6152.07,0.00
2024-12-08 16:55:08,73,4932,38,35,3575.46,6153.00,0.00
2024-12-08 16:55:08,74,4932,38,36,3527.15,6153.01,0.00
2024-12-08 16:55:08,73,4932,37,36,3480.55,6153.70,0.00
2024-12-08 16:55:08,73,4933,37,36,3543.41,6154.00,0.00
2024-12-08 16:55:08,74,4933,38,36,3495.53,6154.01,0.00
2024-12-08 16:55:08,73,4933,38,35,3533.31,6154.07,0.00
2024-12-08 16:55:08,73,4934,38,35,3524.01,6155.00,0.00
2024-12-08 16:55:08,74,4934,39,35,3476.39,6155.01,0.00
2024-12-08 16:55:08,73,4934,38,35,3459.40,6155.60,0.00
2024-12-08 16:55:08,73,4935,38,35,3516.90,6156.00,0.00
2024-12-08 16:55:08,74,4935,38,36,3469.38,6156.01,0.00
2024-12-08 16:55:08,73,4935,38,35,3506.79,6156.07,0.00
2024-12-08 16:55:08,73,4936,38,35,3498.58,6157.00,0.00
2024-12-08 16:55:08,74,4936,38,36,3451.30,6157.01,0.00
2024-12-08 16:55:08,74,4937,38,36,3421.14,6158.00,0.00
2024-12-08 16:55:08,75,4937,38,37,3375.52,6158.01,0.00
2024-12-08 16:55:08,74,4937,38,36,3411.24,6158.07,0.00
2024-12-08 16:55:08,75,4936,39,36,3363.31,6158.13,0.00
2024-12-08 16:55:08,75,4937,39,36,3389.44,6159.00,0.00
2024-12-08 16:55:08,76,4937,39,37,3344.84,6159.01,0.00
2024-12-08 16:55:08,75,4937,38,37,3385.46,6159.04,0.00
2024-12-08 16:55:08,76,4936,39,37,3308.61,6159.33,0.00
2024-12-08 16:55:08,75,4936,38,37,3354.98,6159.81,0.00
2024-12-08 16:55:08,75,4937,38,37,3507.88,6160.00,0.00
2024-12-08 16:55:08,76,4937,39,37,3461.73,6160.01,0.00
2024-12-08 16:55:08,75,4937,39,36,3499.68,6160.05,0.00
2024-12-08 16:55:08,75,4938,39,36,3571.90,6161.00,0.00
2024-12-08 16:55:08,76,4938,40,36,3524.90,6161.01,0.00
2024-12-08 16:55:08,75,4938,39,36,3569.44,6161.04,0.00
2024-12-08 16:55:08,74,4938,38,36,3588.09,6161.18,0.00
2024-12-08 16:55:08,74,4939,38,36,3618.85,6162.00,0.00
2024-12-08 16:55:08,75,4939,38,37,3570.60,6162.01,0.00
2024-12-08 16:55:09,75,4940,38,37,3540.32,6163.00,0.00
2024-12-08 16:55:09,76,4940,39,37,3493.73,6163.01,0.00
2024-12-08 16:55:09,75,4940,39,36,3537.04,6163.04,0.00
2024-12-08 16:55:09,75,4941,39,36,3524.81,6164.00,0.00
2024-12-08 16:55:09,76,4941,40,36,3478.43,6164.01,0.00
2024-12-08 16:55:09,76,4942,40,36,3471.00,6165.00,0.00
2024-12-08 16:55:09,77,4942,41,36,3425.92,6165.01,0.00
2024-12-08 16:55:09,77,4943,41,36,3409.48,6166.00,0.00
2024-12-08 16:55:09,78,4943,41,37,3365.77,6166.01,0.00
2024-12-08 16:55:09,77,4943,40,37,3350.56,6166.71,0.00
2024-12-08 16:55:09,77,4944,40,37,3381.52,6167.00,0.00
2024-12-08 16:55:09,78,4944,41,37,3338.17,6167.01,0.00
2024-12-08 16:55:09,77,4944,41,36,3372.73,6167.07,0.00
2024-12-08 16:55:09,77,4945,41,36,3363.65,6168.00,0.00
2024-12-08 16:55:09,78,4945,41,37,3320.52,6168.01,0.00
2024-12-08 16:55:09,77,4945,40,37,3326.46,6168.35,0.00
2024-12-08 16:55:09,77,4946,40,37,3366.92,6169.00,0.00
2024-12-08 16:55:09,78,4946,41,37,3323.75,6169.01,0.00
2024-12-08 16:55:09,77,4946,41,36,3358.13,6169.07,0.00
2024-12-08 16:55:09,76,4946,40,36,3337.66,6169.66,0.00
2024-12-08 16:55:09,76,4947,40,36,3397.91,6170.00,0.00
2024-12-08 16:55:09,77,4947,41,36,3353.78,6170.01,0.00
2024-12-08 16:55:09,77,4948,41,36,3325.33,6171.00,0.00
2024-12-08 16:55:09,78,4948,42,36,3282.70,6171.01,0.00
2024-12-08 16:55:09,77,4948,42,35,3316.53,6171.07,0.00
2024-12-08 16:55:09,77,4949,42,35,3307.24,6172.00,0.00
2024-12-08 16:55:09,78,4949,42,36,3264.83,6172.01,0.00
2024-12-08 16:55:09,78,4950,42,36,3239.79,6173.00,0.00
2024-12-08 16:55:09,79,4950,43,36,3198.78,6173.01,0.00
2024-12-08 16:55:09,78,4950,43,35,3226.62,6173.09,0.00
2024-12-08 16:55:09,78,4951,43,35,3218.41,6174.00,0.00
2024-12-08 16:55:09,79,4951,44,35,3177.67,6174.01,0.00
2024-12-08 16:55:09,78,4951,43,35,3186.84,6174.26,0.00
2024-12-08 16:55:09,77,4951,43,34,3225.77,6174.30,0.00
2024-12-08 16:55:09,78,4950,43,35,3184.41,6174.32,0.00
2024-12-08 16:55:09,78,4951,43,35,3268.60,6175.00,0.00
2024-12-08 16:55:09,79,4951,44,35,3227.22,6175.01,0.00
2024-12-08 16:55:09,78,4951,43,35,3227.70,6175.39,0.00
2024-12-08 16:55:09,78,4952,43,35,3348.44,6176.00,0.00
2024-12-08 16:55:09,79,4952,44,35,3306.05,6176.01,0.00
2024-12-08 16:55:09,78,4952,44,34,3333.58,6176.09,0.00
2024-12-08 16:55:09,77,4952,43,34,3367.30,6176.25,0.00
2024-12-08 16:55:09,77,4953,43,34,3369.37,6177.00,0.00
2024-12-08 16:55:09,78,4953,44,34,3326.17,6177.01,0.00
2024-12-08 16:55:09,77,4953,43,34,3365.36,6177.03,0.00
2024-12-08 16:55:09,77,4954,43,34,3365.33,6178.00,0.00
2024-12-08 16:55:09,78,4954,44,34,3322.19,6178.01,0.00
2024-12-08 16:55:09,77,4954,44,33,3353.32,6178.09,0.00
2024-12-08 16:55:09,77,4955,44,33,3343.45,6179.00,0.00
2024-12-08 16:55:09,78,4955,45,33,3300.59,6179.01,0.00
2024-12-08 16:55:09,77,4955,44,33,3265.87,6179.60,0.00
2024-12-08 16:55:09,77,4956,44,33,3321.52,6180.00,0.00
2024-12-08 16:55:09,78,4956,44,34,3278.94,6180.01,0.00
2024-12-08 16:55:09,77,4956,44,33,3309.51,6180.10,0.00
2024-12-08 16:55:09,76,4956,43,33,3314.77,6180.72,0.00
2024-12-08 16:55:09,76,4957,43,33,3346.68,6181.00,0.00
2024-12-08 16:55:09,77,4957,43,34,3303.22,6181.01,0.00
2024-12-08 16:55:09,76,4957,42,34,3324.72,6181.01,0.00
2024-12-08 16:55:09,75,4957,41,34,3307.59,6181.73,0.00
2024-12-08 16:55:09,75,4958,41,34,3373.58,6182.00,0.00
2024-12-08 16:55:09,76,4958,41,35,3329.19,6182.01,0.00
2024-12-08 16:55:09,75,4958,41,34,3363.71,6182.09,0.00
2024-12-08 16:55:09,75,4959,41,34,3356.67,6183.00,0.00
2024-12-08 16:55:09,76,4959,42,34,3312.50,6183.01,0.00
2024-12-08 16:55:09,76,4960,42,34,3284.22,6184.00,0.00
2024-12-08 16:55:09,77,4960,42,35,3241.56,6184.01,0.00
2024-12-08 16:55:09,76,4960,42,34,3274.48,6184.11,0.00
2024-12-08 16:55:09,76,4961,42,34,3268.47,6185.00,0.00
2024-12-08 16:55:09,77,4961,42,35,3226.02,6185.01,0.00
2024-12-08 16:55:09,76,4961,41,35,3238.44,6185.24,0.00
2024-12-08 16:55:09,76,4962,41,35,3264.22,6186.00,0.00
2024-12-08 16:55:09,77,4962,41,36,3221.82,6186.01,0.00
2024-12-08 16:55:09,76,4962,40,36,3203.98,6186.72,0.00
2024-12-08 16:55:09,76,4963,40,36,3253.30,6187.00,0.00
2024-12-08 16:55:09,77,4963,41,36,3211.05,6187.01,0.00
2024-12-08 16:55:09,76,4963,40,36,3222.44,6187.25,0.00
2024-12-08 16:55:10,76,4964,40,36,3229.60,6188.00,0.00
2024-12-08 16:55:10,77,4964,41,36,3187.66,6188.01,0.00
2024-12-08 16:55:10,76,4964,41,35,3214.15,6188.11,0.00
2024-12-08 16:55:10,75,4964,40,35,3199.38,6188.77,0.00
2024-12-08 16:55:10,75,4965,40,35,3263.79,6189.00,0.00
2024-12-08 16:55:10,76,4965,40,36,3220.85,6189.01,0.00
2024-12-08 16:55:10,75,4965,39,36,3262.97,6189.01,0.00
2024-12-08 16:55:10,74,4965,38,36,3224.53,6189.65,0.00
2024-12-08 16:55:10,74,4966,38,36,3282.59,6190.00,0.00
2024-12-08 16:55:10,75,4966,38,37,3238.83,6190.01,0.00
2024-12-08 16:55:10,76,4965,39,37,3149.95,6190.53,0.00
2024-12-08 16:55:10,75,4965,38,37,3218.21,6190.73,0.00
2024-12-08 16:55:10,75,4966,38,37,3283.72,6191.00,0.00
2024-12-08 16:55:10,76,4966,38,38,3240.52,6191.01,0.00
2024-12-08 16:55:10,75,4966,38,37,3268.07,6191.16,0.00
2024-12-08 16:55:10,75,4967,38,37,3348.23,6192.00,0.00
2024-12-08 16:55:10,76,4967,39,37,3304.17,6192.01,0.00
2024-12-08 16:55:10,77,4966,39,38,3231.57,6192.26,0.00
2024-12-08 16:55:10,77,4967,39,38,3307.08,6193.00,0.00
2024-12-08 16:55:10,78,4967,40,38,3264.69,6193.01,0.00
2024-12-08 16:55:10,77,4967,40,37,3299.33,6193.13,0.00
2024-12-08 16:55:10,77,4968,40,37,3378.54,6194.00,0.00
2024-12-08 16:55:10,78,4968,41,37,3335.23,6194.01,0.00
2024-12-08 16:55:10,78,4969,41,37,3314.72,6195.00,0.00
2024-12-08 16:55:10,79,4969,41,38,3272.76,6195.01,0.00
2024-12-08 16:55:10,78,4969,41,37,3290.92,6195.14,0.00
2024-12-08 16:55:10,79,4968,42,37,3239.14,6195.33,0.00
2024-12-08 16:55:10,79,4969,42,37,3305.95,6196.00,0.00
2024-12-08 16:55:10,80,4969,42,38,3264.63,6196.01,0.00
2024-12-08 16:55:10,79,4969,41,38,3285.58,6196.11,0.00
2024-12-08 16:55:10,79,4970,41,38,3369.27,6197.00,0.00
2024-12-08 16:55:10,80,4970,42,38,3327.15,6197.01,0.00
2024-12-08 16:55:10,79,4970,41,38,3334.77,6197.09,0.00
2024-12-08 16:55:10,78,4970,41,37,3371.17,6197.12,0.00
2024-12-08 16:55:10,78,4971,41,37,3393.02,6198.00,0.00
2024-12-08 16:55:10,79,4971,41,38,3350.07,6198.01,0.00
2024-12-08 16:55:10,79,4972,41,38,3317.25,6199.00,0.00
2024-12-08 16:55:10,80,4972,41,39,3275.79,6199.01,0.00
2024-12-08 16:55:10,79,4972,41,38,3307.07,6199.11,0.00
2024-12-08 16:55:10,79,4973,41,38,3294.95,6200.00,0.00
2024-12-08 16:55:10,80,4973,41,39,3253.77,6200.01,0.00
2024-12-08 16:55:10,80,4974,41,39,3245.02,6201.00,0.00
2024-12-08 16:55:10,81,4974,41,40,3204.96,6201.01,0.00
2024-12-08 16:55:10,80,4974,40,40,3243.48,6201.03,0.00
2024-12-08 16:55:10,80,4975,40,40,3232.85,6202.00,0.00
2024-12-08 16:55:10,81,4975,40,41,3192.94,6202.01,0.00
2024-12-08 16:55:10,80,4975,40,40,3193.47,6202.31,0.00
2024-12-08 16:55:10,80,4976,40,40,3211.80,6203.00,0.00
2024-12-08 16:55:10,81,4976,41,40,3172.15,6203.01,0.00
2024-12-08 16:55:10,81,4977,41,40,3136.41,6204.00,0.00
2024-12-08 16:55:10,82,4977,42,40,3098.16,6204.01,0.00
2024-12-08 16:55:10,81,4977,41,40,3134.12,6204.04,0.00
2024-12-08 16:55:10,80,4977,41,39,3160.90,6204.13,0.00
2024-12-08 16:55:10,79,4977,41,38,3189.47,6204.19,0.00
2024-12-08 16:55:10,79,4978,41,38,3186.09,6205.00,0.00
2024-12-08 16:55:10,80,4978,42,38,3146.26,6205.01,0.00
2024-12-08 16:55:10,79,4978,41,38,3176.67,6205.06,0.00
2024-12-08 16:55:10,79,4979,41,38,3180.55,6206.00,0.00
2024-12-08 16:55:10,80,4979,42,38,3140.79,6206.01,0.00
2024-12-08 16:55:10,79,4979,41,38,3178.20,6206.04,0.00
2024-12-08 16:55:10,78,4979,41,37,3210.20,6206.10,0.00
2024-12-08 16:55:10,79,4978,42,37,3158.62,6206.30,0.00
2024-12-08 16:55:10,79,4979,42,37,3233.14,6207.00,0.00
2024-12-08 16:55:10,80,4979,42,38,3192.73,6207.01,0.00
2024-12-08 16:55:10,79,4979,41,38,3231.58,6207.03,0.00
2024-12-08 16:55:10,78,4979,40,38,3272.21,6207.03,0.00
2024-12-08 16:55:10,78,4980,40,38,3321.91,6208.00,0.00
2024-12-08 16:55:10,79,4980,40,39,3279.86,6208.01,0.00
2024-12-08 16:55:10,78,4980,40,38,3313.97,6208.08,0.00
2024-12-08 16:55:10,77,4980,39,38,3346.58,6208.23,0.00
2024-12-08 16:55:10,76,4980,38,38,3342.77,6208.57,0.00
2024-12-08 16:55:10,76,4981,38,38,3392.17,6209.00,0.00
2024-12-08 16:55:10,77,4981,38,39,3348.12,6209.01,0.00
2024-12-08 16:55:10,76,4981,37,39,3362.83,6209.22,0.00
2024-12-08 16:55:10,76,4982,37,39,3357.25,6210.00,0.00
2024-12-08 16:55:10,77,4982,37,40,3313.65,6210.01,0.00
2024-12-08 16:55:10,76,4982,37,39,3349.91,6210.08,0.00
2024-12-08 16:55:10,75,4982,36,39,3321.19,6210.93,0.00
2024-12-08 16:55:10,75,4983,36,39,3399.91,6211.00,0.00
2024-12-08 16:55:10,76,4983,36,40,3355.18,6211.01,0.00
2024-12-08 16:55:10,76,4984,36,40,3318.15,6212.00,0.00
2024-12-08 16:55:10,77,4984,37,40,3275.05,6212.01,0.00
2024-12-08 16:55:10,76,4984,37,39,3311.62,6212.08,0.00
2024-12-08 16:55:10,75,4984,36,39,3335.17,6212.32,0.00
2024-12-08 16:55:10,75,4985,36,39,3366.26,6213.00,0.00
2024-12-08 16:55:10,76,4985,36,40,3321.97,6213.01,0.00
2024-12-08 16:55:10,75,4985,35,40,3272.11,6213.64,0.00
2024-12-08 16:55:11,75,4986,35,40,3327.27,6214.00,0.00
2024-12-08 16:55:11,76,4986,35,41,3283.49,6214.01,0.00
2024-12-08 16:55:11,75,4986,35,40,3322.31,6214.08,0.00
2024-12-08 16:55:11,74,4986,34,40,3300.17,6214.62,0.00
2024-12-08 16:55:11,74,4987,34,40,3354.31,6215.00,0.00
2024-12-08 16:55:11,75,4987,35,40,3309.58,6215.01,0.00
2024-12-08 16:55:11,75,4988,35,40,3269.49,6216.00,0.00
2024-12-08 16:55:11,76,4988,35,41,3226.47,6216.01,0.00
2024-12-08 16:55:11,75,4988,35,40,3264.90,6216.08,0.00
2024-12-08 16:55:11,74,4988,34,40,3299.00,6216.24,0.00
2024-12-08 16:55:11,75,4987,35,40,3243.49,6216.45,0.00
2024-12-08 16:55:11,74,4987,34,40,3318.49,6216.47,0.00
2024-12-08 16:55:11,74,4988,34,40,3356.63,6217.00,0.00
2024-12-08 16:55:11,75,4988,34,41,3311.87,6217.01,0.00
2024-12-08 16:55:11,74,4988,33,41,3354.95,6217.03,0.00
2024-12-08 16:55:11,73,4988,33,40,3379.63,6217.08,0.00
2024-12-08 16:55:11,72,4988,32,40,3406.71,6217.08,0.00
2024-12-08 16:55:11,72,4989,32,40,3508.23,6218.00,0.00
2024-12-08 16:55:11,73,4989,32,41,3460.17,6218.01,0.00
2024-12-08 16:55:11,72,4989,31,41,3459.03,6218.10,0.00
2024-12-08 16:55:11,71,4989,31,40,3484.26,6218.47,0.00
2024-12-08 16:55:11,70,4989,31,39,3517.25,6218.61,0.00
2024-12-08 16:55:11,70,4990,31,39,3579.17,6219.00,0.00
2024-12-08 16:55:11,71,4990,32,39,3528.76,6219.01,0.00
2024-12-08 16:55:11,70,4990,32,38,3537.43,6219.09,0.00
2024-12-08 16:55:11,69,4990,31,38,3549.37,6219.68,0.00
2024-12-08 16:55:11,69,4991,31,38,3612.89,6220.00,0.00
2024-12-08 16:55:11,70,4991,31,39,3561.28,6220.01,0.00
2024-12-08 16:55:11,71,4990,31,40,3419.28,6220.62,0.00
2024-12-08 16:55:11,71,4991,31,40,3557.04,6221.00,0.00
2024-12-08 16:55:11,72,4991,32,40,3507.63,6221.01,0.00
2024-12-08 16:55:11,71,4991,32,39,3550.92,6221.08,0.00
2024-12-08 16:55:11,70,4991,31,39,3583.06,6221.29,0.00
2024-12-08 16:55:11,70,4992,31,39,3699.03,6222.00,0.00
2024-12-08 16:55:11,71,4992,31,40,3646.93,6222.01,0.00
2024-12-08 16:55:11,72,4991,31,41,3471.12,6222.92,0.00
2024-12-08 16:55:11,72,4992,31,41,3556.77,6223.00,0.00
2024-12-08 16:55:11,73,4992,31,42,3508.05,6223.01,0.00
2024-12-08 16:55:11,72,4992,30,42,3548.13,6223.06,0.00
2024-12-08 16:55:11,71,4992,30,41,3592.85,6223.07,0.00
2024-12-08 16:55:11,70,4992,29,41,3634.46,6223.21,0.00
2024-12-08 16:55:11,70,4993,29,41,3750.36,6224.00,0.00
2024-12-08 16:55:11,71,4993,29,42,3697.54,6224.01,0.00
2024-12-08 16:55:11,70,4993,28,42,3679.95,6224.29,0.00
2024-12-08 16:55:11,71,4992,28,43,3591.69,6224.79,0.00
2024-12-08 16:55:11,71,4993,28,43,3674.59,6225.00,0.00
2024-12-08 16:55:11,72,4993,28,44,3623.56,6225.01,0.00
2024-12-08 16:55:11,71,4993,27,44,3672.85,6225.03,0.00
2024-12-08 16:55:11,70,4993,27,43,3679.09,6225.09,0.00
2024-12-08 16:55:11,70,4994,27,43,3794.42,6226.00,0.00
2024-12-08 16:55:11,71,4994,27,44,3740.97,6226.01,0.00
2024-12-08 16:55:11,70,4994,26,44,3790.87,6226.06,0.00
2024-12-08 16:55:11,69,4994,25,44,3802.58,6226.29,0.00
2024-12-08 16:55:11,70,4993,25,45,3719.35,6226.71,0.00
2024-12-08 16:55:11,70,4994,25,45,3802.75,6227.00,0.00
2024-12-08 16:55:11,71,4994,26,45,3749.19,6227.01,0.00
2024-12-08 16:55:11,70,4994,25,45,3800.97,6227.03,0.00
2024-12-08 16:55:11,69,4994,25,44,3847.95,6227.06,0.00
2024-12-08 16:55:11,68,4994,24,44,3879.88,6227.27,0.00
2024-12-08 16:55:11,68,4995,24,44,4008.00,6228.00,0.00
2024-12-08 16:55:11,69,4995,24,45,3949.92,6228.02,0.00
2024-12-08 16:55:11,68,4995,23,45,3980.54,6228.06,0.00
2024-12-08 16:55:11,69,4994,24,45,3843.24,6228.91,0.00
2024-12-08 16:55:11,69,4995,24,45,3931.80,6229.00,0.00
2024-12-08 16:55:11,70,4995,25,45,3875.63,6229.01,0.00
2024-12-08 16:55:11,70,4996,25,45,3930.28,6230.00,0.00
2024-12-08 16:55:11,71,4996,26,45,3874.92,6230.01,0.00
2024-12-08 16:55:11,70,4996,26,44,3912.50,6230.11,0.00
2024-12-08 16:55:11,70,4997,26,44,3901.46,6231.00,0.00
2024-12-08 16:55:11,71,4997,27,44,3846.51,6231.01,0.00
2024-12-08 16:55:11,70,4997,27,43,3864.22,6231.30,0.00
2024-12-08 16:55:11,69,4997,26,43,3856.11,6231.70,0.00
2024-12-08 16:55:11,69,4998,26,43,3927.73,6232.00,0.00
2024-12-08 16:55:11,70,4998,27,43,3871.61,6232.01,0.00
2024-12-08 16:55:11,69,4998,27,42,3906.98,6232.13,0.00
2024-12-08 16:55:11,69,4999,27,42,3902.57,6233.00,0.00
2024-12-08 16:55:11,70,4999,28,42,3846.82,6233.01,0.00
2024-12-08 16:55:11,69,4999,27,42,3835.20,6233.38,0.00
2024-12-08 16:55:11,69,5000,27,42,3887.18,6234.00,0.00
2024-12-08 16:55:11,70,5000,27,43,3831.65,6234.01,0.00
2024-12-08 16:55:11,69,5000,27,42,3867.42,6234.13,0.00
2024-12-08 16:55:11,69,5001,27,42,3861.59,6235.00,0.00
2024-12-08 16:55:11,70,5001,28,42,3806.42,6235.01,0.00
2024-12-08 16:55:11,69,5001,27,42,3824.02,6235.16,0.00
2024-12-08 16:55:11,69,5002,27,42,3857.71,6236.00,0.00
2024-12-08 16:55:11,70,5002,27,43,3802.60,6236.01,0.00
2024-12-08 16:55:11,69,5002,27,42,3854.11,6236.06,0.00
2024-12-08 16:55:11,68,5002,27,41,3890.62,6236.13,0.00
2024-12-08 16:55:11,67,5002,26,41,3947.77,6236.15,0.00
2024-12-08 16:55:11,67,5003,26,41,3946.47,6237.00,0.00
2024-12-08 16:55:11,68,5003,26,42,3888.43,6237.02,0.00
2024-12-08 16:55:11,68,5004,26,42,3886.20,6238.00,0.00
2024-12-08 16:55:11,69,5004,26,43,3829.88,6238.02,0.00
2024-12-08 16:55:12,69,5005,26,43,3817.05,6239.00,0.00
2024-12-08 16:55:12,70,5005,27,43,3762.52,6239.01,0.00
2024-12-08 16:55:12,69,5005,26,43,3810.66,6239.10,0.00
2024-12-08 16:55:12,69,5006,26,43,3787.26,6240.00,0.00
2024-12-08 16:55:12,70,5006,27,43,3733.15,6240.01,0.00
2024-12-08 16:55:12,69,5006,27,42,3767.65,6240.12,0.00
2024-12-08 16:55:12,69,5007,27,42,3761.05,6241.00,0.00
2024-12-08 16:55:12,70,5007,27,43,3707.32,6241.01,0.00
2024-12-08 16:55:12,70,5008,27,43,3675.25,6242.00,0.00
2024-12-08 16:55:12,71,5008,28,43,3623.48,6242.01,0.00
2024-12-08 16:55:12,70,5008,28,42,3652.08,6242.11,0.00
2024-12-08 16:55:12,70,5009,28,42,3638.24,6243.00,0.00
2024-12-08 16:55:12,71,5009,29,42,3587.00,6243.01,0.00
2024-12-08 16:55:12,70,5009,28,42,3630.24,6243.13,0.00
2024-12-08 16:55:12,71,5008,29,42,3555.41,6243.25,0.00
2024-12-08 16:55:12,71,5009,29,42,3604.66,6244.00,0.00
2024-12-08 16:55:12,72,5009,30,42,3554.60,6244.01,0.00
2024-12-08 16:55:12,71,5009,30,41,3579.19,6244.13,0.00
2024-12-08 16:55:12,71,5010,30,41,3653.34,6245.00,0.00
2024-12-08 16:55:12,72,5010,31,41,3602.60,6245.01,0.00
2024-12-08 16:55:12,71,5010,31,40,3605.87,6245.31,0.00
2024-12-08 16:55:12,70,5010,30,40,3639.55,6245.33,0.00
2024-12-08 16:55:12,69,5010,29,40,3679.32,6245.51,0.00
2024-12-08 16:55:12,69,5011,29,40,3736.95,6246.00,0.00
2024-12-08 16:55:12,70,5011,30,40,3683.56,6246.01,0.00
2024-12-08 16:55:12,69,5011,30,39,3709.74,6246.13,0.00
2024-12-08 16:55:12,69,5012,30,39,3707.54,6247.00,0.00
2024-12-08 16:55:12,70,5012,30,40,3654.58,6247.01,0.00
2024-12-08 16:55:12,70,5013,30,40,3629.60,6248.00,0.00
2024-12-08 16:55:12,71,5013,31,40,3578.48,6248.01,0.00
2024-12-08 16:55:12,70,5013,30,40,3522.57,6248.93,0.00
2024-12-08 16:55:12,70,5014,30,40,3607.43,6249.00,0.00
2024-12-08 16:55:12,71,5014,30,41,3556.62,6249.01,0.00
2024-12-08 16:55:12,70,5014,30,40,3593.08,6249.13,0.00
2024-12-08 16:55:12,71,5013,30,41,3492.81,6249.87,0.00
2024-12-08 16:55:12,71,5014,30,41,3594.64,6250.00,0.00
2024-12-08 16:55:12,72,5014,30,42,3544.71,6250.01,0.00
2024-12-08 16:55:12,71,5014,29,42,3500.82,6250.76,0.00
2024-12-08 16:55:12,71,5015,29,42,3652.14,6251.00,0.00
2024-12-08 16:55:12,72,5015,30,42,3601.42,6251.01,0.00
2024-12-08 16:55:12,71,5015,30,41,3641.53,6251.11,0.00
2024-12-08 16:55:12,70,5015,30,40,3675.69,6251.11,0.00
2024-12-08 16:55:12,70,5016,30,40,3654.73,6252.00,0.00
2024-12-08 16:55:12,71,5016,30,41,3603.26,6252.01,0.00
2024-12-08 16:55:12,70,5016,29,41,3605.77,6252.14,0.00
2024-12-08 16:55:12,70,5017,29,41,3619.06,6253.00,0.00
2024-12-08 16:55:12,71,5017,29,42,3568.09,6253.01,0.00
2024-12-08 16:55:12,70,5017,29,41,3594.96,6253.13,0.00
2024-12-08 16:55:12,70,5018,29,41,3571.72,6254.00,0.00
2024-12-08 16:55:12,71,5018,29,42,3521.41,6254.01,0.00
2024-12-08 16:55:12,71,5019,29,42,3483.19,6255.00,0.00
2024-12-08 16:55:12,72,5019,29,43,3434.81,6255.01,0.00
2024-12-08 16:55:12,71,5019,28,43,3481.43,6255.03,0.00
2024-12-08 16:55:12,70,5019,28,42,3506.16,6255.13,0.00
2024-12-08 16:55:12,69,5019,27,42,3501.08,6255.71,0.00
2024-12-08 16:55:12,69,5020,27,42,3565.75,6256.00,0.00
2024-12-08 16:55:12,70,5020,28,42,3514.81,6256.01,0.00
2024-12-08 16:55:12,69,5020,27,42,3526.82,6256.22,0.00
2024-12-08 16:55:12,68,5020,27,41,3550.83,6256.57,0.00
2024-12-08 16:55:12,68,5021,27,41,3609.38,6257.00,0.00
2024-12-08 16:55:12,69,5021,28,41,3557.07,6257.02,0.00
2024-12-08 16:55:12,68,5021,28,40,3606.63,6257.04,0.00
2024-12-08 16:55:12,67,5021,28,39,3636.20,6257.13,0.00
2024-12-08 16:55:12,67,5022,28,39,3631.59,6258.00,0.00
2024-12-08 16:55:12,68,5022,29,39,3578.19,6258.02,0.00
2024-12-08 16:55:12,67,5022,28,39,3630.66,6258.02,0.00
2024-12-08 16:55:12,66,5022,28,38,3683.78,6258.03,0.00
2024-12-08 16:55:12,66,5023,28,38,3662.13,6259.00,0.00
2024-12-08 16:55:12,67,5023,28,39,3607.47,6259.02,0.00
2024-12-08 16:55:12,66,5023,28,38,3660.24,6259.03,0.00
2024-12-08 16:55:12,65,5023,28,37,3693.46,6259.09,0.00
2024-12-08 16:55:12,64,5023,27,37,3732.15,6259.16,0.00
2024-12-08 16:55:12,64,5024,27,37,3772.85,6260.00,0.00
2024-12-08 16:55:12,65,5024,27,38,3714.80,6260.02,0.00
2024-12-08 16:55:12,65,5025,27,38,3693.44,6261.00,0.00
2024-12-08 16:55:12,66,5025,28,38,3637.48,6261.02,0.00
2024-12-08 16:55:12,65,5025,28,37,3670.34,6261.09,0.00
2024-12-08 16:55:12,66,5024,28,38,3586.51,6261.58,0.00
2024-12-08 16:55:12,65,5024,27,38,3662.85,6261.94,0.00
2024-12-08 16:55:12,65,5025,27,38,3755.38,6262.00,0.00
2024-12-08 16:55:12,66,5025,28,38,3698.48,6262.02,0.00
2024-12-08 16:55:12,66,5026,28,38,3766.43,6263.00,0.00
2024-12-08 16:55:12,67,5026,29,38,3710.22,6263.02,0.00
2024-12-08 16:55:12,66,5026,29,37,3745.93,6263.09,0.00
2024-12-08 16:55:12,66,5027,29,37,3738.07,6264.00,0.00
2024-12-08 16:55:12,67,5027,30,37,3682.28,6264.02,0.00
2024-12-08 16:55:12,66,5027,29,37,3662.37,6264.52,0.00
2024-12-08 16:55:13,66,5028,29,37,3717.52,6265.00,0.00
2024-12-08 16:55:13,67,5028,29,38,3662.04,6265.02,0.00
2024-12-08 16:55:13,67,5029,29,38,3627.17,6266.00,0.00
2024-12-08 16:55:13,68,5029,30,38,3573.83,6266.02,0.00
2024-12-08 16:55:13,67,5029,30,37,3618.78,6266.12,0.00
2024-12-08 16:55:13,66,5029,30,36,3633.83,6266.76,0.00
2024-12-08 16:55:13,66,5030,30,36,3675.81,6267.00,0.00
2024-12-08 16:55:13,67,5030,30,37,3620.95,6267.02,0.00
2024-12-08 16:55:13,66,5030,29,37,3644.49,6267.08,0.00
2024-12-08 16:55:13,67,5029,30,37,3560.24,6267.28,0.00
2024-12-08 16:55:13,67,5030,30,37,3653.33,6268.00,0.00
2024-12-08 16:55:13,68,5030,30,38,3599.61,6268.02,0.00
2024-12-08 16:55:13,68,5031,30,38,3686.87,6269.00,0.00
2024-12-08 16:55:13,69,5031,31,38,3633.44,6269.02,0.00
2024-12-08 16:55:13,68,5031,30,38,3628.52,6269.65,0.00
2024-12-08 16:55:13,68,5032,30,38,3664.96,6270.00,0.00
2024-12-08 16:55:13,69,5032,31,38,3611.85,6270.02,0.00
2024-12-08 16:55:13,68,5032,30,38,3663.12,6270.03,0.00
2024-12-08 16:55:13,67,5032,30,37,3703.77,6270.06,0.00
2024-12-08 16:55:13,67,5033,30,37,3701.54,6271.00,0.00
2024-12-08 16:55:13,68,5033,31,37,3647.10,6271.02,0.00
2024-12-08 16:55:13,69,5032,32,37,3543.58,6271.57,0.00
2024-12-08 16:55:13,69,5033,32,37,3642.88,6272.00,0.00
2024-12-08 16:55:13,70,5033,32,38,3590.84,6272.01,0.00
2024-12-08 16:55:13,69,5033,32,37,3624.72,6272.09,0.00
2024-12-08 16:55:13,69,5034,32,37,3713.46,6273.00,0.00
2024-12-08 16:55:13,70,5034,33,37,3660.41,6273.01,0.00
2024-12-08 16:55:13,70,5035,33,37,3639.92,6274.00,0.00
2024-12-08 16:55:13,71,5035,34,37,3588.66,6274.01,0.00
2024-12-08 16:55:13,70,5035,34,36,3620.22,6274.09,0.00
2024-12-08 16:55:13,70,5036,34,36,3617.20,6275.00,0.00
2024-12-08 16:55:13,71,5036,34,37,3566.25,6275.01,0.00
2024-12-08 16:55:13,70,5036,33,37,3571.03,6275.10,0.00
2024-12-08 16:55:13,70,5037,33,37,3604.76,6276.00,0.00
2024-12-08 16:55:13,71,5037,34,37,3553.98,6276.01,0.00
2024-12-08 16:55:13,70,5037,33,37,3596.61,6276.06,0.00
2024-12-08 16:55:13,70,5038,33,37,3609.51,6277.00,0.00
2024-12-08 16:55:13,71,5038,33,38,3558.68,6277.01,0.00
2024-12-08 16:55:13,70,5038,33,37,3598.76,6277.07,0.00
2024-12-08 16:55:13,71,5037,33,38,3547.20,6277.11,0.00
2024-12-08 16:55:13,71,5038,33,38,3598.92,6278.00,0.00
2024-12-08 16:55:13,72,5038,33,39,3548.93,6278.01,0.00
2024-12-08 16:55:13,71,5038,33,38,3586.55,6278.06,0.00
2024-12-08 16:55:13,70,5038,32,38,3610.10,6278.33,0.00
2024-12-08 16:55:13,70,5039,32,38,3745.92,6279.00,0.00
2024-12-08 16:55:13,71,5039,33,38,3693.16,6279.01,0.00
2024-12-08 16:55:13,71,5040,33,38,3690.43,6280.00,0.00
2024-12-08 16:55:13,72,5040,33,39,3639.17,6280.01,0.00
2024-12-08 16:55:13,72,5041,33,39,3607.21,6281.00,0.00
2024-12-08 16:55:13,73,5041,34,39,3557.80,6281.01,0.00
2024-12-08 16:55:13,72,5041,34,38,3593.26,6281.06,0.00
2024-12-08 16:55:13,71,5041,33,38,3563.02,6281.93,0.00
2024-12-08 16:55:13,71,5042,33,38,3647.13,6282.00,0.00
2024-12-08 16:55:13,72,5042,34,38,3596.47,6282.01,0.00
2024-12-08 16:55:13,72,5043,34,38,3586.30,6283.00,0.00
2024-12-08 16:55:13,73,5043,35,38,3537.17,6283.01,0.00
2024-12-08 16:55:13,73,5044,35,38,3520.00,6284.00,0.00
2024-12-08 16:55:13,74,5044,35,39,3472.44,6284.01,0.00
2024-12-08 16:55:13,73,5044,35,38,3481.31,6284.36,0.00
2024-12-08 16:55:13,72,5044,34,38,3499.54,6284.71,0.00
2024-12-08 16:55:13,71,5044,33,38,3532.16,6284.86,0.00
2024-12-08 16:55:13,71,5045,33,38,3611.95,6285.00,0.00
2024-12-08 16:55:13,72,5045,33,39,3561.78,6285.01,0.00
2024-12-08 16:55:13,71,5045,33,38,3597.79,6285.06,0.00
2024-12-08 16:55:13,71,5046,33,38,3583.31,6286.00,0.00
2024-12-08 16:55:13,72,5046,34,38,3533.55,6286.01,0.00
2024-12-08 16:55:13,71,5046,33,38,3578.00,6286.03,0.00
2024-12-08 16:55:13,71,5047,33,38,3576.88,6287.00,0.00
2024-12-08 16:55:13,72,5047,33,39,3527.20,6287.01,0.00
2024-12-08 16:55:13,71,5047,33,38,3566.26,6287.04,0.00
2024-12-08 16:55:13,72,5046,34,38,3502.83,6287.29,0.00
2024-12-08 16:55:13,72,5047,34,38,3515.85,6288.00,0.00
2024-12-08 16:55:13,73,5047,35,38,3467.69,6288.01,0.00
2024-12-08 16:55:13,74,5046,35,39,3357.97,6288.58,0.00
2024-12-08 16:55:13,73,5046,34,39,3448.26,6288.71,0.00
2024-12-08 16:55:13,73,5047,34,39,3595.65,6289.00,0.00
2024-12-08 16:55:13,74,5047,34,40,3547.06,6289.01,0.00
2024-12-08 16:55:13,73,5047,34,39,3584.45,6289.06,0.00
2024-12-08 16:55:13,72,5047,33,39,3624.39,6289.21,0.00
2024-12-08 16:55:13,72,5048,33,39,3693.62,6290.00,0.00
2024-12-08 16:55:13,73,5048,34,39,3643.03,6290.01,0.00
2024-12-08 16:55:13,72,5048,33,39,3692.75,6290.01,0.00
2024-12-08 16:55:13,71,5048,32,39,3694.28,6290.08,0.00
2024-12-08 16:55:13,70,5048,31,39,3723.95,6290.30,0.00
2024-12-08 16:55:13,70,5049,31,39,3763.37,6291.00,0.00
2024-12-08 16:55:13,71,5049,32,39,3710.37,6291.01,0.00
2024-12-08 16:55:13,70,5049,32,38,3751.70,6291.06,0.00
2024-12-08 16:55:14,69,5049,31,38,3787.33,6291.28,0.00
2024-12-08 16:55:14,69,5050,31,38,3789.85,6292.00,0.00
2024-12-08 16:55:14,70,5050,31,39,3735.71,6292.01,0.00
2024-12-08 16:55:14,69,5050,30,39,3778.91,6292.02,0.00
2024-12-08 16:55:14,70,5049,30,40,3680.61,6292.41,0.00
2024-12-08 16:55:14,70,5050,30,40,3762.52,6293.00,0.00
2024-12-08 16:55:14,71,5050,31,40,3709.52,6293.01,0.00
2024-12-08 16:55:14,70,5050,31,39,3753.54,6293.04,0.00
2024-12-08 16:55:14,70,5051,31,39,3826.31,6294.00,0.00
2024-12-08 16:55:14,71,5051,31,40,3772.42,6294.01,0.00
2024-12-08 16:55:14,70,5051,30,40,3799.36,6294.16,0.00
2024-12-08 16:55:14,70,5052,30,40,3788.26,6295.00,0.00
2024-12-08 16:55:14,71,5052,31,40,3734.90,6295.01,0.00
2024-12-08 16:55:14,70,5052,31,39,3779.28,6295.04,0.00
2024-12-08 16:55:14,69,5052,30,39,3810.80,6295.23,0.00
2024-12-08 16:55:14,69,5053,30,39,3844.22,6296.00,0.00
2024-12-08 16:55:14,70,5053,31,39,3789.30,6296.01,0.00
2024-12-08 16:55:14,71,5052,32,39,3689.77,6296.41,0.00
2024-12-08 16:55:14,71,5053,32,39,3731.41,6297.00,0.00
2024-12-08 16:55:14,72,5053,33,39,3679.58,6297.01,0.00
2024-12-08 16:55:14,71,5053,33,38,3724.33,6297.04,0.00
2024-12-08 16:55:14,71,5054,33,38,3791.02,6298.00,0.00
2024-12-08 16:55:14,72,5054,34,38,3738.37,6298.01,0.00
2024-12-08 16:55:14,71,5054,34,37,3760.35,6298.18,0.00
2024-12-08 16:55:14,71,5055,34,37,3752.04,6299.00,0.00
2024-12-08 16:55:14,72,5055,34,38,3699.93,6299.01,0.00
2024-12-08 16:55:14,71,5055,34,37,3741.41,6299.04,0.00
2024-12-08 16:55:14,70,5055,34,36,3750.78,6299.63,0.00
2024-12-08 16:55:14,70,5056,34,36,3781.66,6300.00,0.00
2024-12-08 16:55:14,71,5056,35,36,3728.40,6300.01,0.00
2024-12-08 16:55:14,71,5057,35,36,3695.21,6301.00,0.00
2024-12-08 16:55:14,72,5057,35,37,3643.89,6301.01,0.00
2024-12-08 16:55:14,71,5057,35,36,3689.01,6301.06,0.00
2024-12-08 16:55:14,72,5056,36,36,3613.94,6301.43,0.00
2024-12-08 16:55:14,72,5057,36,36,3660.12,6302.00,0.00
2024-12-08 16:55:14,73,5057,37,36,3609.98,6302.01,0.00
2024-12-08 16:55:14,73,5058,37,36,3662.03,6303.00,0.00
2024-12-08 16:55:14,74,5058,38,36,3612.55,6303.01,0.00
2024-12-08 16:55:14,73,5058,38,35,3655.14,6303.07,0.00
2024-12-08 16:55:14,72,5058,37,35,3699.81,6303.15,0.00
2024-12-08 16:55:14,72,5059,37,35,3691.72,6304.00,0.00
2024-12-08 16:55:14,73,5059,38,35,3641.15,6304.01,0.00
2024-12-08 16:55:14,73,5060,38,35,3606.66,6305.00,0.00
2024-12-08 16:55:14,74,5060,39,35,3557.92,6305.01,0.00
2024-12-08 16:55:14,73,5060,39,34,3599.00,6305.07,0.00
2024-12-08 16:55:14,74,5059,40,34,3550.36,6305.10,0.00
2024-12-08 16:55:14,75,5058,41,34,3509.80,6305.24,0.00
2024-12-08 16:55:14,74,5058,40,34,3616.41,6305.39,0.00
2024-12-08 16:55:14,74,5059,40,34,3629.60,6306.00,0.00
2024-12-08 16:55:14,75,5059,40,35,3581.20,6306.01,0.00
2024-12-08 16:55:14,74,5059,39,35,3585.78,6306.34,0.00
2024-12-08 16:55:14,74,5060,39,35,3763.94,6307.00,0.00
2024-12-08 16:55:14,75,5060,40,35,3713.75,6307.01,0.00
2024-12-08 16:55:14,74,5060,40,34,3747.53,6307.10,0.00
2024-12-08 16:55:14,73,5060,39,34,3762.20,6307.63,0.00
2024-12-08 16:55:14,72,5060,38,34,3786.95,6307.88,0.00
2024-12-08 16:55:14,72,5061,38,34,3863.09,6308.00,0.00
2024-12-08 16:55:14,73,5061,39,34,3810.18,6308.01,0.00
2024-12-08 16:55:14,72,5061,39,33,3862.61,6308.01,0.00
2024-12-08 16:55:14,72,5062,39,33,3827.50,6309.00,0.00
2024-12-08 16:55:14,73,5062,40,33,3775.07,6309.01,0.00
2024-12-08 16:55:14,74,5061,40,34,3721.51,6309.08,0.00
2024-12-08 16:55:14,73,5061,40,33,3767.32,6309.10,0.00
2024-12-08 16:55:14,72,5061,39,33,3816.16,6309.15,0.00
2024-12-08 16:55:14,72,5062,39,33,3805.61,6310.00,0.00
2024-12-08 16:55:14,73,5062,39,34,3753.48,6310.01,0.00
2024-12-08 16:55:14,73,5063,39,34,3800.94,6311.00,0.00
2024-12-08 16:55:14,74,5063,39,35,3749.58,6311.01,0.00
2024-12-08 16:55:14,73,5063,39,34,3787.14,6311.08,0.00
2024-12-08 16:55:14,72,5063,38,34,3782.53,6311.79,0.00
2024-12-08 16:55:14,72,5064,38,34,3849.50,6312.00,0.00
2024-12-08 16:55:14,73,5064,38,35,3796.76,6312.01,0.00
2024-12-08 16:55:14,72,5064,37,35,3816.21,6312.08,0.00
2024-12-08 16:55:14,72,5065,37,35,3814.09,6313.00,0.00
2024-12-08 16:55:14,73,5065,37,36,3761.85,6313.01,0.00
2024-12-08 16:55:14,72,5065,37,35,3795.71,6313.10,0.00
2024-12-08 16:55:14,72,5066,37,35,3775.88,6314.00,0.00
2024-12-08 16:55:14,73,5066,37,36,3724.16,6314.01,0.00
2024-12-08 16:55:14,72,5066,36,36,3665.95,6314.88,0.00
2024-12-08 16:55:15,72,5067,36,36,3745.87,6315.00,0.00
2024-12-08 16:55:15,73,5067,36,37,3694.56,6315.01,0.00
2024-12-08 16:55:15,72,5067,36,36,3734.48,6315.04,0.00
2024-12-08 16:55:15,71,5067,35,36,3740.49,6315.20,0.00
2024-12-08 16:55:15,71,5068,35,36,3770.16,6316.00,0.00
2024-12-08 16:55:15,72,5068,35,37,3717.79,6316.01,0.00
2024-12-08 16:55:15,71,5068,35,36,3756.31,6316.10,0.00
2024-12-08 16:55:15,70,5068,34,36,3737.21,6316.69,0.00
2024-12-08 16:55:15,69,5068,33,36,3789.54,6316.71,0.00
2024-12-08 16:55:15,69,5069,33,36,3854.39,6317.00,0.00
2024-12-08 16:55:15,70,5069,33,37,3799.33,6317.01,0.00
2024-12-08 16:55:15,71,5068,34,37,3678.63,6317.83,0.00
2024-12-08 16:55:15,71,5069,34,37,3725.58,6318.00,0.00
2024-12-08 16:55:15,72,5069,35,37,3673.84,6318.01,0.00
2024-12-08 16:55:15,71,5069,35,36,3706.04,6318.11,0.00
2024-12-08 16:55:15,72,5068,36,36,3569.06,6318.94,0.00
2024-12-08 16:55:15,72,5069,36,36,3762.14,6319.00,0.00
2024-12-08 16:55:15,73,5069,36,37,3710.60,6319.01,0.00
2024-12-08 16:55:15,74,5068,36,38,3581.42,6319.53,0.00
2024-12-08 16:55:15,74,5069,36,38,3738.85,6320.00,0.00
2024-12-08 16:55:15,75,5069,36,39,3689.00,6320.01,0.00
2024-12-08 16:55:15,74,5069,36,38,3720.95,6320.11,0.00
2024-12-08 16:55:15,73,5069,35,38,3731.81,6320.41,0.00
2024-12-08 16:55:15,73,5070,35,38,3857.07,6321.00,0.00
2024-12-08 16:55:15,74,5070,35,39,3804.95,6321.01,0.00
2024-12-08 16:55:15,73,5070,34,39,3824.19,6321.10,0.00
2024-12-08 16:55:15,73,5071,34,39,3825.30,6322.00,0.00
2024-12-08 16:55:15,74,5071,34,40,3773.61,6322.01,0.00
2024-12-08 16:55:15,73,5071,34,39,3808.87,6322.10,0.00
2024-12-08 16:55:15,73,5072,34,39,3792.59,6323.00,0.00
2024-12-08 16:55:15,74,5072,34,40,3741.33,6323.01,0.00
2024-12-08 16:55:15,75,5071,35,40,3645.81,6323.49,0.00
2024-12-08 16:55:15,76,5070,35,41,3616.26,6323.67,0.00
2024-12-08 16:55:15,76,5071,35,41,3707.30,6324.00,0.00
2024-12-08 16:55:15,77,5071,36,41,3659.16,6324.01,0.00
2024-12-08 16:55:15,76,5071,36,40,3705.64,6324.03,0.00
2024-12-08 16:55:15,77,5070,37,40,3630.48,6324.22,0.00
2024-12-08 16:55:15,77,5071,37,40,3843.82,6325.00,0.00
2024-12-08 16:55:15,78,5071,38,40,3794.54,6325.01,0.00
2024-12-08 16:55:15,78,5072,38,40,3837.04,6326.00,0.00
2024-12-08 16:55:15,79,5072,39,40,3788.47,6326.01,0.00
2024-12-08 16:55:15,78,5072,39,39,3824.09,6326.08,0.00
2024-12-08 16:55:15,77,5072,38,39,3866.21,6326.16,0.00
2024-12-08 16:55:15,77,5073,38,39,3851.01,6327.00,0.00
2024-12-08 16:55:15,78,5073,39,39,3801.64,6327.01,0.00
2024-12-08 16:55:15,78,5074,39,39,3758.09,6328.00,0.00
2024-12-08 16:55:15,79,5074,40,39,3710.52,6328.01,0.00
2024-12-08 16:55:15,78,5074,40,38,3743.51,6328.09,0.00
2024-12-08 16:55:15,77,5074,39,38,3731.44,6328.83,0.00
2024-12-08 16:55:15,77,5075,39,38,3770.21,6329.00,0.00
2024-12-08 16:55:15,78,5075,40,38,3721.87,6329.01,0.00
2024-12-08 16:55:15,77,5075,39,38,3752.96,6329.05,0.00
2024-12-08 16:55:15,76,5075,38,38,3737.68,6329.65,0.00
2024-12-08 16:55:15,76,5076,38,38,3798.76,6330.00,0.00
2024-12-08 16:55:15,77,5076,39,38,3749.42,6330.01,0.00
2024-12-08 16:55:15,76,5076,39,37,3785.45,6330.08,0.00
2024-12-08 16:55:15,76,5076,39,37,3767.23,6331.00,0.00
2024-12-08 16:55:15,77,5076,40,37,3718.30,6331.01,0.00
2024-12-08 16:55:15,76,5076,39,37,3732.57,6331.18,0.00
2024-12-08 16:55:15,76,5077,39,37,3748.20,6332.00,0.00
2024-12-08 16:55:15,77,5077,39,38,3699.52,6332.01,0.00
2024-12-08 16:55:15,76,5077,38,38,3745.72,6332.04,0.00
2024-12-08 16:55:15,75,5077,37,38,3766.11,6332.16,0.00
2024-12-08 16:55:15,76,5076,37,39,3700.85,6332.34,0.00
2024-12-08 16:55:15,76,5077,37,39,3729.40,6333.00,0.00
2024-12-08 16:55:15,77,5077,37,40,3680.96,6333.01,0.00
2024-12-08 16:55:15,76,5077,36,40,3701.25,6333.15,0.00
2024-12-08 16:55:15,75,5077,35,40,3711.64,6333.60,0.00
2024-12-08 16:55:15,75,5078,35,40,3820.50,6334.00,0.00
2024-12-08 16:55:15,76,5078,36,40,3770.23,6334.01,0.00
2024-12-08 16:55:15,75,5078,36,39,3810.38,6334.07,0.00
2024-12-08 16:55:15,74,5078,35,39,3763.39,6334.96,0.00
2024-12-08 16:55:15,74,5079,35,39,3846.46,6335.00,0.00
2024-12-08 16:55:15,75,5079,35,40,3795.17,6335.01,0.00
2024-12-08 16:55:15,75,5080,35,40,3750.82,6336.00,0.00
2024-12-08 16:55:15,76,5080,35,41,3701.47,6336.01,0.00
2024-12-08 16:55:15,75,5080,35,40,3738.17,6336.08,0.00
2024-12-08 16:55:15,74,5080,35,39,3780.65,6336.20,0.00
2024-12-08 16:55:15,73,5080,34,39,3775.01,6336.49,0.00
2024-12-08 16:55:15,73,5081,34,39,3825.77,6337.00,0.00
2024-12-08 16:55:15,74,5081,35,39,3774.07,6337.01,0.00
2024-12-08 16:55:15,73,5081,34,39,3773.72,6337.11,0.00
2024-12-08 16:55:15,72,5081,34,38,3810.34,6337.24,0.00
2024-12-08 16:55:15,72,5082,34,38,3839.45,6338.00,0.00
2024-12-08 16:55:15,73,5082,35,38,3786.86,6338.01,0.00
2024-12-08 16:55:15,72,5082,35,37,3826.27,6338.08,0.00
2024-12-08 16:55:15,72,5083,35,37,3810.46,6339.00,0.00
2024-12-08 16:55:15,73,5083,35,38,3758.27,6339.01,0.00
2024-12-08 16:55:16,73,5084,35,38,3746.98,6340.00,0.00
2024-12-08 16:55:16,74,5084,35,39,3696.34,6340.01,0.00
2024-12-08 16:55:16,74,5085,35,39,3680.19,6341.00,0.00
2024-12-08 16:55:16,75,5085,36,39,3631.12,6341.01,0.00
2024-12-08 16:55:16,75,5086,36,39,3603.67,6342.00,0.00
2024-12-08 16:55:16,76,5086,36,40,3556.26,6342.01,0.00
2024-12-08 16:55:16,75,5086,36,39,3559.32,6342.40,0.00
2024-12-08 16:55:16,74,5086,35,39,3552.58,6342.82,0.00
2024-12-08 16:55:16,74,5087,35,39,3627.30,6343.00,0.00
2024-12-08 16:55:16,75,5087,35,40,3578.93,6343.01,0.00
2024-12-08 16:55:16,74,5087,35,39,3621.31,6343.08,0.00
2024-12-08 16:55:16,73,5087,34,39,3665.73,6343.17,0.00
2024-12-08 16:55:16,73,5088,34,39,3663.66,6344.00,0.00
2024-12-08 16:55:16,74,5088,35,39,3614.15,6344.01,0.00
2024-12-08 16:55:16,73,5088,34,39,3658.29,6344.07,0.00
2024-12-08 16:55:16,74,5087,35,39,3575.52,6344.35,0.00
2024-12-08 16:55:16,74,5088,35,39,3693.56,6345.00,0.00
2024-12-08 16:55:16,75,5088,36,39,3644.32,6345.01,0.00
2024-12-08 16:55:16,74,5088,36,38,3683.29,6345.07,0.00
2024-12-08 16:55:16,74,5089,36,38,3760.06,6346.00,0.00
2024-12-08 16:55:16,75,5089,36,39,3709.93,6346.01,0.00
2024-12-08 16:55:16,74,5089,35,39,3724.98,6346.23,0.00
2024-12-08 16:55:16,74,5090,35,39,3759.75,6347.00,0.00
2024-12-08 16:55:16,75,5090,36,39,3709.62,6347.01,0.00
2024-12-08 16:55:16,74,5090,35,39,3732.31,6347.07,0.00
2024-12-08 16:55:16,75,5089,36,39,3631.22,6347.64,0.00
2024-12-08 16:55:16,75,5090,36,39,3722.37,6348.00,0.00
2024-12-08 16:55:16,76,5090,37,39,3673.39,6348.01,0.00
2024-12-08 16:55:16,75,5090,37,38,3700.40,6348.13,0.00
2024-12-08 16:55:16,75,5091,37,38,3777.54,6349.00,0.00
2024-12-08 16:55:16,76,5091,37,39,3727.84,6349.01,0.00
2024-12-08 16:55:16,75,5091,37,38,3775.01,6349.04,0.00
2024-12-08 16:55:16,74,5091,36,38,3802.04,6349.15,0.00
2024-12-08 16:55:16,74,5092,36,38,3801.33,6350.00,0.00
2024-12-08 16:55:16,75,5092,36,39,3750.65,6350.01,0.00
2024-12-08 16:55:16,74,5092,36,38,3779.01,6350.12,0.00
2024-12-08 16:55:16,73,5092,35,38,3817.67,6350.21,0.00
2024-12-08 16:55:16,73,5093,35,38,3852.72,6351.00,0.00
2024-12-08 16:55:16,74,5093,36,38,3800.66,6351.01,0.00
2024-12-08 16:55:16,75,5092,37,38,3742.25,6351.15,0.00
2024-12-08 16:55:16,75,5093,37,38,3759.04,6352.00,0.00
2024-12-08 16:55:16,76,5093,37,39,3709.57,6352.01,0.00
2024-12-08 16:55:16,76,5094,37,39,3773.59,6353.00,0.00
2024-12-08 16:55:16,77,5094,37,40,3724.58,6353.01,0.00
2024-12-08 16:55:16,76,5094,37,39,3759.75,6353.07,0.00
2024-12-08 16:55:16,75,5094,36,39,3771.79,6353.15,0.00
2024-12-08 16:55:16,75,5095,36,39,3801.90,6354.00,0.00
2024-12-08 16:55:16,76,5095,36,40,3751.87,6354.01,0.00
2024-12-08 16:55:16,75,5095,36,39,3791.03,6354.05,0.00
2024-12-08 16:55:16,76,5094,36,40,3718.61,6354.17,0.00
2024-12-08 16:55:16,77,5093,37,40,3701.16,6354.53,0.00
2024-12-08 16:55:16,77,5094,37,40,3727.69,6355.00,0.00
2024-12-08 16:55:16,78,5094,37,41,3679.90,6355.01,0.00
2024-12-08 16:55:16,77,5094,37,40,3714.52,6355.10,0.00
2024-12-08 16:55:16,76,5094,36,40,3678.28,6355.92,0.00
2024-12-08 16:55:16,76,5095,36,40,3924.20,6356.00,0.00
2024-12-08 16:55:16,77,5095,36,41,3873.23,6356.01,0.00
2024-12-08 16:55:16,76,5095,35,41,3914.16,6356.01,0.00
2024-12-08 16:55:16,76,5096,35,41,3910.93,6357.00,0.00
2024-12-08 16:55:16,77,5096,36,41,3860.14,6357.01,0.00
2024-12-08 16:55:16,76,5096,35,41,3909.26,6357.03,0.00
2024-12-08 16:55:16,75,5096,35,40,3946.14,6357.08,0.00
2024-12-08 16:55:16,75,5097,35,40,3926.81,6358.00,0.00
2024-12-08 16:55:16,76,5097,36,40,3875.14,6358.01,0.00
2024-12-08 16:55:16,75,5097,35,40,3846.41,6358.68,0.00
2024-12-08 16:55:16,75,5098,35,40,3909.43,6359.00,0.00
2024-12-08 16:55:16,76,5098,35,41,3857.99,6359.01,0.00
2024-12-08 16:55:16,77,5097,36,41,3753.96,6359.53,0.00
2024-12-08 16:55:16,77,5098,36,41,3842.52,6360.00,0.00
2024-12-08 16:55:16,78,5098,36,42,3793.26,6360.01,0.00
2024-12-08 16:55:16,77,5098,36,41,3774.28,6360.60,0.00
2024-12-08 16:55:16,77,5099,36,41,3886.21,6361.00,0.00
2024-12-08 16:55:16,78,5099,37,41,3836.38,6361.01,0.00
2024-12-08 16:55:16,78,5100,37,41,3786.76,6362.00,0.00
2024-12-08 16:55:16,79,5100,38,41,3738.83,6362.01,0.00
2024-12-08 16:55:16,78,5100,38,40,3768.12,6362.09,0.00
2024-12-08 16:55:16,79,5099,39,40,3671.75,6362.80,0.00
2024-12-08 16:55:16,79,5100,39,40,3701.92,6363.00,0.00
2024-12-08 16:55:16,80,5100,39,41,3655.65,6363.01,0.00
2024-12-08 16:55:17,80,5101,39,41,3680.35,6364.00,0.00
2024-12-08 16:55:17,81,5101,40,41,3634.92,6364.01,0.00
2024-12-08 16:55:17,80,5101,40,40,3662.13,6364.09,0.00
2024-12-08 16:55:17,79,5101,39,40,3688.35,6364.14,0.00
2024-12-08 16:55:17,80,5100,39,41,3605.83,6364.66,0.00
2024-12-08 16:55:17,80,5101,39,41,3662.74,6365.00,0.00
2024-12-08 16:55:17,81,5101,40,41,3617.52,6365.01,0.00
2024-12-08 16:55:17,80,5101,40,40,3650.81,6365.03,0.00
2024-12-08 16:55:17,79,5101,39,40,3687.80,6365.13,0.00
2024-12-08 16:55:17,79,5102,39,40,3734.89,6366.00,0.00
2024-12-08 16:55:17,80,5102,39,41,3688.21,6366.01,0.00
2024-12-08 16:55:17,80,5103,39,41,3632.02,6367.00,0.00
2024-12-08 16:55:17,81,5103,40,41,3587.18,6367.01,0.00
2024-12-08 16:55:17,80,5103,40,40,3612.42,6367.10,0.00
2024-12-08 16:55:17,79,5103,40,39,3640.82,6367.32,0.00
2024-12-08 16:55:17,79,5104,40,39,3624.44,6368.00,0.00
2024-12-08 16:55:17,80,5104,40,40,3579.13,6368.01,0.00
2024-12-08 16:55:17,79,5104,39,40,3522.42,6368.73,0.00
2024-12-08 16:55:17,79,5105,39,40,3582.17,6369.00,0.00
2024-12-08 16:55:17,80,5105,39,41,3537.39,6369.01,0.00
2024-12-08 16:55:17,79,5105,39,40,3554.80,6369.14,0.00
2024-12-08 16:55:17,78,5105,38,40,3578.92,6369.27,0.00
2024-12-08 16:55:17,78,5106,38,40,3602.64,6370.00,0.00
2024-12-08 16:55:17,79,5106,38,41,3557.03,6370.01,0.00
2024-12-08 16:55:17,80,5105,38,42,3429.95,6370.63,0.00
2024-12-08 16:55:17,80,5106,38,42,3493.99,6371.00,0.00
2024-12-08 16:55:17,81,5106,38,43,3450.85,6371.01,0.00
2024-12-08 16:55:17,80,5106,38,42,3469.11,6371.15,0.00
2024-12-08 16:55:17,79,5106,37,42,3492.20,6371.25,0.00
2024-12-08 16:55:17,79,5107,37,42,3594.73,6372.00,0.00
2024-12-08 16:55:17,80,5107,38,42,3549.80,6372.01,0.00
2024-12-08 16:55:17,80,5108,38,42,3511.60,6373.00,0.00
2024-12-08 16:55:17,81,5108,38,43,3468.24,6373.01,0.00
2024-12-08 16:55:17,80,5108,38,42,3478.72,6373.15,0.00
2024-12-08 16:55:17,80,5109,38,42,3460.73,6374.00,0.00
2024-12-08 16:55:17,81,5109,38,43,3418.00,6374.01,0.00
2024-12-08 16:55:17,80,5109,37,43,3445.15,6374.05,0.00
2024-12-08 16:55:17,79,5109,36,43,3396.87,6374.89,0.00
2024-12-08 16:55:17,79,5110,36,43,3470.40,6375.00,0.00
2024-12-08 16:55:17,80,5110,37,43,3427.02,6375.01,0.00
2024-12-08 16:55:17,79,5110,37,42,3446.43,6375.14,0.00
2024-12-08 16:55:17,79,5111,37,42,3428.87,6376.00,0.00
2024-12-08 16:55:17,80,5111,38,42,3386.01,6376.01,0.00
2024-12-08 16:55:17,79,5111,37,42,3369.00,6376.60,0.00
2024-12-08 16:55:17,79,5112,37,42,3395.19,6377.00,0.00
2024-12-08 16:55:17,80,5112,38,42,3352.75,6377.01,0.00
2024-12-08 16:55:17,79,5112,38,41,3372.15,6377.14,0.00
2024-12-08 16:55:17,78,5112,38,40,3412.97,6377.15,0.00
2024-12-08 16:55:17,77,5112,37,40,3390.20,6377.87,0.00
2024-12-08 16:55:17,77,5113,37,40,3464.85,6378.00,0.00
2024-12-08 16:55:17,78,5113,37,41,3420.43,6378.01,0.00
2024-12-08 16:55:17,77,5113,36,41,3427.93,6378.29,0.00
2024-12-08 16:55:17,77,5114,36,41,3434.20,6379.00,0.00
2024-12-08 16:55:17,78,5114,36,42,3390.17,6379.01,0.00
2024-12-08 16:55:17,77,5114,35,42,3431.07,6379.03,0.00
2024-12-08 16:55:17,76,5114,35,41,3454.89,6379.13,0.00
2024-12-08 16:55:17,76,5115,35,41,3444.75,6380.00,0.00
2024-12-08 16:55:17,77,5115,35,42,3400.01,6380.01,0.00
2024-12-08 16:55:17,76,5115,34,42,3384.03,6380.24,0.00
2024-12-08 16:55:17,76,5116,34,42,3413.81,6381.00,0.00
2024-12-08 16:55:17,77,5116,34,43,3369.47,6381.01,0.00
2024-12-08 16:55:17,78,5115,34,44,3326.27,6381.04,0.00
2024-12-08 16:55:17,77,5115,34,43,3441.69,6381.05,0.00
2024-12-08 16:55:17,76,5115,34,42,3432.24,6381.62,0.00
2024-12-08 16:55:17,77,5114,35,42,3384.07,6381.69,0.00
2024-12-08 16:55:17,77,5115,35,42,3499.56,6382.00,0.00
2024-12-08 16:55:17,78,5115,35,43,3454.69,6382.01,0.00
2024-12-08 16:55:17,77,5115,35,42,3479.70,6382.13,0.00
2024-12-08 16:55:17,77,5116,35,42,3634.37,6383.00,0.00
2024-12-08 16:55:17,78,5116,36,42,3587.78,6383.01,0.00
2024-12-08 16:55:17,77,5116,35,42,3632.73,6383.03,0.00
2024-12-08 16:55:17,76,5116,34,42,3598.88,6383.63,0.00
2024-12-08 16:55:17,76,5117,34,42,3654.34,6384.00,0.00
2024-12-08 16:55:17,77,5117,35,42,3606.88,6384.01,0.00
2024-12-08 16:55:17,76,5117,35,41,3638.41,6384.11,0.00
2024-12-08 16:55:17,75,5117,34,41,3673.72,6384.24,0.00
2024-12-08 16:55:17,75,5118,34,41,3703.00,6385.00,0.00
2024-12-08 16:55:17,76,5118,35,41,3654.28,6385.01,0.00
2024-12-08 16:55:17,76,5119,35,41,3616.32,6386.00,0.00
2024-12-08 16:55:17,77,5119,35,42,3569.35,6386.01,0.00
2024-12-08 16:55:17,76,5119,35,41,3596.78,6386.11,0.00
2024-12-08 16:55:17,75,5119,34,41,3636.46,6386.20,0.00
2024-12-08 16:55:17,75,5120,34,41,3627.38,6387.00,0.00
2024-12-08 16:55:17,76,5120,35,41,3579.65,6387.01,0.00
2024-12-08 16:55:17,75,5120,35,40,3605.56,6387.11,0.00
2024-12-08 16:55:17,75,5121,35,40,3587.05,6388.00,0.00
2024-12-08 16:55:17,76,5121,35,41,3539.85,6388.01,0.00
2024-12-08 16:55:17,75,5121,34,41,3578.32,6388.05,0.00
2024-12-08 16:55:17,74,5121,34,40,3623.43,6388.10,0.00
2024-12-08 16:55:18,74,5122,34,40,3603.59,6389.00,0.00
2024-12-08 16:55:18,75,5122,34,41,3555.55,6389.01,0.00
2024-12-08 16:55:18,75,5123,34,41,3507.63,6390.00,0.00
2024-12-08 16:55:18,76,5123,34,42,3461.48,6390.01,0.00
2024-12-08 16:55:18,75,5123,34,41,3483.62,6390.09,0.00
2024-12-08 16:55:18,74,5123,33,41,3526.41,6390.16,0.00
2024-12-08 16:55:18,73,5123,33,40,3544.01,6390.56,0.00
2024-12-08 16:55:18,72,5123,32,40,3537.00,6390.89,0.00
2024-12-08 16:55:18,72,5124,32,40,3612.55,6391.00,0.00
2024-12-08 16:55:18,73,5124,32,41,3563.07,6391.01,0.00
2024-12-08 16:55:18,73,5125,32,41,3532.45,6392.00,0.00
2024-12-08 16:55:18,74,5125,32,42,3484.71,6392.01,0.00
2024-12-08 16:55:18,73,5125,31,42,3467.92,6392.48,0.00
2024-12-08 16:55:18,73,5126,31,42,3517.81,6393.00,0.00
2024-12-08 16:55:18,74,5126,32,42,3470.27,6393.01,0.00
2024-12-08 16:55:18,73,5126,31,42,3500.63,6393.04,0.00
2024-12-08 16:55:18,72,5126,31,41,3540.24,6393.08,0.00
2024-12-08 16:55:18,73,5125,32,41,3490.00,6393.14,0.00
2024-12-08 16:55:18,74,5124,33,41,3459.33,6393.35,0.00
2024-12-08 16:55:18,73,5124,32,41,3509.89,6393.60,0.00
2024-12-08 16:55:18,73,5125,32,41,3569.00,6394.00,0.00
2024-12-08 16:55:18,74,5125,32,42,3520.77,6394.01,0.00
2024-12-08 16:55:18,73,5125,31,42,3556.87,6394.01,0.00
2024-12-08 16:55:18,72,5125,30,42,3524.40,6394.83,0.00
2024-12-08 16:55:18,72,5126,30,42,3778.40,6395.00,0.00
2024-12-08 16:55:18,73,5126,30,43,3726.65,6395.01,0.00
2024-12-08 16:55:18,72,5126,29,43,3763.32,6395.06,0.00
2024-12-08 16:55:18,71,5126,29,42,3808.21,6395.06,0.00
2024-12-08 16:55:18,71,5127,29,42,3838.08,6396.00,0.00
2024-12-08 16:55:18,72,5127,29,43,3784.78,6396.01,0.00
2024-12-08 16:55:18,73,5126,29,44,3684.08,6396.53,0.00
2024-12-08 16:55:18,73,5127,29,44,3736.14,6397.00,0.00
2024-12-08 16:55:18,74,5127,30,44,3685.66,6397.01,0.00
2024-12-08 16:55:18,73,5127,30,43,3727.39,6397.06,0.00
2024-12-08 16:55:18,72,5127,29,43,3701.84,6397.69,0.00
2024-12-08 16:55:18,72,5128,29,43,3858.60,6398.00,0.00
2024-12-08 16:55:18,73,5128,30,43,3805.74,6398.01,0.00
2024-12-08 16:55:18,73,5129,30,43,3780.25,6399.00,0.00
2024-12-08 16:55:18,74,5129,31,43,3729.16,6399.01,0.00
2024-12-08 16:55:18,73,5129,31,42,3757.50,6399.14,0.00
2024-12-08 16:55:18,74,5128,31,43,3699.84,6399.27,0.00
2024-12-08 16:55:18,74,5129,31,43,3706.57,6400.00,0.00
2024-12-08 16:55:18,75,5129,32,43,3657.15,6400.01,0.00
2024-12-08 16:55:18,74,5129,31,43,3622.91,6400.60,0.00
2024-12-08 16:55:18,74,5130,31,43,3767.43,6401.00,0.00
2024-12-08 16:55:18,75,5130,32,43,3717.20,6401.01,0.00
2024-12-08 16:55:18,74,5130,31,43,3762.72,6401.08,0.00
2024-12-08 16:55:18,73,5130,31,42,3797.62,6401.12,0.00
2024-12-08 16:55:18,74,5129,31,43,3746.30,6401.15,0.00
2024-12-08 16:55:18,74,5130,31,43,3792.76,6402.00,0.00
2024-12-08 16:55:18,75,5130,32,43,3742.19,6402.01,0.00
2024-12-08 16:55:18,74,5130,31,43,3788.44,6402.03,0.00
2024-12-08 16:55:18,73,5130,30,43,3814.96,6402.15,0.00
2024-12-08 16:55:18,73,5131,30,43,3930.29,6403.00,0.00
2024-12-08 16:55:18,74,5131,30,44,3877.18,6403.01,0.00
2024-12-08 16:55:18,73,5131,30,43,3908.41,6403.12,0.00
2024-12-08 16:55:18,73,5132,30,43,3898.29,6404.00,0.00
2024-12-08 16:55:18,74,5132,31,43,3845.61,6404.01,0.00
2024-12-08 16:55:18,73,5132,30,43,3870.28,6404.17,0.00
2024-12-08 16:55:18,72,5132,29,43,3897.01,6404.56,0.00
2024-12-08 16:55:18,72,5133,29,43,3951.66,6405.00,0.00
2024-12-08 16:55:18,73,5133,29,44,3897.53,6405.01,0.00
2024-12-08 16:55:18,72,5133,29,43,3930.35,6405.13,0.00
2024-12-08 16:55:18,71,5133,29,42,3978.71,6405.23,0.00
2024-12-08 16:55:18,70,5133,28,42,3998.05,6405.66,0.00
2024-12-08 16:55:18,70,5134,28,42,4031.27,6406.00,0.00
2024-12-08 16:55:18,71,5134,29,42,3974.49,6406.01,0.00
2024-12-08 16:55:18,72,5133,29,43,3861.25,6406.36,0.00
2024-12-08 16:55:18,72,5134,29,43,3938.71,6407.00,0.00
2024-12-08 16:55:18,73,5134,29,44,3884.75,6407.01,0.00
2024-12-08 16:55:18,72,5134,29,43,3869.32,6407.60,0.00
2024-12-08 16:55:18,72,5135,29,43,3989.25,6408.00,0.00
2024-12-08 16:55:18,73,5135,30,43,3934.60,6408.01,0.00
2024-12-08 16:55:18,72,5135,30,42,3967.04,6408.13,0.00
2024-12-08 16:55:18,71,5135,29,42,4019.33,6408.18,0.00
2024-12-08 16:55:18,71,5136,29,42,4014.50,6409.00,0.00
2024-12-08 16:55:18,72,5136,30,42,3958.75,6409.01,0.00
2024-12-08 16:55:18,72,5137,30,42,3921.44,6410.00,0.00
2024-12-08 16:55:18,73,5137,30,43,3867.72,6410.01,0.00
2024-12-08 16:55:18,72,5137,30,42,3901.89,6410.13,0.00
2024-12-08 16:55:18,72,5138,30,42,3886.43,6411.00,0.00
2024-12-08 16:55:18,73,5138,31,42,3833.19,6411.01,0.00
2024-12-08 16:55:18,73,5139,31,42,3795.19,6412.00,0.00
2024-12-08 16:55:18,74,5139,32,42,3743.90,6412.01,0.00
2024-12-08 16:55:18,73,5139,32,41,3765.40,6412.19,0.00
2024-12-08 16:55:18,72,5139,32,40,3804.52,6412.38,0.00
2024-12-08 16:55:18,72,5140,32,40,3818.30,6413.00,0.00
2024-12-08 16:55:18,73,5140,33,40,3765.99,6413.01,0.00
2024-12-08 16:55:19,73,5141,33,40,3743.96,6414.00,0.00
2024-12-08 16:55:19,74,5141,34,40,3693.36,6414.01,0.00
2024-12-08 16:55:19,73,5141,34,39,3713.27,6414.21,0.00
2024-12-08 16:55:19,73,5142,34,39,3715.02,6415.00,0.00
2024-12-08 16:55:19,74,5142,35,39,3664.82,6415.01,0.00
2024-12-08 16:55:19,74,5143,35,39,3643.03,6416.00,0.00
2024-12-08 16:55:19,75,5143,36,39,3594.46,6416.01,0.00
2024-12-08 16:55:19,74,5143,36,38,3613.62,6416.20,0.00
2024-12-08 16:55:19,75,5142,36,39,3540.83,6416.61,0.00
2024-12-08 16:55:19,75,5143,36,39,3588.45,6417.00,0.00
2024-12-08 16:55:19,76,5143,37,39,3541.24,6417.01,0.00
2024-12-08 16:55:19,75,5143,36,39,3586.74,6417.03,0.00
2024-12-08 16:55:19,74,5143,35,39,3576.92,6417.24,0.00
2024-12-08 16:55:19,74,5144,35,39,3702.18,6418.00,0.00
2024-12-08 16:55:19,75,5144,35,40,3652.81,6418.01,0.00
2024-12-08 16:55:19,74,5144,35,39,3674.49,6418.19,0.00
2024-12-08 16:55:19,73,5144,34,39,3716.92,6418.19,0.00
2024-12-08 16:55:19,72,5144,33,39,3751.16,6418.46,0.00
2024-12-08 16:55:19,73,5143,34,39,3678.36,6418.81,0.00
2024-12-08 16:55:19,73,5144,34,39,3764.67,6419.00,0.00
2024-12-08 16:55:19,74,5144,34,40,3713.80,6419.01,0.00
2024-12-08 16:55:19,73,5144,33,40,3741.81,6419.01,0.00
2024-12-08 16:55:19,73,5145,33,40,3835.91,6420.00,0.00
2024-12-08 16:55:19,74,5145,33,41,3784.08,6420.01,0.00
2024-12-08 16:55:19,73,5145,33,40,3807.83,6420.18,0.00
2024-12-08 16:55:19,73,5146,33,40,3806.00,6421.00,0.00
2024-12-08 16:55:19,74,5146,33,41,3754.57,6421.01,0.00
2024-12-08 16:55:19,74,5147,33,41,3730.58,6422.00,0.00
2024-12-08 16:55:19,75,5147,33,42,3680.84,6422.01,0.00
2024-12-08 16:55:19,74,5147,32,42,3695.48,6422.01,0.00
2024-12-08 16:55:19,74,5148,32,42,3699.26,6423.00,0.00
2024-12-08 16:55:19,75,5148,33,42,3649.93,6423.01,0.00
2024-12-08 16:55:19,74,5148,33,41,3686.30,6423.20,0.00
2024-12-08 16:55:19,74,5149,33,41,3685.31,6424.00,0.00
2024-12-08 16:55:19,75,5149,34,41,3636.17,6424.01,0.00
2024-12-08 16:55:19,74,5149,33,41,3636.70,6424.18,0.00
2024-12-08 16:55:19,74,5150,33,41,3668.24,6425.00,0.00
2024-12-08 16:55:19,75,5150,33,42,3619.33,6425.01,0.00
2024-12-08 16:55:19,74,5150,33,41,3655.25,6425.14,0.00
2024-12-08 16:55:19,74,5151,33,41,3648.74,6426.00,0.00
2024-12-08 16:55:19,75,5151,33,42,3600.09,6426.01,0.00
2024-12-08 16:55:19,74,5151,32,42,3647.87,6426.01,0.00
2024-12-08 16:55:19,74,5152,32,42,3615.30,6427.00,0.00
2024-12-08 16:55:19,75,5152,33,42,3567.10,6427.01,0.00
2024-12-08 16:55:19,74,5152,33,41,3602.30,6427.12,0.00
2024-12-08 16:55:19,73,5152,32,41,3576.92,6427.97,0.00
2024-12-08 16:55:19,73,5153,32,41,3663.22,6428.00,0.00
2024-12-08 16:55:19,74,5153,33,41,3613.72,6428.01,0.00
2024-12-08 16:55:19,73,5153,32,41,3645.99,6428.11,0.00
2024-12-08 16:55:19,73,5154,32,41,3656.04,6429.00,0.00
2024-12-08 16:55:19,74,5154,32,42,3606.63,6429.01,0.00
2024-12-08 16:55:19,73,5154,32,41,3634.06,6429.14,0.00
2024-12-08 16:55:19,74,5153,32,42,3548.63,6429.70,0.00
2024-12-08 16:55:19,74,5154,32,42,3599.41,6430.00,0.00
2024-12-08 16:55:19,75,5154,33,42,3551.42,6430.01,0.00
2024-12-08 16:55:19,74,5154,32,42,3539.84,6430.65,0.00
2024-12-08 16:55:19,74,5155,32,42,3662.31,6431.00,0.00
2024-12-08 16:55:19,75,5155,32,43,3613.48,6431.01,0.00
2024-12-08 16:55:19,74,5155,32,42,3640.63,6431.14,0.00
2024-12-08 16:55:19,74,5156,32,42,3637.11,6432.00,0.00
2024-12-08 16:55:19,75,5156,33,42,3588.62,6432.01,0.00
2024-12-08 16:55:19,74,5156,33,41,3636.24,6432.01,0.00
2024-12-08 16:55:19,74,5157,33,41,3614.58,6433.00,0.00
2024-12-08 16:55:19,75,5157,34,41,3566.38,6433.01,0.00
2024-12-08 16:55:19,74,5157,34,40,3613.71,6433.01,0.00
2024-12-08 16:55:19,73,5157,34,39,3640.34,6433.12,0.00
2024-12-08 16:55:19,73,5158,34,39,3637.34,6434.00,0.00
2024-12-08 16:55:19,74,5158,34,40,3588.18,6434.01,0.00
2024-12-08 16:55:19,73,5158,33,40,3636.45,6434.01,0.00
2024-12-08 16:55:19,74,5157,34,40,3491.28,6434.80,0.00
2024-12-08 16:55:19,74,5158,34,40,3578.40,6435.00,0.00
2024-12-08 16:55:19,75,5158,35,40,3530.69,6435.01,0.00
2024-12-08 16:55:19,74,5158,34,40,3551.36,6435.03,0.00
2024-12-08 16:55:19,73,5158,34,39,3581.52,6435.10,0.00
2024-12-08 16:55:19,74,5157,35,39,3518.43,6435.35,0.00
2024-12-08 16:55:19,74,5158,35,39,3686.71,6436.00,0.00
2024-12-08 16:55:19,75,5158,35,40,3637.55,6436.01,0.00
2024-12-08 16:55:19,75,5159,35,40,3698.90,6437.00,0.00
2024-12-08 16:55:19,76,5159,36,40,3650.23,6437.01,0.00
2024-12-08 16:55:19,75,5159,36,39,3680.90,6437.09,0.00
2024-12-08 16:55:19,74,5159,35,39,3709.11,6437.22,0.00
2024-12-08 16:55:19,74,5160,35,39,3746.14,6438.00,0.00
2024-12-08 16:55:19,75,5160,35,40,3696.20,6438.01,0.00
2024-12-08 16:55:19,74,5160,34,40,3680.04,6438.45,0.00
2024-12-08 16:55:19,73,5160,33,40,3720.93,6438.59,0.00
2024-12-08 16:55:19,73,5161,33,40,3782.98,6439.00,0.00
2024-12-08 16:55:19,74,5161,34,40,3731.86,6439.01,0.00
2024-12-08 16:55:19,73,5161,34,39,3774.17,6439.04,0.00
2024-12-08 16:55:19,73,5162,34,39,3765.59,6440.00,0.00
2024-12-08 16:55:19,74,5162,35,39,3714.71,6440.01,0.00
2024-12-08 16:55:19,73,5162,35,38,3748.85,6440.08,0.00
2024-12-08 16:55:20,73,5163,35,38,3742.95,6441.00,0.00
2024-12-08 16:55:20,74,5163,35,39,3692.37,6441.01,0.00
2024-12-08 16:55:20,74,5164,35,39,3666.83,6442.00,0.00
2024-12-08 16:55:20,75,5164,36,39,3617.94,6442.01,0.00
2024-12-08 16:55:20,74,5164,36,38,3651.19,6442.08,0.00
2024-12-08 16:55:20,74,5165,36,38,3644.63,6443.00,0.00
2024-12-08 16:55:20,75,5165,37,38,3596.04,6443.01,0.00
2024-12-08 16:55:20,74,5165,36,38,3610.70,6443.08,0.00
2024-12-08 16:55:20,74,5166,36,38,3621.67,6444.00,0.00
2024-12-08 16:55:20,75,5166,37,38,3573.38,6444.01,0.00
2024-12-08 16:55:20,74,5166,37,37,3604.28,6444.08,0.00
2024-12-08 16:55:20,74,5167,37,37,3597.76,6445.00,0.00
2024-12-08 16:55:20,75,5167,37,38,3549.79,6445.01,0.00
2024-12-08 16:55:20,74,5167,36,38,3596.03,6445.03,0.00
2024-12-08 16:55:20,75,5166,37,38,3498.09,6445.56,0.00
2024-12-08 16:55:20,75,5167,37,38,3585.86,6446.00,0.00
2024-12-08 16:55:20,76,5167,38,38,3538.68,6446.01,0.00
2024-12-08 16:55:20,75,5167,38,37,3570.41,6446.07,0.00
2024-12-08 16:55:20,75,5168,38,37,3647.16,6447.00,0.00
2024-12-08 16:55:20,76,5168,38,38,3599.17,6447.01,0.00
2024-12-08 16:55:20,75,5168,37,38,3575.71,6447.49,0.00
2024-12-08 16:55:20,75,5169,37,38,3627.69,6448.00,0.00
2024-12-08 16:55:20,76,5169,37,39,3579.96,6448.01,0.00
2024-12-08 16:55:20,75,5169,37,38,3613.09,6448.07,0.00
2024-12-08 16:55:20,75,5170,37,38,3602.32,6449.00,0.00
2024-12-08 16:55:20,76,5170,38,38,3554.92,6449.01,0.00
2024-12-08 16:55:20,76,5171,38,38,3525.86,6450.00,0.00
2024-12-08 16:55:20,77,5171,38,39,3480.07,6450.01,0.00
2024-12-08 16:55:20,76,5171,38,38,3512.30,6450.07,0.00
2024-12-08 16:55:20,75,5171,37,38,3522.94,6450.61,0.00
2024-12-08 16:55:20,75,5172,37,38,3545.30,6451.00,0.00
2024-12-08 16:55:20,76,5172,38,38,3498.65,6451.01,0.00
2024-12-08 16:55:20,76,5173,38,38,3470.28,6452.00,0.00
2024-12-08 16:55:20,77,5173,39,38,3425.21,6452.01,0.00
2024-12-08 16:55:20,76,5173,39,37,3453.32,6452.08,0.00
2024-12-08 16:55:20,76,5174,39,37,3438.80,6453.00,0.00
2024-12-08 16:55:20,77,5174,40,37,3394.14,6453.01,0.00
2024-12-08 16:55:20,76,5174,39,37,3412.39,6453.15,0.00
2024-12-08 16:55:20,75,5174,38,37,3395.64,6453.69,0.00
2024-12-08 16:55:20,75,5175,38,37,3455.48,6454.00,0.00
2024-12-08 16:55:20,76,5175,38,38,3410.02,6454.01,0.00
2024-12-08 16:55:20,75,5175,38,37,3438.29,6454.08,0.00
2024-12-08 16:55:20,75,5176,38,37,3423.71,6455.00,0.00
2024-12-08 16:55:20,76,5176,38,38,3378.66,6455.01,0.00
2024-12-08 16:55:20,75,5176,38,37,3410.24,6455.08,0.00
2024-12-08 16:55:20,75,5177,38,37,3395.24,6456.00,0.00
2024-12-08 16:55:20,76,5177,38,38,3350.57,6456.01,0.00
2024-12-08 16:55:20,75,5177,37,38,3313.80,6456.77,0.00
2024-12-08 16:55:20,75,5178,37,38,3385.41,6457.00,0.00
2024-12-08 16:55:20,76,5178,37,39,3340.86,6457.01,0.00
2024-12-08 16:55:20,77,5177,37,40,3295.80,6457.07,0.00
2024-12-08 16:55:20,76,5177,37,39,3376.54,6457.09,0.00
2024-12-08 16:55:20,76,5178,37,39,3361.09,6458.00,0.00
2024-12-08 16:55:20,77,5178,37,40,3317.43,6458.01,0.00
2024-12-08 16:55:20,77,5179,37,40,3372.04,6459.00,0.00
2024-12-08 16:55:20,78,5179,38,40,3328.81,6459.01,0.00
2024-12-08 16:55:20,77,5179,38,39,3348.18,6459.13,0.00
2024-12-08 16:55:20,76,5179,37,39,3388.85,6459.18,0.00
2024-12-08 16:55:20,75,5179,36,39,3399.06,6459.67,0.00
2024-12-08 16:55:20,75,5180,36,39,3429.44,6460.00,0.00
2024-12-08 16:55:20,76,5180,37,39,3384.32,6460.01,0.00
2024-12-08 16:55:20,75,5180,36,39,3396.71,6460.17,0.00
2024-12-08 16:55:20,75,5181,36,39,3429.52,6461.00,0.00
2024-12-08 16:55:20,76,5181,37,39,3384.40,6461.01,0.00
2024-12-08 16:55:20,75,5181,37,38,3406.08,6461.15,0.00
2024-12-08 16:55:20,74,5181,36,38,3449.51,6461.19,0.00
2024-12-08 16:55:20,74,5182,36,38,3448.85,6462.00,0.00
2024-12-08 16:55:20,75,5182,37,38,3402.86,6462.01,0.00
2024-12-08 16:55:20,76,5181,38,38,3301.95,6462.22,0.00
2024-12-08 16:55:20,76,5182,38,38,3419.63,6463.00,0.00
2024-12-08 16:55:20,77,5182,38,39,3375.22,6463.01,0.00
2024-12-08 16:55:20,76,5182,38,38,3365.03,6463.15,0.00
2024-12-08 16:55:20,75,5182,37,38,3384.91,6463.49,0.00
2024-12-08 16:55:20,75,5183,37,38,3524.11,6464.00,0.00
2024-12-08 16:55:20,76,5183,37,39,3477.74,6464.01,0.00
2024-12-08 16:55:20,75,5183,36,39,3491.18,6464.12,0.00
2024-12-08 16:55:20,74,5183,35,39,3485.51,6464.65,0.00
2024-12-08 16:55:20,74,5184,35,39,3548.40,6465.00,0.00
2024-12-08 16:55:20,75,5184,36,39,3501.09,6465.01,0.00
2024-12-08 16:55:20,74,5184,35,39,3490.91,6465.20,0.00
2024-12-08 16:55:20,74,5185,35,39,3523.39,6466.00,0.00
2024-12-08 16:55:20,75,5185,35,40,3476.41,6466.01,0.00
2024-12-08 16:55:20,74,5185,35,39,3498.59,6466.16,0.00
2024-12-08 16:55:21,74,5186,35,39,3493.24,6467.00,0.00
2024-12-08 16:55:21,75,5186,35,40,3446.66,6467.01,0.00
2024-12-08 16:55:21,74,5186,34,40,3492.36,6467.03,0.00
2024-12-08 16:55:21,75,5185,34,41,3444.94,6467.07,0.00
2024-12-08 16:55:21,75,5186,34,41,3504.41,6468.00,0.00
2024-12-08 16:55:21,76,5186,35,41,3458.30,6468.01,0.00
2024-12-08 16:55:21,75,5186,35,40,3497.29,6468.07,0.00
2024-12-08 16:55:21,74,5186,35,39,3525.35,6468.15,0.00
2024-12-08 16:55:21,73,5186,34,39,3546.82,6468.56,0.00
2024-12-08 16:55:21,72,5186,33,39,3541.28,6468.96,0.00
2024-12-08 16:55:21,72,5187,33,39,3718.29,6469.00,0.00
2024-12-08 16:55:21,73,5187,34,39,3667.36,6469.01,0.00
2024-12-08 16:55:21,72,5187,33,39,3630.34,6469.71,0.00
2024-12-08 16:55:21,72,5188,33,39,3695.60,6470.00,0.00
2024-12-08 16:55:21,73,5188,34,39,3644.98,6470.01,0.00
2024-12-08 16:55:21,72,5188,33,39,3695.04,6470.01,0.00
2024-12-08 16:55:21,71,5188,33,38,3744.49,6470.04,0.00
2024-12-08 16:55:21,70,5188,32,38,3770.31,6470.19,0.00
2024-12-08 16:55:21,69,5188,31,38,3797.26,6470.61,0.00
2024-12-08 16:55:21,69,5189,31,38,3823.29,6471.00,0.00
2024-12-08 16:55:21,70,5189,32,38,3768.67,6471.01,0.00
2024-12-08 16:55:21,69,5189,32,37,3808.33,6471.13,0.00
2024-12-08 16:55:21,69,5190,32,37,3802.10,6472.00,0.00
2024-12-08 16:55:21,70,5190,33,37,3747.79,6472.01,0.00
2024-12-08 16:55:21,71,5189,33,38,3668.62,6472.17,0.00
2024-12-08 16:55:21,71,5190,33,38,3704.73,6473.00,0.00
2024-12-08 16:55:21,72,5190,34,38,3653.27,6473.01,0.00
2024-12-08 16:55:21,71,5190,34,37,3684.71,6473.13,0.00
2024-12-08 16:55:21,71,5191,34,37,3769.18,6474.00,0.00
2024-12-08 16:55:21,72,5191,35,37,3716.83,6474.01,0.00
2024-12-08 16:55:21,72,5192,35,37,3713.83,6475.00,0.00
2024-12-08 16:55:21,73,5192,35,38,3662.95,6475.01,0.00
2024-12-08 16:55:21,73,5193,35,38,3656.83,6476.00,0.00
2024-12-08 16:55:21,74,5193,36,38,3607.42,6476.01,0.00
2024-12-08 16:55:21,73,5193,35,38,3618.83,6476.14,0.00
2024-12-08 16:55:21,72,5193,34,38,3664.62,6476.19,0.00
2024-12-08 16:55:21,72,5194,34,38,3699.06,6477.00,0.00
2024-12-08 16:55:21,73,5194,34,39,3648.39,6477.01,0.00
2024-12-08 16:55:21,73,5195,34,39,3621.04,6478.00,0.00
2024-12-08 16:55:21,74,5195,34,40,3572.11,6478.01,0.00
2024-12-08 16:55:21,73,5195,34,39,3600.67,6478.12,0.00
2024-12-08 16:55:21,73,5196,34,39,3593.30,6479.00,0.00
2024-12-08 16:55:21,74,5196,35,39,3544.74,6479.01,0.00
2024-12-08 16:55:21,73,5196,35,38,3587.11,6479.10,0.00
2024-12-08 16:55:21,73,5197,35,38,3562.59,6480.00,0.00
2024-12-08 16:55:21,74,5197,36,38,3514.44,6480.01,0.00
2024-12-08 16:55:21,73,5197,36,37,3546.65,6480.11,0.00
2024-12-08 16:55:21,73,5198,36,37,3536.15,6481.00,0.00
2024-12-08 16:55:21,74,5198,36,38,3488.36,6481.01,0.00
2024-12-08 16:55:21,74,5199,36,38,3459.21,6482.00,0.00
2024-12-08 16:55:21,75,5199,36,39,3413.08,6482.01,0.00
2024-12-08 16:55:21,74,5199,35,39,3418.13,6482.28,0.00
2024-12-08 16:55:21,74,5200,35,39,3449.77,6483.00,0.00
2024-12-08 16:55:21,75,5200,36,39,3403.77,6483.01,0.00
2024-12-08 16:55:21,74,5200,35,39,3437.16,6483.16,0.00
2024-12-08 16:55:21,73,5200,35,38,3470.04,6483.17,0.00
2024-12-08 16:55:21,73,5201,35,38,3493.28,6484.00,0.00
2024-12-08 16:55:21,74,5201,35,39,3446.07,6484.01,0.00
2024-12-08 16:55:21,73,5201,34,39,3417.98,6484.52,0.00
2024-12-08 16:55:21,73,5202,34,39,3462.22,6485.00,0.00
2024-12-08 16:55:21,74,5202,34,40,3415.44,6485.01,0.00
2024-12-08 16:55:21,73,5202,34,39,3460.05,6485.04,0.00
2024-12-08 16:55:21,72,5202,34,38,3486.54,6485.17,0.00
2024-12-08 16:55:21,71,5202,33,38,3512.44,6485.30,0.00
2024-12-08 16:55:21,70,5202,33,37,3546.80,6485.54,0.00
2024-12-08 16:55:21,69,5202,33,36,3580.17,6485.70,0.00
2024-12-08 16:55:21,69,5203,33,36,3654.65,6486.00,0.00
2024-12-08 16:55:21,70,5203,34,36,3602.44,6486.01,0.00
2024-12-08 16:55:21,69,5203,33,36,3654.45,6486.02,0.00
2024-12-08 16:55:21,68,5203,32,36,3630.20,6486.52,0.00
2024-12-08 16:55:21,68,5204,32,36,3694.46,6487.00,0.00
2024-12-08 16:55:21,69,5204,33,36,3640.91,6487.02,0.00
2024-12-08 16:55:21,68,5204,33,35,3671.62,6487.16,0.00
2024-12-08 16:55:21,68,5205,33,35,3674.99,6488.00,0.00
2024-12-08 16:55:21,69,5205,34,35,3621.73,6488.02,0.00
2024-12-08 16:55:21,69,5206,34,35,3598.90,6489.00,0.00
2024-12-08 16:55:21,70,5206,34,36,3547.48,6489.01,0.00
2024-12-08 16:55:21,69,5206,34,35,3576.94,6489.16,0.00
2024-12-08 16:55:21,70,5205,35,35,3507.42,6489.47,0.00
2024-12-08 16:55:21,70,5206,35,35,3564.35,6490.00,0.00
2024-12-08 16:55:21,71,5206,36,35,3514.15,6490.01,0.00
2024-12-08 16:55:21,71,5207,36,35,3583.26,6491.00,0.00
2024-12-08 16:55:21,72,5207,37,35,3533.49,6491.01,0.00
2024-12-08 16:55:21,71,5207,37,34,3563.19,6491.16,0.00
2024-12-08 16:55:21,70,5207,36,34,3610.40,6491.21,0.00
2024-12-08 16:55:21,70,5208,36,34,3615.53,6492.00,0.00
2024-12-08 16:55:21,71,5208,37,34,3564.61,6492.01,0.00
2024-12-08 16:55:22,71,5209,37,34,3542.32,6493.00,0.00
2024-12-08 16:55:22,72,5209,37,35,3493.12,6493.01,0.00
2024-12-08 16:55:22,71,5209,37,34,3521.25,6493.16,0.00
2024-12-08 16:55:22,71,5210,37,34,3521.75,6494.00,0.00
2024-12-08 16:55:22,72,5210,38,34,3472.84,6494.01,0.00
2024-12-08 16:55:22,72,5211,38,34,3450.05,6495.00,0.00
2024-12-08 16:55:22,73,5211,38,35,3402.79,6495.01,0.00
2024-12-08 16:55:22,72,5211,38,34,3447.36,6495.04,0.00
2024-12-08 16:55:22,72,5212,38,34,3439.75,6496.00,0.00
2024-12-08 16:55:22,73,5212,39,34,3392.64,6496.01,0.00
2024-12-08 16:55:22,72,5212,39,33,3433.35,6496.11,0.00
2024-12-08 16:55:22,72,5213,39,33,3430.23,6497.00,0.00
2024-12-08 16:55:22,73,5213,39,34,3383.24,6497.01,0.00
2024-12-08 16:55:22,72,5213,39,33,3414.03,6497.13,0.00
2024-12-08 16:55:22,73,5212,40,33,3363.72,6497.21,0.00
2024-12-08 16:55:22,72,5212,39,33,3458.54,6497.67,0.00
2024-12-08 16:55:22,71,5212,38,33,3471.78,6497.97,0.00
2024-12-08 16:55:22,71,5213,38,33,3561.27,6498.00,0.00
2024-12-08 16:55:22,72,5213,39,33,3511.81,6498.01,0.00
2024-12-08 16:55:22,73,5212,40,33,3366.40,6498.78,0.00
2024-12-08 16:55:22,73,5213,40,33,3542.25,6499.00,0.00
2024-12-08 16:55:22,74,5213,41,33,3494.38,6499.01,0.00
2024-12-08 16:55:22,73,5213,40,33,3521.78,6499.04,0.00
2024-12-08 16:55:22,72,5213,39,33,3561.08,6499.18,0.00
2024-12-08 16:55:22,72,5214,39,33,3665.20,6500.00,0.00
2024-12-08 16:55:22,73,5214,40,33,3614.99,6500.01,0.00
2024-12-08 16:55:22,73,5215,40,33,3584.24,6501.00,0.00
2024-12-08 16:55:22,74,5215,40,34,3535.80,6501.01,0.00
2024-12-08 16:55:22,73,5215,40,33,3578.00,6501.01,0.00
2024-12-08 16:55:22,74,5214,41,33,3469.99,6501.93,0.00
2024-12-08 16:55:22,74,5215,41,33,3521.01,6502.00,0.00
2024-12-08 16:55:22,75,5215,42,33,3474.06,6502.01,0.00
2024-12-08 16:55:22,74,5215,41,33,3464.13,6502.62,0.00
2024-12-08 16:55:22,73,5215,40,33,3459.66,6502.95,0.00
2024-12-08 16:55:22,73,5216,40,33,3634.28,6503.00,0.00
2024-12-08 16:55:22,74,5216,41,33,3585.17,6503.01,0.00
2024-12-08 16:55:22,73,5216,41,32,3622.73,6503.10,0.00
2024-12-08 16:55:22,73,5217,41,32,3617.11,6504.00,0.00
2024-12-08 16:55:22,74,5217,42,32,3568.23,6504.01,0.00
2024-12-08 16:55:22,73,5217,42,31,3606.44,6504.10,0.00
2024-12-08 16:55:22,72,5217,41,31,3650.24,6504.19,0.00
2024-12-08 16:55:22,72,5218,41,31,3652.32,6505.00,0.00
2024-12-08 16:55:22,73,5218,41,32,3602.29,6505.01,0.00
2024-12-08 16:55:22,73,5219,41,32,3574.32,6506.00,0.00
2024-12-08 16:55:22,74,5219,42,32,3526.02,6506.01,0.00
2024-12-08 16:55:22,73,5219,42,31,3563.65,6506.10,0.00
2024-12-08 16:55:22,72,5219,41,31,3605.05,6506.21,0.00
2024-12-08 16:55:22,72,5220,41,31,3644.17,6507.00,0.00
2024-12-08 16:55:22,73,5220,41,32,3594.25,6507.01,0.00
2024-12-08 16:55:22,73,5221,41,32,3567.02,6508.00,0.00
2024-12-08 16:55:22,74,5221,42,32,3518.82,6508.01,0.00
2024-12-08 16:55:22,73,5221,42,31,3551.91,6508.12,0.00
2024-12-08 16:55:22,72,5221,41,31,3599.32,6508.15,0.00
2024-12-08 16:55:22,71,5221,40,31,3639.68,6508.23,0.00
2024-12-08 16:55:22,71,5222,40,31,3680.72,6509.00,0.00
2024-12-08 16:55:22,72,5222,40,32,3629.60,6509.01,0.00
2024-12-08 16:55:22,72,5223,40,32,3601.84,6510.00,0.00
2024-12-08 16:55:22,73,5223,41,32,3552.50,6510.01,0.00
2024-12-08 16:55:22,72,5223,41,31,3586.51,6510.13,0.00
2024-12-08 16:55:22,72,5224,41,31,3583.08,6511.00,0.00
2024-12-08 16:55:22,73,5224,41,32,3534.00,6511.01,0.00
2024-12-08 16:55:22,73,5225,41,32,3507.62,6512.00,0.00
2024-12-08 16:55:22,74,5225,42,32,3460.22,6512.01,0.00
2024-12-08 16:55:22,75,5224,42,33,3413.22,6512.05,0.00
2024-12-08 16:55:22,74,5224,41,33,3501.60,6512.05,0.00
2024-12-08 16:55:22,73,5224,41,32,3536.21,6512.12,0.00
2024-12-08 16:55:22,72,5224,40,32,3552.79,6512.63,0.00
2024-12-08 16:55:22,71,5224,39,32,3601.55,6512.65,0.00
2024-12-08 16:55:22,70,5224,38,32,3649.35,6512.70,0.00
2024-12-08 16:55:22,70,5225,38,32,3721.09,6513.00,0.00
2024-12-08 16:55:22,71,5225,39,32,3668.68,6513.01,0.00
2024-12-08 16:55:22,72,5224,39,33,3514.68,6513.81,0.00
2024-12-08 16:55:22,72,5225,39,33,3730.16,6514.00,0.00
2024-12-08 16:55:22,73,5225,40,33,3679.06,6514.01,0.00
2024-12-08 16:55:22,72,5225,39,33,3727.46,6514.04,0.00
2024-12-08 16:55:22,71,5225,39,32,3765.31,6514.10,0.00
2024-12-08 16:55:22,70,5225,38,32,3783.65,6514.64,0.00
2024-12-08 16:55:22,70,5226,38,32,3943.61,6515.00,0.00
2024-12-08 16:55:22,71,5226,39,32,3888.07,6515.01,0.00
2024-12-08 16:55:22,70,5226,38,32,3897.42,6515.29,0.00
2024-12-08 16:55:22,71,5225,38,33,3804.63,6515.83,0.00
2024-12-08 16:55:22,71,5226,38,33,3894.73,6516.00,0.00
2024-12-08 16:55:22,72,5226,38,34,3840.64,6516.01,0.00
2024-12-08 16:55:22,71,5226,38,33,3877.34,6516.11,0.00
2024-12-08 16:55:22,71,5227,38,33,3961.51,6517.00,0.00
2024-12-08 16:55:22,72,5227,39,33,3906.49,6517.01,0.00
2024-12-08 16:55:22,72,5228,39,33,3872.85,6518.00,0.00
2024-12-08 16:55:22,73,5228,39,34,3819.80,6518.01,0.00
2024-12-08 16:55:22,72,5228,39,33,3856.60,6518.11,0.00
2024-12-08 16:55:22,72,5229,39,33,3846.74,6519.00,0.00
2024-12-08 16:55:22,73,5229,40,33,3794.04,6519.01,0.00
2024-12-08 16:55:23,73,5230,40,33,3782.49,6520.00,0.00
2024-12-08 16:55:23,74,5230,41,33,3731.38,6520.01,0.00
2024-12-08 16:55:23,74,5231,41,33,3709.14,6521.00,0.00
2024-12-08 16:55:23,75,5231,41,34,3659.68,6521.01,0.00
2024-12-08 16:55:23,74,5231,40,34,3679.24,6521.20,0.00
2024-12-08 16:55:23,74,5232,40,34,3675.34,6522.00,0.00
2024-12-08 16:55:23,75,5232,41,34,3626.33,6522.01,0.00
2024-12-08 16:55:23,74,5232,41,33,3662.15,6522.11,0.00
2024-12-08 16:55:23,74,5233,41,33,3651.66,6523.00,0.00
2024-12-08 16:55:23,75,5233,41,34,3602.97,6523.01,0.00
2024-12-08 16:55:23,74,5233,40,34,3592.73,6523.58,0.00
2024-12-08 16:55:23,73,5233,39,34,3599.84,6523.97,0.00
2024-12-08 16:55:23,73,5234,39,34,3687.44,6524.00,0.00
2024-12-08 16:55:23,74,5234,39,35,3637.61,6524.01,0.00
2024-12-08 16:55:23,73,5234,39,34,3668.71,6524.12,0.00
2024-12-08 16:55:23,72,5234,38,34,3668.95,6524.53,0.00
2024-12-08 16:55:23,72,5235,38,34,3729.12,6525.00,0.00
2024-12-08 16:55:23,73,5235,38,35,3678.04,6525.01,0.00
2024-12-08 16:55:23,72,5235,37,35,3652.29,6525.53,0.00
2024-12-08 16:55:23,72,5236,37,35,3711.53,6526.00,0.00
2024-12-08 16:55:23,73,5236,37,36,3660.68,6526.01,0.00
2024-12-08 16:55:23,72,5236,37,35,3693.43,6526.13,0.00
2024-12-08 16:55:23,71,5236,36,35,3696.80,6526.49,0.00
2024-12-08 16:55:23,71,5237,36,35,3752.26,6527.00,0.00
2024-12-08 16:55:23,72,5237,37,35,3700.14,6527.01,0.00
2024-12-08 16:55:23,71,5237,36,35,3689.80,6527.18,0.00
2024-12-08 16:55:23,72,5236,37,35,3624.12,6527.43,0.00
2024-12-08 16:55:23,72,5237,37,35,3712.19,6528.00,0.00
2024-12-08 16:55:23,73,5237,38,35,3661.34,6528.01,0.00
2024-12-08 16:55:23,72,5237,38,34,3695.90,6528.13,0.00
2024-12-08 16:55:23,73,5236,38,35,3627.49,6528.43,0.00
2024-12-08 16:55:23,73,5237,38,35,3751.34,6529.00,0.00
2024-12-08 16:55:23,74,5237,38,36,3700.65,6529.01,0.00
2024-12-08 16:55:23,74,5238,38,36,3751.91,6530.00,0.00
2024-12-08 16:55:23,75,5238,38,37,3701.88,6530.01,0.00
2024-12-08 16:55:23,74,5238,38,36,3741.34,6530.11,0.00
2024-12-08 16:55:23,73,5238,37,36,3734.66,6530.56,0.00
2024-12-08 16:55:23,73,5239,37,36,3786.71,6531.00,0.00
2024-12-08 16:55:23,74,5239,37,37,3735.54,6531.01,0.00
2024-12-08 16:55:23,73,5239,36,37,3767.95,6531.10,0.00
2024-12-08 16:55:23,72,5239,35,37,3794.48,6531.21,0.00
2024-12-08 16:55:23,71,5239,34,37,3847.92,6531.21,0.00
2024-12-08 16:55:23,71,5240,34,37,3879.33,6532.00,0.00
2024-12-08 16:55:23,72,5240,34,38,3825.45,6532.01,0.00
2024-12-08 16:55:23,71,5240,34,37,3867.39,6532.10,0.00
2024-12-08 16:55:23,70,5240,33,37,3896.51,6532.10,0.00
2024-12-08 16:55:23,70,5241,33,37,3921.60,6533.00,0.00
2024-12-08 16:55:23,71,5241,33,38,3866.36,6533.01,0.00
2024-12-08 16:55:23,70,5241,32,38,3890.85,6533.20,0.00
2024-12-08 16:55:23,70,5242,32,38,3886.33,6534.00,0.00
2024-12-08 16:55:23,71,5242,32,39,3831.60,6534.01,0.00
2024-12-08 16:55:23,70,5242,31,39,3882.61,6534.06,0.00
2024-12-08 16:55:23,69,5242,31,38,3937.94,6534.06,0.00
2024-12-08 16:55:23,68,5242,31,37,3984.33,6534.09,0.00
2024-12-08 16:55:23,67,5242,30,37,3968.37,6534.88,0.00
2024-12-08 16:55:23,67,5243,30,37,4058.20,6535.00,0.00
2024-12-08 16:55:23,68,5243,30,38,3998.52,6535.02,0.00
2024-12-08 16:55:23,67,5243,29,38,4057.23,6535.02,0.00
2024-12-08 16:55:23,66,5243,28,38,4058.34,6535.12,0.00
2024-12-08 16:55:23,65,5243,28,37,4069.57,6535.82,0.00
2024-12-08 16:55:23,65,5244,28,37,4158.21,6536.00,0.00
2024-12-08 16:55:23,66,5244,28,38,4095.21,6536.02,0.00
2024-12-08 16:55:23,65,5244,28,37,4143.16,6536.08,0.00
2024-12-08 16:55:23,64,5244,27,37,4127.52,6536.69,0.00
2024-12-08 16:55:23,64,5245,27,37,4209.50,6537.00,0.00
2024-12-08 16:55:23,65,5245,28,37,4144.73,6537.02,0.00
2024-12-08 16:55:23,65,5246,28,37,4121.23,6538.00,0.00
2024-12-08 16:55:23,66,5246,28,38,4058.79,6538.02,0.00
2024-12-08 16:55:23,65,5246,28,37,4107.17,6538.08,0.00
2024-12-08 16:55:23,64,5246,27,37,4106.21,6538.56,0.00
2024-12-08 16:55:23,64,5247,27,37,4180.13,6539.00,0.00
2024-12-08 16:55:23,65,5247,28,37,4115.82,6539.02,0.00
2024-12-08 16:55:23,64,5247,27,37,4152.28,6539.13,0.00
2024-12-08 16:55:23,64,5248,27,37,4156.97,6540.00,0.00
2024-12-08 16:55:23,65,5248,27,38,4093.02,6540.02,0.00
2024-12-08 16:55:23,64,5248,27,37,4144.73,6540.08,0.00
2024-12-08 16:55:23,63,5248,26,37,4203.29,6540.18,0.00
2024-12-08 16:55:23,62,5248,25,37,4195.45,6540.69,0.00
2024-12-08 16:55:23,62,5249,25,37,4281.17,6541.00,0.00
2024-12-08 16:55:23,63,5249,25,38,4213.22,6541.02,0.00
2024-12-08 16:55:23,62,5249,24,38,4220.13,6541.34,0.00
2024-12-08 16:55:23,62,5250,24,38,4282.88,6542.00,0.00
2024-12-08 16:55:23,63,5250,24,39,4214.90,6542.02,0.00
2024-12-08 16:55:23,62,5250,24,38,4266.03,6542.10,0.00
2024-12-08 16:55:23,61,5250,23,38,4292.01,6542.15,0.00
2024-12-08 16:55:23,61,5251,23,38,4344.10,6543.00,0.00
2024-12-08 16:55:23,62,5251,24,38,4274.04,6543.02,0.00
2024-12-08 16:55:23,62,5252,24,38,4252.53,6544.00,0.00
2024-12-08 16:55:23,63,5252,25,38,4185.03,6544.02,0.00
2024-12-08 16:55:23,62,5252,25,37,4234.61,6544.10,0.00
2024-12-08 16:55:23,61,5252,24,37,4251.60,6544.38,0.00
2024-12-08 16:55:23,61,5253,24,37,4318.61,6545.00,0.00
2024-12-08 16:55:23,62,5253,24,38,4248.95,6545.02,0.00
2024-12-08 16:55:23,61,5253,23,38,4316.47,6545.03,0.00
2024-12-08 16:55:24,61,5254,23,38,4296.73,6546.00,0.00
2024-12-08 16:55:24,62,5254,23,39,4227.43,6546.02,0.00
2024-12-08 16:55:24,61,5254,23,38,4279.59,6546.08,0.00
2024-12-08 16:55:24,61,5255,23,38,4284.51,6547.00,0.00
2024-12-08 16:55:24,62,5255,24,38,4215.40,6547.02,0.00
2024-12-08 16:55:24,63,5254,25,38,4076.23,6547.84,0.00
2024-12-08 16:55:24,62,5254,24,38,4126.26,6547.97,0.00
2024-12-08 16:55:24,62,5255,24,38,4229.78,6548.00,0.00
2024-12-08 16:55:24,63,5255,24,39,4162.64,6548.02,0.00
2024-12-08 16:55:24,62,5255,24,38,4213.96,6548.08,0.00
2024-12-08 16:55:24,62,5256,24,38,4322.89,6549.00,0.00
2024-12-08 16:55:24,63,5256,24,39,4254.27,6549.02,0.00
2024-12-08 16:55:24,63,5257,24,39,4258.06,6550.00,0.00
2024-12-08 16:55:24,64,5257,25,39,4191.53,6550.02,0.00
2024-12-08 16:55:24,64,5258,25,39,4179.77,6551.00,0.00
2024-12-08 16:55:24,65,5258,25,40,4115.47,6551.02,0.00
2024-12-08 16:55:24,65,5259,25,40,4086.25,6552.00,0.00
2024-12-08 16:55:24,66,5259,26,40,4024.34,6552.02,0.00
2024-12-08 16:55:24,65,5259,26,39,4066.11,6552.08,0.00
2024-12-08 16:55:24,65,5260,26,39,4059.83,6553.00,0.00
2024-12-08 16:55:24,66,5260,26,40,3998.32,6553.02,0.00
2024-12-08 16:55:24,66,5261,26,40,3993.75,6554.00,0.00
2024-12-08 16:55:24,67,5261,27,40,3934.14,6554.02,0.00
2024-12-08 16:55:24,67,5262,27,40,3916.64,6555.00,0.00
2024-12-08 16:55:24,68,5262,27,41,3859.04,6555.02,0.00
2024-12-08 16:55:24,68,5263,27,41,3825.53,6556.00,0.00
2024-12-08 16:55:24,69,5263,27,42,3770.09,6556.02,0.00
2024-12-08 16:55:24,68,5263,27,41,3809.16,6556.07,0.00
2024-12-08 16:55:24,68,5264,27,41,3797.50,6557.00,0.00
2024-12-08 16:55:24,69,5264,28,41,3742.46,6557.02,0.00
2024-12-08 16:55:24,69,5265,28,41,3706.70,6558.00,0.00
2024-12-08 16:55:24,70,5265,28,42,3653.75,6558.01,0.00
2024-12-08 16:55:24,69,5265,28,41,3695.31,6558.09,0.00
2024-12-08 16:55:24,68,5265,28,40,3705.65,6558.60,0.00
2024-12-08 16:55:24,68,5266,28,40,3737.78,6559.00,0.00
2024-12-08 16:55:24,69,5266,29,40,3683.61,6559.02,0.00
2024-12-08 16:55:24,69,5267,29,40,3657.04,6560.00,0.00
2024-12-08 16:55:24,70,5267,30,40,3604.79,6560.01,0.00
2024-12-08 16:55:24,69,5267,30,39,3641.02,6560.10,0.00
2024-12-08 16:55:24,69,5268,30,39,3639.65,6561.00,0.00
2024-12-08 16:55:24,70,5268,30,40,3587.65,6561.01,0.00
2024-12-08 16:55:24,69,5268,29,40,3636.81,6561.04,0.00
2024-12-08 16:55:24,69,5269,29,40,3619.82,6562.00,0.00
2024-12-08 16:55:24,70,5269,29,41,3568.11,6562.01,0.00
2024-12-08 16:55:24,69,5269,29,40,3586.61,6562.17,0.00
2024-12-08 16:55:24,68,5269,28,40,3627.12,6562.19,0.00
2024-12-08 16:55:24,68,5270,28,40,3671.05,6563.00,0.00
2024-12-08 16:55:24,69,5270,28,41,3617.85,6563.02,0.00
2024-12-08 16:55:24,68,5270,27,41,3655.14,6563.18,0.00
2024-12-08 16:55:24,68,5271,27,41,3650.78,6564.00,0.00
2024-12-08 16:55:24,69,5271,27,42,3597.87,6564.02,0.00
2024-12-08 16:55:24,68,5271,26,42,3600.19,6564.19,0.00
2024-12-08 16:55:24,68,5272,26,42,3644.14,6565.00,0.00
2024-12-08 16:55:24,69,5272,27,42,3591.32,6565.02,0.00
2024-12-08 16:55:24,68,5272,27,41,3624.90,6565.18,0.00
2024-12-08 16:55:24,68,5273,27,41,3629.27,6566.00,0.00
2024-12-08 16:55:24,69,5273,27,42,3576.67,6566.02,0.00
2024-12-08 16:55:24,68,5273,26,42,3611.95,6566.15,0.00
2024-12-08 16:55:24,69,5272,26,43,3495.12,6566.45,0.00
2024-12-08 16:55:24,69,5273,26,43,3626.48,6567.00,0.00
2024-12-08 16:55:24,70,5273,27,43,3574.67,6567.01,0.00
2024-12-08 16:55:24,69,5273,27,42,3597.01,6567.16,0.00
2024-12-08 16:55:24,68,5273,26,42,3637.24,6567.16,0.00
2024-12-08 16:55:24,68,5274,26,42,3775.88,6568.00,0.00
2024-12-08 16:55:24,69,5274,26,43,3721.16,6568.02,0.00
2024-12-08 16:55:24,69,5275,26,43,3704.49,6569.00,0.00
2024-12-08 16:55:24,70,5275,27,43,3651.57,6569.01,0.00
2024-12-08 16:55:24,69,5275,27,42,3673.92,6569.16,0.00
2024-12-08 16:55:24,68,5275,26,42,3713.56,6569.18,0.00
2024-12-08 16:55:24,68,5276,26,42,3756.60,6570.00,0.00
2024-12-08 16:55:24,69,5276,27,42,3702.15,6570.02,0.00
2024-12-08 16:55:24,68,5276,26,42,3688.82,6570.71,0.00
2024-12-08 16:55:24,68,5277,26,42,3737.69,6571.00,0.00
2024-12-08 16:55:24,69,5277,27,42,3683.52,6571.02,0.00
2024-12-08 16:55:24,68,5277,26,42,3734.80,6571.04,0.00
2024-12-08 16:55:24,67,5277,26,41,3759.00,6571.15,0.00
2024-12-08 16:55:24,67,5278,26,41,3762.49,6572.00,0.00
2024-12-08 16:55:24,68,5278,26,42,3707.16,6572.02,0.00
2024-12-08 16:55:24,68,5279,26,42,3685.54,6573.00,0.00
2024-12-08 16:55:24,69,5279,26,43,3632.12,6573.02,0.00
2024-12-08 16:55:24,68,5279,25,43,3676.73,6573.02,0.00
2024-12-08 16:55:24,67,5279,25,42,3698.63,6573.13,0.00
2024-12-08 16:55:25,67,5280,25,42,3740.38,6574.00,0.00
2024-12-08 16:55:25,68,5280,26,42,3685.38,6574.02,0.00
2024-12-08 16:55:25,67,5280,25,42,3725.74,6574.13,0.00
2024-12-08 16:55:25,67,5281,25,42,3717.44,6575.00,0.00
2024-12-08 16:55:25,68,5281,26,42,3662.77,6575.02,0.00
2024-12-08 16:55:25,67,5281,26,41,3683.17,6575.13,0.00
2024-12-08 16:55:25,66,5281,25,41,3716.11,6575.23,0.00
2024-12-08 16:55:25,65,5281,24,41,3743.63,6575.68,0.00
2024-12-08 16:55:25,65,5282,24,41,3823.80,6576.00,0.00
2024-12-08 16:55:25,66,5282,25,41,3765.86,6576.02,0.00
2024-12-08 16:55:25,65,5282,24,41,3811.44,6576.12,0.00
2024-12-08 16:55:25,65,5283,24,41,3802.98,6577.00,0.00
2024-12-08 16:55:25,66,5283,25,41,3745.36,6577.02,0.00
2024-12-08 16:55:25,65,5283,25,40,3775.68,6577.14,0.00
2024-12-08 16:55:25,64,5283,24,40,3775.16,6577.50,0.00
2024-12-08 16:55:25,64,5284,24,40,3845.43,6578.00,0.00
2024-12-08 16:55:25,65,5284,25,40,3786.27,6578.02,0.00
2024-12-08 16:55:25,64,5284,24,40,3815.64,6578.16,0.00
2024-12-08 16:55:25,63,5284,23,40,3819.89,6578.52,0.00
2024-12-08 16:55:25,63,5285,23,40,3893.35,6579.00,0.00
2024-12-08 16:55:25,64,5285,23,41,3832.52,6579.02,0.00
2024-12-08 16:55:25,63,5285,23,40,3866.22,6579.14,0.00
2024-12-08 16:55:25,63,5286,23,40,3870.34,6580.00,0.00
2024-12-08 16:55:25,64,5286,24,40,3809.87,6580.02,0.00
2024-12-08 16:55:25,63,5286,24,39,3867.68,6580.05,0.00
2024-12-08 16:55:25,62,5286,23,39,3864.18,6580.66,0.00
2024-12-08 16:55:25,62,5287,23,39,3912.98,6581.00,0.00
2024-12-08 16:55:25,63,5287,23,40,3850.87,6581.02,0.00
2024-12-08 16:55:25,62,5287,23,39,3886.46,6581.13,0.00
2024-12-08 16:55:25,62,5288,23,39,3887.39,6582.00,0.00
2024-12-08 16:55:25,63,5288,23,40,3825.69,6582.02,0.00
2024-12-08 16:55:25,62,5288,22,40,3822.77,6582.39,0.00
2024-12-08 16:55:25,62,5289,22,40,3881.67,6583.00,0.00
2024-12-08 16:55:25,63,5289,23,40,3820.06,6583.02,0.00
2024-12-08 16:55:25,62,5289,22,40,3879.55,6583.03,0.00
2024-12-08 16:55:25,61,5289,22,39,3917.26,6583.12,0.00
2024-12-08 16:55:25,60,5289,21,39,3904.92,6583.58,0.00
2024-12-08 16:55:25,60,5290,21,39,3987.54,6584.00,0.00
2024-12-08 16:55:25,61,5290,22,39,3922.17,6584.02,0.00
2024-12-08 16:55:25,60,5290,21,39,3982.08,6584.08,0.00
2024-12-08 16:55:25,60,5291,21,39,3962.72,6585.00,0.00
2024-12-08 16:55:25,61,5291,22,39,3897.76,6585.02,0.00
2024-12-08 16:55:25,60,5291,22,38,3935.29,6585.10,0.00
2024-12-08 16:55:25,60,5292,22,38,3930.62,6586.00,0.00
2024-12-08 16:55:25,61,5292,22,39,3866.18,6586.02,0.00
2024-12-08 16:55:25,60,5292,22,38,3881.32,6586.33,0.00
2024-12-08 16:55:25,60,5293,22,38,3911.06,6587.00,0.00
2024-12-08 16:55:25,61,5293,22,39,3846.94,6587.02,0.00
2024-12-08 16:55:25,60,5293,22,38,3882.53,6587.12,0.00
2024-12-08 16:55:25,60,5294,22,38,3890.79,6588.00,0.00
2024-12-08 16:55:25,61,5294,23,38,3827.00,6588.02,0.00
2024-12-08 16:55:25,60,5294,22,38,3784.09,6588.93,0.00
2024-12-08 16:55:25,60,5295,22,38,3889.56,6589.00,0.00
2024-12-08 16:55:25,61,5295,22,39,3825.80,6589.02,0.00
2024-12-08 16:55:25,60,5295,22,38,3858.84,6589.15,0.00
2024-12-08 16:55:25,60,5296,22,38,3869.28,6590.00,0.00
2024-12-08 16:55:25,61,5296,23,38,3805.85,6590.02,0.00
2024-12-08 16:55:25,60,5296,22,38,3858.89,6590.13,0.00
2024-12-08 16:55:25,60,5297,22,38,3890.20,6591.00,0.00
2024-12-08 16:55:25,61,5297,23,38,3826.43,6591.02,0.00
2024-12-08 16:55:25,60,5297,23,37,3858.38,6591.15,0.00
2024-12-08 16:55:25,60,5298,23,37,3868.82,6592.00,0.00
2024-12-08 16:55:25,61,5298,24,37,3805.40,6592.02,0.00
2024-12-08 16:55:25,61,5299,24,37,3791.81,6593.00,0.00
2024-12-08 16:55:25,62,5299,25,37,3730.65,6593.02,0.00
2024-12-08 16:55:25,61,5299,25,36,3789.65,6593.03,0.00
2024-12-08 16:55:25,60,5299,25,35,3824.27,6593.13,0.00
2024-12-08 16:55:25,60,5300,25,35,3833.61,6594.00,0.00
2024-12-08 16:55:25,61,5300,26,35,3770.77,6594.02,0.00
2024-12-08 16:55:25,62,5299,27,35,3659.10,6594.50,0.00
2024-12-08 16:55:25,62,5300,27,35,3730.87,6595.00,0.00
2024-12-08 16:55:25,63,5300,28,35,3671.64,6595.02,0.00
2024-12-08 16:55:25,62,5300,28,34,3728.74,6595.03,0.00
2024-12-08 16:55:25,61,5300,28,33,3761.79,6595.13,0.00
2024-12-08 16:55:25,61,5301,28,33,3878.03,6596.00,0.00
2024-12-08 16:55:25,62,5301,29,33,3815.48,6596.02,0.00
2024-12-08 16:55:25,62,5302,29,33,3799.93,6597.00,0.00
2024-12-08 16:55:25,63,5302,29,34,3739.61,6597.02,0.00
2024-12-08 16:55:25,62,5302,28,34,3798.86,6597.02,0.00
2024-12-08 16:55:25,61,5302,28,33,3834.14,6597.12,0.00
2024-12-08 16:55:25,61,5303,28,33,3841.18,6598.00,0.00
2024-12-08 16:55:25,62,5303,28,34,3779.22,6598.02,0.00
2024-12-08 16:55:25,61,5303,27,34,3771.50,6598.66,0.00
2024-12-08 16:55:25,61,5304,27,34,3857.20,6599.00,0.00
2024-12-08 16:55:25,62,5304,27,35,3794.99,6599.02,0.00
2024-12-08 16:55:25,62,5305,27,35,3773.21,6600.00,0.00
2024-12-08 16:55:25,63,5305,28,35,3713.32,6600.02,0.00
2024-12-08 16:55:25,62,5305,28,34,3758.34,6600.11,0.00
2024-12-08 16:55:25,61,5305,27,34,3744.49,6600.64,0.00
2024-12-08 16:55:26,61,5306,27,34,3829.16,6601.00,0.00
2024-12-08 16:55:26,62,5306,27,35,3767.40,6601.02,0.00
2024-12-08 16:55:26,61,5306,27,34,3828.07,6601.02,0.00
2024-12-08 16:55:26,60,5306,26,34,3843.70,6601.20,0.00
2024-12-08 16:55:26,60,5307,26,34,3901.44,6602.00,0.00
2024-12-08 16:55:26,61,5307,26,35,3837.48,6602.02,0.00
2024-12-08 16:55:26,60,5307,26,34,3876.16,6602.12,0.00
2024-12-08 16:55:26,60,5308,26,34,3884.42,6603.00,0.00
2024-12-08 16:55:26,61,5308,27,34,3820.74,6603.02,0.00
2024-12-08 16:55:26,61,5309,27,34,3805.20,6604.00,0.00
2024-12-08 16:55:26,62,5309,27,35,3743.83,6604.02,0.00
2024-12-08 16:55:26,61,5309,27,34,3779.25,6604.12,0.00
2024-12-08 16:55:26,61,5310,27,34,3786.29,6605.00,0.00
2024-12-08 16:55:26,62,5310,28,34,3725.22,6605.02,0.00
2024-12-08 16:55:26,61,5310,27,34,3724.73,6605.61,0.00
2024-12-08 16:55:26,61,5311,27,34,3807.32,6606.00,0.00
2024-12-08 16:55:26,62,5311,27,35,3745.91,6606.02,0.00
2024-12-08 16:55:26,62,5312,27,35,3729.66,6607.00,0.00
2024-12-08 16:55:26,63,5312,28,35,3670.46,6607.02,0.00
2024-12-08 16:55:26,62,5312,28,34,3706.25,6607.11,0.00
2024-12-08 16:55:26,62,5313,28,34,3712.11,6608.00,0.00
2024-12-08 16:55:26,63,5313,28,35,3653.19,6608.02,0.00
2024-12-08 16:55:26,62,5313,28,34,3686.56,6608.11,0.00
2024-12-08 16:55:26,61,5313,27,34,3666.01,6608.97,0.00
2024-12-08 16:55:26,61,5314,27,34,3772.21,6609.00,0.00
2024-12-08 16:55:26,62,5314,27,35,3711.37,6609.02,0.00
2024-12-08 16:55:26,62,5315,27,35,3696.55,6610.00,0.00
2024-12-08 16:55:26,63,5315,27,36,3637.87,6610.02,0.00
2024-12-08 16:55:26,62,5315,27,35,3672.05,6610.11,0.00
2024-12-08 16:55:26,62,5316,27,35,3677.91,6611.00,0.00
2024-12-08 16:55:26,63,5316,27,36,3619.53,6611.02,0.00
2024-12-08 16:55:26,62,5316,26,36,3593.89,6611.52,0.00
2024-12-08 16:55:26,62,5317,26,36,3668.87,6612.00,0.00
2024-12-08 16:55:26,63,5317,27,36,3610.64,6612.02,0.00
2024-12-08 16:55:26,62,5317,27,35,3644.36,6612.11,0.00
2024-12-08 16:55:26,62,5318,27,35,3650.23,6613.00,0.00
2024-12-08 16:55:26,63,5318,27,36,3592.29,6613.02,0.00
2024-12-08 16:55:26,64,5317,27,37,3428.63,6613.86,0.00
2024-12-08 16:55:26,64,5318,27,37,3533.12,6614.00,0.00
2024-12-08 16:55:26,65,5318,27,38,3478.76,6614.02,0.00
2024-12-08 16:55:26,64,5318,26,38,3532.09,6614.02,0.00
2024-12-08 16:55:26,65,5317,26,39,3477.75,6614.05,0.00
2024-12-08 16:55:26,64,5317,25,39,3601.81,6614.05,0.00
2024-12-08 16:55:26,63,5317,25,38,3639.05,6614.10,0.00
2024-12-08 16:55:26,63,5318,25,38,3789.72,6615.00,0.00
2024-12-08 16:55:26,64,5318,25,39,3730.51,6615.02,0.00
2024-12-08 16:55:26,65,5317,25,40,3596.67,6615.39,0.00
2024-12-08 16:55:26,65,5318,25,40,3803.70,6616.00,0.00
2024-12-08 16:55:26,66,5318,26,40,3746.07,6616.02,0.00
2024-12-08 16:55:26,65,5318,26,39,3783.37,6616.08,0.00
2024-12-08 16:55:26,64,5318,25,39,3838.61,6616.08,0.00
2024-12-08 16:55:26,64,5319,25,39,3984.94,6617.00,0.00
2024-12-08 16:55:26,65,5319,26,39,3923.64,6617.02,0.00
2024-12-08 16:55:26,64,5319,25,39,3928.44,6617.55,0.00
2024-12-08 16:55:26,63,5319,24,39,3947.96,6617.65,0.00
2024-12-08 16:55:26,63,5320,24,39,4030.18,6618.00,0.00
2024-12-08 16:55:26,64,5320,25,39,3967.21,6618.02,0.00
2024-12-08 16:55:26,63,5320,25,38,4009.19,6618.08,0.00
2024-12-08 16:55:26,63,5321,25,38,4011.88,6619.00,0.00
2024-12-08 16:55:26,64,5321,26,38,3949.19,6619.02,0.00
2024-12-08 16:55:26,64,5322,26,38,3930.25,6620.00,0.00
2024-12-08 16:55:26,65,5322,27,38,3869.78,6620.02,0.00
2024-12-08 16:55:26,64,5322,27,37,3909.58,6620.08,0.00
2024-12-08 16:55:26,64,5323,27,37,3911.18,6621.00,0.00
2024-12-08 16:55:26,65,5323,28,37,3851.01,6621.02,0.00
2024-12-08 16:55:26,66,5322,28,38,3742.14,6621.50,0.00
2024-12-08 16:55:26,65,5322,27,38,3822.36,6621.95,0.00
2024-12-08 16:55:26,65,5323,27,38,3921.21,6622.00,0.00
2024-12-08 16:55:26,66,5323,28,38,3861.79,6622.02,0.00
2024-12-08 16:55:26,65,5323,28,37,3900.23,6622.08,0.00
2024-12-08 16:55:26,65,5324,28,37,4002.69,6623.00,0.00
2024-12-08 16:55:26,66,5324,29,37,3942.05,6623.02,0.00
2024-12-08 16:55:26,65,5324,28,37,3938.16,6623.34,0.00
2024-12-08 16:55:26,65,5325,28,37,3996.72,6624.00,0.00
2024-12-08 16:55:26,66,5325,29,37,3936.16,6624.02,0.00
2024-12-08 16:55:26,65,5325,29,36,3994.18,6624.03,0.00
2024-12-08 16:55:26,64,5325,29,35,4033.83,6624.09,0.00
2024-12-08 16:55:26,64,5326,29,35,4036.48,6625.00,0.00
2024-12-08 16:55:26,65,5326,29,36,3974.38,6625.02,0.00
2024-12-08 16:55:26,65,5327,29,36,3976.24,6626.00,0.00
2024-12-08 16:55:26,66,5327,29,37,3916.00,6626.02,0.00
2024-12-08 16:55:26,66,5328,29,37,3904.43,6627.00,0.00
2024-12-08 16:55:26,67,5328,30,37,3846.15,6627.02,0.00
2024-12-08 16:55:26,66,5328,29,37,3844.18,6627.36,0.00
2024-12-08 16:55:27,66,5329,29,37,3902.88,6628.00,0.00
2024-12-08 16:55:27,67,5329,30,37,3844.63,6628.02,0.00
2024-12-08 16:55:27,66,5329,30,36,3890.85,6628.09,0.00
2024-12-08 16:55:27,67,5328,30,37,3822.94,6628.27,0.00
2024-12-08 16:55:27,67,5329,30,37,3888.74,6629.00,0.00
2024-12-08 16:55:27,68,5329,30,38,3831.56,6629.02,0.00
2024-12-08 16:55:27,68,5330,30,38,3907.90,6630.00,0.00
2024-12-08 16:55:27,69,5330,31,38,3851.26,6630.02,0.00
2024-12-08 16:55:27,68,5330,31,37,3889.40,6630.09,0.00
2024-12-08 16:55:27,67,5330,30,37,3945.76,6630.10,0.00
2024-12-08 16:55:27,67,5331,30,37,3985.92,6631.00,0.00
2024-12-08 16:55:27,68,5331,31,37,3927.30,6631.02,0.00
2024-12-08 16:55:27,67,5331,30,37,3955.28,6631.18,0.00
2024-12-08 16:55:27,67,5332,30,37,3963.82,6632.00,0.00
2024-12-08 16:55:27,68,5332,30,38,3905.53,6632.02,0.00
2024-12-08 16:55:27,67,5332,30,37,3946.02,6632.09,0.00
2024-12-08 16:55:27,67,5333,30,37,3945.60,6633.00,0.00
2024-12-08 16:55:27,68,5333,31,37,3887.58,6633.02,0.00
2024-12-08 16:55:27,67,5333,31,36,3943.64,6633.03,0.00
2024-12-08 16:55:27,66,5333,30,36,3943.10,6633.11,0.00
2024-12-08 16:55:27,66,5334,30,36,3984.88,6634.00,0.00
2024-12-08 16:55:27,67,5334,30,37,3925.41,6634.02,0.00
2024-12-08 16:55:27,66,5334,30,36,3967.81,6634.08,0.00
2024-12-08 16:55:27,65,5334,29,36,3997.88,6634.54,0.00
2024-12-08 16:55:27,65,5335,29,36,4028.86,6635.00,0.00
2024-12-08 16:55:27,66,5335,29,37,3967.82,6635.02,0.00
2024-12-08 16:55:27,66,5336,29,37,3943.28,6636.00,0.00
2024-12-08 16:55:27,67,5336,30,37,3884.42,6636.02,0.00
2024-12-08 16:55:27,68,5335,30,38,3824.39,6636.09,0.00
2024-12-08 16:55:27,67,5335,30,37,3944.87,6636.09,0.00
2024-12-08 16:55:27,66,5335,29,37,3923.54,6636.70,0.00
2024-12-08 16:55:27,66,5336,29,37,4004.21,6637.00,0.00
2024-12-08 16:55:27,67,5336,30,37,3944.44,6637.02,0.00
2024-12-08 16:55:27,66,5336,29,37,4002.21,6637.03,0.00
2024-12-08 16:55:27,65,5336,28,37,4036.90,6637.08,0.00
2024-12-08 16:55:27,65,5337,28,37,4180.45,6638.00,0.00
2024-12-08 16:55:27,66,5337,28,38,4117.11,6638.02,0.00
2024-12-08 16:55:27,65,5337,28,37,4166.18,6638.06,0.00
2024-12-08 16:55:27,65,5338,28,37,4165.76,6639.00,0.00
2024-12-08 16:55:27,66,5338,29,37,4102.64,6639.02,0.00
2024-12-08 16:55:27,66,5339,29,37,4108.70,6640.00,0.00
2024-12-08 16:55:27,67,5339,30,37,4047.38,6640.02,0.00
2024-12-08 16:55:27,68,5338,30,38,3930.55,6640.62,0.00
2024-12-08 16:55:27,68,5339,30,38,4011.62,6641.00,0.00
2024-12-08 16:55:27,69,5339,30,39,3953.48,6641.02,0.00
2024-12-08 16:55:27,68,5339,29,39,3985.97,6641.10,0.00
2024-12-08 16:55:27,68,5340,29,39,4094.46,6642.00,0.00
2024-12-08 16:55:27,69,5340,29,40,4035.12,6642.02,0.00
2024-12-08 16:55:27,69,5341,29,40,4008.77,6643.00,0.00
2024-12-08 16:55:27,70,5341,30,40,3951.51,6643.01,0.00
2024-12-08 16:55:27,69,5341,30,39,3999.18,6643.07,0.00
2024-12-08 16:55:27,68,5341,29,39,3987.96,6643.94,0.00
2024-12-08 16:55:27,68,5342,29,39,4081.80,6644.00,0.00
2024-12-08 16:55:27,69,5342,29,40,4022.64,6644.02,0.00
2024-12-08 16:55:27,69,5343,29,40,3996.28,6645.00,0.00
2024-12-08 16:55:27,70,5343,30,40,3939.19,6645.01,0.00
2024-12-08 16:55:27,69,5343,30,39,3983.80,6645.07,0.00
2024-12-08 16:55:27,68,5343,29,39,4039.47,6645.12,0.00
2024-12-08 16:55:27,67,5343,28,39,4032.56,6645.60,0.00
2024-12-08 16:55:27,67,5344,28,39,4105.28,6646.00,0.00
2024-12-08 16:55:27,68,5344,29,39,4044.91,6646.02,0.00
2024-12-08 16:55:27,68,5345,29,39,4019.13,6647.00,0.00
2024-12-08 16:55:27,69,5345,29,40,3960.88,6647.02,0.00
2024-12-08 16:55:27,68,5345,29,39,4002.54,6647.07,0.00
2024-12-08 16:55:27,68,5346,29,39,4000.18,6648.00,0.00
2024-12-08 16:55:27,69,5346,30,39,3942.20,6648.02,0.00
2024-12-08 16:55:27,69,5347,30,39,3916.44,6649.00,0.00
2024-12-08 16:55:27,70,5347,30,40,3860.49,6649.01,0.00
2024-12-08 16:55:27,69,5347,30,39,3900.09,6649.07,0.00
2024-12-08 16:55:27,69,5348,30,39,3896.79,6650.00,0.00
2024-12-08 16:55:27,70,5348,31,39,3841.12,6650.01,0.00
2024-12-08 16:55:27,70,5349,31,39,3815.50,6651.00,0.00
2024-12-08 16:55:27,71,5349,31,40,3761.76,6651.01,0.00
2024-12-08 16:55:27,70,5349,31,39,3800.33,6651.07,0.00
2024-12-08 16:55:28,70,5350,31,39,3796.12,6652.00,0.00
2024-12-08 16:55:28,71,5350,31,40,3742.65,6652.01,0.00
2024-12-08 16:55:28,70,5350,30,40,3709.89,6652.57,0.00
2024-12-08 16:55:28,70,5351,30,40,3776.73,6653.00,0.00
2024-12-08 16:55:28,71,5351,31,40,3723.54,6653.01,0.00
2024-12-08 16:55:28,70,5351,31,39,3759.65,6653.07,0.00
2024-12-08 16:55:28,69,5351,30,39,3810.31,6653.13,0.00
2024-12-08 16:55:28,68,5351,29,39,3805.46,6653.56,0.00
2024-12-08 16:55:28,68,5352,29,39,3874.28,6654.00,0.00
2024-12-08 16:55:28,69,5352,29,40,3818.13,6654.02,0.00
2024-12-08 16:55:28,68,5352,28,40,3783.54,6654.59,0.00
2024-12-08 16:55:28,68,5353,28,40,3854.31,6655.00,0.00
2024-12-08 16:55:28,69,5353,29,40,3798.45,6655.02,0.00
2024-12-08 16:55:28,68,5353,29,39,3837.70,6655.07,0.00
2024-12-08 16:55:28,67,5353,28,39,3891.03,6655.13,0.00
2024-12-08 16:55:28,67,5354,28,39,3893.55,6656.00,0.00
2024-12-08 16:55:28,68,5354,28,40,3836.29,6656.02,0.00
2024-12-08 16:55:28,68,5355,28,40,3812.54,6657.00,0.00
2024-12-08 16:55:28,69,5355,28,41,3757.28,6657.02,0.00
2024-12-08 16:55:28,68,5355,27,41,3782.07,6657.07,0.00
2024-12-08 16:55:28,67,5355,27,40,3825.60,6657.08,0.00
2024-12-08 16:55:28,67,5356,27,40,3863.91,6658.00,0.00
2024-12-08 16:55:28,68,5356,28,40,3807.09,6658.02,0.00
2024-12-08 16:55:28,67,5356,28,39,3861.93,6658.03,0.00
2024-12-08 16:55:28,67,5357,28,39,3857.53,6659.00,0.00
2024-12-08 16:55:28,68,5357,28,40,3800.81,6659.02,0.00
2024-12-08 16:55:28,67,5357,27,40,3825.14,6659.16,0.00
2024-12-08 16:55:28,67,5358,27,40,3869.40,6660.00,0.00
2024-12-08 16:55:28,68,5358,28,40,3812.49,6660.02,0.00
2024-12-08 16:55:28,67,5358,27,40,3864.30,6660.09,0.00
2024-12-08 16:55:28,66,5358,27,39,3899.66,6660.14,0.00
2024-12-08 16:55:28,65,5358,26,39,3937.17,6660.28,0.00
2024-12-08 16:55:28,65,5359,26,39,3991.96,6661.00,0.00
2024-12-08 16:55:28,66,5359,26,40,3931.48,6661.02,0.00
2024-12-08 16:55:28,66,5360,26,40,3912.41,6662.00,0.00
2024-12-08 16:55:28,67,5360,26,41,3854.02,6662.02,0.00
2024-12-08 16:55:28,66,5360,26,40,3884.20,6662.14,0.00
2024-12-08 16:55:28,65,5360,25,40,3909.84,6662.63,0.00
2024-12-08 16:55:28,65,5361,25,40,3988.03,6663.00,0.00
2024-12-08 16:55:28,66,5361,26,40,3927.61,6663.02,0.00
2024-12-08 16:55:28,65,5361,25,40,3955.26,6663.06,0.00
2024-12-08 16:55:28,66,5360,26,40,3892.32,6663.14,0.00
2024-12-08 16:55:28,65,5360,25,40,4015.77,6663.15,0.00
2024-12-08 16:55:28,65,5361,25,40,4041.94,6664.00,0.00
2024-12-08 16:55:28,66,5361,26,40,3980.70,6664.02,0.00
2024-12-08 16:55:28,66,5362,26,40,4057.17,6665.00,0.00
2024-12-08 16:55:28,67,5362,26,41,3996.61,6665.02,0.00
2024-12-08 16:55:28,66,5362,26,40,4039.03,6665.09,0.00
2024-12-08 16:55:28,66,5363,26,40,4038.92,6666.00,0.00
2024-12-08 16:55:28,67,5363,27,40,3978.64,6666.02,0.00
2024-12-08 16:55:28,68,5362,27,41,3883.48,6666.29,0.00
2024-12-08 16:55:28,68,5363,27,41,3951.32,6667.00,0.00
2024-12-08 16:55:28,69,5363,28,41,3894.05,6667.02,0.00
2024-12-08 16:55:28,69,5364,28,41,3989.85,6668.00,0.00
2024-12-08 16:55:28,70,5364,29,41,3932.85,6668.01,0.00
2024-12-08 16:55:28,70,5365,29,41,3919.59,6669.00,0.00
2024-12-08 16:55:28,71,5365,30,41,3864.38,6669.01,0.00
2024-12-08 16:55:28,71,5366,30,41,3834.32,6670.00,0.00
2024-12-08 16:55:28,72,5366,30,42,3781.07,6670.01,0.00
2024-12-08 16:55:28,71,5366,30,41,3816.50,6670.08,0.00
2024-12-08 16:55:28,70,5366,29,41,3857.38,6670.29,0.00
2024-12-08 16:55:28,70,5367,29,41,3861.81,6671.00,0.00
2024-12-08 16:55:28,71,5367,30,41,3807.42,6671.01,0.00
2024-12-08 16:55:28,71,5368,30,41,3781.70,6672.00,0.00
2024-12-08 16:55:28,72,5368,31,41,3729.18,6672.01,0.00
2024-12-08 16:55:28,73,5367,32,41,3673.55,6672.11,0.00
2024-12-08 16:55:28,73,5368,32,41,3734.02,6673.00,0.00
2024-12-08 16:55:28,74,5368,32,42,3683.57,6673.01,0.00
2024-12-08 16:55:29,74,5369,32,42,3766.34,6674.00,0.00
2024-12-08 16:55:29,75,5369,33,42,3716.12,6674.01,0.00
2024-12-08 16:55:29,75,5370,33,42,3702.05,6675.00,0.00
2024-12-08 16:55:29,76,5370,33,43,3653.34,6675.01,0.00
2024-12-08 16:55:29,77,5369,33,44,3547.63,6675.57,0.00
2024-12-08 16:55:29,77,5370,33,44,3609.77,6676.00,0.00
2024-12-08 16:55:29,78,5370,34,44,3563.49,6676.01,0.00
2024-12-08 16:55:29,78,5371,34,44,3609.95,6677.00,0.00
2024-12-08 16:55:29,79,5371,35,44,3564.25,6677.01,0.00
2024-12-08 16:55:29,78,5371,35,43,3591.99,6677.08,0.00
2024-12-08 16:55:29,78,5372,35,43,3565.55,6678.00,0.00
2024-12-08 16:55:29,79,5372,36,43,3520.41,6678.01,0.00
2024-12-08 16:55:29,78,5372,36,42,3555.29,6678.08,0.00
2024-12-08 16:55:29,77,5372,36,41,3591.66,6678.18,0.00
2024-12-08 16:55:29,77,5373,36,41,3582.79,6679.00,0.00
2024-12-08 16:55:29,78,5373,37,41,3536.86,6679.01,0.00
2024-12-08 16:55:29,77,5373,36,41,3552.50,6679.21,0.00
2024-12-08 16:55:29,76,5373,35,41,3553.70,6679.53,0.00
2024-12-08 16:55:29,75,5373,34,41,3588.81,6679.68,0.00
2024-12-08 16:55:29,75,5374,34,41,3656.72,6680.00,0.00
2024-12-08 16:55:29,76,5374,35,41,3608.61,6680.01,0.00
2024-12-08 16:55:29,75,5374,35,40,3645.93,6680.08,0.00
2024-12-08 16:55:29,75,5375,35,40,3638.44,6681.00,0.00
2024-12-08 16:55:29,76,5375,35,41,3590.57,6681.01,0.00
2024-12-08 16:55:29,76,5376,35,41,3560.45,6682.00,0.00
2024-12-08 16:55:29,77,5376,36,41,3514.21,6682.01,0.00
2024-12-08 16:55:29,78,5375,37,41,3469.15,6682.04,0.00
2024-12-08 16:55:29,77,5375,37,40,3563.06,6682.09,0.00
2024-12-08 16:55:29,76,5375,36,40,3535.31,6682.97,0.00
2024-12-08 16:55:29,76,5376,36,40,3621.50,6683.00,0.00
2024-12-08 16:55:29,77,5376,37,40,3574.46,6683.01,0.00
2024-12-08 16:55:29,77,5377,37,40,3658.24,6684.00,0.00
2024-12-08 16:55:29,78,5377,38,40,3611.34,6684.01,0.00
2024-12-08 16:55:29,78,5378,38,40,3604.74,6685.00,0.00
2024-12-08 16:55:29,79,5378,38,41,3559.11,6685.01,0.00
2024-12-08 16:55:29,79,5379,38,41,3544.30,6686.00,0.00
2024-12-08 16:55:29,80,5379,38,42,3499.99,6686.01,0.00
2024-12-08 16:55:29,80,5380,38,42,3470.55,6687.00,0.00
2024-12-08 16:55:29,81,5380,38,43,3427.70,6687.01,0.00
2024-12-08 16:55:29,80,5380,38,42,3459.78,6687.01,0.00
2024-12-08 16:55:29,80,5381,38,42,3440.78,6688.00,0.00
2024-12-08 16:55:29,81,5381,39,42,3398.30,6688.01,0.00
2024-12-08 16:55:29,80,5381,38,42,3409.07,6688.23,0.00
2024-12-08 16:55:29,80,5382,38,42,3402.21,6689.00,0.00
2024-12-08 16:55:29,81,5382,39,42,3360.21,6689.01,0.00
2024-12-08 16:55:29,80,5382,39,41,3398.04,6689.06,0.00
2024-12-08 16:55:29,80,5383,39,41,3378.75,6690.00,0.00
2024-12-08 16:55:29,81,5383,40,41,3337.03,6690.01,0.00
2024-12-08 16:55:29,80,5383,40,40,3357.85,6690.06,0.00
2024-12-08 16:55:29,79,5383,39,40,3337.24,6690.87,0.00
2024-12-08 16:55:29,79,5383,39,40,3404.57,6691.00,0.00
2024-12-08 16:55:29,80,5383,40,40,3362.01,6691.01,0.00
2024-12-08 16:55:29,79,5383,40,39,3383.40,6691.06,0.00
2024-12-08 16:55:29,78,5383,39,39,3386.60,6691.44,0.00
2024-12-08 16:55:29,77,5383,38,39,3413.33,6691.70,0.00
2024-12-08 16:55:29,77,5384,38,39,3469.86,6692.00,0.00
2024-12-08 16:55:29,78,5384,39,39,3425.37,6692.01,0.00
2024-12-08 16:55:29,77,5384,38,39,3437.76,6692.23,0.00
2024-12-08 16:55:29,77,5385,38,39,3427.19,6693.00,0.00
2024-12-08 16:55:29,78,5385,38,40,3383.25,6693.01,0.00
2024-12-08 16:55:29,77,5385,37,40,3424.59,6693.04,0.00
2024-12-08 16:55:29,76,5385,37,39,3467.89,6693.05,0.00
2024-12-08 16:55:29,77,5384,38,39,3396.06,6693.48,0.00
2024-12-08 16:55:29,76,5384,37,39,3465.68,6693.62,0.00
2024-12-08 16:55:29,76,5385,37,39,3480.01,6694.00,0.00
2024-12-08 16:55:29,77,5385,38,39,3434.82,6694.01,0.00
2024-12-08 16:55:29,76,5385,38,38,3459.76,6694.05,0.00
2024-12-08 16:55:29,75,5385,37,38,3496.95,6694.19,0.00
2024-12-08 16:55:29,74,5385,36,38,3543.31,6694.20,0.00
2024-12-08 16:55:29,73,5385,35,38,3535.73,6694.67,0.00
2024-12-08 16:55:29,72,5385,34,38,3564.31,6694.86,0.00
2024-12-08 16:55:29,72,5386,34,38,3734.11,6695.00,0.00
2024-12-08 16:55:29,73,5386,34,39,3682.96,6695.01,0.00
2024-12-08 16:55:29,72,5386,33,39,3731.33,6695.04,0.00
2024-12-08 16:55:29,71,5386,33,38,3765.03,6695.04,0.00
2024-12-08 16:55:29,70,5386,32,38,3805.48,6695.21,0.00
2024-12-08 16:55:30,70,5387,32,38,3832.31,6696.00,0.00
2024-12-08 16:55:30,71,5387,32,39,3778.34,6696.01,0.00
2024-12-08 16:55:30,70,5387,31,39,3751.06,6696.83,0.00
2024-12-08 16:55:30,70,5388,31,39,3813.73,6697.00,0.00
2024-12-08 16:55:30,71,5388,31,40,3760.01,6697.01,0.00
2024-12-08 16:55:30,71,5389,31,40,3736.23,6698.00,0.00
2024-12-08 16:55:30,72,5389,32,40,3684.34,6698.01,0.00
2024-12-08 16:55:30,71,5389,31,40,3629.42,6698.92,0.00
2024-12-08 16:55:30,71,5390,31,40,3718.18,6699.00,0.00
2024-12-08 16:55:30,72,5390,31,41,3666.54,6699.01,0.00
2024-12-08 16:55:30,71,5390,31,40,3708.75,6699.04,0.00
2024-12-08 16:55:30,71,5391,31,40,3691.54,6700.00,0.00
2024-12-08 16:55:30,72,5391,32,40,3640.26,6700.01,0.00
2024-12-08 16:55:30,71,5391,31,40,3675.50,6700.03,0.00
2024-12-08 16:55:30,70,5391,31,39,3712.69,6700.03,0.00
2024-12-08 16:55:30,69,5391,31,38,3710.18,6700.81,0.00
2024-12-08 16:55:30,69,5392,31,38,3794.82,6701.00,0.00
2024-12-08 16:55:30,70,5392,31,39,3740.61,6701.01,0.00
2024-12-08 16:55:30,69,5392,30,39,3770.55,6701.06,0.00
2024-12-08 16:55:30,70,5391,30,40,3650.98,6701.79,0.00
2024-12-08 16:55:30,70,5392,30,40,3757.17,6702.00,0.00
2024-12-08 16:55:30,71,5392,30,41,3704.25,6702.01,0.00
2024-12-08 16:55:30,70,5392,29,41,3737.07,6702.03,0.00
2024-12-08 16:55:30,69,5392,29,40,3786.38,6702.04,0.00
2024-12-08 16:55:30,69,5393,29,40,3917.11,6703.00,0.00
2024-12-08 16:55:30,70,5393,30,40,3861.15,6703.01,0.00
2024-12-08 16:55:30,69,5393,29,40,3861.87,6703.36,0.00
2024-12-08 16:55:30,69,5394,29,40,3916.72,6704.00,0.00
2024-12-08 16:55:30,70,5394,29,41,3860.77,6704.01,0.00
2024-12-08 16:55:30,69,5394,29,40,3911.87,6704.04,0.00
2024-12-08 16:55:30,69,5395,29,40,3906.62,6705.00,0.00
2024-12-08 16:55:30,70,5395,29,41,3850.81,6705.01,0.00
2024-12-08 16:55:30,70,5396,29,41,3823.60,6706.00,0.00
2024-12-08 16:55:30,71,5396,30,41,3769.75,6706.01,0.00
2024-12-08 16:55:30,70,5396,30,40,3818.82,6706.04,0.00
2024-12-08 16:55:30,69,5396,29,40,3801.55,6706.65,0.00
2024-12-08 16:55:30,69,5397,29,40,3875.71,6707.00,0.00
2024-12-08 16:55:30,70,5397,30,40,3820.34,6707.01,0.00
2024-12-08 16:55:30,69,5397,29,40,3846.55,6707.02,0.00
2024-12-08 16:55:30,70,5396,29,41,3717.30,6707.87,0.00
2024-12-08 16:55:30,70,5397,29,41,3850.62,6708.00,0.00
2024-12-08 16:55:30,71,5397,30,41,3796.38,6708.01,0.00
2024-12-08 16:55:30,70,5397,30,40,3847.74,6708.03,0.00
2024-12-08 16:55:30,71,5396,31,40,3791.67,6708.08,0.00
2024-12-08 16:55:30,71,5397,31,40,3950.03,6709.00,0.00
2024-12-08 16:55:30,72,5397,31,41,3895.16,6709.01,0.00
2024-12-08 16:55:30,72,5398,31,41,3960.05,6710.00,0.00
2024-12-08 16:55:30,73,5398,31,42,3905.80,6710.01,0.00
2024-12-08 16:55:30,72,5398,31,41,3956.32,6710.03,0.00
2024-12-08 16:55:30,72,5399,31,41,3947.59,6711.00,0.00
2024-12-08 16:55:30,73,5399,31,42,3893.51,6711.01,0.00
2024-12-08 16:55:30,72,5399,30,42,3915.97,6711.21,0.00
2024-12-08 16:55:30,72,5400,30,42,3948.86,6712.00,0.00
2024-12-08 16:55:30,73,5400,31,42,3894.76,6712.01,0.00
2024-12-08 16:55:30,74,5399,32,42,3840.32,6712.07,0.00
2024-12-08 16:55:30,74,5400,32,42,3879.17,6713.00,0.00
2024-12-08 16:55:30,75,5400,32,43,3827.45,6713.01,0.00
2024-12-08 16:55:30,75,5401,32,43,3915.80,6714.00,0.00
2024-12-08 16:55:30,76,5401,32,44,3864.28,6714.01,0.00
2024-12-08 16:55:30,76,5402,32,44,3859.32,6715.00,0.00
2024-12-08 16:55:30,77,5402,32,45,3809.20,6715.01,0.00
2024-12-08 16:55:30,77,5403,32,45,3796.58,6716.00,0.00
2024-12-08 16:55:30,78,5403,32,46,3747.91,6716.01,0.00
2024-12-08 16:55:30,77,5403,31,46,3757.01,6716.34,0.00
2024-12-08 16:55:30,78,5402,31,47,3643.31,6716.91,0.00
2024-12-08 16:55:30,78,5403,31,47,3728.65,6717.00,0.00
2024-12-08 16:55:30,79,5403,32,47,3681.45,6717.01,0.00
2024-12-08 16:55:30,78,5403,32,46,3713.15,6717.04,0.00
2024-12-08 16:55:30,77,5403,31,46,3689.17,6717.87,0.00
2024-12-08 16:55:30,77,5404,31,46,3855.03,6718.00,0.00
2024-12-08 16:55:30,78,5404,31,47,3805.61,6718.01,0.00
2024-12-08 16:55:30,77,5404,31,46,3836.71,6718.04,0.00
2024-12-08 16:55:30,77,5405,31,46,3825.07,6719.00,0.00
2024-12-08 16:55:30,78,5405,31,47,3776.03,6719.01,0.00
2024-12-08 16:55:30,77,5405,31,46,3805.87,6719.04,0.00
2024-12-08 16:55:30,77,5406,31,46,3794.22,6720.00,0.00
2024-12-08 16:55:30,78,5406,32,46,3745.57,6720.01,0.00
2024-12-08 16:55:30,77,5406,31,46,3774.15,6720.04,0.00
2024-12-08 16:55:30,76,5406,30,46,3760.99,6720.70,0.00
2024-12-08 16:55:30,76,5407,30,46,3829.32,6721.00,0.00
2024-12-08 16:55:30,77,5407,30,47,3779.59,6721.01,0.00
2024-12-08 16:55:30,76,5407,30,46,3828.44,6721.01,0.00
2024-12-08 16:55:30,75,5407,30,45,3876.80,6721.04,0.00
2024-12-08 16:55:30,76,5406,31,45,3796.77,6721.50,0.00
2024-12-08 16:55:30,76,5407,31,45,3832.72,6722.00,0.00
2024-12-08 16:55:30,77,5407,32,45,3782.94,6722.01,0.00
2024-12-08 16:55:30,76,5407,32,44,3812.38,6722.04,0.00
2024-12-08 16:55:30,75,5407,31,44,3843.49,6722.04,0.00
2024-12-08 16:55:31,75,5408,31,44,3955.89,6723.00,0.00
2024-12-08 16:55:31,76,5408,32,44,3903.84,6723.01,0.00
2024-12-08 16:55:31,75,5408,31,44,3922.79,6723.23,0.00
2024-12-08 16:55:31,75,5409,31,44,3936.99,6724.00,0.00
2024-12-08 16:55:31,76,5409,32,44,3885.19,6724.01,0.00
2024-12-08 16:55:31,76,5410,32,44,3852.33,6725.00,0.00
2024-12-08 16:55:31,77,5410,33,44,3802.30,6725.01,0.00
2024-12-08 16:55:31,76,5410,33,43,3840.83,6725.04,0.00
2024-12-08 16:55:31,75,5410,32,43,3872.20,6725.33,0.00
2024-12-08 16:55:31,74,5410,31,43,3905.73,6725.49,0.00
2024-12-08 16:55:31,74,5411,31,43,3961.83,6726.00,0.00
2024-12-08 16:55:31,75,5411,31,44,3909.00,6726.01,0.00
2024-12-08 16:55:31,74,5411,31,43,3947.29,6726.03,0.00
2024-12-08 16:55:31,74,5412,31,43,3927.86,6727.00,0.00
2024-12-08 16:55:31,75,5412,32,43,3875.49,6727.01,0.00
2024-12-08 16:55:31,74,5412,32,42,3906.95,6727.04,0.00
2024-12-08 16:55:31,74,5413,32,42,3885.14,6728.00,0.00
2024-12-08 16:55:31,75,5413,33,42,3833.34,6728.01,0.00
2024-12-08 16:55:31,74,5413,32,42,3767.57,6728.70,0.00
2024-12-08 16:55:31,74,5414,32,42,3838.75,6729.00,0.00
2024-12-08 16:55:31,75,5414,33,42,3787.56,6729.01,0.00
2024-12-08 16:55:31,74,5414,33,41,3836.02,6729.04,0.00
2024-12-08 16:55:31,74,5415,33,41,3806.09,6730.00,0.00
2024-12-08 16:55:31,75,5415,34,41,3755.34,6730.01,0.00
2024-12-08 16:55:31,75,5416,34,41,3700.18,6731.00,0.00
2024-12-08 16:55:31,76,5416,34,42,3651.49,6731.01,0.00
2024-12-08 16:55:31,75,5416,34,41,3697.49,6731.04,0.00
2024-12-08 16:55:31,74,5416,33,41,3725.63,6731.05,0.00
2024-12-08 16:55:31,73,5416,32,41,3747.97,6731.36,0.00
2024-12-08 16:55:31,73,5417,32,41,3786.12,6732.00,0.00
2024-12-08 16:55:31,74,5417,33,41,3734.95,6732.01,0.00
2024-12-08 16:55:31,73,5417,33,40,3764.91,6732.04,0.00
2024-12-08 16:55:31,74,5416,34,40,3684.19,6732.51,0.00
2024-12-08 16:55:31,73,5416,33,40,3746.99,6732.58,0.00
2024-12-08 16:55:31,73,5417,33,40,3810.96,6733.00,0.00
2024-12-08 16:55:31,74,5417,33,41,3759.46,6733.01,0.00
2024-12-08 16:55:31,73,5417,33,40,3743.86,6733.53,0.00
2024-12-08 16:55:31,73,5418,33,40,3860.44,6734.00,0.00
2024-12-08 16:55:31,74,5418,33,41,3808.27,6734.01,0.00
2024-12-08 16:55:31,73,5418,33,40,3859.51,6734.01,0.00
2024-12-08 16:55:31,72,5418,33,39,3906.58,6734.06,0.00
2024-12-08 16:55:31,72,5419,33,39,3899.67,6735.00,0.00
2024-12-08 16:55:31,73,5419,34,39,3846.25,6735.01,0.00
2024-12-08 16:55:31,72,5419,33,39,3845.51,6735.35,0.00
2024-12-08 16:55:31,72,5420,33,39,3895.57,6736.00,0.00
2024-12-08 16:55:31,73,5420,33,40,3842.21,6736.01,0.00
2024-12-08 16:55:31,72,5420,33,39,3889.03,6736.06,0.00
2024-12-08 16:55:31,72,5421,33,39,3882.11,6737.00,0.00
2024-12-08 16:55:31,73,5421,34,39,3828.93,6737.01,0.00
2024-12-08 16:55:31,72,5421,33,39,3847.55,6737.25,0.00
2024-12-08 16:55:31,72,5422,33,39,3853.68,6738.00,0.00
2024-12-08 16:55:31,73,5422,34,39,3800.89,6738.01,0.00
2024-12-08 16:55:31,74,5421,35,39,3749.52,6738.04,0.00
2024-12-08 16:55:31,73,5421,35,38,3879.37,6738.08,0.00
2024-12-08 16:55:31,74,5420,36,38,3796.19,6738.57,0.00
2024-12-08 16:55:31,74,5421,36,38,3841.15,6739.00,0.00
2024-12-08 16:55:31,75,5421,36,39,3789.93,6739.01,0.00
2024-12-08 16:55:31,74,5421,35,39,3788.76,6739.16,0.00
2024-12-08 16:55:31,74,5422,35,39,4006.06,6740.00,0.00
2024-12-08 16:55:31,75,5422,36,39,3952.64,6740.01,0.00
2024-12-08 16:55:31,74,5422,36,38,3999.70,6740.07,0.00
2024-12-08 16:55:31,73,5422,35,38,4018.50,6740.15,0.00
2024-12-08 16:55:31,73,5423,35,38,4054.15,6741.00,0.00
2024-12-08 16:55:31,74,5423,35,39,3999.36,6741.01,0.00
2024-12-08 16:55:31,73,5423,34,39,3989.56,6741.19,0.00
2024-12-08 16:55:31,74,5422,34,40,3916.66,6741.50,0.00
2024-12-08 16:55:31,73,5422,33,40,3961.21,6741.67,0.00
2024-12-08 16:55:31,73,5423,33,40,4031.66,6742.00,0.00
2024-12-08 16:55:31,74,5423,34,40,3977.18,6742.01,0.00
2024-12-08 16:55:31,73,5423,34,39,4024.29,6742.07,0.00
2024-12-08 16:55:31,72,5423,33,39,4074.88,6742.10,0.00
2024-12-08 16:55:31,71,5423,32,39,4092.72,6742.68,0.00
2024-12-08 16:55:31,71,5424,32,39,4261.07,6743.00,0.00
2024-12-08 16:55:31,72,5424,32,40,4201.89,6743.01,0.00
2024-12-08 16:55:31,72,5425,32,40,4173.48,6744.00,0.00
2024-12-08 16:55:31,73,5425,32,41,4116.31,6744.01,0.00
2024-12-08 16:55:31,72,5425,32,40,4166.01,6744.08,0.00
2024-12-08 16:55:31,72,5426,32,40,4160.98,6745.00,0.00
2024-12-08 16:55:31,73,5426,33,40,4103.98,6745.01,0.00
2024-12-08 16:55:31,72,5426,32,40,4132.90,6745.08,0.00
2024-12-08 16:55:31,72,5427,32,40,4146.61,6746.00,0.00
2024-12-08 16:55:31,73,5427,32,41,4089.80,6746.01,0.00
2024-12-08 16:55:31,72,5427,32,40,4137.26,6746.08,0.00
2024-12-08 16:55:31,72,5428,32,40,4132.23,6747.00,0.00
2024-12-08 16:55:31,73,5428,33,40,4075.62,6747.01,0.00
2024-12-08 16:55:31,73,5429,33,40,4046.65,6748.00,0.00
2024-12-08 16:55:31,74,5429,34,40,3991.96,6748.01,0.00
2024-12-08 16:55:31,73,5429,34,39,4036.50,6748.08,0.00
2024-12-08 16:55:32,73,5430,34,39,4030.61,6749.00,0.00
2024-12-08 16:55:32,74,5430,34,40,3976.14,6749.01,0.00
2024-12-08 16:55:32,73,5430,33,40,3992.76,6749.22,0.00
2024-12-08 16:55:32,74,5429,34,40,3930.66,6749.37,0.00
2024-12-08 16:55:32,74,5430,34,40,4017.78,6750.00,0.00
2024-12-08 16:55:32,75,5430,34,41,3964.21,6750.01,0.00
2024-12-08 16:55:32,75,5431,34,41,4024.20,6751.00,0.00
2024-12-08 16:55:32,76,5431,34,42,3971.25,6751.01,0.00
2024-12-08 16:55:32,75,5431,34,41,4014.31,6751.09,0.00
2024-12-08 16:55:32,74,5431,33,41,4063.11,6751.16,0.00
2024-12-08 16:55:32,74,5432,33,41,4061.85,6752.00,0.00
2024-12-08 16:55:32,75,5432,33,42,4007.69,6752.01,0.00
2024-12-08 16:55:32,74,5432,32,42,4007.21,6752.31,0.00
2024-12-08 16:55:32,73,5432,31,42,4036.44,6752.69,0.00
2024-12-08 16:55:32,73,5433,31,42,4107.93,6753.00,0.00
2024-12-08 16:55:32,74,5433,31,43,4052.41,6753.01,0.00
2024-12-08 16:55:32,75,5432,32,43,3994.79,6753.09,0.00
2024-12-08 16:55:32,74,5432,32,42,4128.82,6753.11,0.00
2024-12-08 16:55:32,74,5433,32,42,4123.93,6754.00,0.00
2024-12-08 16:55:32,75,5433,33,42,4068.95,6754.01,0.00
2024-12-08 16:55:32,74,5433,33,41,4122.12,6754.03,0.00
2024-12-08 16:55:32,74,5434,33,41,4184.79,6755.00,0.00
2024-12-08 16:55:32,75,5434,33,42,4128.99,6755.01,0.00
2024-12-08 16:55:32,74,5434,33,41,4180.25,6755.07,0.00
2024-12-08 16:55:32,73,5434,33,40,4225.36,6755.10,0.00
2024-12-08 16:55:32,73,5435,33,40,4220.39,6756.00,0.00
2024-12-08 16:55:32,74,5435,34,40,4163.36,6756.01,0.00
2024-12-08 16:55:32,73,5435,34,39,4218.55,6756.03,0.00
2024-12-08 16:55:32,73,5436,34,39,4191.59,6757.00,0.00
2024-12-08 16:55:32,74,5436,35,39,4134.94,6757.01,0.00
2024-12-08 16:55:32,73,5436,35,38,4170.33,6757.10,0.00
2024-12-08 16:55:32,73,5437,35,38,4165.36,6758.00,0.00
2024-12-08 16:55:32,74,5437,36,38,4109.07,6758.01,0.00
2024-12-08 16:55:32,75,5436,36,39,4027.30,6758.17,0.00
2024-12-08 16:55:32,75,5437,36,39,4050.18,6759.00,0.00
2024-12-08 16:55:32,76,5437,36,40,3996.89,6759.01,0.00
2024-12-08 16:55:32,75,5437,36,39,4028.59,6759.11,0.00
2024-12-08 16:55:32,75,5438,36,39,4112.97,6760.00,0.00
2024-12-08 16:55:32,76,5438,37,39,4058.85,6760.01,0.00
2024-12-08 16:55:32,75,5438,36,39,4111.18,6760.03,0.00
2024-12-08 16:55:32,74,5438,35,39,4073.06,6760.64,0.00
2024-12-08 16:55:32,74,5439,35,39,4140.04,6761.00,0.00
2024-12-08 16:55:32,75,5439,36,39,4084.83,6761.01,0.00
2024-12-08 16:55:32,74,5439,36,38,4119.97,6761.10,0.00
2024-12-08 16:55:32,75,5438,36,39,4044.45,6761.43,0.00
2024-12-08 16:55:32,75,5439,36,39,4132.67,6762.00,0.00
2024-12-08 16:55:32,76,5439,37,39,4078.29,6762.01,0.00
2024-12-08 16:55:32,76,5440,37,39,4136.42,6763.00,0.00
2024-12-08 16:55:32,77,5440,37,40,4082.70,6763.01,0.00
2024-12-08 16:55:32,76,5440,37,39,4117.76,6763.09,0.00
2024-12-08 16:55:32,77,5439,37,40,4011.27,6763.88,0.00
2024-12-08 16:55:32,76,5439,36,40,4054.10,6763.91,0.00
2024-12-08 16:55:32,76,5440,36,40,4136.95,6764.00,0.00
2024-12-08 16:55:32,77,5440,36,41,4083.22,6764.01,0.00
2024-12-08 16:55:32,77,5441,36,41,4138.15,6765.00,0.00
2024-12-08 16:55:32,78,5441,36,42,4085.10,6765.01,0.00
2024-12-08 16:55:32,77,5441,36,41,4118.86,6765.10,0.00
2024-12-08 16:55:32,76,5441,35,41,4099.26,6765.92,0.00
2024-12-08 16:55:32,76,5442,35,41,4183.01,6766.00,0.00
2024-12-08 16:55:32,77,5442,36,41,4128.68,6766.01,0.00
2024-12-08 16:55:32,78,5441,37,41,3985.34,6766.62,0.00
2024-12-08 16:55:32,78,5442,37,41,4063.89,6767.00,0.00
2024-12-08 16:55:32,79,5442,38,41,4012.45,6767.01,0.00
2024-12-08 16:55:32,78,5442,38,40,4044.84,6767.10,0.00
2024-12-08 16:55:32,78,5443,38,40,4117.26,6768.00,0.00
2024-12-08 16:55:32,79,5443,38,41,4065.15,6768.01,0.00
2024-12-08 16:55:32,78,5443,37,41,4091.28,6768.14,0.00
2024-12-08 16:55:32,77,5443,36,41,4100.24,6768.47,0.00
2024-12-08 16:55:32,77,5444,36,41,4144.10,6769.00,0.00
2024-12-08 16:55:32,78,5444,37,41,4090.98,6769.01,0.00
2024-12-08 16:55:32,77,5444,37,40,4123.05,6769.12,0.00
2024-12-08 16:55:32,77,5445,37,40,4105.44,6770.00,0.00
2024-12-08 16:55:32,78,5445,38,40,4052.81,6770.01,0.00
2024-12-08 16:55:32,77,5445,37,40,4014.33,6770.64,0.00
2024-12-08 16:55:32,76,5445,36,40,4054.30,6770.78,0.00
2024-12-08 16:55:32,76,5446,36,40,4128.42,6771.00,0.00
2024-12-08 16:55:32,77,5446,37,40,4074.81,6771.01,0.00
2024-12-08 16:55:32,76,5446,37,39,4107.97,6771.12,0.00
2024-12-08 16:55:32,76,5447,37,39,4099.57,6772.00,0.00
2024-12-08 16:55:32,77,5447,38,39,4046.33,6772.01,0.00
2024-12-08 16:55:32,77,5448,38,39,4013.47,6773.00,0.00
2024-12-08 16:55:32,78,5448,39,39,3962.02,6773.01,0.00
2024-12-08 16:55:32,77,5448,39,38,3993.28,6773.12,0.00
2024-12-08 16:55:32,77,5449,39,38,3984.04,6774.00,0.00
2024-12-08 16:55:32,78,5449,40,38,3932.96,6774.01,0.00
2024-12-08 16:55:32,78,5450,40,38,3921.13,6775.00,0.00
2024-12-08 16:55:32,79,5450,41,38,3871.50,6775.01,0.00
2024-12-08 16:55:33,79,5451,41,38,3847.34,6776.00,0.00
2024-12-08 16:55:33,80,5451,42,38,3799.25,6776.01,0.00
2024-12-08 16:55:33,79,5451,41,38,3780.08,6776.49,0.00
2024-12-08 16:55:33,78,5451,40,38,3810.22,6776.73,0.00
2024-12-08 16:55:33,78,5452,40,38,3879.07,6777.00,0.00
2024-12-08 16:55:33,79,5452,40,39,3829.97,6777.01,0.00
2024-12-08 16:55:33,78,5452,40,38,3867.81,6777.12,0.00
2024-12-08 16:55:33,78,5453,40,38,3858.93,6778.00,0.00
2024-12-08 16:55:33,79,5453,40,39,3810.08,6778.01,0.00
2024-12-08 16:55:33,80,5452,41,39,3699.06,6778.71,0.00
2024-12-08 16:55:33,80,5453,41,39,3743.77,6779.00,0.00
2024-12-08 16:55:33,81,5453,41,40,3697.55,6779.01,0.00
2024-12-08 16:55:33,80,5453,41,39,3726.85,6779.11,0.00
2024-12-08 16:55:33,80,5454,41,39,3802.44,6780.00,0.00
2024-12-08 16:55:33,81,5454,41,40,3755.50,6780.01,0.00
2024-12-08 16:55:33,80,5454,40,40,3749.93,6780.13,0.00
2024-12-08 16:55:33,80,5455,40,40,3775.71,6781.00,0.00
2024-12-08 16:55:33,81,5455,41,40,3729.09,6781.01,0.00
2024-12-08 16:55:33,80,5455,40,40,3757.26,6781.13,0.00
2024-12-08 16:55:33,80,5456,40,40,3766.04,6782.00,0.00
2024-12-08 16:55:33,81,5456,40,41,3719.54,6782.01,0.00
2024-12-08 16:55:33,80,5456,39,41,3763.51,6782.04,0.00
2024-12-08 16:55:33,79,5456,39,40,3795.71,6782.11,0.00
2024-12-08 16:55:33,79,5457,39,40,3787.62,6783.00,0.00
2024-12-08 16:55:33,80,5457,40,40,3740.28,6783.01,0.00
2024-12-08 16:55:33,79,5457,39,40,3730.14,6783.17,0.00
2024-12-08 16:55:33,79,5458,39,40,3759.83,6784.00,0.00
2024-12-08 16:55:33,80,5458,40,40,3712.84,6784.01,0.00
2024-12-08 16:55:33,79,5458,40,39,3740.12,6784.14,0.00
2024-12-08 16:55:33,79,5459,40,39,3733.76,6785.00,0.00
2024-12-08 16:55:33,80,5459,41,39,3687.09,6785.01,0.00
2024-12-08 16:55:33,79,5459,41,38,3731.36,6785.04,0.00
2024-12-08 16:55:33,78,5459,40,38,3694.82,6785.87,0.00
2024-12-08 16:55:33,78,5460,40,38,3773.22,6786.00,0.00
2024-12-08 16:55:33,79,5460,41,38,3725.46,6786.01,0.00
2024-12-08 16:55:33,78,5460,41,37,3755.85,6786.13,0.00
2024-12-08 16:55:33,78,5461,41,37,3749.41,6787.00,0.00
2024-12-08 16:55:33,79,5461,42,37,3701.95,6787.01,0.00
2024-12-08 16:55:33,79,5462,42,37,3671.76,6788.00,0.00
2024-12-08 16:55:33,80,5462,43,37,3625.86,6788.01,0.00
2024-12-08 16:55:33,79,5462,43,36,3654.60,6788.13,0.00
2024-12-08 16:55:33,78,5462,42,36,3696.93,6788.19,0.00
2024-12-08 16:55:33,78,5463,42,36,3694.81,6789.00,0.00
2024-12-08 16:55:33,79,5463,42,37,3648.04,6789.01,0.00
2024-12-08 16:55:33,78,5463,41,37,3692.21,6789.04,0.00
2024-12-08 16:55:33,77,5463,40,37,3711.11,6789.21,0.00
2024-12-08 16:55:33,77,5464,40,37,3712.67,6790.00,0.00
2024-12-08 16:55:33,78,5464,40,38,3665.08,6790.01,0.00
2024-12-08 16:55:33,77,5464,40,37,3696.83,6790.12,0.00
2024-12-08 16:55:33,76,5464,39,37,3719.46,6790.33,0.00
2024-12-08 16:55:33,76,5465,39,37,3763.67,6791.00,0.00
2024-12-08 16:55:33,77,5465,39,38,3714.79,6791.01,0.00
2024-12-08 16:55:33,76,5465,39,37,3758.33,6791.08,0.00
2024-12-08 16:55:33,75,5465,38,37,3750.52,6791.17,0.00
2024-12-08 16:55:33,75,5466,38,37,3785.44,6792.00,0.00
2024-12-08 16:55:33,76,5466,39,37,3735.63,6792.01,0.00
2024-12-08 16:55:33,76,5467,39,37,3712.17,6793.00,0.00
2024-12-08 16:55:33,77,5467,40,37,3663.96,6793.01,0.00
2024-12-08 16:55:33,76,5467,39,37,3709.50,6793.04,0.00
2024-12-08 16:55:33,75,5467,39,36,3731.83,6793.19,0.00
2024-12-08 16:55:33,75,5468,39,36,3731.42,6794.00,0.00
2024-12-08 16:55:33,76,5468,39,37,3682.32,6794.01,0.00
2024-12-08 16:55:33,76,5469,39,37,3661.70,6795.00,0.00
2024-12-08 16:55:33,77,5469,39,38,3614.15,6795.01,0.00
2024-12-08 16:55:33,76,5469,38,38,3637.33,6795.21,0.00
2024-12-08 16:55:33,76,5470,38,38,3655.68,6796.00,0.00
2024-12-08 16:55:33,77,5470,39,38,3608.21,6796.01,0.00
2024-12-08 16:55:33,76,5470,38,38,3615.49,6796.16,0.00
2024-12-08 16:55:33,75,5470,38,37,3660.08,6796.20,0.00
2024-12-08 16:55:33,75,5471,38,37,3696.81,6797.00,0.00
2024-12-08 16:55:33,76,5471,38,38,3648.17,6797.01,0.00
2024-12-08 16:55:33,76,5472,38,38,3640.89,6798.00,0.00
2024-12-08 16:55:33,77,5472,38,39,3593.60,6798.01,0.00
2024-12-08 16:55:33,76,5472,37,39,3628.42,6798.20,0.00
2024-12-08 16:55:33,77,5471,37,40,3525.07,6798.49,0.00
2024-12-08 16:55:33,77,5472,37,40,3642.73,6799.00,0.00
2024-12-08 16:55:33,78,5472,38,40,3596.02,6799.01,0.00
2024-12-08 16:55:33,78,5473,38,40,3649.64,6800.00,0.00
2024-12-08 16:55:33,79,5473,38,41,3603.45,6800.01,0.00
2024-12-08 16:55:33,78,5473,38,40,3630.52,6800.21,0.00
2024-12-08 16:55:33,77,5473,37,40,3643.90,6800.62,0.00
2024-12-08 16:55:34,77,5474,37,40,3671.56,6801.00,0.00
2024-12-08 16:55:34,78,5474,37,41,3624.49,6801.01,0.00
2024-12-08 16:55:34,77,5474,37,40,3665.40,6801.09,0.00
2024-12-08 16:55:34,76,5474,36,40,3680.82,6801.22,0.00
2024-12-08 16:55:34,76,5475,36,40,3710.72,6802.00,0.00
2024-12-08 16:55:34,77,5475,36,41,3662.52,6802.01,0.00
2024-12-08 16:55:34,76,5475,36,40,3707.15,6802.05,0.00
2024-12-08 16:55:34,76,5476,36,40,3674.43,6803.00,0.00
2024-12-08 16:55:34,77,5476,37,40,3626.71,6803.01,0.00
2024-12-08 16:55:34,76,5476,36,40,3645.02,6803.17,0.00
2024-12-08 16:55:34,76,5477,36,40,3668.02,6804.00,0.00
2024-12-08 16:55:34,77,5477,36,41,3620.39,6804.01,0.00
2024-12-08 16:55:34,76,5477,36,40,3650.15,6804.15,0.00
2024-12-08 16:55:34,75,5477,36,39,3669.15,6804.41,0.00
2024-12-08 16:55:34,75,5478,36,39,3684.06,6805.00,0.00
2024-12-08 16:55:34,76,5478,37,39,3635.59,6805.01,0.00
2024-12-08 16:55:34,75,5478,37,38,3665.95,6805.15,0.00
2024-12-08 16:55:34,76,5477,38,38,3580.37,6805.72,0.00
2024-12-08 16:55:34,76,5478,38,38,3633.44,6806.00,0.00
2024-12-08 16:55:34,77,5478,38,39,3586.25,6806.01,0.00
2024-12-08 16:55:34,76,5478,38,38,3610.19,6806.15,0.00
2024-12-08 16:55:34,76,5479,38,38,3695.77,6807.00,0.00
2024-12-08 16:55:34,77,5479,39,38,3647.78,6807.01,0.00
2024-12-08 16:55:34,77,5480,39,38,3622.96,6808.00,0.00
2024-12-08 16:55:34,78,5480,40,38,3576.51,6808.01,0.00
2024-12-08 16:55:34,77,5480,40,37,3601.77,6808.14,0.00
2024-12-08 16:55:34,76,5480,39,37,3646.49,6808.18,0.00
2024-12-08 16:55:34,76,5481,39,37,3645.19,6809.00,0.00
2024-12-08 16:55:34,77,5481,40,37,3597.85,6809.01,0.00
2024-12-08 16:55:34,76,5481,40,36,3599.50,6809.07,0.00
2024-12-08 16:55:34,76,5482,40,36,3626.01,6810.00,0.00
2024-12-08 16:55:34,77,5482,40,37,3578.92,6810.01,0.00
2024-12-08 16:55:34,76,5482,39,37,3614.08,6810.04,0.00
2024-12-08 16:55:34,75,5482,38,37,3634.16,6810.19,0.00
2024-12-08 16:55:34,75,5483,38,37,3670.07,6811.00,0.00
2024-12-08 16:55:34,76,5483,38,38,3621.78,6811.01,0.00
2024-12-08 16:55:34,75,5483,38,37,3651.01,6811.12,0.00
2024-12-08 16:55:34,75,5484,38,37,3646.08,6812.00,0.00
2024-12-08 16:55:34,76,5484,38,38,3598.11,6812.01,0.00
2024-12-08 16:55:34,77,5483,39,38,3469.65,6812.55,0.00
2024-12-08 16:55:34,77,5484,39,38,3556.69,6813.00,0.00
2024-12-08 16:55:34,78,5484,40,38,3511.09,6813.01,0.00
2024-12-08 16:55:34,77,5484,39,38,3554.93,6813.03,0.00
2024-12-08 16:55:34,76,5484,39,37,3585.58,6813.11,0.00
2024-12-08 16:55:34,75,5484,38,37,3611.27,6813.27,0.00
2024-12-08 16:55:34,75,5485,38,37,3743.46,6814.00,0.00
2024-12-08 16:55:34,76,5485,38,38,3694.20,6814.01,0.00
2024-12-08 16:55:34,75,5485,38,37,3741.64,6814.03,0.00
2024-12-08 16:55:34,75,5486,38,37,3717.62,6815.00,0.00
2024-12-08 16:55:34,76,5486,39,37,3668.70,6815.01,0.00
2024-12-08 16:55:34,75,5486,39,36,3701.28,6815.09,0.00
2024-12-08 16:55:34,75,5487,39,36,3694.53,6816.00,0.00
2024-12-08 16:55:34,76,5487,40,36,3645.92,6816.01,0.00
2024-12-08 16:55:34,75,5487,39,36,3643.31,6816.32,0.00
2024-12-08 16:55:34,75,5488,39,36,3688.28,6817.00,0.00
2024-12-08 16:55:34,76,5488,40,36,3639.75,6817.01,0.00
2024-12-08 16:55:34,75,5488,40,35,3670.12,6817.11,0.00
2024-12-08 16:55:34,75,5489,40,35,3664.28,6818.00,0.00
2024-12-08 16:55:34,76,5489,40,36,3616.06,6818.01,0.00
2024-12-08 16:55:34,75,5489,39,36,3603.65,6818.63,0.00
2024-12-08 16:55:34,75,5490,39,36,3641.10,6819.00,0.00
2024-12-08 16:55:34,76,5490,40,36,3593.19,6819.01,0.00
2024-12-08 16:55:34,76,5491,40,36,3569.28,6820.00,0.00
2024-12-08 16:55:34,77,5491,41,36,3522.93,6820.01,0.00
2024-12-08 16:55:34,78,5490,42,36,3427.21,6820.53,0.00
2024-12-08 16:55:34,77,5490,41,36,3471.84,6820.71,0.00
2024-12-08 16:55:34,77,5491,41,36,3511.76,6821.00,0.00
2024-12-08 16:55:34,78,5491,41,37,3466.74,6821.01,0.00
2024-12-08 16:55:34,77,5491,41,36,3496.72,6821.10,0.00
2024-12-08 16:55:34,77,5492,41,36,3577.84,6822.00,0.00
2024-12-08 16:55:34,78,5492,42,36,3531.97,6822.01,0.00
2024-12-08 16:55:34,79,5491,42,37,3439.04,6822.49,0.00
2024-12-08 16:55:34,79,5492,42,37,3529.25,6823.00,0.00
2024-12-08 16:55:34,80,5492,43,37,3485.14,6823.01,0.00
2024-12-08 16:55:34,79,5492,42,37,3526.67,6823.04,0.00
2024-12-08 16:55:34,78,5492,42,36,3560.51,6823.09,0.00
2024-12-08 16:55:34,79,5491,43,36,3511.14,6823.18,0.00
2024-12-08 16:55:34,78,5491,42,36,3575.68,6823.71,0.00
2024-12-08 16:55:34,78,5492,42,36,3695.75,6824.00,0.00
2024-12-08 16:55:34,79,5492,42,37,3648.97,6824.01,0.00
2024-12-08 16:55:34,78,5492,41,37,3693.14,6824.04,0.00
2024-12-08 16:55:34,77,5492,41,36,3730.47,6824.08,0.00
2024-12-08 16:55:34,78,5491,41,37,3644.41,6824.67,0.00
2024-12-08 16:55:34,78,5492,41,37,3781.17,6825.00,0.00
2024-12-08 16:55:34,79,5492,42,37,3733.31,6825.01,0.00
2024-12-08 16:55:34,78,5492,42,36,3768.93,6825.08,0.00
2024-12-08 16:55:34,77,5492,41,36,3744.05,6825.88,0.00
2024-12-08 16:55:35,77,5493,41,36,3913.45,6826.00,0.00
2024-12-08 16:55:35,78,5493,42,36,3863.27,6826.01,0.00
2024-12-08 16:55:35,77,5493,42,35,3891.06,6826.04,0.00
2024-12-08 16:55:35,78,5492,43,35,3781.09,6826.69,0.00
2024-12-08 16:55:35,78,5493,43,35,3865.36,6827.00,0.00
2024-12-08 16:55:35,79,5493,43,36,3816.44,6827.01,0.00
2024-12-08 16:55:35,78,5493,42,36,3835.66,6827.19,0.00
2024-12-08 16:55:35,78,5494,42,36,3925.77,6828.00,0.00
2024-12-08 16:55:35,79,5494,43,36,3876.08,6828.01,0.00
2024-12-08 16:55:35,78,5494,42,36,3916.05,6828.03,0.00
2024-12-08 16:55:35,77,5494,42,35,3954.50,6828.07,0.00
2024-12-08 16:55:35,76,5494,41,35,3999.39,6828.17,0.00
2024-12-08 16:55:35,76,5495,41,35,4033.17,6829.00,0.00
2024-12-08 16:55:35,77,5495,41,36,3980.79,6829.01,0.00
2024-12-08 16:55:35,76,5495,40,36,4030.33,6829.05,0.00
2024-12-08 16:55:35,76,5496,40,36,4029.86,6830.00,0.00
2024-12-08 16:55:35,77,5496,40,37,3977.52,6830.01,0.00
2024-12-08 16:55:35,76,5496,39,37,4028.06,6830.03,0.00
2024-12-08 16:55:35,76,5497,39,37,4021.76,6831.00,0.00
2024-12-08 16:55:35,77,5497,40,37,3969.53,6831.01,0.00
2024-12-08 16:55:35,76,5497,39,37,3993.04,6831.17,0.00
2024-12-08 16:55:35,76,5498,39,37,4004.18,6832.00,0.00
2024-12-08 16:55:35,77,5498,39,38,3952.18,6832.01,0.00
2024-12-08 16:55:35,77,5499,39,38,3920.87,6833.00,0.00
2024-12-08 16:55:35,78,5499,39,39,3870.60,6833.01,0.00
2024-12-08 16:55:35,77,5499,39,38,3908.45,6833.05,0.00
2024-12-08 16:55:35,76,5499,38,38,3952.72,6833.16,0.00
2024-12-08 16:55:35,75,5499,37,38,3981.83,6833.45,0.00
2024-12-08 16:55:35,74,5499,36,38,4002.04,6833.85,0.00
2024-12-08 16:55:35,74,5499,36,38,4084.36,6834.00,0.00
2024-12-08 16:55:35,75,5499,36,39,4029.90,6834.01,0.00
2024-12-08 16:55:35,74,5499,35,39,4059.43,6834.04,0.00
2024-12-08 16:55:35,75,5498,35,40,3968.41,6834.31,0.00
2024-12-08 16:55:35,76,5497,35,41,3908.27,6834.59,0.00
2024-12-08 16:55:35,76,5498,35,41,3994.93,6835.00,0.00
2024-12-08 16:55:35,77,5498,36,41,3943.05,6835.01,0.00
2024-12-08 16:55:35,76,5498,36,40,3988.64,6835.04,0.00
2024-12-08 16:55:35,75,5498,35,40,4016.30,6835.04,0.00
2024-12-08 16:55:35,75,5499,35,40,4223.11,6836.00,0.00
2024-12-08 16:55:35,76,5499,35,41,4167.54,6836.01,0.00
2024-12-08 16:55:35,75,5499,34,41,4162.98,6836.12,0.00
2024-12-08 16:55:35,75,5500,34,41,4193.77,6837.00,0.00
2024-12-08 16:55:35,76,5500,35,41,4138.59,6837.01,0.00
2024-12-08 16:55:35,75,5500,35,40,4185.57,6837.04,0.00
2024-12-08 16:55:35,74,5500,34,40,4236.61,6837.12,0.00
2024-12-08 16:55:35,75,5499,34,41,4130.89,6837.87,0.00
2024-12-08 16:55:35,75,5500,34,41,4183.90,6838.00,0.00
2024-12-08 16:55:35,76,5500,35,41,4128.85,6838.01,0.00
2024-12-08 16:55:35,75,5500,34,41,4182.99,6838.01,0.00
2024-12-08 16:55:35,75,5501,34,41,4242.93,6839.00,0.00
2024-12-08 16:55:35,76,5501,35,41,4187.10,6839.01,0.00
2024-12-08 16:55:35,75,5501,35,40,4237.46,6839.03,0.00
2024-12-08 16:55:35,75,5502,35,40,4224.78,6840.00,0.00
2024-12-08 16:55:35,76,5502,35,41,4169.19,6840.01,0.00
2024-12-08 16:55:35,76,5503,35,41,4136.78,6841.00,0.00
2024-12-08 16:55:35,77,5503,35,42,4083.06,6841.01,0.00
2024-12-08 16:55:35,76,5503,35,41,4132.28,6841.03,0.00
2024-12-08 16:55:35,76,5504,35,41,4118.10,6842.00,0.00
2024-12-08 16:55:35,77,5504,35,42,4064.61,6842.01,0.00
2024-12-08 16:55:35,76,5504,34,42,4072.19,6842.05,0.00
2024-12-08 16:55:35,75,5504,33,42,4126.18,6842.05,0.00
2024-12-08 16:55:35,74,5504,32,42,4176.23,6842.12,0.00
2024-12-08 16:55:35,74,5505,32,42,4205.99,6843.00,0.00
2024-12-08 16:55:35,75,5505,33,42,4149.91,6843.01,0.00
2024-12-08 16:55:35,74,5505,32,42,4135.39,6843.43,0.00
2024-12-08 16:55:35,74,5506,32,42,4183.10,6844.00,0.00
2024-12-08 16:55:35,75,5506,32,43,4127.32,6844.01,0.00
2024-12-08 16:55:35,74,5506,32,42,4167.38,6844.05,0.00
2024-12-08 16:55:35,74,5507,32,42,4149.70,6845.00,0.00
2024-12-08 16:55:35,75,5507,33,42,4094.37,6845.01,0.00
2024-12-08 16:55:35,74,5507,32,42,4117.38,6845.18,0.00
2024-12-08 16:55:35,74,5508,32,42,4143.19,6846.00,0.00
2024-12-08 16:55:35,75,5508,32,43,4087.95,6846.01,0.00
2024-12-08 16:55:35,74,5508,32,42,4128.40,6846.05,0.00
2024-12-08 16:55:35,73,5508,31,42,4179.36,6846.14,0.00
2024-12-08 16:55:35,73,5509,31,42,4164.71,6847.00,0.00
2024-12-08 16:55:35,74,5509,31,43,4108.43,6847.01,0.00
2024-12-08 16:55:35,73,5509,30,43,4064.41,6847.55,0.00
2024-12-08 16:55:35,73,5510,30,43,4121.44,6848.00,0.00
2024-12-08 16:55:35,74,5510,31,43,4065.75,6848.01,0.00
2024-12-08 16:55:35,73,5510,30,43,4120.51,6848.01,0.00
2024-12-08 16:55:35,72,5510,30,42,4175.83,6848.03,0.00
2024-12-08 16:55:35,71,5510,30,41,4222.12,6848.04,0.00
2024-12-08 16:55:35,70,5510,29,41,4240.53,6848.36,0.00
2024-12-08 16:55:35,71,5509,30,41,4176.99,6848.44,0.00
2024-12-08 16:55:35,71,5510,30,41,4284.41,6849.00,0.00
2024-12-08 16:55:35,72,5510,30,42,4224.91,6849.01,0.00
2024-12-08 16:55:35,72,5511,30,42,4265.10,6850.00,0.00
2024-12-08 16:55:35,73,5511,30,43,4206.68,6850.01,0.00
2024-12-08 16:55:35,72,5511,30,42,4249.89,6850.06,0.00
2024-12-08 16:55:35,71,5511,29,42,4278.89,6850.07,0.00
2024-12-08 16:55:35,71,5512,29,42,4285.65,6851.00,0.00
2024-12-08 16:55:35,72,5512,29,43,4226.13,6851.01,0.00
2024-12-08 16:55:36,71,5512,28,43,4244.19,6851.08,0.00
2024-12-08 16:55:36,70,5512,27,43,4232.85,6851.67,0.00
2024-12-08 16:55:36,70,5513,27,43,4293.37,6852.00,0.00
2024-12-08 16:55:36,71,5513,27,44,4232.90,6852.01,0.00
2024-12-08 16:55:36,70,5513,27,43,4270.89,6852.09,0.00
2024-12-08 16:55:36,70,5514,27,43,4240.86,6853.00,0.00
2024-12-08 16:55:36,71,5514,28,43,4181.13,6853.01,0.00
2024-12-08 16:55:36,72,5513,29,43,4053.08,6853.61,0.00
2024-12-08 16:55:36,71,5513,28,43,4097.85,6853.86,0.00
2024-12-08 16:55:36,71,5514,28,43,4178.76,6854.00,0.00
2024-12-08 16:55:36,72,5514,29,43,4120.72,6854.01,0.00
2024-12-08 16:55:36,71,5514,29,42,4157.55,6854.08,0.00
2024-12-08 16:55:36,72,5513,29,43,4050.80,6854.64,0.00
2024-12-08 16:55:36,71,5513,29,42,4115.01,6854.76,0.00
2024-12-08 16:55:36,71,5514,29,42,4247.05,6855.00,0.00
2024-12-08 16:55:36,72,5514,29,43,4188.07,6855.01,0.00
2024-12-08 16:55:36,71,5514,28,43,4193.44,6855.34,0.00
2024-12-08 16:55:36,70,5514,27,43,4218.15,6855.46,0.00
2024-12-08 16:55:36,70,5515,27,43,4369.22,6856.00,0.00
2024-12-08 16:55:36,71,5515,28,43,4307.68,6856.01,0.00
2024-12-08 16:55:36,70,5515,28,42,4348.67,6856.09,0.00
2024-12-08 16:55:36,70,5516,28,42,4336.80,6857.00,0.00
2024-12-08 16:55:36,71,5516,29,42,4275.71,6857.01,0.00
2024-12-08 16:55:36,71,5517,29,42,4238.89,6858.00,0.00
2024-12-08 16:55:36,72,5517,30,42,4180.01,6858.01,0.00
2024-12-08 16:55:36,71,5517,30,41,4216.70,6858.10,0.00
2024-12-08 16:55:36,72,5516,30,42,4120.75,6858.64,0.00
2024-12-08 16:55:36,72,5517,30,42,4168.17,6859.00,0.00
2024-12-08 16:55:36,73,5517,31,42,4111.08,6859.01,0.00
2024-12-08 16:55:36,72,5517,30,42,4091.88,6859.47,0.00
2024-12-08 16:55:36,72,5518,30,42,4235.23,6860.00,0.00
2024-12-08 16:55:36,73,5518,31,42,4177.22,6860.01,0.00
2024-12-08 16:55:36,72,5518,31,41,4214.30,6860.10,0.00
2024-12-08 16:55:36,73,5517,31,42,4151.90,6860.19,0.00
2024-12-08 16:55:36,73,5518,31,42,4193.71,6861.00,0.00
2024-12-08 16:55:36,74,5518,32,42,4137.04,6861.01,0.00
2024-12-08 16:55:36,74,5519,32,42,4187.79,6862.00,0.00
2024-12-08 16:55:36,75,5519,32,43,4131.96,6862.01,0.00
2024-12-08 16:55:36,74,5519,32,42,4167.42,6862.10,0.00
2024-12-08 16:55:36,73,5519,31,42,4170.57,6862.77,0.00
2024-12-08 16:55:36,73,5520,31,42,4210.59,6863.00,0.00
2024-12-08 16:55:36,74,5520,32,42,4153.69,6863.01,0.00
2024-12-08 16:55:36,74,5521,32,42,4115.71,6864.00,0.00
2024-12-08 16:55:36,75,5521,33,42,4060.84,6864.01,0.00
2024-12-08 16:55:36,74,5521,33,41,4096.26,6864.10,0.00
2024-12-08 16:55:36,75,5520,34,41,4036.19,6864.20,0.00
2024-12-08 16:55:36,74,5520,33,41,4047.26,6864.97,0.00
2024-12-08 16:55:36,74,5521,33,41,4138.19,6865.00,0.00
2024-12-08 16:55:36,75,5521,33,42,4083.01,6865.01,0.00
2024-12-08 16:55:36,74,5521,33,41,4137.26,6865.01,0.00
2024-12-08 16:55:36,74,5522,33,41,4193.68,6866.00,0.00
2024-12-08 16:55:36,75,5522,33,42,4137.77,6866.01,0.00
2024-12-08 16:55:36,74,5522,33,41,4177.00,6866.08,0.00
2024-12-08 16:55:36,73,5522,32,41,4215.30,6866.23,0.00
2024-12-08 16:55:36,73,5523,32,41,4250.59,6867.00,0.00
2024-12-08 16:55:36,74,5523,33,41,4193.15,6867.01,0.00
2024-12-08 16:55:36,74,5524,33,41,4155.95,6868.00,0.00
2024-12-08 16:55:36,75,5524,33,42,4100.54,6868.01,0.00
2024-12-08 16:55:36,74,5524,33,41,4139.26,6868.08,0.00
2024-12-08 16:55:36,74,5525,33,41,4124.29,6869.00,0.00
2024-12-08 16:55:36,75,5525,33,42,4069.30,6869.01,0.00
2024-12-08 16:55:36,76,5524,34,42,4012.16,6869.09,0.00
2024-12-08 16:55:36,76,5525,34,42,4061.35,6870.00,0.00
2024-12-08 16:55:36,77,5525,34,43,4008.61,6870.01,0.00
2024-12-08 16:55:36,77,5526,34,43,4058.98,6871.00,0.00
2024-12-08 16:55:36,78,5526,35,43,4006.94,6871.01,0.00
2024-12-08 16:55:36,77,5526,35,42,4042.05,6871.08,0.00
2024-12-08 16:55:36,76,5526,34,42,4054.21,6871.54,0.00
2024-12-08 16:55:36,75,5526,33,42,4054.42,6871.88,0.00
2024-12-08 16:55:36,75,5527,33,42,4137.90,6872.00,0.00
2024-12-08 16:55:36,76,5527,34,42,4083.46,6872.01,0.00
2024-12-08 16:55:36,76,5528,34,42,4071.38,6873.00,0.00
2024-12-08 16:55:36,77,5528,35,42,4018.50,6873.01,0.00
2024-12-08 16:55:36,77,5529,35,42,4000.68,6874.00,0.00
2024-12-08 16:55:36,78,5529,35,43,3949.39,6874.01,0.00
2024-12-08 16:55:36,77,5529,34,43,3955.54,6874.38,0.00
2024-12-08 16:55:36,76,5529,33,43,3995.97,6874.51,0.00
2024-12-08 16:55:36,76,5530,33,43,4028.60,6875.00,0.00
2024-12-08 16:55:36,77,5530,33,44,3976.28,6875.01,0.00
2024-12-08 16:55:36,77,5531,33,44,3944.71,6876.00,0.00
2024-12-08 16:55:36,78,5531,34,44,3894.14,6876.01,0.00
2024-12-08 16:55:36,77,5531,34,43,3935.80,6876.08,0.00
2024-12-08 16:55:36,76,5531,33,43,3898.86,6876.97,0.00
2024-12-08 16:55:36,76,5532,33,43,3987.55,6877.00,0.00
2024-12-08 16:55:36,77,5532,33,44,3935.76,6877.01,0.00
2024-12-08 16:55:36,76,5532,32,44,3946.61,6877.09,0.00
2024-12-08 16:55:36,75,5532,31,44,3991.94,6877.20,0.00
2024-12-08 16:55:36,74,5532,30,44,4044.96,6877.20,0.00
2024-12-08 16:55:36,75,5531,31,44,3959.19,6877.69,0.00
2024-12-08 16:55:37,75,5532,31,44,4050.23,6878.00,0.00
2024-12-08 16:55:37,76,5532,31,45,3996.94,6878.01,0.00
2024-12-08 16:55:37,75,5532,31,44,4039.25,6878.08,0.00
2024-12-08 16:55:37,75,5533,31,44,4122.83,6879.00,0.00
2024-12-08 16:55:37,76,5533,31,45,4068.58,6879.01,0.00
2024-12-08 16:55:37,76,5534,31,45,4052.80,6880.00,0.00
2024-12-08 16:55:37,77,5534,32,45,4000.16,6880.01,0.00
2024-12-08 16:55:37,76,5534,32,44,4050.99,6880.03,0.00
2024-12-08 16:55:37,75,5534,31,44,4007.54,6880.83,0.00
2024-12-08 16:55:37,75,5535,31,44,4087.50,6881.00,0.00
2024-12-08 16:55:37,76,5535,31,45,4033.72,6881.01,0.00
2024-12-08 16:55:37,75,5535,31,44,4070.10,6881.08,0.00
2024-12-08 16:55:37,75,5536,31,44,4061.47,6882.00,0.00
2024-12-08 16:55:37,76,5536,32,44,4008.03,6882.01,0.00
2024-12-08 16:55:37,75,5536,31,44,4003.81,6882.39,0.00
2024-12-08 16:55:37,75,5537,31,44,4053.80,6883.00,0.00
2024-12-08 16:55:37,76,5537,31,45,4000.46,6883.01,0.00
2024-12-08 16:55:37,75,5537,31,44,4040.98,6883.09,0.00
2024-12-08 16:55:37,74,5537,30,44,4087.26,6883.20,0.00
2024-12-08 16:55:37,74,5538,30,44,4088.28,6884.00,0.00
2024-12-08 16:55:37,75,5538,30,45,4033.77,6884.01,0.00
2024-12-08 16:55:37,75,5539,30,45,4003.15,6885.00,0.00
2024-12-08 16:55:37,76,5539,31,45,3950.47,6885.01,0.00
2024-12-08 16:55:37,75,5539,31,44,3989.71,6885.09,0.00
2024-12-08 16:55:37,75,5540,31,44,3982.91,6886.00,0.00
2024-12-08 16:55:37,76,5540,31,45,3930.51,6886.01,0.00
2024-12-08 16:55:37,75,5540,30,45,3979.50,6886.01,0.00
2024-12-08 16:55:37,74,5540,29,45,4031.42,6886.03,0.00
2024-12-08 16:55:37,73,5540,28,45,3997.53,6886.89,0.00
2024-12-08 16:55:37,73,5541,28,45,4084.40,6887.00,0.00
2024-12-08 16:55:37,74,5541,28,46,4029.21,6887.01,0.00
2024-12-08 16:55:37,73,5541,28,45,4075.00,6887.07,0.00
2024-12-08 16:55:37,74,5540,28,46,4012.52,6887.20,0.00
2024-12-08 16:55:37,74,5541,28,46,4102.06,6888.00,0.00
2024-12-08 16:55:37,75,5541,28,47,4047.37,6888.01,0.00
2024-12-08 16:55:37,74,5541,27,47,4052.76,6888.08,0.00
2024-12-08 16:55:37,74,5542,27,47,4176.21,6889.00,0.00
2024-12-08 16:55:37,75,5542,28,47,4120.52,6889.01,0.00
2024-12-08 16:55:37,74,5542,28,46,4166.93,6889.07,0.00
2024-12-08 16:55:37,74,5543,28,46,4159.12,6890.00,0.00
2024-12-08 16:55:37,75,5543,28,47,4103.67,6890.01,0.00
2024-12-08 16:55:37,74,5543,27,47,4072.82,6890.60,0.00
2024-12-08 16:55:37,74,5544,27,47,4138.31,6891.00,0.00
2024-12-08 16:55:37,75,5544,28,47,4083.13,6891.01,0.00
2024-12-08 16:55:37,74,5544,28,46,4127.16,6891.07,0.00
2024-12-08 16:55:37,74,5545,28,46,4119.35,6892.00,0.00
2024-12-08 16:55:37,75,5545,28,47,4064.42,6892.01,0.00
2024-12-08 16:55:37,75,5546,28,47,4033.77,6893.00,0.00
2024-12-08 16:55:37,76,5546,28,48,3980.69,6893.01,0.00
2024-12-08 16:55:37,75,5546,28,47,4020.93,6893.08,0.00
2024-12-08 16:55:37,76,5545,28,48,3965.31,6893.15,0.00
2024-12-08 16:55:37,75,5545,27,48,3975.18,6893.52,0.00
2024-12-08 16:55:37,75,5546,27,48,4034.35,6894.00,0.00
2024-12-08 16:55:37,76,5546,27,49,3981.27,6894.01,0.00
2024-12-08 16:55:37,75,5546,26,49,3996.66,6894.01,0.00
2024-12-08 16:55:37,75,5547,26,49,4094.69,6895.00,0.00
2024-12-08 16:55:37,76,5547,27,49,4040.82,6895.01,0.00
2024-12-08 16:55:37,75,5547,26,49,4016.78,6895.53,0.00
2024-12-08 16:55:37,75,5548,26,49,4076.90,6896.00,0.00
2024-12-08 16:55:37,76,5548,26,50,4023.25,6896.01,0.00
2024-12-08 16:55:37,75,5548,26,49,4064.05,6896.08,0.00
2024-12-08 16:55:37,75,5549,26,49,4056.34,6897.00,0.00
2024-12-08 16:55:37,76,5549,27,49,4002.96,6897.01,0.00
2024-12-08 16:55:37,76,5550,27,49,3971.78,6898.00,0.00
2024-12-08 16:55:37,77,5550,28,49,3920.20,6898.01,0.00
2024-12-08 16:55:37,76,5550,28,48,3960.91,6898.08,0.00
2024-12-08 16:55:37,77,5549,29,48,3885.43,6898.46,0.00
2024-12-08 16:55:37,77,5550,29,48,3919.87,6899.00,0.00
2024-12-08 16:55:37,78,5550,30,48,3869.61,6899.01,0.00
2024-12-08 16:55:37,79,5549,30,49,3736.98,6899.49,0.00
2024-12-08 16:55:37,79,5550,30,49,3912.02,6900.00,0.00
2024-12-08 16:55:37,80,5550,31,49,3863.12,6900.01,0.00
2024-12-08 16:55:37,79,5550,31,48,3899.35,6900.10,0.00
2024-12-08 16:55:37,78,5550,30,48,3941.82,6900.21,0.00
2024-12-08 16:55:37,78,5551,30,48,4028.21,6901.00,0.00
2024-12-08 16:55:37,79,5551,31,48,3977.22,6901.01,0.00
2024-12-08 16:55:37,79,5552,31,48,3942.71,6902.00,0.00
2024-12-08 16:55:37,80,5552,32,48,3893.42,6902.01,0.00
2024-12-08 16:55:37,79,5552,32,47,3938.36,6902.06,0.00
2024-12-08 16:55:37,78,5552,32,46,3980.01,6902.09,0.00
2024-12-08 16:55:37,77,5552,31,46,4012.49,6902.35,0.00
2024-12-08 16:55:37,76,5552,30,46,4035.55,6902.74,0.00
2024-12-08 16:55:37,76,5553,30,46,4108.43,6903.00,0.00
2024-12-08 16:55:37,77,5553,30,47,4055.07,6903.01,0.00
2024-12-08 16:55:37,78,5552,31,47,3921.32,6903.97,0.00
2024-12-08 16:55:38,78,5553,31,47,3987.75,6904.00,0.00
2024-12-08 16:55:38,79,5553,32,47,3937.27,6904.01,0.00
2024-12-08 16:55:38,79,5554,32,47,3993.12,6905.00,0.00
2024-12-08 16:55:38,80,5554,32,48,3943.20,6905.01,0.00
2024-12-08 16:55:38,79,5554,32,47,3979.16,6905.09,0.00
2024-12-08 16:55:38,78,5554,31,47,3941.19,6905.95,0.00
2024-12-08 16:55:38,78,5555,31,47,4026.22,6906.00,0.00
2024-12-08 16:55:38,79,5555,31,48,3975.26,6906.01,0.00
2024-12-08 16:55:38,78,5555,30,48,3994.42,6906.22,0.00
2024-12-08 16:55:38,79,5554,31,48,3860.26,6906.94,0.00
2024-12-08 16:55:38,79,5555,31,48,3945.13,6907.00,0.00
2024-12-08 16:55:38,80,5555,32,48,3895.82,6907.01,0.00
2024-12-08 16:55:38,79,5555,32,47,3934.67,6907.09,0.00
2024-12-08 16:55:38,79,5556,32,47,4011.11,6908.00,0.00
2024-12-08 16:55:38,80,5556,32,48,3960.97,6908.01,0.00
2024-12-08 16:55:38,81,5555,33,48,3836.93,6908.88,0.00
2024-12-08 16:55:38,81,5556,33,48,3920.63,6909.00,0.00
2024-12-08 16:55:38,82,5556,33,49,3872.82,6909.01,0.00
2024-12-08 16:55:38,81,5556,32,49,3918.09,6909.04,0.00
2024-12-08 16:55:38,80,5556,32,48,3960.17,6909.08,0.00
2024-12-08 16:55:38,80,5557,32,48,4035.00,6910.00,0.00
2024-12-08 16:55:38,81,5557,33,48,3985.18,6910.01,0.00
2024-12-08 16:55:38,80,5557,32,48,3948.88,6910.60,0.00
2024-12-08 16:55:38,80,5558,32,48,4007.94,6911.00,0.00
2024-12-08 16:55:38,81,5558,33,48,3958.46,6911.01,0.00
2024-12-08 16:55:38,80,5558,33,47,4000.19,6911.08,0.00
2024-12-08 16:55:38,81,5557,34,47,3931.29,6911.38,0.00
2024-12-08 16:55:38,81,5558,34,47,4013.64,6912.00,0.00
2024-12-08 16:55:38,82,5558,35,47,3964.69,6912.01,0.00
2024-12-08 16:55:38,82,5559,35,47,4015.01,6913.00,0.00
2024-12-08 16:55:38,83,5559,36,47,3966.63,6913.01,0.00
2024-12-08 16:55:38,82,5559,36,46,4008.29,6913.09,0.00
2024-12-08 16:55:38,83,5558,36,47,3918.66,6913.71,0.00
2024-12-08 16:55:38,83,5559,36,47,3967.85,6914.00,0.00
2024-12-08 16:55:38,84,5559,37,47,3920.61,6914.01,0.00
2024-12-08 16:55:38,83,5559,36,47,3936.26,6914.23,0.00
2024-12-08 16:55:38,84,5558,37,47,3851.87,6914.80,0.00
2024-12-08 16:55:38,83,5558,36,47,3886.70,6914.89,0.00
2024-12-08 16:55:38,83,5559,36,47,4045.90,6915.00,0.00
2024-12-08 16:55:38,84,5559,36,48,3997.74,6915.01,0.00
2024-12-08 16:55:38,83,5559,36,47,4039.26,6915.08,0.00
2024-12-08 16:55:38,83,5560,36,47,4109.82,6916.00,0.00
2024-12-08 16:55:38,84,5560,36,48,4060.89,6916.01,0.00
2024-12-08 16:55:38,84,5561,36,48,4025.70,6917.00,0.00
2024-12-08 16:55:38,85,5561,37,48,3978.34,6917.01,0.00
2024-12-08 16:55:38,84,5561,37,47,4016.98,6917.08,0.00
2024-12-08 16:55:38,84,5562,37,47,4001.59,6918.00,0.00
2024-12-08 16:55:38,85,5562,37,48,3954.51,6918.01,0.00
2024-12-08 16:55:38,84,5562,36,48,3968.26,6918.24,0.00
2024-12-08 16:55:38,83,5562,35,48,4005.28,6918.40,0.00
2024-12-08 16:55:38,82,5562,34,48,4032.39,6918.71,0.00
2024-12-08 16:55:38,82,5563,34,48,4058.54,6919.00,0.00
2024-12-08 16:55:38,83,5563,34,49,4009.64,6919.01,0.00
2024-12-08 16:55:38,84,5562,35,49,3959.44,6919.07,0.00
2024-12-08 16:55:38,83,5562,35,48,4022.33,6919.10,0.00
2024-12-08 16:55:38,84,5561,36,48,3939.28,6919.63,0.00
2024-12-08 16:55:38,85,5560,36,49,3862.59,6919.85,0.00
2024-12-08 16:55:38,85,5561,36,49,3940.07,6920.00,0.00
2024-12-08 16:55:38,86,5561,37,49,3894.26,6920.01,0.00
2024-12-08 16:55:38,85,5561,36,49,3937.64,6920.04,0.00
2024-12-08 16:55:38,84,5561,35,49,3928.36,6920.18,0.00
2024-12-08 16:55:38,84,5562,35,49,4195.00,6921.00,0.00
2024-12-08 16:55:38,85,5562,35,50,4145.65,6921.01,0.00
2024-12-08 16:55:38,84,5562,35,49,4186.51,6921.08,0.00
2024-12-08 16:55:38,84,5563,35,49,4166.70,6922.00,0.00
2024-12-08 16:55:38,85,5563,36,49,4117.68,6922.01,0.00
2024-12-08 16:55:38,84,5563,35,49,4103.59,6922.68,0.00
2024-12-08 16:55:38,84,5564,35,49,4125.02,6923.00,0.00
2024-12-08 16:55:38,85,5564,36,49,4076.49,6923.01,0.00
2024-12-08 16:55:38,84,5564,36,48,4115.15,6923.10,0.00
2024-12-08 16:55:38,84,5565,36,48,4096.50,6924.00,0.00
2024-12-08 16:55:38,85,5565,37,48,4048.31,6924.01,0.00
2024-12-08 16:55:38,84,5565,36,48,4061.88,6924.02,0.00
2024-12-08 16:55:38,85,5564,36,49,3962.21,6924.57,0.00
2024-12-08 16:55:38,84,5564,35,49,4006.84,6924.69,0.00
2024-12-08 16:55:38,84,5565,35,49,4063.43,6925.00,0.00
2024-12-08 16:55:38,85,5565,36,49,4015.62,6925.01,0.00
2024-12-08 16:55:38,84,5565,36,48,4053.56,6925.10,0.00
2024-12-08 16:55:38,84,5566,36,48,4116.55,6926.00,0.00
2024-12-08 16:55:38,85,5566,36,49,4068.12,6926.01,0.00
2024-12-08 16:55:38,84,5566,35,49,4114.09,6926.04,0.00
2024-12-08 16:55:38,85,5565,36,49,4042.90,6926.15,0.00
2024-12-08 16:55:38,85,5566,36,49,4082.98,6927.00,0.00
2024-12-08 16:55:38,86,5566,36,50,4035.50,6927.01,0.00
2024-12-08 16:55:38,85,5566,36,49,4073.22,6927.09,0.00
2024-12-08 16:55:38,84,5566,35,49,4042.55,6927.93,0.00
2024-12-08 16:55:38,84,5567,35,49,4202.60,6928.00,0.00
2024-12-08 16:55:38,85,5567,35,50,4153.15,6928.01,0.00
2024-12-08 16:55:38,86,5566,36,50,4104.86,6928.04,0.00
2024-12-08 16:55:38,87,5565,36,51,4052.98,6928.90,0.00
2024-12-08 16:55:39,87,5566,36,51,4100.05,6929.00,0.00
2024-12-08 16:55:39,88,5566,37,51,4053.46,6929.01,0.00
2024-12-08 16:55:39,87,5566,37,50,4091.33,6929.09,0.00
2024-12-08 16:55:39,86,5566,36,50,4128.50,6929.23,0.00
2024-12-08 16:55:39,87,5565,36,51,4058.13,6929.59,0.00
2024-12-08 16:55:39,88,5564,36,52,4015.85,6929.65,0.00
2024-12-08 16:55:39,89,5563,37,52,4018.46,6929.84,0.00
2024-12-08 16:55:39,89,5564,37,52,4217.13,6930.00,0.00
2024-12-08 16:55:39,90,5564,38,52,4170.27,6930.01,0.00
2024-12-08 16:55:39,90,5565,38,52,4365.54,6931.00,0.00
2024-12-08 16:55:39,91,5565,38,53,4317.56,6931.01,0.00
2024-12-08 16:55:39,91,5566,38,53,4268.90,6932.00,0.00
2024-12-08 16:55:39,92,5566,38,54,4222.50,6932.01,0.00
2024-12-08 16:55:39,92,5567,38,54,4164.59,6933.00,0.00
2024-12-08 16:55:39,93,5567,38,55,4119.81,6933.01,0.00
2024-12-08 16:55:39,92,5567,38,54,4154.82,6933.09,0.00
2024-12-08 16:55:39,91,5567,37,54,4096.14,6933.98,0.00
2024-12-08 16:55:39,91,5568,37,54,4170.82,6934.00,0.00
2024-12-08 16:55:39,92,5568,37,55,4125.49,6934.01,0.00
2024-12-08 16:55:39,92,5569,37,55,4087.55,6935.00,0.00
2024-12-08 16:55:39,93,5569,37,56,4043.60,6935.01,0.00
2024-12-08 16:55:39,92,5569,36,56,4033.36,6935.54,0.00
2024-12-08 16:55:39,92,5570,36,56,4050.68,6936.00,0.00
2024-12-08 16:55:39,93,5570,37,56,4007.13,6936.01,0.00
2024-12-08 16:55:39,92,5570,36,56,3992.36,6936.57,0.00
2024-12-08 16:55:39,92,5571,36,56,4016.77,6937.00,0.00
2024-12-08 16:55:39,93,5571,37,56,3973.58,6937.01,0.00
2024-12-08 16:55:39,93,5572,37,56,3930.95,6938.00,0.00
2024-12-08 16:55:39,94,5572,37,57,3889.14,6938.01,0.00
2024-12-08 16:55:39,93,5572,37,56,3919.04,6938.09,0.00
2024-12-08 16:55:39,92,5572,36,56,3903.89,6938.84,0.00
2024-12-08 16:55:39,92,5573,36,56,3966.09,6939.00,0.00
2024-12-08 16:55:39,93,5573,36,57,3923.44,6939.01,0.00
2024-12-08 16:55:39,94,5572,37,57,3831.37,6939.36,0.00
2024-12-08 16:55:39,94,5573,37,57,3900.86,6940.00,0.00
2024-12-08 16:55:39,95,5573,37,58,3859.80,6940.01,0.00
2024-12-08 16:55:39,94,5573,36,58,3871.61,6940.14,0.00
2024-12-08 16:55:39,93,5573,35,58,3864.38,6940.74,0.00
2024-12-08 16:55:39,94,5572,36,58,3821.07,6940.79,0.00
2024-12-08 16:55:39,94,5573,36,58,3958.01,6941.00,0.00
2024-12-08 16:55:39,95,5573,36,59,3916.34,6941.01,0.00
2024-12-08 16:55:39,94,5573,36,58,3938.09,6941.10,0.00
2024-12-08 16:55:39,93,5573,35,58,3969.30,6941.26,0.00
2024-12-08 16:55:39,94,5572,35,59,3910.21,6941.40,0.00
2024-12-08 16:55:39,94,5573,35,59,3989.58,6942.00,0.00
2024-12-08 16:55:39,95,5573,35,60,3947.59,6942.01,0.00
2024-12-08 16:55:39,94,5573,35,59,3986.65,6942.04,0.00
2024-12-08 16:55:39,93,5573,35,58,4012.35,6942.09,0.00
2024-12-08 16:55:39,92,5573,34,58,4022.04,6942.20,0.00
2024-12-08 16:55:39,92,5574,34,58,4095.09,6943.00,0.00
2024-12-08 16:55:39,93,5574,35,58,4051.06,6943.01,0.00
2024-12-08 16:55:39,92,5574,35,57,4074.74,6943.09,0.00
2024-12-08 16:55:39,91,5574,34,57,4035.99,6943.70,0.00
2024-12-08 16:55:39,91,5575,34,57,4074.93,6944.00,0.00
2024-12-08 16:55:39,92,5575,35,57,4030.64,6944.01,0.00
2024-12-08 16:55:39,92,5576,35,57,3961.86,6945.00,0.00
2024-12-08 16:55:39,93,5576,35,58,3919.26,6945.01,0.00
2024-12-08 16:55:39,94,5575,35,59,3871.68,6945.12,0.00
2024-12-08 16:55:39,95,5574,36,59,3855.37,6945.45,0.00
2024-12-08 16:55:39,94,5574,35,59,3890.11,6945.70,0.00
2024-12-08 16:55:39,95,5573,35,60,3848.44,6945.73,0.00
2024-12-08 16:55:39,94,5573,34,60,3880.20,6945.93,0.00
2024-12-08 16:55:39,94,5574,34,60,3919.42,6946.00,0.00
2024-12-08 16:55:39,95,5574,35,60,3878.17,6946.01,0.00
2024-12-08 16:55:39,94,5574,35,59,3916.48,6946.04,0.00
2024-12-08 16:55:39,94,5575,35,59,4108.37,6947.00,0.00
2024-12-08 16:55:39,95,5575,35,60,4065.12,6947.01,0.00
2024-12-08 16:55:39,96,5574,36,60,4019.90,6947.07,0.00
2024-12-08 16:55:39,95,5574,36,59,4104.62,6947.26,0.00
2024-12-08 16:55:39,95,5575,36,59,4107.86,6948.00,0.00
2024-12-08 16:55:39,96,5575,37,59,4065.07,6948.01,0.00
2024-12-08 16:55:39,95,5575,37,58,4105.91,6948.03,0.00
2024-12-08 16:55:39,94,5575,36,58,4148.85,6948.03,0.00
2024-12-08 16:55:39,94,5576,36,58,4194.17,6949.00,0.00
2024-12-08 16:55:39,95,5576,36,59,4150.02,6949.01,0.00
2024-12-08 16:55:39,95,5577,36,59,4127.33,6950.00,0.00
2024-12-08 16:55:39,96,5577,37,59,4084.34,6950.01,0.00
2024-12-08 16:55:39,96,5578,37,59,4058.53,6951.00,0.00
2024-12-08 16:55:39,97,5578,38,59,4016.69,6951.01,0.00
2024-12-08 16:55:39,98,5577,39,59,3909.02,6951.71,0.00
2024-12-08 16:55:39,98,5578,39,59,3960.32,6952.00,0.00
2024-12-08 16:55:39,99,5578,39,60,3920.31,6952.01,0.00
2024-12-08 16:55:39,100,5577,40,60,3829.84,6952.52,0.00
2024-12-08 16:55:39,100,5578,40,60,3936.36,6953.00,0.00
2024-12-08 16:55:39,101,5578,41,60,3897.39,6953.01,0.00
2024-12-08 16:55:39,100,5578,41,59,3924.55,6953.03,0.00
2024-12-08 16:55:39,100,5579,41,59,3963.56,6954.00,0.00
2024-12-08 16:55:40,101,5579,41,60,3924.32,6954.01,0.00
2024-12-08 16:55:40,102,5578,42,60,3807.26,6954.89,0.00
2024-12-08 16:55:40,102,5579,42,60,3848.37,6955.00,0.00
2024-12-08 16:55:40,103,5579,42,61,3811.00,6955.01,0.00
2024-12-08 16:55:40,102,5579,42,60,3838.15,6955.05,0.00
2024-12-08 16:55:40,101,5579,41,60,3786.21,6955.88,0.00
2024-12-08 16:55:40,101,5580,41,60,3915.77,6956.00,0.00
2024-12-08 16:55:40,102,5580,41,61,3877.38,6956.01,0.00
2024-12-08 16:55:40,101,5580,41,60,3905.45,6956.05,0.00
2024-12-08 16:55:40,100,5580,40,60,3929.27,6956.27,0.00
2024-12-08 16:55:40,99,5580,39,60,3939.20,6956.50,0.00
2024-12-08 16:55:40,99,5581,39,60,3972.57,6957.00,0.00
2024-12-08 16:55:40,100,5581,39,61,3932.85,6957.01,0.00
2024-12-08 16:55:40,99,5581,39,60,3961.34,6957.05,0.00
2024-12-08 16:55:40,98,5581,38,60,3989.70,6957.07,0.00
2024-12-08 16:55:40,98,5582,38,60,3981.87,6958.00,0.00
2024-12-08 16:55:40,99,5582,39,60,3941.65,6958.01,0.00
2024-12-08 16:55:40,98,5582,38,60,3979.76,6958.03,0.00
2024-12-08 16:55:40,97,5582,38,59,4011.46,6958.04,0.00
2024-12-08 16:55:40,96,5582,37,59,4038.82,6958.25,0.00
2024-12-08 16:55:40,95,5582,36,59,4051.30,6958.25,0.00
2024-12-08 16:55:40,94,5582,36,58,4051.46,6958.62,0.00
2024-12-08 16:55:40,94,5583,36,58,4099.15,6959.00,0.00
2024-12-08 16:55:40,95,5583,37,58,4056.00,6959.01,0.00
2024-12-08 16:55:40,94,5583,37,57,4088.06,6959.04,0.00
2024-12-08 16:55:40,95,5582,38,57,3994.87,6959.61,0.00
2024-12-08 16:55:40,96,5581,39,57,3938.98,6959.91,0.00
2024-12-08 16:55:40,96,5582,39,57,3980.84,6960.00,0.00
2024-12-08 16:55:40,97,5582,40,57,3939.80,6960.01,0.00
2024-12-08 16:55:40,96,5582,40,56,3966.35,6960.05,0.00
2024-12-08 16:55:40,97,5581,40,57,3855.82,6960.51,0.00
2024-12-08 16:55:40,98,5580,40,58,3819.10,6960.66,0.00
2024-12-08 16:55:40,98,5581,40,58,4025.14,6961.00,0.00
2024-12-08 16:55:40,99,5581,40,59,3984.48,6961.01,0.00
2024-12-08 16:55:40,98,5581,40,58,4007.40,6961.07,0.00
2024-12-08 16:55:40,98,5582,40,58,4114.74,6962.00,0.00
2024-12-08 16:55:40,99,5582,41,58,4073.18,6962.01,0.00
2024-12-08 16:55:40,98,5582,41,57,4096.29,6962.07,0.00
2024-12-08 16:55:40,97,5582,40,57,4129.19,6962.21,0.00
2024-12-08 16:55:40,97,5583,40,57,4102.95,6963.00,0.00
2024-12-08 16:55:40,98,5583,41,57,4061.08,6963.01,0.00
2024-12-08 16:55:40,97,5583,41,56,4083.58,6963.07,0.00
2024-12-08 16:55:40,96,5583,40,56,4094.00,6963.28,0.00
2024-12-08 16:55:40,96,5584,40,56,4111.96,6964.00,0.00
2024-12-08 16:55:40,97,5584,41,56,4069.57,6964.01,0.00
2024-12-08 16:55:40,96,5584,41,55,4092.40,6964.07,0.00
2024-12-08 16:55:40,95,5584,40,55,4126.16,6964.20,0.00
2024-12-08 16:55:40,95,5585,40,55,4108.30,6965.00,0.00
2024-12-08 16:55:40,96,5585,40,56,4065.50,6965.01,0.00
2024-12-08 16:55:40,96,5586,40,56,4017.77,6966.00,0.00
2024-12-08 16:55:40,97,5586,41,56,3976.35,6966.01,0.00
2024-12-08 16:55:40,98,5585,42,56,3935.07,6966.04,0.00
2024-12-08 16:55:40,97,5585,42,55,4004.68,6966.08,0.00
2024-12-08 16:55:40,98,5584,43,55,3906.05,6966.82,0.00
2024-12-08 16:55:40,98,5585,43,55,3946.16,6967.00,0.00
2024-12-08 16:55:40,99,5585,44,55,3906.30,6967.01,0.00
2024-12-08 16:55:40,98,5585,44,54,3925.86,6967.07,0.00
2024-12-08 16:55:40,97,5585,43,54,3949.16,6967.26,0.00
2024-12-08 16:55:40,97,5586,43,54,4103.11,6968.00,0.00
2024-12-08 16:55:40,98,5586,44,54,4061.24,6968.01,0.00
2024-12-08 16:55:40,97,5586,44,53,4082.98,6968.07,0.00
2024-12-08 16:55:40,97,5587,44,53,4052.43,6969.00,0.00
2024-12-08 16:55:40,98,5587,44,54,4011.08,6969.01,0.00
2024-12-08 16:55:40,97,5587,44,53,4043.00,6969.05,0.00
2024-12-08 16:55:40,96,5587,43,53,4057.63,6969.33,0.00
2024-12-08 16:55:40,97,5586,44,53,3975.65,6969.79,0.00
2024-12-08 16:55:40,97,5587,44,53,4044.02,6970.00,0.00
2024-12-08 16:55:40,98,5587,44,54,4002.75,6970.01,0.00
2024-12-08 16:55:40,97,5587,44,53,4024.64,6970.07,0.00
2024-12-08 16:55:40,96,5587,43,53,4050.59,6970.07,0.00
2024-12-08 16:55:40,95,5587,43,52,4073.71,6970.32,0.00
2024-12-08 16:55:40,95,5588,43,52,4169.98,6971.00,0.00
2024-12-08 16:55:40,96,5588,44,52,4126.54,6971.01,0.00
2024-12-08 16:55:40,95,5588,43,52,4167.79,6971.03,0.00
2024-12-08 16:55:40,96,5587,43,53,4091.78,6971.31,0.00
2024-12-08 16:55:40,96,5588,43,53,4132.55,6972.00,0.00
2024-12-08 16:55:40,97,5588,44,53,4089.95,6972.01,0.00
2024-12-08 16:55:40,96,5588,44,52,4089.25,6972.38,0.00
2024-12-08 16:55:40,96,5589,44,52,4171.92,6973.00,0.00
2024-12-08 16:55:40,97,5589,44,53,4128.91,6973.01,0.00
2024-12-08 16:55:40,96,5589,43,53,4142.93,6973.21,0.00
2024-12-08 16:55:40,96,5590,43,53,4131.08,6974.00,0.00
2024-12-08 16:55:40,97,5590,44,53,4088.49,6974.01,0.00
2024-12-08 16:55:40,96,5590,44,52,4128.91,6974.03,0.00
2024-12-08 16:55:40,95,5590,44,51,4163.57,6974.07,0.00
2024-12-08 16:55:40,96,5589,44,52,4077.24,6974.70,0.00
2024-12-08 16:55:40,97,5588,44,53,4044.61,6974.78,0.00
2024-12-08 16:55:40,97,5589,44,53,4082.90,6975.00,0.00
2024-12-08 16:55:40,98,5589,45,53,4041.24,6975.01,0.00
2024-12-08 16:55:40,97,5589,45,52,4064.23,6975.07,0.00
2024-12-08 16:55:40,96,5589,44,52,4101.61,6975.14,0.00
2024-12-08 16:55:40,95,5589,43,52,4140.91,6975.18,0.00
2024-12-08 16:55:41,96,5588,44,52,4068.27,6975.62,0.00
2024-12-08 16:55:41,96,5589,44,52,4262.46,6976.00,0.00
2024-12-08 16:55:41,97,5589,44,53,4218.51,6976.01,0.00
2024-12-08 16:55:41,97,5590,44,53,4248.12,6977.00,0.00
2024-12-08 16:55:41,98,5590,45,53,4204.78,6977.01,0.00
2024-12-08 16:55:41,97,5590,45,52,4237.36,6977.09,0.00
2024-12-08 16:55:41,96,5590,44,52,4245.07,6977.59,0.00
2024-12-08 16:55:41,96,5591,44,52,4258.53,6978.00,0.00
2024-12-08 16:55:41,97,5591,44,53,4214.63,6978.01,0.00
2024-12-08 16:55:41,96,5591,44,52,4256.36,6978.03,0.00
2024-12-08 16:55:41,95,5591,43,52,4221.74,6978.81,0.00
2024-12-08 16:55:41,95,5592,43,52,4282.14,6979.00,0.00
2024-12-08 16:55:41,96,5592,43,53,4237.53,6979.01,0.00
2024-12-08 16:55:41,95,5592,43,52,4271.88,6979.08,0.00
2024-12-08 16:55:41,96,5591,44,52,4192.86,6979.58,0.00
2024-12-08 16:55:41,95,5591,43,52,4226.92,6979.70,0.00
2024-12-08 16:55:41,95,5592,43,52,4249.31,6980.00,0.00
2024-12-08 16:55:41,96,5592,43,53,4205.05,6980.01,0.00
2024-12-08 16:55:41,95,5592,43,52,4233.17,6980.06,0.00
2024-12-08 16:55:41,96,5591,43,53,4103.77,6980.79,0.00
2024-12-08 16:55:41,96,5592,43,53,4244.11,6981.00,0.00
2024-12-08 16:55:41,97,5592,43,54,4200.36,6981.01,0.00
2024-12-08 16:55:41,98,5591,43,55,4122.11,6981.32,0.00
2024-12-08 16:55:41,97,5591,42,55,4159.53,6981.75,0.00
2024-12-08 16:55:41,97,5592,42,55,4283.27,6982.00,0.00
2024-12-08 16:55:41,98,5592,42,56,4239.56,6982.01,0.00
2024-12-08 16:55:41,97,5592,42,55,4275.37,6982.07,0.00
2024-12-08 16:55:41,97,5593,42,55,4310.40,6983.00,0.00
2024-12-08 16:55:41,98,5593,42,56,4266.42,6983.01,0.00
2024-12-08 16:55:41,98,5594,42,56,4206.67,6984.00,0.00
2024-12-08 16:55:41,99,5594,43,56,4164.18,6984.01,0.00
2024-12-08 16:55:41,98,5594,43,55,4198.85,6984.07,0.00
2024-12-08 16:55:41,97,5594,42,55,4149.14,6984.91,0.00
2024-12-08 16:55:41,97,5595,42,55,4214.75,6985.00,0.00
2024-12-08 16:55:41,98,5595,43,55,4171.74,6985.01,0.00
2024-12-08 16:55:41,97,5595,43,54,4190.82,6985.10,0.00
2024-12-08 16:55:41,98,5594,43,55,4123.29,6985.48,0.00
2024-12-08 16:55:41,97,5594,42,55,4175.44,6985.59,0.00
2024-12-08 16:55:41,97,5595,42,55,4174.35,6986.00,0.00
2024-12-08 16:55:41,98,5595,43,55,4131.75,6986.01,0.00
2024-12-08 16:55:41,97,5595,43,54,4166.02,6986.07,0.00
2024-12-08 16:55:41,97,5596,43,54,4194.26,6987.00,0.00
2024-12-08 16:55:41,98,5596,44,54,4151.46,6987.01,0.00
2024-12-08 16:55:41,99,5595,44,55,4108.83,6987.04,0.00
2024-12-08 16:55:41,98,5595,43,55,4094.89,6987.48,0.00
2024-12-08 16:55:41,97,5595,43,54,4097.15,6987.78,0.00
2024-12-08 16:55:41,97,5596,43,54,4152.38,6988.00,0.00
2024-12-08 16:55:41,98,5596,43,55,4110.01,6988.01,0.00
2024-12-08 16:55:41,97,5596,43,54,4138.28,6988.10,0.00
2024-12-08 16:55:41,97,5597,43,54,4170.83,6989.00,0.00
2024-12-08 16:55:41,98,5597,44,54,4128.27,6989.01,0.00
2024-12-08 16:55:41,97,5597,43,54,4165.96,6989.03,0.00
2024-12-08 16:55:41,98,5596,43,55,4101.37,6989.16,0.00
2024-12-08 16:55:41,97,5596,42,55,4120.58,6989.75,0.00
2024-12-08 16:55:41,97,5597,42,55,4141.47,6990.00,0.00
2024-12-08 16:55:41,98,5597,42,56,4099.21,6990.01,0.00
2024-12-08 16:55:41,97,5597,42,55,4126.89,6990.09,0.00
2024-12-08 16:55:41,97,5598,42,55,4171.03,6991.00,0.00
2024-12-08 16:55:41,98,5598,42,56,4128.47,6991.01,0.00
2024-12-08 16:55:41,98,5599,42,56,4073.03,6992.00,0.00
2024-12-08 16:55:41,99,5599,42,57,4031.89,6992.01,0.00
2024-12-08 16:55:41,98,5599,42,56,4065.78,6992.03,0.00
2024-12-08 16:55:41,97,5599,42,55,4101.21,6992.04,0.00
2024-12-08 16:55:41,96,5599,41,55,4061.96,6992.72,0.00
2024-12-08 16:55:41,96,5600,41,55,4106.00,6993.00,0.00
2024-12-08 16:55:41,97,5600,41,56,4063.67,6993.01,0.00
2024-12-08 16:55:41,96,5600,41,55,4091.91,6993.07,0.00
2024-12-08 16:55:41,97,5599,41,56,4049.01,6993.10,0.00
2024-12-08 16:55:41,96,5599,40,56,4081.09,6993.37,0.00
2024-12-08 16:55:41,96,5600,40,56,4069.26,6994.00,0.00
2024-12-08 16:55:41,97,5600,41,56,4027.31,6994.01,0.00
2024-12-08 16:55:41,98,5599,41,57,3908.07,6994.71,0.00
2024-12-08 16:55:41,97,5599,40,57,3969.68,6994.87,0.00
2024-12-08 16:55:41,97,5600,40,57,4102.67,6995.00,0.00
2024-12-08 16:55:41,98,5600,40,58,4060.81,6995.01,0.00
2024-12-08 16:55:41,97,5600,40,57,4088.43,6995.07,0.00
2024-12-08 16:55:41,97,5601,40,57,4104.63,6996.00,0.00
2024-12-08 16:55:41,98,5601,40,58,4062.74,6996.01,0.00
2024-12-08 16:55:41,97,5601,39,58,4039.94,6996.16,0.00
2024-12-08 16:55:41,96,5601,38,58,4067.10,6996.28,0.00
2024-12-08 16:55:41,96,5602,38,58,4067.53,6997.00,0.00
2024-12-08 16:55:41,97,5602,39,58,4025.60,6997.01,0.00
2024-12-08 16:55:41,98,5601,40,58,3971.90,6997.11,0.00
2024-12-08 16:55:41,98,5602,40,58,3966.93,6998.00,0.00
2024-12-08 16:55:41,99,5602,41,58,3926.86,6998.01,0.00
2024-12-08 16:55:41,98,5602,40,58,3879.71,6998.66,0.00
2024-12-08 16:55:41,98,5603,40,58,3965.17,6999.00,0.00
2024-12-08 16:55:41,99,5603,40,59,3925.12,6999.01,0.00
2024-12-08 16:55:42,98,5603,39,59,3958.86,6999.02,0.00
2024-12-08 16:55:42,98,5604,39,59,3878.89,7000.00,0.00
2024-12-08 16:55:42,99,5604,39,60,3839.71,7000.01,0.00
2024-12-08 16:55:42,98,5604,39,59,3858.82,7000.08,0.00
2024-12-08 16:55:42,97,5604,38,59,3786.37,7000.98,0.00
2024-12-08 16:55:42,97,5604,38,59,3840.25,7001.00,0.00
2024-12-08 16:55:42,98,5604,38,60,3801.06,7001.01,0.00
2024-12-08 16:55:42,97,5604,38,59,3831.57,7001.07,0.00
2024-12-08 16:55:42,97,5605,38,59,3751.59,7002.00,0.00
2024-12-08 16:55:42,98,5605,38,60,3713.31,7002.01,0.00
2024-12-08 16:55:42,97,5605,38,59,3738.41,7002.08,0.00
2024-12-08 16:55:42,96,5605,37,59,3727.87,7002.52,0.00
2024-12-08 16:55:42,97,5604,38,59,3680.84,7002.66,0.00
2024-12-08 16:55:42,96,5604,37,59,3711.30,7002.96,0.00
2024-12-08 16:55:42,96,5605,37,59,3758.38,7003.00,0.00
2024-12-08 16:55:42,97,5605,37,60,3719.63,7003.01,0.00
2024-12-08 16:55:42,96,5605,36,60,3718.70,7003.27,0.00
2024-12-08 16:55:42,97,5604,36,61,3649.63,7003.50,0.00
2024-12-08 16:55:42,98,5603,36,62,3610.73,7003.95,0.00
2024-12-08 16:55:42,98,5604,36,62,3754.48,7004.00,0.00
2024-12-08 16:55:42,99,5604,36,63,3716.56,7004.01,0.00
2024-12-08 16:55:42,100,5603,36,64,3603.05,7004.46,0.00
2024-12-08 16:55:42,100,5604,36,64,3778.99,7005.00,0.00
2024-12-08 16:55:42,101,5604,37,64,3741.57,7005.01,0.00
2024-12-08 16:55:42,100,5604,37,63,3756.24,7005.11,0.00
2024-12-08 16:55:42,99,5604,36,63,3772.44,7005.33,0.00
2024-12-08 16:55:42,98,5604,36,62,3740.27,7005.92,0.00
2024-12-08 16:55:42,98,5605,36,62,3877.59,7006.00,0.00
2024-12-08 16:55:42,99,5605,36,63,3838.42,7006.01,0.00
2024-12-08 16:55:42,100,5604,36,64,3743.32,7006.51,0.00
2024-12-08 16:55:42,99,5604,35,64,3768.05,7006.75,0.00
2024-12-08 16:55:42,99,5605,35,64,3813.83,7007.00,0.00
2024-12-08 16:55:42,100,5605,36,64,3775.69,7007.01,0.00
2024-12-08 16:55:42,99,5605,35,64,3747.18,7007.52,0.00
2024-12-08 16:55:42,98,5605,35,63,3744.82,7007.89,0.00
2024-12-08 16:55:42,98,5606,35,63,3880.06,7008.00,0.00
2024-12-08 16:55:42,99,5606,36,63,3840.87,7008.01,0.00
2024-12-08 16:55:42,98,5606,35,63,3861.48,7008.11,0.00
2024-12-08 16:55:42,98,5607,35,63,3825.30,7009.00,0.00
2024-12-08 16:55:42,99,5607,36,63,3786.66,7009.01,0.00
2024-12-08 16:55:42,98,5607,36,62,3801.20,7009.11,0.00
2024-12-08 16:55:42,99,5606,37,62,3755.75,7009.23,0.00
2024-12-08 16:55:42,99,5607,37,62,3792.55,7010.00,0.00
2024-12-08 16:55:42,100,5607,38,62,3754.63,7010.01,0.00
2024-12-08 16:55:42,99,5607,37,62,3786.88,7010.06,0.00
2024-12-08 16:55:42,98,5607,36,62,3736.43,7010.68,0.00
2024-12-08 16:55:42,98,5608,36,62,3857.57,7011.00,0.00
2024-12-08 16:55:42,99,5608,36,63,3818.61,7011.01,0.00
2024-12-08 16:55:42,98,5608,35,63,3855.43,7011.03,0.00
2024-12-08 16:55:42,97,5608,34,63,3894.45,7011.03,0.00
2024-12-08 16:55:42,98,5607,34,64,3854.71,7011.05,0.00
2024-12-08 16:55:42,97,5607,34,63,3950.93,7011.10,0.00
2024-12-08 16:55:42,96,5607,34,62,3958.45,7011.52,0.00
2024-12-08 16:55:42,96,5608,34,62,3969.03,7012.00,0.00
2024-12-08 16:55:42,97,5608,35,62,3928.11,7012.01,0.00
2024-12-08 16:55:42,96,5608,34,62,3927.42,7012.13,0.00
2024-12-08 16:55:42,97,5607,34,63,3849.37,7012.68,0.00
2024-12-08 16:55:42,97,5608,34,63,4006.12,7013.00,0.00
2024-12-08 16:55:42,98,5608,35,63,3965.24,7013.01,0.00
2024-12-08 16:55:42,97,5608,35,62,3998.91,7013.09,0.00
2024-12-08 16:55:42,97,5609,35,62,4048.82,7014.00,0.00
2024-12-08 16:55:42,98,5609,36,62,4007.51,7014.01,0.00
2024-12-08 16:55:42,98,5610,36,62,3961.85,7015.00,0.00
2024-12-08 16:55:42,99,5610,37,62,3921.83,7015.01,0.00
2024-12-08 16:55:42,98,5610,37,61,3954.91,7015.09,0.00
2024-12-08 16:55:42,97,5610,36,61,3914.26,7015.97,0.00
2024-12-08 16:55:42,97,5611,36,61,3984.44,7016.00,0.00
2024-12-08 16:55:42,98,5611,36,62,3943.78,7016.01,0.00
2024-12-08 16:55:42,97,5611,35,62,3974.13,7016.09,0.00
2024-12-08 16:55:42,97,5612,35,62,3958.94,7017.00,0.00
2024-12-08 16:55:42,98,5612,36,62,3918.55,7017.01,0.00
2024-12-08 16:55:42,97,5612,36,61,3950.59,7017.09,0.00
2024-12-08 16:55:42,97,5613,36,61,3917.57,7018.00,0.00
2024-12-08 16:55:42,98,5613,36,62,3877.60,7018.01,0.00
2024-12-08 16:55:42,97,5613,35,62,3861.12,7018.43,0.00
2024-12-08 16:55:42,97,5614,35,62,3880.43,7019.00,0.00
2024-12-08 16:55:42,98,5614,36,62,3840.83,7019.01,0.00
2024-12-08 16:55:42,97,5614,36,61,3878.98,7019.02,0.00
2024-12-08 16:55:42,96,5614,36,60,3913.05,7019.08,0.00
2024-12-08 16:55:42,95,5614,35,60,3922.80,7019.28,0.00
2024-12-08 16:55:42,96,5613,35,61,3834.09,7019.90,0.00
2024-12-08 16:55:42,96,5614,35,61,3932.08,7020.00,0.00
2024-12-08 16:55:42,97,5614,36,61,3891.54,7020.01,0.00
2024-12-08 16:55:42,96,5614,35,61,3892.60,7020.30,0.00
2024-12-08 16:55:42,96,5615,35,61,3941.68,7021.00,0.00
2024-12-08 16:55:42,97,5615,35,62,3901.05,7021.01,0.00
2024-12-08 16:55:42,98,5614,35,63,3812.87,7021.48,0.00
2024-12-08 16:55:42,99,5613,36,63,3797.11,7021.59,0.00
2024-12-08 16:55:42,99,5614,36,63,3784.54,7022.00,0.00
2024-12-08 16:55:42,100,5614,37,63,3746.69,7022.01,0.00
2024-12-08 16:55:43,101,5613,37,64,3646.80,7022.70,0.00
2024-12-08 16:55:43,100,5613,36,64,3677.71,7022.84,0.00
2024-12-08 16:55:43,100,5614,36,64,3828.13,7023.00,0.00
2024-12-08 16:55:43,101,5614,36,65,3790.22,7023.01,0.00
2024-12-08 16:55:43,100,5614,36,64,3816.90,7023.10,0.00
2024-12-08 16:55:43,101,5613,37,64,3729.67,7023.77,0.00
2024-12-08 16:55:43,100,5613,37,63,3749.26,7023.94,0.00
2024-12-08 16:55:43,99,5613,36,63,3761.74,7023.95,0.00
2024-12-08 16:55:43,99,5614,36,63,3900.12,7024.00,0.00
2024-12-08 16:55:43,100,5614,36,64,3861.12,7024.01,0.00
2024-12-08 16:55:43,99,5614,36,63,3880.27,7024.10,0.00
2024-12-08 16:55:43,98,5614,35,63,3905.60,7024.31,0.00
2024-12-08 16:55:43,99,5613,35,64,3835.22,7024.72,0.00
2024-12-08 16:55:43,99,5614,35,64,3934.63,7025.00,0.00
2024-12-08 16:55:43,100,5614,35,65,3895.29,7025.01,0.00
2024-12-08 16:55:43,99,5614,35,64,3912.65,7025.11,0.00
2024-12-08 16:55:43,99,5615,35,64,3947.03,7026.00,0.00
2024-12-08 16:55:43,100,5615,35,65,3907.56,7026.01,0.00
2024-12-08 16:55:43,99,5615,34,65,3938.29,7026.03,0.00
2024-12-08 16:55:43,98,5615,34,64,3967.91,7026.11,0.00
2024-12-08 16:55:43,99,5614,35,64,3896.81,7026.58,0.00
2024-12-08 16:55:43,99,5615,35,64,3938.62,7027.00,0.00
2024-12-08 16:55:43,100,5615,35,65,3899.24,7027.01,0.00
2024-12-08 16:55:43,99,5615,35,64,3936.50,7027.03,0.00
2024-12-08 16:55:43,98,5615,35,63,3964.48,7027.06,0.00
2024-12-08 16:55:43,99,5614,36,63,3873.52,7027.67,0.00
2024-12-08 16:55:43,99,5615,36,63,3945.70,7028.00,0.00
2024-12-08 16:55:43,100,5615,37,63,3906.24,7028.01,0.00
2024-12-08 16:55:43,99,5615,36,63,3944.99,7028.01,0.00
2024-12-08 16:55:43,98,5615,36,62,3983.59,7028.02,0.00
2024-12-08 16:55:43,97,5615,35,62,4023.93,7028.02,0.00
2024-12-08 16:55:43,96,5615,35,61,4048.28,7028.06,0.00
2024-12-08 16:55:43,96,5616,35,61,4063.10,7029.00,0.00
2024-12-08 16:55:43,97,5616,35,62,4021.21,7029.01,0.00
2024-12-08 16:55:43,96,5616,35,61,4042.55,7029.07,0.00
2024-12-08 16:55:43,95,5616,34,61,4078.45,7029.11,0.00
2024-12-08 16:55:43,94,5616,33,61,4083.67,7029.58,0.00
2024-12-08 16:55:43,93,5616,32,61,4105.00,7029.71,0.00
2024-12-08 16:55:43,93,5617,32,61,4144.15,7030.00,0.00
2024-12-08 16:55:43,94,5617,32,62,4100.07,7030.01,0.00
2024-12-08 16:55:43,93,5617,32,61,4132.50,7030.03,0.00
2024-12-08 16:55:43,92,5617,32,60,4125.04,7030.63,0.00
2024-12-08 16:55:43,92,5618,32,60,4125.17,7031.00,0.00
2024-12-08 16:55:43,93,5618,32,61,4080.81,7031.01,0.00
2024-12-08 16:55:43,94,5617,33,61,3977.15,7031.22,0.00
2024-12-08 16:55:43,94,5618,33,61,3992.87,7032.00,0.00
2024-12-08 16:55:43,95,5618,33,62,3950.84,7032.01,0.00
2024-12-08 16:55:43,94,5618,33,61,3991.36,7032.02,0.00
2024-12-08 16:55:43,93,5618,32,61,4025.96,7032.05,0.00
2024-12-08 16:55:43,92,5618,32,60,4068.96,7032.05,0.00
2024-12-08 16:55:43,93,5617,33,60,4000.19,7032.40,0.00
2024-12-08 16:55:43,92,5617,33,59,4045.63,7032.72,0.00
2024-12-08 16:55:43,91,5617,32,59,4071.06,7032.79,0.00
2024-12-08 16:55:43,92,5616,32,60,4022.28,7032.87,0.00
2024-12-08 16:55:43,92,5617,32,60,4171.99,7033.00,0.00
2024-12-08 16:55:43,93,5617,32,61,4127.13,7033.01,0.00
2024-12-08 16:55:43,94,5616,33,61,4082.49,7033.04,0.00
2024-12-08 16:55:43,93,5616,32,61,4190.83,7033.05,0.00
2024-12-08 16:55:43,93,5617,32,61,4290.04,7034.00,0.00
2024-12-08 16:55:43,94,5617,32,62,4244.40,7034.01,0.00
2024-12-08 16:55:43,93,5617,32,61,4268.08,7034.05,0.00
2024-12-08 16:55:43,94,5616,32,62,4167.94,7034.61,0.00
2024-12-08 16:55:43,94,5617,32,62,4285.26,7035.00,0.00
2024-12-08 16:55:43,95,5617,32,63,4240.15,7035.01,0.00
2024-12-08 16:55:43,94,5617,32,62,4216.59,7035.46,0.00
2024-12-08 16:55:43,94,5618,32,62,4309.78,7036.00,0.00
2024-12-08 16:55:43,95,5618,33,62,4264.41,7036.01,0.00
2024-12-08 16:55:43,95,5619,33,62,4219.23,7037.00,0.00
2024-12-08 16:55:43,96,5619,34,62,4175.28,7037.01,0.00
2024-12-08 16:55:43,96,5620,34,62,4117.46,7038.00,0.00
2024-12-08 16:55:43,97,5620,35,62,4075.01,7038.01,0.00
2024-12-08 16:55:43,96,5620,35,61,4105.00,7038.02,0.00
2024-12-08 16:55:43,97,5619,35,62,4018.99,7038.59,0.00
2024-12-08 16:55:43,96,5619,35,61,4079.58,7038.64,0.00
2024-12-08 16:55:43,96,5620,35,61,4091.91,7039.00,0.00
2024-12-08 16:55:43,97,5620,36,61,4049.73,7039.01,0.00
2024-12-08 16:55:43,96,5620,35,61,4089.71,7039.03,0.00
2024-12-08 16:55:43,95,5620,35,60,4120.16,7039.03,0.00
2024-12-08 16:55:43,96,5619,36,60,4010.78,7039.82,0.00
2024-12-08 16:55:43,96,5620,36,60,4123.86,7040.00,0.00
2024-12-08 16:55:43,97,5620,37,60,4081.34,7040.01,0.00
2024-12-08 16:55:43,96,5620,37,59,4108.14,7040.03,0.00
2024-12-08 16:55:43,95,5620,36,59,4119.07,7040.35,0.00
2024-12-08 16:55:43,96,5619,36,60,4067.43,7040.49,0.00
2024-12-08 16:55:43,96,5620,36,60,4175.96,7041.00,0.00
2024-12-08 16:55:43,97,5620,36,61,4132.91,7041.01,0.00
2024-12-08 16:55:43,96,5620,36,60,4157.77,7041.03,0.00
2024-12-08 16:55:43,95,5620,35,60,4193.54,7041.11,0.00
2024-12-08 16:55:43,94,5620,34,60,4219.50,7041.30,0.00
2024-12-08 16:55:43,94,5621,34,60,4306.27,7042.00,0.00
2024-12-08 16:55:43,95,5621,35,60,4260.94,7042.01,0.00
2024-12-08 16:55:43,95,5622,35,60,4211.46,7043.00,0.00
2024-12-08 16:55:43,96,5622,36,60,4167.59,7043.01,0.00
2024-12-08 16:55:43,96,5623,36,60,4101.90,7044.00,0.00
2024-12-08 16:55:43,97,5623,36,61,4059.61,7044.01,0.00
2024-12-08 16:55:43,96,5623,36,60,4084.48,7044.05,0.00
2024-12-08 16:55:43,95,5623,36,59,4104.85,7044.37,0.00
2024-12-08 16:55:43,95,5624,36,59,4086.57,7045.00,0.00
2024-12-08 16:55:43,96,5624,36,60,4044.00,7045.01,0.00
2024-12-08 16:55:43,95,5624,35,60,4073.47,7045.02,0.00
2024-12-08 16:55:43,94,5624,35,59,4103.32,7045.04,0.00
2024-12-08 16:55:43,95,5623,35,60,4044.64,7045.28,0.00
2024-12-08 16:55:43,94,5623,34,60,4052.77,7045.58,0.00
2024-12-08 16:55:44,94,5624,34,60,4086.60,7046.00,0.00
2024-12-08 16:55:44,95,5624,34,61,4043.58,7046.01,0.00
2024-12-08 16:55:44,94,5624,33,61,4084.12,7046.01,0.00
2024-12-08 16:55:44,93,5624,33,60,4114.41,7046.03,0.00
2024-12-08 16:55:44,92,5624,32,60,4139.99,7046.05,0.00
2024-12-08 16:55:44,91,5624,32,59,4131.64,7046.67,0.00
2024-12-08 16:55:44,91,5625,32,59,4263.53,7047.00,0.00
2024-12-08 16:55:44,92,5625,33,59,4217.19,7047.01,0.00
2024-12-08 16:55:44,91,5625,33,58,4247.28,7047.03,0.00
2024-12-08 16:55:44,90,5625,32,58,4237.39,7047.48,0.00
2024-12-08 16:55:44,89,5625,31,58,4264.28,7047.66,0.00
2024-12-08 16:55:44,89,5626,31,58,4319.98,7048.00,0.00
2024-12-08 16:55:44,90,5626,31,59,4271.98,7048.01,0.00
2024-12-08 16:55:44,89,5626,30,59,4203.67,7048.69,0.00
2024-12-08 16:55:44,89,5627,30,59,4259.27,7049.00,0.00
2024-12-08 16:55:44,90,5627,31,59,4211.95,7049.01,0.00
2024-12-08 16:55:44,89,5627,31,58,4254.54,7049.06,0.00
2024-12-08 16:55:44,88,5627,30,58,4244.74,7049.51,0.00
2024-12-08 16:55:44,87,5627,29,58,4287.24,7049.56,0.00
2024-12-08 16:55:44,86,5627,29,57,4321.27,7049.63,0.00
2024-12-08 16:55:44,87,5626,29,58,4266.79,7049.71,0.00
2024-12-08 16:55:44,87,5627,29,58,4338.42,7050.00,0.00
2024-12-08 16:55:44,88,5627,29,59,4289.12,7050.01,0.00
2024-12-08 16:55:44,89,5626,29,60,4217.21,7050.15,0.00
2024-12-08 16:55:44,89,5627,29,60,4297.40,7051.00,0.00
2024-12-08 16:55:44,90,5627,29,61,4249.65,7051.01,0.00
2024-12-08 16:55:44,89,5627,29,60,4291.08,7051.06,0.00
2024-12-08 16:55:44,90,5626,29,61,4242.62,7051.09,0.00
2024-12-08 16:55:44,89,5626,28,61,4299.93,7051.36,0.00
2024-12-08 16:55:44,89,5627,28,61,4404.65,7052.00,0.00
2024-12-08 16:55:44,90,5627,28,62,4355.71,7052.01,0.00
2024-12-08 16:55:44,90,5628,28,62,4386.24,7053.00,0.00
2024-12-08 16:55:44,91,5628,29,62,4338.03,7053.01,0.00
2024-12-08 16:55:44,90,5628,29,61,4381.55,7053.06,0.00
2024-12-08 16:55:44,89,5628,28,61,4369.29,7053.55,0.00
2024-12-08 16:55:44,89,5629,28,61,4405.56,7054.00,0.00
2024-12-08 16:55:44,90,5629,29,61,4356.61,7054.01,0.00
2024-12-08 16:55:44,91,5628,30,61,4284.75,7054.15,0.00
2024-12-08 16:55:44,90,5628,29,61,4379.46,7054.29,0.00
2024-12-08 16:55:44,91,5627,30,61,4328.25,7054.35,0.00
2024-12-08 16:55:44,91,5628,30,61,4375.35,7055.00,0.00
2024-12-08 16:55:44,92,5628,31,61,4327.80,7055.01,0.00
2024-12-08 16:55:44,91,5628,31,60,4369.18,7055.08,0.00
2024-12-08 16:55:44,91,5629,31,60,4488.80,7056.00,0.00
2024-12-08 16:55:44,92,5629,32,60,4440.01,7056.01,0.00
2024-12-08 16:55:44,91,5629,31,60,4405.62,7056.79,0.00
2024-12-08 16:55:44,91,5630,31,60,4434.26,7057.00,0.00
2024-12-08 16:55:44,92,5630,31,61,4386.06,7057.01,0.00
2024-12-08 16:55:44,91,5630,31,60,4428.08,7057.08,0.00
2024-12-08 16:55:44,90,5630,30,60,4395.47,7057.96,0.00
2024-12-08 16:55:44,90,5631,30,60,4470.79,7058.00,0.00
2024-12-08 16:55:44,91,5631,31,60,4421.66,7058.01,0.00
2024-12-08 16:55:44,91,5632,31,60,4393.56,7059.00,0.00
2024-12-08 16:55:44,92,5632,32,60,4345.81,7059.01,0.00
2024-12-08 16:55:44,92,5633,32,60,4305.16,7060.00,0.00
2024-12-08 16:55:44,93,5633,33,60,4258.87,7060.01,0.00
2024-12-08 16:55:44,94,5632,33,61,4172.53,7060.31,0.00
2024-12-08 16:55:44,94,5633,33,61,4156.52,7061.00,0.00
2024-12-08 16:55:44,95,5633,33,62,4112.77,7061.01,0.00
2024-12-08 16:55:44,96,5632,34,62,4069.19,7061.04,0.00
2024-12-08 16:55:44,96,5633,34,62,4110.29,7062.00,0.00
2024-12-08 16:55:44,97,5633,34,63,4067.91,7062.01,0.00
2024-12-08 16:55:44,96,5633,34,62,4099.28,7062.07,0.00
2024-12-08 16:55:44,96,5634,34,62,4111.78,7063.00,0.00
2024-12-08 16:55:44,97,5634,34,63,4069.39,7063.01,0.00
2024-12-08 16:55:44,96,5634,34,62,4093.42,7063.08,0.00
2024-12-08 16:55:44,95,5634,33,62,4017.54,7063.88,0.00
2024-12-08 16:55:44,95,5635,33,62,4083.81,7064.00,0.00
2024-12-08 16:55:44,96,5635,34,62,4041.27,7064.01,0.00
2024-12-08 16:55:44,95,5635,34,61,4058.50,7064.08,0.00
2024-12-08 16:55:44,94,5635,33,61,4022.02,7064.72,0.00
2024-12-08 16:55:44,95,5634,33,62,3963.72,7064.76,0.00
2024-12-08 16:55:44,95,5635,33,62,4034.57,7065.00,0.00
2024-12-08 16:55:44,96,5635,33,63,3992.55,7065.01,0.00
2024-12-08 16:55:44,95,5635,33,62,4016.76,7065.08,0.00
2024-12-08 16:55:44,94,5635,32,62,3960.08,7065.93,0.00
2024-12-08 16:55:44,94,5636,32,62,4105.21,7066.00,0.00
2024-12-08 16:55:44,95,5636,32,63,4062.00,7066.01,0.00
2024-12-08 16:55:44,94,5636,32,62,4087.95,7066.09,0.00
2024-12-08 16:55:44,93,5636,31,62,4112.24,7066.32,0.00
2024-12-08 16:55:44,92,5636,31,61,4113.00,7066.71,0.00
2024-12-08 16:55:44,92,5637,31,61,4169.32,7067.00,0.00
2024-12-08 16:55:44,93,5637,32,61,4124.49,7067.01,0.00
2024-12-08 16:55:44,92,5637,32,60,4151.68,7067.09,0.00
2024-12-08 16:55:44,91,5637,32,59,4176.02,7067.37,0.00
2024-12-08 16:55:44,91,5638,32,59,4178.67,7068.00,0.00
2024-12-08 16:55:44,92,5638,32,60,4133.25,7068.01,0.00
2024-12-08 16:55:44,91,5638,32,59,4160.83,7068.09,0.00
2024-12-08 16:55:44,91,5639,32,59,4142.70,7069.00,0.00
2024-12-08 16:55:44,92,5639,32,60,4097.67,7069.01,0.00
2024-12-08 16:55:44,91,5639,32,59,4139.61,7069.04,0.00
2024-12-08 16:55:45,91,5640,32,59,4118.63,7070.00,0.00
2024-12-08 16:55:45,92,5640,33,59,4073.87,7070.01,0.00
2024-12-08 16:55:45,92,5641,33,59,4038.49,7071.00,0.00
2024-12-08 16:55:45,93,5641,33,60,3995.06,7071.01,0.00
2024-12-08 16:55:45,93,5642,33,60,3947.86,7072.00,0.00
2024-12-08 16:55:45,94,5642,34,60,3905.86,7072.01,0.00
2024-12-08 16:55:45,95,5641,35,60,3863.26,7072.05,0.00
2024-12-08 16:55:45,94,5641,35,59,3931.47,7072.09,0.00
2024-12-08 16:55:45,93,5641,35,58,3956.98,7072.22,0.00
2024-12-08 16:55:45,94,5640,36,58,3911.88,7072.28,0.00
2024-12-08 16:55:45,93,5640,35,58,3954.06,7072.48,0.00
2024-12-08 16:55:45,93,5641,35,58,3981.86,7073.00,0.00
2024-12-08 16:55:45,94,5641,36,58,3939.50,7073.01,0.00
2024-12-08 16:55:45,93,5641,35,58,3948.86,7073.26,0.00
2024-12-08 16:55:45,92,5641,34,58,3990.25,7073.27,0.00
2024-12-08 16:55:45,92,5642,34,58,4140.54,7074.00,0.00
2024-12-08 16:55:45,93,5642,34,59,4096.02,7074.01,0.00
2024-12-08 16:55:45,92,5642,33,59,4139.77,7074.01,0.00
2024-12-08 16:55:45,92,5643,33,59,4084.68,7075.00,0.00
2024-12-08 16:55:45,93,5643,33,60,4040.76,7075.01,0.00
2024-12-08 16:55:45,92,5643,32,60,4081.63,7075.04,0.00
2024-12-08 16:55:45,93,5642,33,60,4020.25,7075.10,0.00
2024-12-08 16:55:45,92,5642,32,60,4076.93,7075.41,0.00
2024-12-08 16:55:45,91,5642,31,60,4083.47,7075.86,0.00
2024-12-08 16:55:45,91,5643,31,60,4151.24,7076.00,0.00
2024-12-08 16:55:45,92,5643,32,60,4106.12,7076.01,0.00
2024-12-08 16:55:45,91,5643,32,59,4138.85,7076.06,0.00
2024-12-08 16:55:45,91,5644,32,59,4194.31,7077.00,0.00
2024-12-08 16:55:45,92,5644,33,59,4148.72,7077.01,0.00
2024-12-08 16:55:45,91,5644,33,58,4181.89,7077.06,0.00
2024-12-08 16:55:45,90,5644,32,58,4147.29,7077.73,0.00
2024-12-08 16:55:45,90,5645,32,58,4207.28,7078.00,0.00
2024-12-08 16:55:45,91,5645,33,58,4161.05,7078.01,0.00
2024-12-08 16:55:45,91,5646,33,58,4144.47,7079.00,0.00
2024-12-08 16:55:45,92,5646,33,59,4099.42,7079.01,0.00
2024-12-08 16:55:45,91,5646,32,59,4141.38,7079.04,0.00
2024-12-08 16:55:45,91,5647,32,59,4124.73,7080.00,0.00
2024-12-08 16:55:45,92,5647,32,60,4079.89,7080.01,0.00
2024-12-08 16:55:45,92,5648,32,60,4051.89,7081.00,0.00
2024-12-08 16:55:45,93,5648,32,61,4008.32,7081.01,0.00
2024-12-08 16:55:45,93,5649,32,61,3965.22,7082.00,0.00
2024-12-08 16:55:45,94,5649,33,61,3923.03,7082.01,0.00
2024-12-08 16:55:45,93,5649,33,60,3952.30,7082.04,0.00
2024-12-08 16:55:45,92,5649,33,59,3988.07,7082.14,0.00
2024-12-08 16:55:45,91,5649,32,59,3943.44,7082.97,0.00
2024-12-08 16:55:45,91,5650,32,59,4018.96,7083.00,0.00
2024-12-08 16:55:45,92,5650,33,59,3975.28,7083.01,0.00
2024-12-08 16:55:45,91,5650,33,58,4010.43,7083.04,0.00
2024-12-08 16:55:45,92,5649,33,59,3929.38,7083.47,0.00
2024-12-08 16:55:45,92,5650,33,59,3969.62,7084.00,0.00
2024-12-08 16:55:45,93,5650,33,60,3926.94,7084.01,0.00
2024-12-08 16:55:45,92,5650,33,59,3961.18,7084.04,0.00
2024-12-08 16:55:45,91,5650,32,59,3986.35,7084.22,0.00
2024-12-08 16:55:45,90,5650,31,59,3973.90,7084.66,0.00
2024-12-08 16:55:45,90,5651,31,59,4106.19,7085.00,0.00
2024-12-08 16:55:45,91,5651,32,59,4061.07,7085.01,0.00
2024-12-08 16:55:45,91,5652,32,59,4026.86,7086.00,0.00
2024-12-08 16:55:45,92,5652,33,59,3983.09,7086.01,0.00
2024-12-08 16:55:45,91,5652,33,58,4004.98,7086.04,0.00
2024-12-08 16:55:45,91,5653,33,58,3983.92,7087.00,0.00
2024-12-08 16:55:45,92,5653,34,58,3940.62,7087.01,0.00
2024-12-08 16:55:45,91,5653,34,57,3974.27,7087.04,0.00
2024-12-08 16:55:45,91,5654,34,57,3953.36,7088.00,0.00
2024-12-08 16:55:45,92,5654,35,57,3910.39,7088.01,0.00
2024-12-08 16:55:45,91,5654,35,56,3943.08,7088.04,0.00
2024-12-08 16:55:45,91,5655,35,56,3921.45,7089.00,0.00
2024-12-08 16:55:45,92,5655,36,56,3878.82,7089.01,0.00
2024-12-08 16:55:45,93,5654,36,57,3760.96,7089.71,0.00
2024-12-08 16:55:45,93,5655,36,57,3835.14,7090.00,0.00
2024-12-08 16:55:45,94,5655,36,58,3794.34,7090.01,0.00
2024-12-08 16:55:45,95,5654,36,59,3753.42,7090.04,0.00
2024-12-08 16:55:45,94,5654,36,58,3787.29,7090.10,0.00
2024-12-08 16:55:45,95,5653,37,58,3683.57,7090.72,0.00
2024-12-08 16:55:45,95,5654,37,58,3830.07,7091.00,0.00
2024-12-08 16:55:45,96,5654,37,59,3790.17,7091.01,0.00
2024-12-08 16:55:45,95,5654,36,59,3796.40,7091.22,0.00
2024-12-08 16:55:45,94,5654,35,59,3831.87,7091.29,0.00
2024-12-08 16:55:45,93,5654,34,59,3825.17,7091.56,0.00
2024-12-08 16:55:45,93,5655,34,59,3999.89,7092.00,0.00
2024-12-08 16:55:45,94,5655,34,60,3957.33,7092.01,0.00
2024-12-08 16:55:45,93,5655,34,59,3987.96,7092.08,0.00
2024-12-08 16:55:45,93,5656,34,59,3932.59,7093.00,0.00
2024-12-08 16:55:45,94,5656,34,60,3890.75,7093.01,0.00
2024-12-08 16:55:45,93,5656,34,59,3916.60,7093.09,0.00
2024-12-08 16:55:45,92,5656,34,58,3886.35,7093.76,0.00
2024-12-08 16:55:46,92,5657,34,58,3914.00,7094.00,0.00
2024-12-08 16:55:46,93,5657,35,58,3871.91,7094.01,0.00
2024-12-08 16:55:46,93,5658,35,58,3838.38,7095.00,0.00
2024-12-08 16:55:46,94,5658,35,59,3797.55,7095.01,0.00
2024-12-08 16:55:46,94,5659,35,59,3755.32,7096.00,0.00
2024-12-08 16:55:46,95,5659,35,60,3715.79,7096.01,0.00
2024-12-08 16:55:46,94,5659,35,59,3749.34,7096.04,0.00
2024-12-08 16:55:46,93,5659,35,58,3744.95,7096.40,0.00
2024-12-08 16:55:46,93,5660,35,58,3751.19,7097.00,0.00
2024-12-08 16:55:46,94,5660,35,59,3711.29,7097.01,0.00
2024-12-08 16:55:46,95,5659,35,60,3660.34,7097.10,0.00
2024-12-08 16:55:46,96,5658,36,60,3662.22,7097.34,0.00
2024-12-08 16:55:46,97,5657,36,61,3602.72,7097.74,0.00
2024-12-08 16:55:46,97,5658,36,61,3614.76,7098.00,0.00
2024-12-08 16:55:46,98,5658,37,61,3577.88,7098.01,0.00
2024-12-08 16:55:46,97,5658,36,61,3568.32,7098.29,0.00
2024-12-08 16:55:46,97,5659,36,61,3734.92,7099.00,0.00
2024-12-08 16:55:46,98,5659,37,61,3696.81,7099.01,0.00
2024-12-08 16:55:46,99,5658,37,62,3620.88,7099.22,0.00
2024-12-08 16:55:46,98,5658,37,61,3649.91,7099.69,0.00
2024-12-08 16:55:46,98,5659,37,61,3667.13,7100.00,0.00
2024-12-08 16:55:46,99,5659,38,61,3630.09,7100.01,0.00
2024-12-08 16:55:46,98,5659,38,60,3635.05,7100.14,0.00
2024-12-08 16:55:46,97,5659,37,60,3654.70,7100.32,0.00
2024-12-08 16:55:46,97,5660,37,60,3721.34,7101.00,0.00
2024-12-08 16:55:46,98,5660,37,61,3683.37,7101.01,0.00
2024-12-08 16:55:46,97,5660,36,61,3720.11,7101.01,0.00
2024-12-08 16:55:46,96,5660,35,61,3725.99,7101.26,0.00
2024-12-08 16:55:46,95,5660,34,61,3760.37,7101.30,0.00
2024-12-08 16:55:46,94,5660,33,61,3737.40,7101.68,0.00
2024-12-08 16:55:46,94,5661,33,61,3772.85,7102.00,0.00
2024-12-08 16:55:46,95,5661,33,62,3733.14,7102.01,0.00
2024-12-08 16:55:46,94,5661,33,61,3770.60,7102.03,0.00
2024-12-08 16:55:46,93,5661,33,60,3810.38,7102.03,0.00
2024-12-08 16:55:46,93,5662,33,60,3742.32,7103.00,0.00
2024-12-08 16:55:46,94,5662,33,61,3702.50,7103.01,0.00
2024-12-08 16:55:46,93,5662,33,60,3732.40,7103.04,0.00
2024-12-08 16:55:46,92,5662,33,59,3740.06,7103.46,0.00
2024-12-08 16:55:46,91,5662,33,58,3750.34,7103.68,0.00
2024-12-08 16:55:46,90,5662,32,58,3781.78,7103.70,0.00
2024-12-08 16:55:46,89,5662,31,58,3782.89,7103.94,0.00
2024-12-08 16:55:46,89,5663,31,58,3858.76,7104.00,0.00
2024-12-08 16:55:46,90,5663,31,59,3815.88,7104.01,0.00
2024-12-08 16:55:46,89,5663,31,58,3849.99,7104.05,0.00
2024-12-08 16:55:46,88,5663,30,58,3857.01,7104.26,0.00
2024-12-08 16:55:46,88,5664,30,58,3863.18,7105.00,0.00
2024-12-08 16:55:46,89,5664,30,59,3819.77,7105.01,0.00
2024-12-08 16:55:46,88,5664,29,59,3860.97,7105.03,0.00
2024-12-08 16:55:46,87,5664,29,58,3894.74,7105.05,0.00
2024-12-08 16:55:46,88,5663,30,58,3775.65,7105.67,0.00
2024-12-08 16:55:46,88,5664,30,58,3866.90,7106.00,0.00
2024-12-08 16:55:46,89,5664,30,59,3823.45,7106.01,0.00
2024-12-08 16:55:46,88,5664,30,58,3854.00,7106.05,0.00
2024-12-08 16:55:46,87,5664,29,58,3840.45,7106.66,0.00
2024-12-08 16:55:46,86,5664,28,58,3850.42,7106.69,0.00
2024-12-08 16:55:46,85,5664,27,58,3885.64,7106.82,0.00
2024-12-08 16:55:46,85,5665,27,58,4031.81,7107.00,0.00
2024-12-08 16:55:46,86,5665,28,58,3984.93,7107.01,0.00
2024-12-08 16:55:46,85,5665,28,57,4016.77,7107.05,0.00
2024-12-08 16:55:46,84,5665,27,57,4016.54,7107.42,0.00
2024-12-08 16:55:46,84,5666,27,57,4035.74,7108.00,0.00
2024-12-08 16:55:46,85,5666,28,57,3988.26,7108.01,0.00
2024-12-08 16:55:46,84,5666,27,57,4028.14,7108.04,0.00
2024-12-08 16:55:46,83,5666,27,56,4061.26,7108.05,0.00
2024-12-08 16:55:46,84,5665,28,56,3953.87,7108.79,0.00
2024-12-08 16:55:46,84,5666,28,56,4017.68,7109.00,0.00
2024-12-08 16:55:46,85,5666,29,56,3970.42,7109.01,0.00
2024-12-08 16:55:46,84,5666,29,55,4000.77,7109.05,0.00
2024-12-08 16:55:46,85,5665,30,55,3950.38,7109.12,0.00
2024-12-08 16:55:46,84,5665,29,55,4049.94,7109.27,0.00
2024-12-08 16:55:46,84,5666,29,55,4100.70,7110.00,0.00
2024-12-08 16:55:46,85,5666,30,55,4052.46,7110.01,0.00
2024-12-08 16:55:46,84,5666,30,54,4082.94,7110.05,0.00
2024-12-08 16:55:46,83,5666,29,54,4072.63,7110.51,0.00
2024-12-08 16:55:46,84,5665,30,54,3991.24,7110.80,0.00
2024-12-08 16:55:46,83,5665,29,54,4025.24,7110.93,0.00
2024-12-08 16:55:46,83,5666,29,54,4191.49,7111.00,0.00
2024-12-08 16:55:46,84,5666,29,55,4141.59,7111.01,0.00
2024-12-08 16:55:46,83,5666,29,54,4172.66,7111.05,0.00
2024-12-08 16:55:46,82,5666,28,54,4176.04,7111.48,0.00
2024-12-08 16:55:46,82,5667,28,54,4294.18,7112.00,0.00
2024-12-08 16:55:46,83,5667,28,55,4242.44,7112.01,0.00
2024-12-08 16:55:46,82,5667,28,54,4275.11,7112.05,0.00
2024-12-08 16:55:46,81,5667,28,53,4223.36,7112.69,0.00
2024-12-08 16:55:46,81,5668,28,53,4289.49,7113.00,0.00
2024-12-08 16:55:46,82,5668,29,53,4237.18,7113.01,0.00
2024-12-08 16:55:46,83,5667,30,53,4122.16,7113.70,0.00
2024-12-08 16:55:46,84,5666,30,54,4074.82,7113.74,0.00
2024-12-08 16:55:46,84,5667,30,54,4147.36,7114.00,0.00
2024-12-08 16:55:46,85,5667,31,54,4098.57,7114.01,0.00
2024-12-08 16:55:46,85,5668,31,54,4252.90,7115.00,0.00
2024-12-08 16:55:46,86,5668,32,54,4203.45,7115.01,0.00
2024-12-08 16:55:46,86,5669,32,54,4181.00,7116.00,0.00
2024-12-08 16:55:46,87,5669,33,54,4132.94,7116.01,0.00
2024-12-08 16:55:47,87,5670,33,54,4096.78,7117.00,0.00
2024-12-08 16:55:47,88,5670,33,55,4050.23,7117.01,0.00
2024-12-08 16:55:47,87,5670,33,54,4082.90,7117.06,0.00
2024-12-08 16:55:47,87,5671,33,54,4056.56,7118.00,0.00
2024-12-08 16:55:47,88,5671,34,54,4010.46,7118.01,0.00
2024-12-08 16:55:47,87,5671,34,53,4047.28,7118.06,0.00
2024-12-08 16:55:47,86,5671,33,53,4063.85,7118.27,0.00
2024-12-08 16:55:47,87,5670,34,53,3971.72,7118.66,0.00
2024-12-08 16:55:47,87,5671,34,53,4047.29,7119.00,0.00
2024-12-08 16:55:47,88,5671,35,53,4001.30,7119.01,0.00
2024-12-08 16:55:47,89,5670,36,53,3956.34,7119.03,0.00
2024-12-08 16:55:47,88,5670,36,52,3956.04,7119.49,0.00
2024-12-08 16:55:47,88,5671,36,52,4072.76,7120.00,0.00
2024-12-08 16:55:47,89,5671,37,52,4027.00,7120.01,0.00
2024-12-08 16:55:47,89,5672,37,52,4080.25,7121.00,0.00
2024-12-08 16:55:47,90,5672,37,53,4034.92,7121.01,0.00
2024-12-08 16:55:47,91,5671,38,53,3920.79,7121.70,0.00
2024-12-08 16:55:47,91,5672,38,53,3976.38,7122.00,0.00
2024-12-08 16:55:47,92,5672,38,54,3933.16,7122.01,0.00
2024-12-08 16:55:47,91,5672,38,53,3974.05,7122.03,0.00
2024-12-08 16:55:47,90,5672,38,52,4000.81,7122.10,0.00
2024-12-08 16:55:47,90,5673,38,52,4055.22,7123.00,0.00
2024-12-08 16:55:47,91,5673,39,52,4010.66,7123.01,0.00
2024-12-08 16:55:47,90,5673,39,51,4036.35,7123.10,0.00
2024-12-08 16:55:47,89,5673,38,51,4052.19,7123.40,0.00
2024-12-08 16:55:47,89,5674,38,51,4090.25,7124.00,0.00
2024-12-08 16:55:47,90,5674,38,52,4044.80,7124.01,0.00
2024-12-08 16:55:47,89,5674,38,51,4069.47,7124.10,0.00
2024-12-08 16:55:47,90,5673,38,52,3918.87,7124.52,0.00
2024-12-08 16:55:47,90,5674,38,52,3990.50,7125.00,0.00
2024-12-08 16:55:47,91,5674,39,52,3946.65,7125.01,0.00
2024-12-08 16:55:47,90,5674,39,51,3967.57,7125.10,0.00
2024-12-08 16:55:47,89,5674,39,50,3979.71,7125.47,0.00
2024-12-08 16:55:47,90,5673,40,50,3880.32,7125.82,0.00
2024-12-08 16:55:47,90,5674,40,50,4034.85,7126.00,0.00
2024-12-08 16:55:47,91,5674,40,51,3990.51,7126.01,0.00
2024-12-08 16:55:47,91,5675,40,51,4030.23,7127.00,0.00
2024-12-08 16:55:47,92,5675,40,52,3986.43,7127.01,0.00
2024-12-08 16:55:47,91,5675,40,51,4019.30,7127.13,0.00
2024-12-08 16:55:47,90,5675,39,51,4039.49,7127.37,0.00
2024-12-08 16:55:47,90,5676,39,51,4074.00,7128.00,0.00
2024-12-08 16:55:47,91,5676,40,51,4029.23,7128.01,0.00
2024-12-08 16:55:47,92,5675,40,52,3935.07,7128.52,0.00
2024-12-08 16:55:47,92,5676,40,52,3958.69,7129.00,0.00
2024-12-08 16:55:47,93,5676,41,52,3916.12,7129.01,0.00
2024-12-08 16:55:47,92,5676,41,51,3952.51,7129.04,0.00
2024-12-08 16:55:47,92,5677,41,51,4008.11,7130.00,0.00
2024-12-08 16:55:47,93,5677,41,52,3965.02,7130.01,0.00
2024-12-08 16:55:47,92,5677,41,51,3998.84,7130.13,0.00
2024-12-08 16:55:47,92,5678,41,51,3982.62,7131.00,0.00
2024-12-08 16:55:47,93,5678,42,51,3939.79,7131.01,0.00
2024-12-08 16:55:47,92,5678,41,51,3965.57,7131.02,0.00
2024-12-08 16:55:47,91,5678,41,50,3985.66,7131.12,0.00
2024-12-08 16:55:47,91,5679,41,50,3999.03,7132.00,0.00
2024-12-08 16:55:47,92,5679,42,50,3955.56,7132.01,0.00
2024-12-08 16:55:47,91,5679,42,49,3977.10,7132.11,0.00
2024-12-08 16:55:47,91,5680,42,49,3956.24,7133.00,0.00
2024-12-08 16:55:47,92,5680,43,49,3913.24,7133.01,0.00
2024-12-08 16:55:47,91,5680,43,48,3934.32,7133.11,0.00
2024-12-08 16:55:47,90,5680,43,47,3977.96,7133.11,0.00
2024-12-08 16:55:47,89,5680,42,47,4012.29,7133.26,0.00
2024-12-08 16:55:47,90,5679,43,47,3947.13,7133.54,0.00
2024-12-08 16:55:47,90,5680,43,47,3980.41,7134.00,0.00
2024-12-08 16:55:47,91,5680,43,48,3936.67,7134.01,0.00
2024-12-08 16:55:47,90,5680,43,47,3978.05,7134.03,0.00
2024-12-08 16:55:47,89,5680,43,46,4021.94,7134.03,0.00
2024-12-08 16:55:47,88,5680,42,46,4012.55,7134.19,0.00
2024-12-08 16:55:47,89,5679,42,47,3951.07,7134.42,0.00
2024-12-08 16:55:47,89,5680,42,47,4065.64,7135.00,0.00
2024-12-08 16:55:47,90,5680,42,48,4020.47,7135.01,0.00
2024-12-08 16:55:47,89,5680,42,47,4063.25,7135.03,0.00
2024-12-08 16:55:47,88,5680,42,46,4103.75,7135.08,0.00
2024-12-08 16:55:47,87,5680,41,46,4124.75,7135.29,0.00
2024-12-08 16:55:47,88,5679,41,47,4066.45,7135.43,0.00
2024-12-08 16:55:47,89,5678,41,48,4086.87,7135.57,0.00
2024-12-08 16:55:47,90,5677,41,49,4048.73,7135.78,0.00
2024-12-08 16:55:47,90,5678,41,49,4250.00,7136.00,0.00
2024-12-08 16:55:47,91,5678,41,50,4203.30,7136.01,0.00
2024-12-08 16:55:47,92,5677,41,51,4097.54,7136.62,0.00
2024-12-08 16:55:47,92,5678,41,51,4393.95,7137.00,0.00
2024-12-08 16:55:47,93,5678,41,52,4346.70,7137.01,0.00
2024-12-08 16:55:47,92,5678,41,51,4384.66,7137.09,0.00
2024-12-08 16:55:47,91,5678,40,51,4350.56,7137.84,0.00
2024-12-08 16:55:47,91,5679,40,51,4495.81,7138.00,0.00
2024-12-08 16:55:47,92,5679,41,51,4446.94,7138.01,0.00
2024-12-08 16:55:47,91,5679,40,51,4493.47,7138.03,0.00
2024-12-08 16:55:47,92,5678,41,51,4401.96,7138.38,0.00
2024-12-08 16:55:47,92,5679,41,51,4417.01,7139.00,0.00
2024-12-08 16:55:47,93,5679,42,51,4369.52,7139.01,0.00
2024-12-08 16:55:47,92,5679,42,50,4408.50,7139.09,0.00
2024-12-08 16:55:47,92,5680,42,50,4441.31,7140.00,0.00
2024-12-08 16:55:47,93,5680,42,51,4393.55,7140.01,0.00
2024-12-08 16:55:47,92,5680,41,51,4361.39,7140.73,0.00
2024-12-08 16:55:48,92,5681,41,51,4373.76,7141.00,0.00
2024-12-08 16:55:48,93,5681,42,51,4326.73,7141.01,0.00
2024-12-08 16:55:48,92,5681,42,50,4366.01,7141.09,0.00
2024-12-08 16:55:48,93,5680,42,51,4291.44,7141.41,0.00
2024-12-08 16:55:48,92,5680,42,50,4338.90,7141.74,0.00
2024-12-08 16:55:48,92,5681,42,50,4367.05,7142.00,0.00
2024-12-08 16:55:48,93,5681,42,51,4320.10,7142.01,0.00
2024-12-08 16:55:48,93,5682,42,51,4359.44,7143.00,0.00
2024-12-08 16:55:48,94,5682,43,51,4313.06,7143.01,0.00
2024-12-08 16:55:48,94,5683,43,51,4265.81,7144.00,0.00
2024-12-08 16:55:48,95,5683,43,52,4220.91,7144.01,0.00
2024-12-08 16:55:48,94,5683,42,52,4261.56,7144.06,0.00
2024-12-08 16:55:48,93,5683,42,51,4302.00,7144.08,0.00
2024-12-08 16:55:48,94,5682,42,52,4250.94,7144.17,0.00
2024-12-08 16:55:48,94,5683,42,52,4279.04,7145.00,0.00
2024-12-08 16:55:48,95,5683,42,53,4233.99,7145.01,0.00
2024-12-08 16:55:48,94,5683,42,52,4258.53,7145.08,0.00
2024-12-08 16:55:48,93,5683,42,51,4292.35,7145.22,0.00
2024-12-08 16:55:48,92,5683,41,51,4305.13,7145.69,0.00
2024-12-08 16:55:48,92,5684,41,51,4407.13,7146.00,0.00
2024-12-08 16:55:48,93,5684,42,51,4359.74,7146.01,0.00
2024-12-08 16:55:48,92,5684,42,50,4404.81,7146.03,0.00
2024-12-08 16:55:48,91,5684,41,50,4427.34,7146.17,0.00
2024-12-08 16:55:48,92,5683,41,51,4292.03,7146.85,0.00
2024-12-08 16:55:48,92,5684,41,51,4366.74,7147.00,0.00
2024-12-08 16:55:48,93,5684,42,51,4319.78,7147.01,0.00
2024-12-08 16:55:48,92,5684,41,51,4364.42,7147.03,0.00
2024-12-08 16:55:48,93,5683,42,51,4266.64,7147.31,0.00
2024-12-08 16:55:48,93,5684,42,51,4377.04,7148.00,0.00
2024-12-08 16:55:48,94,5684,42,52,4330.47,7148.01,0.00
2024-12-08 16:55:48,93,5684,42,51,4359.37,7148.03,0.00
2024-12-08 16:55:48,94,5683,43,51,4254.96,7148.63,0.00
2024-12-08 16:55:48,94,5684,43,51,4380.14,7149.00,0.00
2024-12-08 16:55:48,95,5684,44,51,4334.03,7149.01,0.00
2024-12-08 16:55:48,96,5683,44,52,4288.89,7149.03,0.00
2024-12-08 16:55:48,95,5683,44,51,4307.83,7149.26,0.00
2024-12-08 16:55:48,95,5684,44,51,4376.10,7150.00,0.00
2024-12-08 16:55:48,96,5684,44,52,4330.52,7150.01,0.00
2024-12-08 16:55:48,95,5684,44,51,4367.84,7150.02,0.00
2024-12-08 16:55:48,94,5684,44,50,4412.78,7150.03,0.00
2024-12-08 16:55:48,93,5684,43,50,4453.34,7150.13,0.00
2024-12-08 16:55:48,92,5684,42,50,4500.20,7150.14,0.00
2024-12-08 16:55:48,91,5684,41,50,4513.61,7150.64,0.00
2024-12-08 16:55:48,91,5685,41,50,4613.69,7151.00,0.00
2024-12-08 16:55:48,92,5685,41,51,4563.54,7151.01,0.00
2024-12-08 16:55:48,91,5685,41,50,4597.98,7151.03,0.00
2024-12-08 16:55:48,90,5685,40,50,4614.13,7151.11,0.00
2024-12-08 16:55:48,90,5686,40,50,4629.46,7152.00,0.00
2024-12-08 16:55:48,91,5686,40,51,4578.59,7152.01,0.00
2024-12-08 16:55:48,90,5686,40,50,4613.58,7152.03,0.00
2024-12-08 16:55:48,91,5685,40,51,4553.51,7152.19,0.00
2024-12-08 16:55:48,92,5684,41,51,4458.78,7152.88,0.00
2024-12-08 16:55:48,92,5685,41,51,4533.52,7153.00,0.00
2024-12-08 16:55:48,93,5685,41,52,4484.77,7153.01,0.00
2024-12-08 16:55:48,92,5685,41,51,4517.20,7153.03,0.00
2024-12-08 16:55:48,91,5685,40,51,4494.43,7153.60,0.00
2024-12-08 16:55:48,91,5686,40,51,4700.50,7154.00,0.00
2024-12-08 16:55:48,92,5686,40,52,4649.41,7154.01,0.00
2024-12-08 16:55:48,91,5686,39,52,4699.03,7154.02,0.00
2024-12-08 16:55:48,90,5686,38,52,4750.89,7154.02,0.00
2024-12-08 16:55:48,90,5687,38,52,4733.05,7155.00,0.00
2024-12-08 16:55:48,91,5687,39,52,4681.03,7155.01,0.00
2024-12-08 16:55:48,91,5688,39,52,4655.92,7156.00,0.00
2024-12-08 16:55:48,92,5688,40,52,4605.31,7156.01,0.00
2024-12-08 16:55:48,92,5689,40,52,4550.79,7157.00,0.00
2024-12-08 16:55:48,93,5689,41,52,4501.86,7157.01,0.00
2024-12-08 16:55:48,94,5688,41,53,4421.08,7157.27,0.00
2024-12-08 16:55:48,94,5689,41,53,4455.08,7158.00,0.00
2024-12-08 16:55:48,95,5689,41,54,4408.18,7158.01,0.00
2024-12-08 16:55:48,94,5689,41,53,4448.24,7158.03,0.00
2024-12-08 16:55:48,94,5690,41,53,4454.14,7159.00,0.00
2024-12-08 16:55:48,95,5690,41,54,4407.25,7159.01,0.00
2024-12-08 16:55:48,96,5689,41,55,4360.61,7159.04,0.00
2024-12-08 16:55:48,95,5689,41,54,4466.81,7159.04,0.00
2024-12-08 16:55:48,94,5689,41,53,4453.63,7159.78,0.00
2024-12-08 16:55:48,94,5690,41,53,4483.50,7160.00,0.00
2024-12-08 16:55:48,95,5690,42,53,4436.30,7160.01,0.00
2024-12-08 16:55:48,95,5691,42,53,4465.33,7161.00,0.00
2024-12-08 16:55:48,96,5691,43,53,4418.82,7161.01,0.00
2024-12-08 16:55:48,96,5692,43,53,4371.81,7162.00,0.00
2024-12-08 16:55:48,97,5692,44,53,4326.74,7162.01,0.00
2024-12-08 16:55:48,96,5692,44,52,4365.01,7162.04,0.00
2024-12-08 16:55:48,95,5692,43,52,4362.09,7162.47,0.00
2024-12-08 16:55:48,96,5691,44,52,4307.78,7162.62,0.00
2024-12-08 16:55:49,96,5692,44,52,4359.59,7163.00,0.00
2024-12-08 16:55:49,97,5692,44,53,4314.65,7163.01,0.00
2024-12-08 16:55:49,97,5693,44,53,4349.37,7164.00,0.00
2024-12-08 16:55:49,98,5693,45,53,4304.99,7164.01,0.00
2024-12-08 16:55:49,97,5693,45,52,4347.18,7164.03,0.00
2024-12-08 16:55:49,97,5694,45,52,4298.97,7165.00,0.00
2024-12-08 16:55:49,98,5694,45,53,4255.10,7165.01,0.00
2024-12-08 16:55:49,97,5694,45,52,4290.86,7165.03,0.00
2024-12-08 16:55:49,98,5693,45,53,4244.17,7165.09,0.00
2024-12-08 16:55:49,97,5693,44,53,4210.33,7165.97,0.00
2024-12-08 16:55:49,97,5694,44,53,4282.01,7166.00,0.00
2024-12-08 16:55:49,98,5694,45,53,4238.32,7166.01,0.00
2024-12-08 16:55:49,99,5693,46,53,4178.83,7166.06,0.00
2024-12-08 16:55:49,98,5693,46,52,4210.91,7166.67,0.00
2024-12-08 16:55:49,98,5694,46,52,4303.04,7167.00,0.00
2024-12-08 16:55:49,99,5694,46,53,4259.57,7167.01,0.00
2024-12-08 16:55:49,98,5694,46,52,4295.72,7167.03,0.00
2024-12-08 16:55:49,97,5694,45,52,4261.32,7167.71,0.00
2024-12-08 16:55:49,97,5695,45,52,4386.82,7168.00,0.00
2024-12-08 16:55:49,98,5695,45,53,4342.05,7168.01,0.00
2024-12-08 16:55:49,97,5695,44,53,4351.40,7168.19,0.00
2024-12-08 16:55:49,98,5694,45,53,4271.42,7168.70,0.00
2024-12-08 16:55:49,97,5694,44,53,4328.78,7168.73,0.00
2024-12-08 16:55:49,97,5695,44,53,4381.90,7169.00,0.00
2024-12-08 16:55:49,98,5695,44,54,4337.19,7169.01,0.00
2024-12-08 16:55:49,99,5694,45,54,4273.57,7169.08,0.00
2024-12-08 16:55:49,99,5695,45,54,4344.55,7170.00,0.00
2024-12-08 16:55:49,100,5695,45,55,4301.11,7170.01,0.00
2024-12-08 16:55:49,99,5695,44,55,4316.17,7170.08,0.00
2024-12-08 16:55:49,98,5695,43,55,4350.76,7170.20,0.00
2024-12-08 16:55:49,98,5696,43,55,4438.58,7171.00,0.00
2024-12-08 16:55:49,99,5696,44,55,4393.74,7171.01,0.00
2024-12-08 16:55:49,99,5697,44,55,4349.32,7172.00,0.00
2024-12-08 16:55:49,100,5697,45,55,4305.83,7172.01,0.00
2024-12-08 16:55:49,99,5697,45,54,4335.19,7172.03,0.00
2024-12-08 16:55:49,98,5697,44,54,4314.16,7172.61,0.00
2024-12-08 16:55:49,98,5698,44,54,4328.97,7173.00,0.00
2024-12-08 16:55:49,99,5698,44,55,4285.24,7173.01,0.00
2024-12-08 16:55:49,100,5697,45,55,4157.57,7173.78,0.00
2024-12-08 16:55:49,100,5698,45,55,4252.86,7174.00,0.00
2024-12-08 16:55:49,101,5698,46,55,4210.76,7174.01,0.00
2024-12-08 16:55:49,101,5699,46,55,4237.74,7175.00,0.00
2024-12-08 16:55:49,102,5699,47,55,4196.20,7175.01,0.00
2024-12-08 16:55:49,101,5699,47,54,4219.85,7175.03,0.00
2024-12-08 16:55:49,101,5700,47,54,4186.48,7176.00,0.00
2024-12-08 16:55:49,102,5700,48,54,4145.44,7176.01,0.00
2024-12-08 16:55:49,101,5700,47,54,4141.88,7176.31,0.00
2024-12-08 16:55:49,101,5701,47,54,4157.15,7177.00,0.00
2024-12-08 16:55:49,102,5701,48,54,4116.40,7177.01,0.00
2024-12-08 16:55:49,101,5701,48,53,4152.07,7177.03,0.00
2024-12-08 16:55:49,100,5701,47,53,4177.89,7177.25,0.00
2024-12-08 16:55:49,100,5702,47,53,4157.62,7178.00,0.00
2024-12-08 16:55:49,101,5702,47,54,4116.45,7178.01,0.00
2024-12-08 16:55:49,102,5701,47,55,4003.57,7178.67,0.00
2024-12-08 16:55:49,103,5700,47,56,3957.90,7178.96,0.00
2024-12-08 16:55:49,103,5701,47,56,4023.42,7179.00,0.00
2024-12-08 16:55:49,104,5701,48,56,3984.73,7179.01,0.00
2024-12-08 16:55:49,103,5701,47,56,3997.45,7179.15,0.00
2024-12-08 16:55:49,102,5701,46,56,4032.38,7179.16,0.00
2024-12-08 16:55:49,101,5701,45,56,4067.94,7179.22,0.00
2024-12-08 16:55:49,101,5702,45,56,4212.22,7180.00,0.00
2024-12-08 16:55:49,102,5702,45,57,4170.93,7180.01,0.00
2024-12-08 16:55:49,102,5703,45,57,4123.71,7181.00,0.00
2024-12-08 16:55:49,103,5703,46,57,4083.67,7181.01,0.00
2024-12-08 16:55:49,102,5703,45,57,4089.15,7181.27,0.00
2024-12-08 16:55:49,103,5702,45,58,3988.93,7181.78,0.00
2024-12-08 16:55:49,103,5703,45,58,4020.64,7182.00,0.00
2024-12-08 16:55:49,104,5703,46,58,3981.98,7182.01,0.00
2024-12-08 16:55:49,103,5703,46,57,4013.47,7182.03,0.00
2024-12-08 16:55:49,102,5703,45,57,4016.25,7182.54,0.00
2024-12-08 16:55:49,103,5702,46,57,3909.71,7182.98,0.00
2024-12-08 16:55:49,103,5703,46,57,4020.61,7183.00,0.00
2024-12-08 16:55:49,104,5703,46,58,3981.95,7183.01,0.00
2024-12-08 16:55:49,103,5703,45,58,3917.37,7183.64,0.00
2024-12-08 16:55:49,103,5704,45,58,4023.38,7184.00,0.00
2024-12-08 16:55:49,104,5704,46,58,3984.69,7184.01,0.00
2024-12-08 16:55:49,103,5704,45,58,3963.33,7184.54,0.00
2024-12-08 16:55:49,102,5704,45,57,4000.62,7184.55,0.00
2024-12-08 16:55:49,102,5705,45,57,4012.95,7185.00,0.00
2024-12-08 16:55:49,103,5705,46,57,3973.98,7185.01,0.00
2024-12-08 16:55:49,102,5705,46,56,3937.20,7185.61,0.00
2024-12-08 16:55:49,102,5706,46,56,3944.43,7186.00,0.00
2024-12-08 16:55:49,103,5706,47,56,3906.14,7186.01,0.00
2024-12-08 16:55:49,102,5706,47,55,3940.93,7186.04,0.00
2024-12-08 16:55:50,102,5707,47,55,3906.65,7187.00,0.00
2024-12-08 16:55:50,103,5707,48,55,3868.73,7187.01,0.00
2024-12-08 16:55:50,104,5706,48,56,3736.19,7187.88,0.00
2024-12-08 16:55:50,104,5707,48,56,3822.91,7188.00,0.00
2024-12-08 16:55:50,105,5707,48,57,3786.50,7188.01,0.00
2024-12-08 16:55:50,105,5708,48,57,3795.74,7189.00,0.00
2024-12-08 16:55:50,106,5708,48,58,3759.93,7189.01,0.00
2024-12-08 16:55:50,105,5708,48,57,3788.75,7189.06,0.00
2024-12-08 16:55:50,106,5707,49,57,3713.90,7189.62,0.00
2024-12-08 16:55:50,107,5706,49,58,3695.35,7189.68,0.00
2024-12-08 16:55:50,108,5705,49,59,3661.69,7189.70,0.00
2024-12-08 16:55:50,108,5706,49,59,3684.25,7190.00,0.00
2024-12-08 16:55:50,109,5706,50,59,3650.45,7190.01,0.00
2024-12-08 16:55:50,108,5706,49,59,3671.51,7190.01,0.00
2024-12-08 16:55:50,107,5706,49,58,3693.74,7190.05,0.00
2024-12-08 16:55:50,107,5707,49,58,3868.40,7191.00,0.00
2024-12-08 16:55:50,108,5707,50,58,3832.58,7191.01,0.00
2024-12-08 16:55:50,107,5707,50,57,3854.98,7191.06,0.00
2024-12-08 16:55:50,108,5706,51,57,3760.20,7191.53,0.00
2024-12-08 16:55:50,109,5705,52,57,3786.59,7191.59,0.00
2024-12-08 16:55:50,109,5706,52,57,3796.40,7192.00,0.00
2024-12-08 16:55:50,110,5706,52,58,3761.89,7192.01,0.00
2024-12-08 16:55:50,109,5706,52,57,3777.30,7192.09,0.00
2024-12-08 16:55:50,108,5706,51,57,3809.52,7192.13,0.00
2024-12-08 16:55:50,107,5706,50,57,3809.53,7192.24,0.00
2024-12-08 16:55:50,107,5707,50,57,3927.07,7193.00,0.00
2024-12-08 16:55:50,108,5707,51,57,3890.71,7193.01,0.00
2024-12-08 16:55:50,107,5707,51,56,3904.92,7193.12,0.00
2024-12-08 16:55:50,108,5706,52,56,3840.30,7193.54,0.00
2024-12-08 16:55:50,108,5707,52,56,3839.97,7194.00,0.00
2024-12-08 16:55:50,109,5707,52,57,3804.74,7194.01,0.00
2024-12-08 16:55:50,109,5708,52,57,3798.65,7195.00,0.00
2024-12-08 16:55:50,110,5708,52,58,3764.12,7195.01,0.00
2024-12-08 16:55:50,109,5708,51,58,3790.76,7195.10,0.00
2024-12-08 16:55:50,108,5708,51,57,3823.20,7195.11,0.00
2024-12-08 16:55:50,109,5707,51,58,3782.86,7195.20,0.00
2024-12-08 16:55:50,108,5707,51,57,3831.14,7195.58,0.00
2024-12-08 16:55:50,109,5706,51,58,3785.93,7195.71,0.00
2024-12-08 16:55:50,110,5705,51,59,3746.35,7195.79,0.00
2024-12-08 16:55:50,110,5706,51,59,3792.51,7196.00,0.00
2024-12-08 16:55:50,111,5706,51,60,3758.34,7196.01,0.00
2024-12-08 16:55:50,110,5706,50,60,3702.82,7196.75,0.00
2024-12-08 16:55:50,111,5705,50,61,3668.18,7196.78,0.00
2024-12-08 16:55:50,111,5706,50,61,3909.81,7197.00,0.00
2024-12-08 16:55:50,112,5706,50,62,3874.91,7197.01,0.00
2024-12-08 16:55:50,111,5706,50,61,3896.88,7197.14,0.00
2024-12-08 16:55:50,111,5707,50,61,3911.44,7198.00,0.00
2024-12-08 16:55:50,112,5707,50,62,3876.51,7198.01,0.00
2024-12-08 16:55:50,111,5707,49,62,3821.62,7198.74,0.00
2024-12-08 16:55:50,111,5708,49,62,3853.85,7199.00,0.00
2024-12-08 16:55:50,112,5708,49,63,3819.44,7199.01,0.00
2024-12-08 16:55:50,111,5708,48,63,3820.21,7199.30,0.00
2024-12-08 16:55:50,110,5708,47,63,3829.97,7199.51,0.00
2024-12-08 16:55:50,110,5709,47,63,3808.54,7200.00,0.00
2024-12-08 16:55:50,111,5709,47,64,3774.23,7200.01,0.00
2024-12-08 16:55:50,110,5709,46,64,3799.45,7200.13,0.00
2024-12-08 16:55:50,109,5709,46,63,3827.70,7200.14,0.00
2024-12-08 16:55:50,110,5708,46,64,3787.70,7200.23,0.00
2024-12-08 16:55:50,109,5708,45,64,3860.13,7200.30,0.00
2024-12-08 16:55:50,108,5708,45,63,3844.98,7200.69,0.00
2024-12-08 16:55:50,108,5709,45,63,3846.33,7201.00,0.00
2024-12-08 16:55:50,109,5709,46,63,3811.05,7201.01,0.00
2024-12-08 16:55:50,108,5709,45,63,3840.76,7201.08,0.00
2024-12-08 16:55:50,107,5709,44,63,3847.12,7201.30,0.00
2024-12-08 16:55:50,106,5709,43,63,3780.89,7201.85,0.00
2024-12-08 16:55:50,106,5710,43,63,3903.93,7202.00,0.00
2024-12-08 16:55:50,107,5710,43,64,3867.45,7202.01,0.00
2024-12-08 16:55:50,106,5710,43,63,3891.05,7202.14,0.00
2024-12-08 16:55:50,105,5710,42,63,3858.24,7202.55,0.00
2024-12-08 16:55:50,105,5711,42,63,3847.28,7203.00,0.00
2024-12-08 16:55:50,106,5711,43,63,3810.99,7203.01,0.00
2024-12-08 16:55:50,105,5711,42,63,3780.22,7203.41,0.00
2024-12-08 16:55:50,106,5710,42,64,3725.80,7203.60,0.00
2024-12-08 16:55:50,105,5710,42,63,3807.91,7203.66,0.00
2024-12-08 16:55:50,104,5710,42,62,3824.97,7203.66,0.00
2024-12-08 16:55:50,104,5711,42,62,3861.72,7204.00,0.00
2024-12-08 16:55:50,105,5711,42,63,3824.94,7204.01,0.00
2024-12-08 16:55:50,104,5711,42,62,3858.27,7204.05,0.00
2024-12-08 16:55:50,103,5711,41,62,3856.69,7204.39,0.00
2024-12-08 16:55:50,104,5710,42,62,3806.55,7204.59,0.00
2024-12-08 16:55:50,104,5711,42,62,3915.00,7205.00,0.00
2024-12-08 16:55:50,105,5711,43,62,3877.71,7205.01,0.00
2024-12-08 16:55:50,104,5711,42,62,3851.66,7205.63,0.00
2024-12-08 16:55:50,104,5712,42,62,3936.35,7206.00,0.00
2024-12-08 16:55:50,105,5712,43,62,3898.86,7206.01,0.00
2024-12-08 16:55:50,104,5712,43,61,3932.90,7206.05,0.00
2024-12-08 16:55:50,105,5711,43,62,3852.40,7206.47,0.00
2024-12-08 16:55:50,105,5712,43,62,3864.51,7207.00,0.00
2024-12-08 16:55:50,106,5712,44,62,3828.06,7207.01,0.00
2024-12-08 16:55:50,105,5712,44,61,3850.12,7207.12,0.00
2024-12-08 16:55:50,104,5712,43,61,3874.73,7207.30,0.00
2024-12-08 16:55:50,105,5711,44,61,3831.69,7207.40,0.00
2024-12-08 16:55:50,104,5711,43,61,3865.20,7207.52,0.00
2024-12-08 16:55:50,103,5711,42,61,3891.64,7207.59,0.00
2024-12-08 16:55:50,102,5711,41,61,3927.78,7207.62,0.00
2024-12-08 16:55:50,101,5711,40,61,3958.60,7207.62,0.00
2024-12-08 16:55:50,100,5711,39,61,3994.60,7207.67,0.00
2024-12-08 16:55:50,100,5712,39,61,4076.39,7208.00,0.00
2024-12-08 16:55:50,101,5712,40,61,4036.03,7208.01,0.00
2024-12-08 16:55:50,100,5712,40,60,4052.63,7208.13,0.00
2024-12-08 16:55:50,101,5711,41,60,3995.47,7208.39,0.00
2024-12-08 16:55:51,101,5712,41,60,4082.28,7209.00,0.00
2024-12-08 16:55:51,102,5712,41,61,4042.26,7209.01,0.00
2024-12-08 16:55:51,101,5712,40,61,4073.01,7209.05,0.00
2024-12-08 16:55:51,101,5713,40,61,4112.99,7210.00,0.00
2024-12-08 16:55:51,102,5713,40,62,4072.67,7210.01,0.00
2024-12-08 16:55:51,101,5713,39,62,4106.14,7210.10,0.00
2024-12-08 16:55:51,100,5713,39,61,4145.76,7210.11,0.00
2024-12-08 16:55:51,101,5712,40,61,4029.72,7210.59,0.00
2024-12-08 16:55:51,101,5713,40,61,4081.07,7211.00,0.00
2024-12-08 16:55:51,102,5713,40,62,4041.06,7211.01,0.00
2024-12-08 16:55:51,101,5713,39,62,4026.96,7211.39,0.00
2024-12-08 16:55:51,102,5712,40,62,3980.92,7211.49,0.00
2024-12-08 16:55:51,103,5711,40,63,3969.64,7211.51,0.00
2024-12-08 16:55:51,103,5712,40,63,4118.93,7212.00,0.00
2024-12-08 16:55:51,104,5712,41,63,4079.33,7212.01,0.00
2024-12-08 16:55:51,103,5712,40,63,4111.35,7212.03,0.00
2024-12-08 16:55:51,102,5712,40,62,4149.54,7212.05,0.00
2024-12-08 16:55:51,103,5711,41,62,4060.21,7212.45,0.00
2024-12-08 16:55:51,103,5712,41,62,4235.28,7213.00,0.00
2024-12-08 16:55:51,104,5712,42,62,4194.56,7213.01,0.00
2024-12-08 16:55:51,105,5711,43,62,4123.75,7213.27,0.00
2024-12-08 16:55:51,104,5711,42,62,4151.59,7213.65,0.00
2024-12-08 16:55:51,104,5712,42,62,4244.39,7214.00,0.00
2024-12-08 16:55:51,105,5712,42,63,4203.97,7214.01,0.00
2024-12-08 16:55:51,104,5712,42,62,4236.78,7214.11,0.00
2024-12-08 16:55:51,105,5711,43,62,4167.66,7214.33,0.00
2024-12-08 16:55:51,105,5712,43,62,4195.01,7215.00,0.00
2024-12-08 16:55:51,106,5712,44,62,4155.43,7215.01,0.00
2024-12-08 16:55:51,106,5713,44,62,4123.44,7216.00,0.00
2024-12-08 16:55:51,107,5713,44,63,4084.90,7216.01,0.00
2024-12-08 16:55:51,106,5713,44,62,4113.24,7216.10,0.00
2024-12-08 16:55:51,107,5712,45,62,4061.71,7216.30,0.00
2024-12-08 16:55:51,106,5712,45,61,4093.29,7216.32,0.00
2024-12-08 16:55:51,105,5712,45,60,4096.34,7216.45,0.00
2024-12-08 16:55:51,105,5713,45,60,4078.59,7217.00,0.00
2024-12-08 16:55:51,106,5713,45,61,4040.12,7217.01,0.00
2024-12-08 16:55:51,105,5713,45,60,4057.99,7217.11,0.00
2024-12-08 16:55:51,105,5714,45,60,4051.34,7218.00,0.00
2024-12-08 16:55:51,106,5714,46,60,4013.12,7218.01,0.00
2024-12-08 16:55:51,105,5714,45,60,4036.91,7218.04,0.00
2024-12-08 16:55:51,104,5714,44,60,4074.34,7218.05,0.00
2024-12-08 16:55:51,103,5714,43,60,4113.19,7218.05,0.00
2024-12-08 16:55:51,102,5714,43,59,4137.96,7218.09,0.00
2024-12-08 16:55:51,101,5714,42,59,4124.49,7218.40,0.00
2024-12-08 16:55:51,101,5715,42,59,4130.46,7219.00,0.00
2024-12-08 16:55:51,102,5715,43,59,4089.96,7219.01,0.00
2024-12-08 16:55:51,103,5714,43,60,4048.16,7219.06,0.00
2024-12-08 16:55:51,102,5714,43,59,4110.50,7219.30,0.00
2024-12-08 16:55:51,101,5714,42,59,4146.37,7219.34,0.00
2024-12-08 16:55:51,102,5713,43,59,4089.30,7219.46,0.00
2024-12-08 16:55:51,103,5712,44,59,4101.47,7219.48,0.00
2024-12-08 16:55:51,104,5711,44,60,4082.32,7219.80,0.00
2024-12-08 16:55:51,103,5711,43,60,4092.08,7219.92,0.00
2024-12-08 16:55:51,103,5712,43,60,4152.36,7220.00,0.00
2024-12-08 16:55:51,104,5712,43,61,4112.44,7220.01,0.00
2024-12-08 16:55:51,103,5712,42,61,4014.04,7220.78,0.00
2024-12-08 16:55:51,103,5713,42,61,4314.54,7221.00,0.00
2024-12-08 16:55:51,104,5713,42,62,4273.06,7221.01,0.00
2024-12-08 16:55:51,103,5713,42,61,4307.55,7221.09,0.00
2024-12-08 16:55:51,102,5713,41,61,4287.81,7221.36,0.00
2024-12-08 16:55:51,101,5713,41,60,4323.70,7221.45,0.00
2024-12-08 16:55:51,101,5714,41,60,4310.25,7222.00,0.00
2024-12-08 16:55:51,102,5714,42,60,4267.99,7222.01,0.00
2024-12-08 16:55:51,101,5714,41,60,4298.11,7222.06,0.00
2024-12-08 16:55:51,100,5714,41,59,4328.09,7222.09,0.00
2024-12-08 16:55:51,99,5714,40,59,4337.94,7222.26,0.00
2024-12-08 16:55:51,98,5714,40,58,4371.39,7222.33,0.00
2024-12-08 16:55:51,98,5715,40,58,4378.20,7223.00,0.00
2024-12-08 16:55:51,99,5715,40,59,4333.97,7223.01,0.00
2024-12-08 16:55:51,98,5715,40,58,4357.58,7223.11,0.00
2024-12-08 16:55:51,97,5715,40,57,4387.24,7223.24,0.00
2024-12-08 16:55:51,96,5715,39,57,4381.52,7223.50,0.00
2024-12-08 16:55:51,96,5716,39,57,4402.65,7224.00,0.00
2024-12-08 16:55:51,97,5716,40,57,4357.26,7224.01,0.00
2024-12-08 16:55:51,96,5716,40,56,4398.90,7224.05,0.00
2024-12-08 16:55:51,95,5716,40,55,4424.68,7224.12,0.00
2024-12-08 16:55:51,94,5716,39,55,4426.38,7224.45,0.00
2024-12-08 16:55:51,94,5717,39,55,4443.71,7225.00,0.00
2024-12-08 16:55:51,95,5717,39,56,4396.93,7225.01,0.00
2024-12-08 16:55:51,96,5716,40,56,4321.09,7225.22,0.00
2024-12-08 16:55:51,95,5716,39,56,4311.35,7225.66,0.00
2024-12-08 16:55:51,94,5716,38,56,4343.01,7225.84,0.00
2024-12-08 16:55:51,94,5717,38,56,4393.04,7226.00,0.00
2024-12-08 16:55:51,95,5717,38,57,4346.80,7226.01,0.00
2024-12-08 16:55:51,94,5717,38,56,4364.22,7226.18,0.00
2024-12-08 16:55:51,94,5718,38,56,4404.77,7227.00,0.00
2024-12-08 16:55:51,95,5718,38,57,4358.41,7227.01,0.00
2024-12-08 16:55:51,94,5718,38,56,4394.80,7227.13,0.00
2024-12-08 16:55:51,93,5718,37,56,4404.44,7227.59,0.00
2024-12-08 16:55:51,93,5719,37,56,4420.91,7228.00,0.00
2024-12-08 16:55:51,94,5719,37,57,4373.88,7228.01,0.00
2024-12-08 16:55:51,95,5718,37,58,4298.23,7228.23,0.00
2024-12-08 16:55:51,94,5718,36,58,4368.49,7228.30,0.00
2024-12-08 16:55:51,93,5718,36,57,4352.16,7228.84,0.00
2024-12-08 16:55:51,93,5719,36,57,4405.69,7229.00,0.00
2024-12-08 16:55:51,94,5719,36,58,4358.82,7229.01,0.00
2024-12-08 16:55:51,95,5718,37,58,4245.90,7229.68,0.00
2024-12-08 16:55:51,95,5719,37,58,4359.68,7230.00,0.00
2024-12-08 16:55:51,96,5719,37,59,4314.27,7230.01,0.00
2024-12-08 16:55:51,97,5718,38,59,4207.93,7230.18,0.00
2024-12-08 16:55:52,97,5719,38,59,4284.13,7231.00,0.00
2024-12-08 16:55:52,98,5719,39,59,4240.41,7231.01,0.00
2024-12-08 16:55:52,97,5719,38,59,4252.10,7231.04,0.00
2024-12-08 16:55:52,96,5719,37,59,4228.47,7231.60,0.00
2024-12-08 16:55:52,95,5719,36,59,4245.25,7231.74,0.00
2024-12-08 16:55:52,94,5719,36,58,4282.40,7231.81,0.00
2024-12-08 16:55:52,94,5720,36,58,4422.58,7232.00,0.00
2024-12-08 16:55:52,95,5720,37,58,4376.03,7232.01,0.00
2024-12-08 16:55:52,94,5720,37,57,4413.36,7232.12,0.00
2024-12-08 16:55:52,94,5721,37,57,4395.14,7233.00,0.00
2024-12-08 16:55:52,95,5721,37,58,4348.88,7233.01,0.00
2024-12-08 16:55:52,94,5721,36,58,4392.07,7233.04,0.00
2024-12-08 16:55:52,93,5721,36,57,4420.63,7233.11,0.00
2024-12-08 16:55:52,93,5722,36,57,4397.50,7234.00,0.00
2024-12-08 16:55:52,94,5722,36,58,4350.72,7234.01,0.00
2024-12-08 16:55:52,93,5722,36,57,4376.50,7234.11,0.00
2024-12-08 16:55:52,92,5722,35,57,4392.66,7234.19,0.00
2024-12-08 16:55:52,92,5723,35,57,4386.23,7235.00,0.00
2024-12-08 16:55:52,93,5723,36,57,4339.06,7235.01,0.00
2024-12-08 16:55:52,92,5723,36,56,4383.08,7235.04,0.00
2024-12-08 16:55:52,93,5722,36,57,4290.50,7235.46,0.00
2024-12-08 16:55:52,92,5722,35,57,4314.51,7235.74,0.00
2024-12-08 16:55:52,92,5723,35,57,4367.46,7236.00,0.00
2024-12-08 16:55:52,93,5723,35,58,4320.50,7236.01,0.00
2024-12-08 16:55:52,92,5723,35,57,4364.32,7236.04,0.00
2024-12-08 16:55:52,92,5724,35,57,4404.14,7237.00,0.00
2024-12-08 16:55:52,93,5724,35,58,4356.78,7237.01,0.00
2024-12-08 16:55:52,92,5724,35,57,4400.99,7237.04,0.00
2024-12-08 16:55:52,91,5724,35,56,4390.73,7237.52,0.00
2024-12-08 16:55:52,91,5725,35,56,4401.36,7238.00,0.00
2024-12-08 16:55:52,92,5725,35,57,4353.52,7238.01,0.00
2024-12-08 16:55:52,91,5725,34,57,4399.77,7238.02,0.00
2024-12-08 16:55:52,90,5725,33,57,4447.05,7238.03,0.00
2024-12-08 16:55:52,91,5724,34,57,4369.19,7238.22,0.00
2024-12-08 16:55:52,90,5724,34,56,4420.63,7238.53,0.00
2024-12-08 16:55:52,90,5725,34,56,4435.99,7239.00,0.00
2024-12-08 16:55:52,91,5725,35,56,4387.24,7239.01,0.00
2024-12-08 16:55:52,90,5725,35,55,4423.12,7239.06,0.00
2024-12-08 16:55:52,89,5725,34,55,4425.77,7239.69,0.00
2024-12-08 16:55:52,88,5725,33,55,4441.59,7239.94,0.00
2024-12-08 16:55:52,88,5726,33,55,4602.05,7240.00,0.00
2024-12-08 16:55:52,89,5726,33,56,4550.34,7240.01,0.00
2024-12-08 16:55:52,88,5726,32,56,4585.60,7240.01,0.00
2024-12-08 16:55:52,87,5726,32,55,4616.68,7240.08,0.00
2024-12-08 16:55:52,87,5727,32,55,4633.15,7241.00,0.00
2024-12-08 16:55:52,88,5727,33,55,4580.50,7241.01,0.00
2024-12-08 16:55:52,87,5727,33,54,4632.31,7241.01,0.00
2024-12-08 16:55:52,86,5727,33,53,4685.34,7241.01,0.00
2024-12-08 16:55:52,87,5726,33,54,4557.32,7241.39,0.00
2024-12-08 16:55:52,87,5727,33,54,4601.07,7242.00,0.00
2024-12-08 16:55:52,88,5727,33,55,4548.79,7242.01,0.00
2024-12-08 16:55:52,87,5727,33,54,4580.68,7242.07,0.00
2024-12-08 16:55:52,87,5728,33,54,4646.99,7243.00,0.00
2024-12-08 16:55:52,88,5728,34,54,4594.18,7243.01,0.00
2024-12-08 16:55:52,89,5727,34,55,4539.32,7243.08,0.00
2024-12-08 16:55:52,89,5728,34,55,4533.59,7244.00,0.00
2024-12-08 16:55:52,90,5728,35,55,4483.22,7244.01,0.00
2024-12-08 16:55:52,90,5729,35,55,4524.41,7245.00,0.00
2024-12-08 16:55:52,91,5729,35,56,4474.69,7245.01,0.00
2024-12-08 16:55:52,90,5729,35,55,4523.60,7245.01,0.00
2024-12-08 16:55:52,89,5729,34,55,4535.10,7245.09,0.00
2024-12-08 16:55:52,89,5730,34,55,4538.60,7246.00,0.00
2024-12-08 16:55:52,90,5730,34,56,4488.17,7246.01,0.00
2024-12-08 16:55:52,89,5730,34,55,4528.85,7246.07,0.00
2024-12-08 16:55:52,89,5731,34,55,4496.53,7247.00,0.00
2024-12-08 16:55:52,90,5731,35,55,4446.56,7247.01,0.00
2024-12-08 16:55:52,90,5732,35,55,4392.45,7248.00,0.00
2024-12-08 16:55:52,91,5732,35,56,4344.18,7248.01,0.00
2024-12-08 16:55:52,90,5732,35,55,4387.69,7248.07,0.00
2024-12-08 16:55:52,90,5733,35,55,4354.97,7249.00,0.00
2024-12-08 16:55:52,91,5733,36,55,4307.11,7249.01,0.00
2024-12-08 16:55:52,90,5733,35,55,4329.22,7249.07,0.00
2024-12-08 16:55:52,91,5732,36,55,4208.79,7249.70,0.00
2024-12-08 16:55:52,92,5731,36,56,4160.82,7249.97,0.00
2024-12-08 16:55:52,92,5732,36,56,4239.65,7250.00,0.00
2024-12-08 16:55:52,93,5732,36,57,4194.07,7250.01,0.00
2024-12-08 16:55:52,92,5732,36,56,4226.97,7250.07,0.00
2024-12-08 16:55:52,92,5733,36,56,4351.26,7251.00,0.00
2024-12-08 16:55:52,93,5733,37,56,4304.47,7251.01,0.00
2024-12-08 16:55:52,92,5733,36,56,4322.95,7251.17,0.00
2024-12-08 16:55:52,91,5733,36,55,4338.36,7251.50,0.00
2024-12-08 16:55:52,91,5734,36,55,4372.52,7252.00,0.00
2024-12-08 16:55:52,92,5734,36,56,4324.99,7252.01,0.00
2024-12-08 16:55:52,91,5734,35,56,4346.57,7252.14,0.00
2024-12-08 16:55:52,92,5733,36,56,4288.65,7252.30,0.00
2024-12-08 16:55:52,93,5732,36,57,4271.31,7252.46,0.00
2024-12-08 16:55:52,93,5733,36,57,4367.27,7253.00,0.00
2024-12-08 16:55:52,94,5733,37,57,4320.81,7253.01,0.00
2024-12-08 16:55:52,93,5733,37,56,4366.49,7253.01,0.00
2024-12-08 16:55:52,93,5734,37,56,4476.46,7254.00,0.00
2024-12-08 16:55:52,94,5734,38,56,4428.84,7254.01,0.00
2024-12-08 16:55:52,95,5733,38,57,4358.59,7254.15,0.00
2024-12-08 16:55:53,95,5734,38,57,4378.10,7255.00,0.00
2024-12-08 16:55:53,96,5734,38,58,4332.49,7255.01,0.00
2024-12-08 16:55:53,95,5734,38,57,4372.01,7255.05,0.00
2024-12-08 16:55:53,95,5735,38,57,4410.39,7256.00,0.00
2024-12-08 16:55:53,96,5735,38,58,4364.45,7256.01,0.00
2024-12-08 16:55:53,95,5735,37,58,4339.50,7256.42,0.00
2024-12-08 16:55:53,95,5736,37,58,4363.32,7257.00,0.00
2024-12-08 16:55:53,96,5736,38,58,4317.87,7257.01,0.00
2024-12-08 16:55:53,95,5736,38,57,4361.80,7257.02,0.00
2024-12-08 16:55:53,94,5736,37,57,4339.94,7257.37,0.00
2024-12-08 16:55:53,94,5737,37,57,4353.01,7258.00,0.00
2024-12-08 16:55:53,95,5737,38,57,4307.19,7258.01,0.00
2024-12-08 16:55:53,94,5737,38,56,4340.67,7258.04,0.00
2024-12-08 16:55:53,94,5738,38,56,4287.63,7259.00,0.00
2024-12-08 16:55:53,95,5738,38,57,4242.49,7259.01,0.00
2024-12-08 16:55:53,96,5737,38,58,4119.97,7259.76,0.00
2024-12-08 16:55:53,96,5738,38,58,4130.08,7260.00,0.00
2024-12-08 16:55:53,97,5738,39,58,4087.50,7260.01,0.00
2024-12-08 16:55:53,96,5738,39,57,4121.30,7260.07,0.00
2024-12-08 16:55:53,95,5738,38,57,4088.62,7260.83,0.00
2024-12-08 16:55:53,96,5737,38,58,4017.97,7260.93,0.00
2024-12-08 16:55:53,96,5738,38,58,4182.60,7261.00,0.00
2024-12-08 16:55:53,97,5738,38,59,4139.48,7261.01,0.00
2024-12-08 16:55:53,97,5739,38,59,4091.28,7262.00,0.00
2024-12-08 16:55:53,98,5739,39,59,4049.53,7262.01,0.00
2024-12-08 16:55:53,97,5739,39,58,4080.82,7262.07,0.00
2024-12-08 16:55:53,96,5739,38,58,4084.44,7262.37,0.00
2024-12-08 16:55:53,95,5739,38,57,4082.59,7262.83,0.00
2024-12-08 16:55:53,95,5740,38,57,4096.63,7263.00,0.00
2024-12-08 16:55:53,96,5740,38,58,4053.95,7263.01,0.00
2024-12-08 16:55:53,95,5740,38,57,4051.84,7263.26,0.00
2024-12-08 16:55:53,95,5741,38,57,4012.96,7264.00,0.00
2024-12-08 16:55:53,96,5741,38,58,3971.16,7264.01,0.00
2024-12-08 16:55:53,95,5741,37,58,3980.82,7264.11,0.00
2024-12-08 16:55:53,94,5741,36,58,3974.53,7264.69,0.00
2024-12-08 16:55:53,93,5741,35,58,3996.06,7264.87,0.00
2024-12-08 16:55:53,92,5741,35,57,4028.01,7264.89,0.00
2024-12-08 16:55:53,92,5742,35,57,4078.24,7265.00,0.00
2024-12-08 16:55:53,93,5742,36,57,4034.39,7265.01,0.00
2024-12-08 16:55:53,92,5742,36,56,3966.51,7265.96,0.00
2024-12-08 16:55:53,92,5743,36,56,4042.37,7266.00,0.00
2024-12-08 16:55:53,93,5743,37,56,3998.90,7266.01,0.00
2024-12-08 16:55:53,94,5742,37,57,3922.42,7266.29,0.00
2024-12-08 16:55:53,94,5743,37,57,3960.39,7267.00,0.00
2024-12-08 16:55:53,95,5743,38,57,3918.70,7267.01,0.00
2024-12-08 16:55:53,94,5743,38,56,3958.08,7267.03,0.00
2024-12-08 16:55:53,93,5743,38,55,3992.05,7267.06,0.00
2024-12-08 16:55:53,93,5744,38,55,4048.28,7268.00,0.00
2024-12-08 16:55:53,94,5744,39,55,4005.22,7268.01,0.00
2024-12-08 16:55:53,93,5744,38,55,4023.36,7268.02,0.00
2024-12-08 16:55:53,92,5744,38,54,4052.50,7268.05,0.00
2024-12-08 16:55:53,91,5744,37,54,4034.27,7268.34,0.00
2024-12-08 16:55:53,91,5745,37,54,4066.66,7269.00,0.00
2024-12-08 16:55:53,92,5745,37,55,4022.45,7269.01,0.00
2024-12-08 16:55:53,91,5745,36,55,4035.81,7269.21,0.00
2024-12-08 16:55:53,91,5746,36,55,4025.61,7270.00,0.00
2024-12-08 16:55:53,92,5746,36,56,3981.85,7270.01,0.00
2024-12-08 16:55:53,91,5746,36,55,4017.64,7270.07,0.00
2024-12-08 16:55:53,90,5746,35,55,4052.18,7270.20,0.00
2024-12-08 16:55:53,89,5746,34,55,4073.95,7270.37,0.00
2024-12-08 16:55:53,89,5747,34,55,4110.32,7271.00,0.00
2024-12-08 16:55:53,90,5747,34,56,4064.65,7271.01,0.00
2024-12-08 16:55:53,91,5746,35,56,3912.99,7271.84,0.00
2024-12-08 16:55:53,91,5747,35,56,4023.41,7272.00,0.00
2024-12-08 16:55:53,92,5747,36,56,3979.68,7272.01,0.00
2024-12-08 16:55:53,91,5747,36,55,4015.44,7272.08,0.00
2024-12-08 16:55:53,91,5748,36,55,4055.77,7273.00,0.00
2024-12-08 16:55:53,92,5748,36,56,4011.69,7273.01,0.00
2024-12-08 16:55:53,91,5748,35,56,3997.48,7273.20,0.00
2024-12-08 16:55:53,91,5749,35,56,3991.27,7274.00,0.00
2024-12-08 16:55:53,92,5749,36,56,3947.88,7274.01,0.00
2024-12-08 16:55:53,91,5749,36,55,3984.89,7274.08,0.00
2024-12-08 16:55:53,90,5749,36,54,3906.53,7274.87,0.00
2024-12-08 16:55:53,90,5750,36,54,3932.06,7275.00,0.00
2024-12-08 16:55:53,91,5750,36,55,3888.85,7275.01,0.00
2024-12-08 16:55:53,92,5749,37,55,3845.80,7275.04,0.00
2024-12-08 16:55:53,91,5749,37,54,3944.04,7275.09,0.00
2024-12-08 16:55:53,90,5749,36,54,3976.03,7275.23,0.00
2024-12-08 16:55:53,89,5749,35,54,3957.13,7275.66,0.00
2024-12-08 16:55:53,88,5749,34,54,3954.28,7275.91,0.00
2024-12-08 16:55:53,88,5750,34,54,4030.42,7276.00,0.00
2024-12-08 16:55:53,89,5750,34,55,3985.14,7276.01,0.00
2024-12-08 16:55:53,88,5750,33,55,3996.31,7276.24,0.00
2024-12-08 16:55:53,88,5751,33,55,4087.89,7277.00,0.00
2024-12-08 16:55:53,89,5751,34,55,4041.95,7277.01,0.00
2024-12-08 16:55:53,89,5752,34,55,4004.46,7278.00,0.00
2024-12-08 16:55:53,90,5752,35,55,3959.97,7278.01,0.00
2024-12-08 16:55:53,89,5752,35,54,3968.43,7278.24,0.00
2024-12-08 16:55:53,88,5752,34,54,3959.16,7278.65,0.00
2024-12-08 16:55:54,88,5753,34,54,4015.38,7279.00,0.00
2024-12-08 16:55:54,89,5753,35,54,3970.26,7279.01,0.00
2024-12-08 16:55:54,88,5753,35,53,4007.14,7279.09,0.00
2024-12-08 16:55:54,88,5754,35,53,3989.71,7280.00,0.00
2024-12-08 16:55:54,89,5754,35,54,3944.88,7280.01,0.00
2024-12-08 16:55:54,88,5754,35,53,3975.22,7280.10,0.00
2024-12-08 16:55:54,87,5754,35,52,3945.20,7280.68,0.00
2024-12-08 16:55:54,87,5755,35,52,4005.71,7281.00,0.00
2024-12-08 16:55:54,88,5755,35,53,3960.19,7281.01,0.00
2024-12-08 16:55:54,89,5754,36,53,3831.38,7281.83,0.00
2024-12-08 16:55:54,89,5755,36,53,3912.54,7282.00,0.00
2024-12-08 16:55:54,90,5755,37,53,3869.06,7282.01,0.00
2024-12-08 16:55:54,90,5756,37,53,3906.04,7283.00,0.00
2024-12-08 16:55:54,91,5756,37,54,3863.12,7283.01,0.00
2024-12-08 16:55:54,92,5755,38,54,3796.62,7283.15,0.00
2024-12-08 16:55:54,91,5755,37,54,3825.01,7283.65,0.00
2024-12-08 16:55:54,91,5756,37,54,3879.72,7284.00,0.00
2024-12-08 16:55:54,92,5756,37,55,3837.55,7284.01,0.00
2024-12-08 16:55:54,91,5756,37,54,3866.14,7284.10,0.00
2024-12-08 16:55:54,90,5756,36,54,3896.20,7284.27,0.00
2024-12-08 16:55:54,90,5757,36,54,3954.36,7285.00,0.00
2024-12-08 16:55:54,91,5757,37,54,3910.91,7285.01,0.00
2024-12-08 16:55:54,90,5757,37,53,3934.96,7285.10,0.00
2024-12-08 16:55:54,89,5757,37,52,3960.62,7285.29,0.00
2024-12-08 16:55:54,88,5757,36,52,3945.35,7285.69,0.00
2024-12-08 16:55:54,88,5758,36,52,4006.05,7286.00,0.00
2024-12-08 16:55:54,89,5758,37,52,3961.03,7286.01,0.00
2024-12-08 16:55:54,88,5758,36,52,4002.75,7286.05,0.00
2024-12-08 16:55:54,87,5758,35,52,4026.16,7286.12,0.00
2024-12-08 16:55:54,87,5759,35,52,4037.65,7287.00,0.00
2024-12-08 16:55:54,88,5759,36,52,3991.76,7287.01,0.00
2024-12-08 16:55:54,88,5760,36,52,3975.51,7288.00,0.00
2024-12-08 16:55:54,89,5760,36,53,3930.84,7288.01,0.00
2024-12-08 16:55:54,89,5761,36,53,3907.52,7289.00,0.00
2024-12-08 16:55:54,90,5761,37,53,3864.10,7289.01,0.00
2024-12-08 16:55:54,89,5761,36,53,3882.97,7289.11,0.00
2024-12-08 16:55:54,89,5762,36,53,3871.58,7290.00,0.00
2024-12-08 16:55:54,90,5762,37,53,3828.56,7290.01,0.00
2024-12-08 16:55:54,89,5762,37,52,3853.58,7290.10,0.00
2024-12-08 16:55:54,90,5761,37,53,3757.22,7290.83,0.00
2024-12-08 16:55:54,90,5762,37,53,3804.35,7291.00,0.00
2024-12-08 16:55:54,91,5762,37,54,3762.54,7291.01,0.00
2024-12-08 16:55:54,90,5762,37,53,3778.45,7291.13,0.00
2024-12-08 16:55:54,90,5763,37,53,3843.25,7292.00,0.00
2024-12-08 16:55:54,91,5763,38,53,3801.02,7292.01,0.00
2024-12-08 16:55:54,90,5763,37,53,3815.70,7292.01,0.00
2024-12-08 16:55:54,89,5763,37,52,3856.13,7292.03,0.00
2024-12-08 16:55:54,88,5763,36,52,3865.21,7292.28,0.00
2024-12-08 16:55:54,87,5763,35,52,3898.44,7292.43,0.00
2024-12-08 16:55:54,87,5764,35,52,3940.10,7293.00,0.00
2024-12-08 16:55:54,88,5764,36,52,3895.32,7293.01,0.00
2024-12-08 16:55:54,87,5764,36,51,3925.03,7293.14,0.00
2024-12-08 16:55:54,87,5765,36,51,3911.89,7294.00,0.00
2024-12-08 16:55:54,88,5765,36,52,3867.44,7294.01,0.00
2024-12-08 16:55:54,88,5766,36,52,3795.76,7295.00,0.00
2024-12-08 16:55:54,89,5766,37,52,3753.11,7295.01,0.00
2024-12-08 16:55:54,88,5766,37,51,3793.29,7295.03,0.00
2024-12-08 16:55:54,87,5766,37,50,3825.16,7295.13,0.00
2024-12-08 16:55:54,86,5766,36,50,3811.09,7295.58,0.00
2024-12-08 16:55:54,86,5767,36,50,3841.13,7296.00,0.00
2024-12-08 16:55:54,87,5767,37,50,3796.98,7296.01,0.00
2024-12-08 16:55:54,86,5767,37,49,3838.59,7296.04,0.00
2024-12-08 16:55:54,85,5767,37,48,3882.24,7296.05,0.00
2024-12-08 16:55:54,84,5767,36,48,3845.73,7296.77,0.00
2024-12-08 16:55:54,83,5767,35,48,3883.77,7296.89,0.00
2024-12-08 16:55:54,83,5768,35,48,3930.55,7297.00,0.00
2024-12-08 16:55:54,84,5768,35,49,3883.76,7297.01,0.00
2024-12-08 16:55:54,83,5768,35,48,3927.93,7297.04,0.00
2024-12-08 16:55:54,82,5768,35,47,3966.94,7297.10,0.00
2024-12-08 16:55:54,82,5769,35,47,3953.70,7298.00,0.00
2024-12-08 16:55:54,83,5769,36,47,3906.06,7298.01,0.00
2024-12-08 16:55:54,83,5770,36,47,3868.92,7299.00,0.00
2024-12-08 16:55:54,84,5770,36,48,3822.86,7299.01,0.00
2024-12-08 16:55:54,83,5770,36,47,3855.75,7299.11,0.00
2024-12-08 16:55:54,82,5770,35,47,3816.20,7299.82,0.00
2024-12-08 16:55:54,82,5771,35,47,3892.02,7300.00,0.00
2024-12-08 16:55:54,83,5771,36,47,3845.12,7300.01,0.00
2024-12-08 16:55:54,83,5772,36,47,3808.36,7301.00,0.00
2024-12-08 16:55:54,84,5772,37,47,3763.02,7301.01,0.00
2024-12-08 16:55:54,83,5772,37,46,3795.19,7301.12,0.00
2024-12-08 16:55:54,83,5773,37,46,3782.93,7302.00,0.00
2024-12-08 16:55:54,84,5773,38,46,3737.89,7302.01,0.00
2024-12-08 16:55:54,84,5774,38,46,3700.60,7303.00,0.00
2024-12-08 16:55:54,85,5774,38,47,3657.06,7303.01,0.00
2024-12-08 16:55:54,84,5774,38,46,3687.58,7303.12,0.00
2024-12-08 16:55:55,84,5775,38,46,3672.49,7304.00,0.00
2024-12-08 16:55:55,85,5775,39,46,3629.28,7304.01,0.00
2024-12-08 16:55:55,84,5775,38,46,3594.38,7304.54,0.00
2024-12-08 16:55:55,84,5776,38,46,3645.40,7305.00,0.00
2024-12-08 16:55:55,85,5776,39,46,3602.51,7305.01,0.00
2024-12-08 16:55:55,84,5776,39,45,3634.11,7305.12,0.00
2024-12-08 16:55:55,83,5776,38,45,3662.39,7305.33,0.00
2024-12-08 16:55:55,83,5777,38,45,3660.55,7306.00,0.00
2024-12-08 16:55:55,84,5777,38,46,3616.97,7306.01,0.00
2024-12-08 16:55:55,83,5777,37,46,3613.95,7306.37,0.00
2024-12-08 16:55:55,83,5778,37,46,3618.99,7307.00,0.00
2024-12-08 16:55:55,84,5778,37,47,3575.90,7307.01,0.00
2024-12-08 16:55:55,83,5778,37,46,3608.44,7307.12,0.00
2024-12-08 16:55:55,82,5778,36,46,3568.98,7307.95,0.00
2024-12-08 16:55:55,82,5779,36,46,3654.57,7308.00,0.00
2024-12-08 16:55:55,83,5779,37,46,3610.54,7308.01,0.00
2024-12-08 16:55:55,82,5779,36,46,3591.83,7308.43,0.00
2024-12-08 16:55:55,82,5780,36,46,3633.90,7309.00,0.00
2024-12-08 16:55:55,83,5780,36,47,3590.12,7309.01,0.00
2024-12-08 16:55:55,82,5780,36,46,3631.23,7309.04,0.00
2024-12-08 16:55:55,81,5780,36,45,3667.95,7309.12,0.00
2024-12-08 16:55:55,80,5780,36,44,3694.57,7309.34,0.00
2024-12-08 16:55:55,81,5779,37,44,3641.78,7309.46,0.00
2024-12-08 16:55:55,81,5780,37,44,3699.12,7310.00,0.00
2024-12-08 16:55:55,82,5780,37,45,3654.00,7310.01,0.00
2024-12-08 16:55:55,81,5780,37,44,3696.42,7310.04,0.00
2024-12-08 16:55:55,81,5781,37,44,3743.07,7311.00,0.00
2024-12-08 16:55:55,82,5781,37,45,3697.43,7311.01,0.00
2024-12-08 16:55:55,81,5781,37,44,3740.38,7311.04,0.00
2024-12-08 16:55:55,80,5781,37,43,3774.35,7311.15,0.00
2024-12-08 16:55:55,79,5781,36,43,3739.48,7311.91,0.00
2024-12-08 16:55:55,79,5782,36,43,3822.99,7312.00,0.00
2024-12-08 16:55:55,80,5782,36,44,3775.21,7312.01,0.00
2024-12-08 16:55:55,79,5782,35,44,3764.71,7312.20,0.00
2024-12-08 16:55:55,79,5783,35,44,3781.40,7313.00,0.00
2024-12-08 16:55:55,80,5783,35,45,3734.13,7313.01,0.00
2024-12-08 16:55:55,79,5783,34,45,3766.56,7313.10,0.00
2024-12-08 16:55:55,78,5783,34,44,3808.19,7313.14,0.00
2024-12-08 16:55:55,79,5782,35,44,3747.60,7313.29,0.00
2024-12-08 16:55:55,79,5783,35,44,3826.76,7314.00,0.00
2024-12-08 16:55:55,80,5783,36,44,3778.92,7314.01,0.00
2024-12-08 16:55:55,79,5783,35,44,3784.59,7314.28,0.00
2024-12-08 16:55:55,78,5783,34,44,3777.90,7314.55,0.00
2024-12-08 16:55:55,78,5784,34,44,3926.22,7315.00,0.00
2024-12-08 16:55:55,79,5784,34,45,3876.52,7315.01,0.00
2024-12-08 16:55:55,78,5784,34,44,3918.24,7315.12,0.00
2024-12-08 16:55:55,77,5784,34,43,3959.64,7315.17,0.00
2024-12-08 16:55:55,77,5785,34,43,3933.73,7316.00,0.00
2024-12-08 16:55:55,78,5785,35,43,3883.29,7316.01,0.00
2024-12-08 16:55:55,79,5784,35,44,3787.50,7316.35,0.00
2024-12-08 16:55:55,79,5785,35,44,3817.46,7317.00,0.00
2024-12-08 16:55:55,80,5785,36,44,3769.74,7317.01,0.00
2024-12-08 16:55:55,79,5785,35,44,3710.44,7317.61,0.00
2024-12-08 16:55:55,79,5786,35,44,3859.90,7318.00,0.00
2024-12-08 16:55:55,80,5786,35,45,3811.65,7318.01,0.00
2024-12-08 16:55:55,79,5786,35,44,3846.95,7318.17,0.00
2024-12-08 16:55:55,78,5786,35,43,3893.59,7318.19,0.00
2024-12-08 16:55:55,78,5787,35,43,3872.30,7319.00,0.00
2024-12-08 16:55:55,79,5787,35,44,3823.29,7319.01,0.00
2024-12-08 16:55:55,78,5787,34,44,3870.43,7319.03,0.00
2024-12-08 16:55:55,77,5787,33,44,3919.75,7319.03,0.00
2024-12-08 16:55:55,76,5787,32,44,3970.36,7319.03,0.00
2024-12-08 16:55:55,75,5787,32,43,4009.13,7319.13,0.00
2024-12-08 16:55:55,74,5787,31,43,4010.24,7319.68,0.00
2024-12-08 16:55:55,74,5788,31,43,4038.42,7320.00,0.00
2024-12-08 16:55:55,75,5788,32,43,3984.57,7320.01,0.00
2024-12-08 16:55:55,76,5787,32,44,3902.31,7320.18,0.00
2024-12-08 16:55:55,75,5787,31,44,4002.08,7320.29,0.00
2024-12-08 16:55:55,75,5788,31,44,4033.27,7321.00,0.00
2024-12-08 16:55:55,76,5788,32,44,3980.20,7321.01,0.00
2024-12-08 16:55:55,75,5788,32,43,4021.58,7321.13,0.00
2024-12-08 16:55:55,75,5789,32,43,4090.07,7322.00,0.00
2024-12-08 16:55:55,76,5789,33,43,4036.25,7322.01,0.00
2024-12-08 16:55:55,75,5789,32,43,4032.56,7322.37,0.00
2024-12-08 16:55:55,76,5788,32,44,3969.93,7322.53,0.00
2024-12-08 16:55:55,76,5789,32,44,4026.28,7323.00,0.00
2024-12-08 16:55:55,77,5789,33,44,3973.99,7323.01,0.00
2024-12-08 16:55:55,76,5789,33,43,4024.36,7323.03,0.00
2024-12-08 16:55:55,75,5789,33,42,4067.28,7323.12,0.00
2024-12-08 16:55:55,75,5790,33,42,4123.85,7324.00,0.00
2024-12-08 16:55:55,76,5790,33,43,4069.59,7324.01,0.00
2024-12-08 16:55:55,75,5790,32,43,4017.17,7324.76,0.00
2024-12-08 16:55:55,75,5791,32,43,4084.42,7325.00,0.00
2024-12-08 16:55:55,76,5791,32,44,4030.68,7325.01,0.00
2024-12-08 16:55:55,75,5791,31,44,4082.47,7325.03,0.00
2024-12-08 16:55:55,76,5790,32,44,4001.79,7325.16,0.00
2024-12-08 16:55:55,76,5791,32,44,4063.65,7326.00,0.00
2024-12-08 16:55:55,77,5791,32,45,4010.87,7326.01,0.00
2024-12-08 16:55:55,78,5790,33,45,3954.77,7326.10,0.00
2024-12-08 16:55:55,77,5790,33,44,4053.82,7326.22,0.00
2024-12-08 16:55:55,76,5790,33,43,4099.15,7326.33,0.00
2024-12-08 16:55:55,76,5791,33,43,4208.55,7327.00,0.00
2024-12-08 16:55:55,77,5791,34,43,4153.90,7327.01,0.00
2024-12-08 16:55:55,78,5790,34,44,4019.57,7327.76,0.00
2024-12-08 16:55:55,78,5791,34,44,4193.29,7328.00,0.00
2024-12-08 16:55:55,79,5791,35,44,4140.21,7328.01,0.00
2024-12-08 16:55:56,79,5792,35,44,4186.01,7329.00,0.00
2024-12-08 16:55:56,80,5792,35,45,4133.69,7329.01,0.00
2024-12-08 16:55:56,79,5792,34,45,4184.16,7329.03,0.00
2024-12-08 16:55:56,78,5792,33,45,4215.05,7329.08,0.00
2024-12-08 16:55:56,79,5791,33,46,4136.39,7329.42,0.00
2024-12-08 16:55:56,78,5791,32,46,4199.97,7329.73,0.00
2024-12-08 16:55:56,78,5792,32,46,4241.29,7330.00,0.00
2024-12-08 16:55:56,79,5792,32,47,4187.60,7330.01,0.00
2024-12-08 16:55:56,80,5791,33,47,4058.90,7330.61,0.00
2024-12-08 16:55:56,80,5792,33,47,4175.48,7331.00,0.00
2024-12-08 16:55:56,81,5792,33,48,4123.93,7331.01,0.00
2024-12-08 16:55:56,80,5792,33,47,4157.16,7331.06,0.00
2024-12-08 16:55:56,79,5792,32,47,4079.64,7331.92,0.00
2024-12-08 16:55:56,79,5793,32,47,4247.56,7332.00,0.00
2024-12-08 16:55:56,80,5793,32,48,4194.46,7332.01,0.00
2024-12-08 16:55:56,79,5793,31,48,4245.70,7332.03,0.00
2024-12-08 16:55:56,78,5793,30,48,4232.18,7332.17,0.00
2024-12-08 16:55:56,78,5794,30,48,4205.18,7333.00,0.00
2024-12-08 16:55:56,79,5794,30,49,4151.95,7333.01,0.00
2024-12-08 16:55:56,78,5794,30,48,4195.79,7333.06,0.00
2024-12-08 16:55:56,77,5794,29,48,4201.77,7333.21,0.00
2024-12-08 16:55:56,76,5794,29,47,4192.28,7333.86,0.00
2024-12-08 16:55:56,76,5795,29,47,4261.30,7334.00,0.00
2024-12-08 16:55:56,77,5795,29,48,4205.96,7334.01,0.00
2024-12-08 16:55:56,76,5795,29,47,4259.38,7334.03,0.00
2024-12-08 16:55:56,76,5796,29,47,4216.83,7335.00,0.00
2024-12-08 16:55:56,77,5796,29,48,4162.06,7335.01,0.00
2024-12-08 16:55:56,76,5796,29,47,4082.48,7335.92,0.00
2024-12-08 16:55:56,76,5797,29,47,4173.28,7336.00,0.00
2024-12-08 16:55:56,77,5797,30,47,4119.08,7336.01,0.00
2024-12-08 16:55:56,77,5798,30,47,4080.22,7337.00,0.00
2024-12-08 16:55:56,78,5798,30,48,4027.91,7337.01,0.00
2024-12-08 16:55:56,77,5798,30,47,4078.32,7337.03,0.00
2024-12-08 16:55:56,76,5798,29,47,4002.16,7337.76,0.00
2024-12-08 16:55:56,76,5799,29,47,4081.53,7338.00,0.00
2024-12-08 16:55:56,77,5799,29,48,4028.53,7338.01,0.00
2024-12-08 16:55:56,76,5799,29,47,4065.38,7338.04,0.00
2024-12-08 16:55:56,75,5799,28,47,4089.55,7338.31,0.00
2024-12-08 16:55:56,76,5798,28,48,4006.55,7338.68,0.00
2024-12-08 16:55:56,76,5799,28,48,4089.05,7339.00,0.00
2024-12-08 16:55:56,77,5799,28,49,4035.95,7339.01,0.00
2024-12-08 16:55:56,76,5799,28,48,4062.68,7339.07,0.00
2024-12-08 16:55:56,75,5799,27,48,4085.22,7339.32,0.00
2024-12-08 16:55:56,75,5800,27,48,4225.17,7340.00,0.00
2024-12-08 16:55:56,76,5800,28,48,4169.57,7340.01,0.00
2024-12-08 16:55:56,75,5800,28,47,4194.55,7340.07,0.00
2024-12-08 16:55:56,74,5800,27,47,4216.77,7340.34,0.00
2024-12-08 16:55:56,74,5801,27,47,4259.68,7341.00,0.00
2024-12-08 16:55:56,75,5801,27,48,4202.89,7341.01,0.00
2024-12-08 16:55:56,74,5801,27,47,4232.64,7341.07,0.00
2024-12-08 16:55:56,73,5801,26,47,4239.79,7341.43,0.00
2024-12-08 16:55:56,73,5802,26,47,4293.66,7342.00,0.00
2024-12-08 16:55:56,74,5802,27,47,4235.63,7342.01,0.00
2024-12-08 16:55:56,73,5802,27,46,4286.24,7342.03,0.00
2024-12-08 16:55:56,72,5802,26,46,4249.17,7342.56,0.00
2024-12-08 16:55:56,72,5803,26,46,4314.67,7343.00,0.00
2024-12-08 16:55:56,73,5803,26,47,4255.57,7343.01,0.00
2024-12-08 16:55:56,72,5803,26,46,4292.24,7343.06,0.00
2024-12-08 16:55:56,72,5804,26,46,4276.69,7344.00,0.00
2024-12-08 16:55:56,73,5804,27,46,4218.11,7344.01,0.00
2024-12-08 16:55:56,73,5805,27,46,4178.17,7345.00,0.00
2024-12-08 16:55:56,74,5805,27,47,4121.71,7345.01,0.00
2024-12-08 16:55:56,73,5805,27,46,4166.12,7345.08,0.00
2024-12-08 16:55:56,73,5806,27,46,4150.81,7346.00,0.00
2024-12-08 16:55:56,74,5806,27,47,4094.72,7346.01,0.00
2024-12-08 16:55:56,73,5806,27,46,4138.73,7346.03,0.00
2024-12-08 16:55:56,72,5806,26,46,4169.69,7346.03,0.00
2024-12-08 16:55:56,71,5806,26,45,4205.25,7346.28,0.00
2024-12-08 16:55:56,71,5807,26,45,4250.53,7347.00,0.00
2024-12-08 16:55:56,72,5807,26,46,4191.49,7347.01,0.00
2024-12-08 16:55:56,72,5808,26,46,4154.17,7348.00,0.00
2024-12-08 16:55:56,73,5808,27,46,4097.27,7348.01,0.00
2024-12-08 16:55:56,72,5808,27,45,4143.98,7348.07,0.00
2024-12-08 16:55:56,73,5807,28,45,4057.19,7348.51,0.00
2024-12-08 16:55:56,73,5808,28,45,4174.80,7349.00,0.00
2024-12-08 16:55:56,74,5808,28,46,4118.38,7349.01,0.00
2024-12-08 16:55:56,73,5808,27,46,4135.79,7349.14,0.00
2024-12-08 16:55:56,73,5809,27,46,4267.49,7350.00,0.00
2024-12-08 16:55:56,74,5809,27,47,4209.82,7350.01,0.00
2024-12-08 16:55:56,73,5809,27,46,4241.33,7350.08,0.00
2024-12-08 16:55:56,72,5809,26,46,4236.13,7350.53,0.00
2024-12-08 16:55:56,72,5810,26,46,4296.99,7351.00,0.00
2024-12-08 16:55:56,73,5810,26,47,4238.13,7351.01,0.00
2024-12-08 16:55:56,72,5810,25,47,4246.02,7351.29,0.00
2024-12-08 16:55:56,72,5811,25,47,4289.74,7352.00,0.00
2024-12-08 16:55:56,73,5811,25,48,4230.97,7352.01,0.00
2024-12-08 16:55:56,72,5811,25,47,4274.44,7352.10,0.00
2024-12-08 16:55:56,71,5811,24,47,4320.19,7352.23,0.00
2024-12-08 16:55:56,71,5812,24,47,4360.69,7353.00,0.00
2024-12-08 16:55:56,72,5812,25,47,4300.13,7353.01,0.00
2024-12-08 16:55:56,71,5812,24,47,4322.40,7353.11,0.00
2024-12-08 16:55:56,70,5812,24,46,4330.81,7353.49,0.00
2024-12-08 16:55:57,70,5813,24,46,4384.70,7354.00,0.00
2024-12-08 16:55:57,71,5813,24,47,4322.95,7354.01,0.00
2024-12-08 16:55:57,70,5813,24,46,4366.86,7354.11,0.00
2024-12-08 16:55:57,70,5814,24,46,4313.18,7355.00,0.00
2024-12-08 16:55:57,71,5814,24,47,4252.43,7355.01,0.00
2024-12-08 16:55:57,71,5815,24,47,4155.41,7356.00,0.00
2024-12-08 16:55:57,72,5815,24,48,4097.69,7356.01,0.00
2024-12-08 16:55:57,71,5815,24,47,4139.16,7356.11,0.00
2024-12-08 16:55:57,72,5814,24,48,4055.95,7356.40,0.00
2024-12-08 16:55:57,71,5814,23,48,4065.21,7356.97,0.00
2024-12-08 16:55:57,71,5815,23,48,4166.46,7357.00,0.00
2024-12-08 16:55:57,72,5815,23,49,4108.59,7357.01,0.00
2024-12-08 16:55:57,71,5815,22,49,3994.78,7357.89,0.00
2024-12-08 16:55:57,71,5816,22,49,4149.63,7358.00,0.00
2024-12-08 16:55:57,72,5816,22,50,4092.00,7358.01,0.00
2024-12-08 16:55:57,71,5816,22,49,4130.99,7358.11,0.00
2024-12-08 16:55:57,70,5816,21,49,4168.04,7358.19,0.00
2024-12-08 16:55:57,69,5816,20,49,4189.76,7358.36,0.00
2024-12-08 16:55:57,70,5815,20,50,4100.63,7358.76,0.00
2024-12-08 16:55:57,70,5816,20,50,4163.21,7359.00,0.00
2024-12-08 16:55:57,71,5816,20,51,4104.58,7359.01,0.00
2024-12-08 16:55:57,70,5816,20,50,4123.43,7359.17,0.00
2024-12-08 16:55:57,69,5816,20,49,4041.55,7359.96,0.00
2024-12-08 16:55:57,69,5817,20,49,4251.70,7360.00,0.00
2024-12-08 16:55:57,70,5817,20,50,4190.96,7360.01,0.00
2024-12-08 16:55:57,69,5817,20,49,4231.45,7360.13,0.00
2024-12-08 16:55:57,68,5817,19,49,4237.69,7360.46,0.00
2024-12-08 16:55:57,69,5816,20,49,4173.10,7360.52,0.00
2024-12-08 16:55:57,69,5817,20,49,4254.03,7361.00,0.00
2024-12-08 16:55:57,70,5817,20,50,4193.26,7361.01,0.00
2024-12-08 16:55:57,69,5817,19,50,4215.64,7361.12,0.00
2024-12-08 16:55:57,68,5817,19,49,4273.39,7361.12,0.00
2024-12-08 16:55:57,68,5818,19,49,4386.59,7362.00,0.00
2024-12-08 16:55:57,69,5818,20,49,4323.01,7362.02,0.00
2024-12-08 16:55:57,68,5818,19,49,4344.38,7362.12,0.00
2024-12-08 16:55:57,67,5818,18,49,4316.76,7362.70,0.00
2024-12-08 16:55:57,67,5819,18,49,4378.35,7363.00,0.00
2024-12-08 16:55:57,68,5819,18,50,4313.96,7363.02,0.00
2024-12-08 16:55:57,67,5819,18,49,4351.98,7363.12,0.00
2024-12-08 16:55:57,67,5820,18,49,4287.70,7364.00,0.00
2024-12-08 16:55:57,68,5820,18,50,4224.65,7364.02,0.00
2024-12-08 16:55:57,67,5820,17,50,4248.17,7364.18,0.00
2024-12-08 16:55:57,66,5820,17,49,4220.69,7364.85,0.00
2024-12-08 16:55:57,66,5821,17,49,4316.01,7365.00,0.00
2024-12-08 16:55:57,67,5821,17,50,4251.59,7365.02,0.00
2024-12-08 16:55:57,68,5820,18,50,4112.07,7365.38,0.00
2024-12-08 16:55:57,67,5820,17,50,4194.11,7365.58,0.00
2024-12-08 16:55:57,67,5821,17,50,4243.59,7366.00,0.00
2024-12-08 16:55:57,68,5821,18,50,4181.19,7366.02,0.00
2024-12-08 16:55:57,67,5821,17,50,4194.34,7366.13,0.00
2024-12-08 16:55:57,66,5821,16,50,4189.43,7366.62,0.00
2024-12-08 16:55:57,66,5822,16,50,4371.85,7367.00,0.00
2024-12-08 16:55:57,67,5822,17,50,4306.60,7367.02,0.00
2024-12-08 16:55:57,66,5822,17,49,4355.13,7367.18,0.00
2024-12-08 16:55:57,66,5823,17,49,4337.08,7368.00,0.00
2024-12-08 16:55:57,67,5823,17,50,4272.34,7368.02,0.00
2024-12-08 16:55:57,67,5824,17,50,4229.09,7369.00,0.00
2024-12-08 16:55:57,68,5824,18,50,4166.90,7369.02,0.00
2024-12-08 16:55:57,67,5824,18,49,4226.89,7369.03,0.00
2024-12-08 16:55:57,66,5824,17,49,4140.53,7369.97,0.00
2024-12-08 16:55:57,66,5825,17,49,4249.98,7370.00,0.00
2024-12-08 16:55:57,67,5825,18,49,4186.55,7370.02,0.00
2024-12-08 16:55:57,66,5825,18,48,4247.75,7370.03,0.00
2024-12-08 16:55:57,65,5825,18,47,4296.10,7370.08,0.00
2024-12-08 16:55:57,64,5825,17,47,4334.37,7370.27,0.00
2024-12-08 16:55:57,64,5826,17,47,4366.96,7371.00,0.00
2024-12-08 16:55:57,65,5826,18,47,4299.78,7371.02,0.00
2024-12-08 16:55:57,64,5826,17,47,4364.66,7371.03,0.00
2024-12-08 16:55:57,63,5826,17,46,4425.77,7371.13,0.00
2024-12-08 16:55:57,63,5827,17,46,4402.64,7372.00,0.00
2024-12-08 16:55:57,64,5827,18,46,4333.85,7372.02,0.00
2024-12-08 16:55:57,64,5828,18,46,4286.87,7373.00,0.00
2024-12-08 16:55:57,65,5828,18,47,4220.92,7373.02,0.00
2024-12-08 16:55:57,64,5828,18,46,4255.79,7373.13,0.00
2024-12-08 16:55:57,63,5828,18,45,4261.05,7373.68,0.00
2024-12-08 16:55:57,63,5829,18,45,4302.71,7374.00,0.00
2024-12-08 16:55:57,64,5829,18,46,4235.48,7374.02,0.00
2024-12-08 16:55:57,63,5829,17,46,4245.23,7374.29,0.00
2024-12-08 16:55:57,62,5829,16,46,4309.06,7374.31,0.00
2024-12-08 16:55:57,62,5830,16,46,4367.22,7375.00,0.00
2024-12-08 16:55:57,63,5830,17,46,4297.90,7375.02,0.00
2024-12-08 16:55:57,62,5830,16,46,4366.03,7375.02,0.00
2024-12-08 16:55:57,61,5830,15,46,4436.40,7375.02,0.00
2024-12-08 16:55:57,62,5829,15,47,4307.44,7375.45,0.00
2024-12-08 16:55:57,61,5829,14,47,4395.71,7375.77,0.00
2024-12-08 16:55:57,61,5830,14,47,4499.87,7376.00,0.00
2024-12-08 16:55:57,62,5830,15,47,4427.29,7376.02,0.00
2024-12-08 16:55:57,61,5830,15,46,4479.33,7376.10,0.00
2024-12-08 16:55:57,61,5831,15,46,4596.86,7377.00,0.00
2024-12-08 16:55:57,62,5831,15,47,4522.72,7377.02,0.00
2024-12-08 16:55:57,61,5831,14,47,4595.66,7377.02,0.00
2024-12-08 16:55:57,61,5832,14,47,4563.55,7378.00,0.00
2024-12-08 16:55:57,62,5832,15,47,4489.94,7378.02,0.00
2024-12-08 16:55:57,61,5832,15,46,4536.95,7378.08,0.00
2024-12-08 16:55:57,60,5832,14,46,4611.35,7378.10,0.00
2024-12-08 16:55:57,60,5833,14,46,4606.27,7379.00,0.00
2024-12-08 16:55:57,61,5833,14,47,4530.76,7379.02,0.00
2024-12-08 16:55:58,61,5834,14,47,4509.86,7380.00,0.00
2024-12-08 16:55:58,62,5834,15,47,4437.12,7380.02,0.00
2024-12-08 16:55:58,63,5833,16,47,4305.26,7380.44,0.00
2024-12-08 16:55:58,63,5834,16,47,4369.63,7381.00,0.00
2024-12-08 16:55:58,64,5834,16,48,4301.36,7381.02,0.00
2024-12-08 16:55:58,63,5834,16,47,4351.03,7381.08,0.00
2024-12-08 16:55:58,62,5834,15,47,4345.16,7381.76,0.00
2024-12-08 16:55:58,62,5835,15,47,4556.52,7382.00,0.00
2024-12-08 16:55:58,63,5835,16,47,4484.20,7382.02,0.00
2024-12-08 16:55:58,63,5836,16,47,4438.62,7383.00,0.00
2024-12-08 16:55:58,64,5836,17,47,4369.27,7383.02,0.00
2024-12-08 16:55:58,63,5836,17,46,4437.45,7383.02,0.00
2024-12-08 16:55:58,62,5836,17,45,4486.41,7383.06,0.00
2024-12-08 16:55:58,62,5837,17,45,4462.94,7384.00,0.00
2024-12-08 16:55:58,63,5837,17,46,4392.10,7384.02,0.00
2024-12-08 16:55:58,63,5838,17,46,4308.30,7385.00,0.00
2024-12-08 16:55:58,64,5838,18,46,4240.98,7385.02,0.00
2024-12-08 16:55:58,63,5838,18,45,4287.21,7385.06,0.00
2024-12-08 16:55:58,62,5838,18,44,4317.66,7385.21,0.00
2024-12-08 16:55:58,61,5838,17,44,4327.52,7385.72,0.00
2024-12-08 16:55:58,61,5839,17,44,4407.60,7386.00,0.00
2024-12-08 16:55:58,62,5839,17,45,4336.50,7386.02,0.00
2024-12-08 16:55:58,62,5840,17,45,4275.56,7387.00,0.00
2024-12-08 16:55:58,63,5840,17,46,4207.69,7387.02,0.00
2024-12-08 16:55:58,62,5840,17,45,4270.06,7387.06,0.00
2024-12-08 16:55:58,62,5841,17,45,4238.48,7388.00,0.00
2024-12-08 16:55:58,63,5841,18,45,4171.20,7388.02,0.00
2024-12-08 16:55:58,62,5841,17,45,4233.95,7388.06,0.00
2024-12-08 16:55:58,61,5841,17,44,4265.82,7388.25,0.00
2024-12-08 16:55:58,60,5841,17,43,4283.59,7388.78,0.00
2024-12-08 16:55:58,60,5842,17,43,4384.54,7389.00,0.00
2024-12-08 16:55:58,61,5842,17,44,4312.67,7389.02,0.00
2024-12-08 16:55:58,60,5842,17,43,4361.15,7389.07,0.00
2024-12-08 16:55:58,60,5843,17,43,4352.83,7390.00,0.00
2024-12-08 16:55:58,61,5843,18,43,4281.47,7390.02,0.00
2024-12-08 16:55:58,61,5844,18,43,4248.74,7391.00,0.00
2024-12-08 16:55:58,62,5844,19,43,4180.22,7391.02,0.00
2024-12-08 16:55:58,61,5844,19,42,4225.73,7391.07,0.00
2024-12-08 16:55:58,61,5845,19,42,4216.72,7392.00,0.00
2024-12-08 16:55:58,62,5845,19,43,4148.71,7392.02,0.00
2024-12-08 16:55:58,62,5846,19,43,4115.33,7393.00,0.00
2024-12-08 16:55:58,63,5846,20,43,4050.01,7393.02,0.00
2024-12-08 16:55:58,62,5846,20,42,4093.87,7393.06,0.00
2024-12-08 16:55:58,61,5846,19,42,4111.79,7393.66,0.00
2024-12-08 16:55:58,61,5847,19,42,4194.58,7394.00,0.00
2024-12-08 16:55:58,62,5847,19,43,4126.92,7394.02,0.00
2024-12-08 16:55:58,62,5848,19,43,4094.90,7395.00,0.00
2024-12-08 16:55:58,63,5848,19,44,4029.91,7395.02,0.00
2024-12-08 16:55:58,62,5848,19,43,4073.44,7395.06,0.00
2024-12-08 16:55:58,62,5849,19,43,4060.27,7396.00,0.00
2024-12-08 16:55:58,63,5849,20,43,3995.83,7396.02,0.00
2024-12-08 16:55:58,62,5849,19,43,3919.75,7396.97,0.00
2024-12-08 16:55:58,62,5850,19,43,4036.68,7397.00,0.00
2024-12-08 16:55:58,63,5850,20,43,3972.61,7397.02,0.00
2024-12-08 16:55:58,62,5850,20,42,4016.41,7397.06,0.00
2024-12-08 16:55:58,62,5851,20,42,3998.65,7398.00,0.00
2024-12-08 16:55:58,63,5851,20,43,3935.18,7398.02,0.00
2024-12-08 16:55:58,63,5852,20,43,3897.33,7399.00,0.00
2024-12-08 16:55:58,64,5852,20,44,3836.43,7399.02,0.00
2024-12-08 16:55:58,63,5852,20,43,3877.37,7399.08,0.00
2024-12-08 16:55:58,62,5852,20,42,3885.09,7399.60,0.00
2024-12-08 16:55:58,61,5852,19,42,3862.40,7399.89,0.00
2024-12-08 16:55:58,60,5852,18,42,3892.17,7399.97,0.00
2024-12-08 16:55:58,60,5853,18,42,4013.05,7400.00,0.00
2024-12-08 16:55:58,61,5853,18,43,3947.26,7400.02,0.00
2024-12-08 16:55:58,60,5853,17,43,3881.11,7400.73,0.00
2024-12-08 16:55:58,60,5854,17,43,3982.64,7401.00,0.00
2024-12-08 16:55:58,61,5854,18,43,3917.35,7401.02,0.00
2024-12-08 16:55:58,60,5854,18,42,3961.67,7401.08,0.00
2024-12-08 16:55:58,59,5854,17,42,4014.10,7401.27,0.00
2024-12-08 16:55:58,58,5854,16,42,4015.02,7401.57,0.00
2024-12-08 16:55:58,58,5855,16,42,4109.32,7402.00,0.00
2024-12-08 16:55:58,59,5855,17,42,4039.67,7402.02,0.00
2024-12-08 16:55:58,58,5855,17,41,4078.70,7402.09,0.00
2024-12-08 16:55:58,58,5856,17,41,4086.48,7403.00,0.00
2024-12-08 16:55:58,59,5856,17,42,4017.22,7403.02,0.00
2024-12-08 16:55:58,58,5856,17,41,4054.85,7403.09,0.00
2024-12-08 16:55:58,58,5857,17,41,4062.74,7404.00,0.00
2024-12-08 16:55:58,59,5857,18,41,3993.88,7404.02,0.00
2024-12-08 16:55:58,59,5858,18,41,3976.47,7405.00,0.00
2024-12-08 16:55:58,60,5858,18,42,3910.20,7405.02,0.00
2024-12-08 16:55:58,59,5858,18,41,3959.83,7405.09,0.00
2024-12-08 16:55:58,58,5858,17,41,4023.02,7405.16,0.00
2024-12-08 16:55:58,59,5857,17,42,3944.86,7405.32,0.00
2024-12-08 16:55:58,58,5857,17,41,4047.66,7405.66,0.00
2024-12-08 16:55:58,57,5857,16,41,4113.51,7405.72,0.00
2024-12-08 16:55:58,57,5858,16,41,4170.91,7406.00,0.00
2024-12-08 16:55:58,58,5858,16,42,4099.00,7406.02,0.00
2024-12-08 16:55:58,57,5858,16,41,4169.61,7406.02,0.00
2024-12-08 16:55:58,56,5858,15,41,4208.36,7406.05,0.00
2024-12-08 16:55:58,55,5858,15,40,4266.70,7406.06,0.00
2024-12-08 16:55:59,55,5859,15,40,4464.54,7407.00,0.00
2024-12-08 16:55:59,56,5859,16,40,4384.82,7407.02,0.00
2024-12-08 16:55:59,55,5859,16,39,4463.20,7407.02,0.00
2024-12-08 16:55:59,55,5860,16,39,4444.75,7408.00,0.00
2024-12-08 16:55:59,56,5860,16,40,4365.38,7408.02,0.00
2024-12-08 16:55:59,55,5860,16,39,4427.24,7408.04,0.00
2024-12-08 16:55:59,55,5861,16,39,4435.60,7409.00,0.00
2024-12-08 16:55:59,56,5861,17,39,4356.39,7409.02,0.00
2024-12-08 16:55:59,55,5861,17,38,4434.25,7409.02,0.00
2024-12-08 16:55:59,55,5862,17,38,4450.64,7410.00,0.00
2024-12-08 16:55:59,56,5862,18,38,4371.17,7410.02,0.00
2024-12-08 16:55:59,56,5863,18,38,4369.84,7411.00,0.00
2024-12-08 16:55:59,57,5863,18,39,4293.18,7411.02,0.00
2024-12-08 16:55:59,57,5864,18,39,4272.95,7412.00,0.00
2024-12-08 16:55:59,58,5864,19,39,4199.28,7412.02,0.00
2024-12-08 16:55:59,57,5864,19,38,4259.96,7412.04,0.00
2024-12-08 16:55:59,56,5864,18,38,4292.54,7412.63,0.00
2024-12-08 16:55:59,56,5865,18,38,4344.45,7413.00,0.00
2024-12-08 16:55:59,57,5865,18,39,4268.23,7413.02,0.00
2024-12-08 16:55:59,57,5866,18,39,4249.87,7414.00,0.00
2024-12-08 16:55:59,58,5866,18,40,4176.59,7414.02,0.00
2024-12-08 16:55:59,57,5866,18,39,4232.96,7414.04,0.00
2024-12-08 16:55:59,56,5866,17,39,4230.08,7414.54,0.00
2024-12-08 16:55:59,56,5867,17,39,4328.41,7415.00,0.00
2024-12-08 16:55:59,57,5867,17,40,4252.47,7415.02,0.00
2024-12-08 16:55:59,56,5867,16,40,4272.90,7415.27,0.00
2024-12-08 16:55:59,56,5868,16,40,4351.51,7416.00,0.00
2024-12-08 16:55:59,57,5868,16,41,4275.17,7416.02,0.00
2024-12-08 16:55:59,57,5869,16,41,4258.45,7417.00,0.00
2024-12-08 16:55:59,58,5869,17,41,4185.03,7417.02,0.00
2024-12-08 16:55:59,57,5869,17,40,4237.64,7417.07,0.00
2024-12-08 16:55:59,56,5869,16,40,4251.65,7417.46,0.00
2024-12-08 16:55:59,56,5870,16,40,4343.63,7418.00,0.00
2024-12-08 16:55:59,57,5870,17,40,4267.42,7418.02,0.00
2024-12-08 16:55:59,57,5871,17,40,4249.18,7419.00,0.00
2024-12-08 16:55:59,58,5871,17,41,4175.92,7419.02,0.00
2024-12-08 16:55:59,57,5871,17,40,4229.67,7419.07,0.00
2024-12-08 16:55:59,57,5872,17,40,4239.34,7420.00,0.00
2024-12-08 16:55:59,58,5872,18,40,4166.25,7420.02,0.00
2024-12-08 16:55:59,57,5872,17,40,4145.40,7420.79,0.00
2024-12-08 16:55:59,57,5873,17,40,4260.13,7421.00,0.00
2024-12-08 16:55:59,58,5873,18,40,4186.68,7421.02,0.00
2024-12-08 16:55:59,57,5873,18,39,4241.91,7421.07,0.00
2024-12-08 16:55:59,57,5874,18,39,4251.59,7422.00,0.00
2024-12-08 16:55:59,58,5874,18,40,4178.28,7422.02,0.00
2024-12-08 16:55:59,57,5874,17,40,4168.40,7422.42,0.00
2024-12-08 16:55:59,57,5875,17,40,4256.06,7423.00,0.00
2024-12-08 16:55:59,58,5875,18,40,4182.68,7423.02,0.00
2024-12-08 16:55:59,57,5875,18,39,4227.45,7423.12,0.00
2024-12-08 16:55:59,56,5875,17,39,4261.03,7423.38,0.00
2024-12-08 16:55:59,56,5876,17,39,4347.65,7424.00,0.00
2024-12-08 16:55:59,57,5876,17,40,4271.37,7424.02,0.00
2024-12-08 16:55:59,57,5877,17,40,4255.57,7425.00,0.00
2024-12-08 16:55:59,58,5877,18,40,4182.20,7425.02,0.00
2024-12-08 16:55:59,57,5877,18,39,4229.55,7425.12,0.00
2024-12-08 16:55:59,57,5878,18,39,4243.12,7426.00,0.00
2024-12-08 16:55:59,58,5878,18,40,4169.96,7426.02,0.00
2024-12-08 16:55:59,58,5879,18,40,4117.07,7427.00,0.00
2024-12-08 16:55:59,59,5879,18,41,4047.29,7427.02,0.00
2024-12-08 16:55:59,58,5879,18,40,4113.24,7427.05,0.00
2024-12-08 16:55:59,57,5879,18,39,4164.58,7427.11,0.00
2024-12-08 16:55:59,56,5879,17,39,4199.47,7427.61,0.00
2024-12-08 16:55:59,56,5880,17,39,4257.43,7428.00,0.00
2024-12-08 16:55:59,57,5880,17,40,4182.74,7428.02,0.00
2024-12-08 16:55:59,56,5880,16,40,4138.00,7428.93,0.00
2024-12-08 16:55:59,55,5880,16,39,4167.60,7428.95,0.00
2024-12-08 16:55:59,55,5881,16,39,4260.15,7429.00,0.00
2024-12-08 16:55:59,56,5881,17,39,4184.08,7429.02,0.00
2024-12-08 16:55:59,55,5881,17,38,4230.48,7429.15,0.00
2024-12-08 16:55:59,54,5881,16,38,4255.18,7429.19,0.00
2024-12-08 16:55:59,54,5882,16,38,4286.45,7430.00,0.00
2024-12-08 16:55:59,55,5882,17,38,4208.51,7430.02,0.00
2024-12-08 16:55:59,54,5882,16,38,4162.92,7430.69,0.00
2024-12-08 16:55:59,53,5882,15,38,4174.79,7430.92,0.00
2024-12-08 16:55:59,53,5883,15,38,4309.44,7431.00,0.00
2024-12-08 16:55:59,54,5883,15,39,4229.64,7431.02,0.00
2024-12-08 16:55:59,53,5883,15,38,4271.63,7431.19,0.00
2024-12-08 16:55:59,53,5884,15,38,4292.12,7432.00,0.00
2024-12-08 16:55:59,54,5884,16,38,4212.64,7432.02,0.00
2024-12-08 16:55:59,53,5884,15,38,4243.09,7432.23,0.00
2024-12-08 16:55:59,53,5885,15,38,4320.99,7433.00,0.00
2024-12-08 16:55:59,54,5885,16,38,4240.97,7433.02,0.00
2024-12-08 16:55:59,54,5886,16,38,4216.66,7434.00,0.00
2024-12-08 16:55:59,55,5886,16,39,4139.99,7434.02,0.00
2024-12-08 16:55:59,54,5886,16,38,4201.56,7434.20,0.00
2024-12-08 16:55:59,54,5887,16,38,4217.27,7435.00,0.00
2024-12-08 16:55:59,55,5887,17,38,4140.59,7435.02,0.00
2024-12-08 16:55:59,55,5888,17,38,4124.17,7436.00,0.00
2024-12-08 16:56:00,56,5888,18,38,4050.52,7436.02,0.00
2024-12-08 16:56:00,56,5889,18,38,4012.32,7437.00,0.00
2024-12-08 16:56:00,57,5889,19,38,3941.93,7437.02,0.00
2024-12-08 16:56:00,56,5889,19,37,3985.76,7437.05,0.00
2024-12-08 16:56:00,55,5889,18,37,4049.91,7437.16,0.00
2024-12-08 16:56:00,55,5890,18,37,4047.99,7438.00,0.00
2024-12-08 16:56:00,56,5890,18,38,3975.70,7438.02,0.00
2024-12-08 16:56:00,55,5890,18,37,4025.38,7438.06,0.00
2024-12-08 16:56:00,54,5890,17,37,4032.82,7438.70,0.00
2024-12-08 16:56:00,54,5891,17,37,4093.64,7439.00,0.00
2024-12-08 16:56:00,55,5891,18,37,4019.21,7439.02,0.00
2024-12-08 16:56:00,54,5891,18,36,4086.76,7439.07,0.00
2024-12-08 16:56:00,54,5892,18,36,4092.61,7440.00,0.00
2024-12-08 16:56:00,55,5892,18,37,4018.20,7440.02,0.00
2024-12-08 16:56:00,55,5893,18,37,3991.40,7441.00,0.00
2024-12-08 16:56:00,56,5893,18,38,3920.13,7441.02,0.00
2024-12-08 16:56:00,55,5893,18,37,3990.05,7441.02,0.00
2024-12-08 16:56:00,54,5893,18,36,4059.82,7441.06,0.00
2024-12-08 16:56:00,54,5894,18,36,4061.98,7442.00,0.00
2024-12-08 16:56:00,55,5894,19,36,3988.13,7442.02,0.00
2024-12-08 16:56:00,54,5894,19,35,4033.07,7442.11,0.00
2024-12-08 16:56:00,54,5895,19,35,4036.20,7443.00,0.00
2024-12-08 16:56:00,55,5895,20,35,3962.82,7443.02,0.00
2024-12-08 16:56:00,55,5896,20,35,3941.10,7444.00,0.00
2024-12-08 16:56:00,56,5896,20,36,3870.73,7444.02,0.00
2024-12-08 16:56:00,56,5897,20,36,3839.12,7445.00,0.00
2024-12-08 16:56:00,57,5897,21,36,3771.76,7445.02,0.00
2024-12-08 16:56:00,56,5897,21,35,3833.81,7445.07,0.00
2024-12-08 16:56:00,56,5898,21,35,3833.43,7446.00,0.00
2024-12-08 16:56:00,57,5898,22,35,3766.17,7446.02,0.00
2024-12-08 16:56:00,56,5898,22,34,3832.10,7446.02,0.00
2024-12-08 16:56:00,55,5898,22,33,3878.78,7446.07,0.00
2024-12-08 16:56:00,54,5898,21,33,3848.42,7446.96,0.00
2024-12-08 16:56:00,54,5899,21,33,3983.58,7447.00,0.00
2024-12-08 16:56:00,55,5899,22,33,3911.16,7447.02,0.00
2024-12-08 16:56:00,54,5899,21,33,3912.89,7447.30,0.00
2024-12-08 16:56:00,54,5900,21,33,3986.12,7448.00,0.00
2024-12-08 16:56:00,55,5900,21,34,3913.64,7448.02,0.00
2024-12-08 16:56:00,54,5900,21,33,3958.55,7448.07,0.00
2024-12-08 16:56:00,53,5900,21,32,4010.88,7448.32,0.00
2024-12-08 16:56:00,52,5900,20,32,4054.08,7448.73,0.00
2024-12-08 16:56:00,52,5901,20,32,4118.62,7449.00,0.00
2024-12-08 16:56:00,53,5901,21,32,4040.91,7449.02,0.00
2024-12-08 16:56:00,53,5902,21,32,4016.87,7450.00,0.00
2024-12-08 16:56:00,54,5902,21,33,3942.49,7450.02,0.00
2024-12-08 16:56:00,53,5902,21,32,4010.24,7450.08,0.00
2024-12-08 16:56:00,53,5903,21,32,4010.19,7451.00,0.00
2024-12-08 16:56:00,54,5903,22,32,3935.93,7451.02,0.00
2024-12-08 16:56:00,54,5904,22,32,3909.41,7452.00,0.00
2024-12-08 16:56:00,55,5904,22,33,3838.33,7452.02,0.00
2024-12-08 16:56:00,54,5904,22,32,3883.20,7452.07,0.00
2024-12-08 16:56:00,53,5904,21,32,3867.71,7452.62,0.00
2024-12-08 16:56:00,53,5905,21,32,3975.31,7453.00,0.00
2024-12-08 16:56:00,54,5905,21,33,3901.69,7453.02,0.00
2024-12-08 16:56:00,55,5904,21,34,3798.25,7453.13,0.00
2024-12-08 16:56:00,55,5905,21,34,3874.19,7454.00,0.00
2024-12-08 16:56:00,56,5905,21,35,3805.01,7454.02,0.00
2024-12-08 16:56:00,55,5905,21,34,3848.45,7454.07,0.00
2024-12-08 16:56:00,54,5905,21,33,3899.81,7454.26,0.00
2024-12-08 16:56:00,54,5906,21,33,4056.69,7455.00,0.00
2024-12-08 16:56:00,55,5906,21,34,3982.93,7455.02,0.00
2024-12-08 16:56:00,55,5907,21,34,3968.92,7456.00,0.00
2024-12-08 16:56:00,56,5907,22,34,3898.05,7456.02,0.00
2024-12-08 16:56:00,55,5907,22,33,3936.43,7456.11,0.00
2024-12-08 16:56:00,56,5906,23,33,3808.90,7456.20,0.00
2024-12-08 16:56:00,55,5906,23,32,3935.45,7456.44,0.00
2024-12-08 16:56:00,54,5906,22,32,3987.42,7456.63,0.00
2024-12-08 16:56:00,54,5907,22,32,4091.62,7457.00,0.00
2024-12-08 16:56:00,55,5907,23,32,4017.23,7457.02,0.00
2024-12-08 16:56:00,54,5907,22,32,4054.37,7457.13,0.00
2024-12-08 16:56:00,53,5907,21,32,4084.99,7457.62,0.00
2024-12-08 16:56:00,53,5908,21,32,4288.35,7458.00,0.00
2024-12-08 16:56:00,54,5908,21,33,4208.93,7458.02,0.00
2024-12-08 16:56:00,53,5908,21,32,4261.64,7458.09,0.00
2024-12-08 16:56:00,52,5908,20,32,4311.34,7458.52,0.00
2024-12-08 16:56:00,52,5909,20,32,4346.95,7459.00,0.00
2024-12-08 16:56:00,53,5909,20,33,4264.94,7459.02,0.00
2024-12-08 16:56:00,52,5909,19,33,4273.80,7459.54,0.00
2024-12-08 16:56:00,51,5909,18,33,4351.78,7459.61,0.00
2024-12-08 16:56:00,51,5910,18,33,4414.02,7460.00,0.00
2024-12-08 16:56:00,52,5910,19,33,4329.13,7460.02,0.00
2024-12-08 16:56:00,51,5910,19,32,4384.79,7460.10,0.00
2024-12-08 16:56:00,50,5910,18,32,4366.25,7460.96,0.00
2024-12-08 16:56:00,50,5911,18,32,4512.50,7461.00,0.00
2024-12-08 16:56:00,51,5911,18,33,4424.02,7461.02,0.00
2024-12-08 16:56:00,51,5912,18,33,4411.19,7462.00,0.00
2024-12-08 16:56:00,52,5912,19,33,4326.36,7462.02,0.00
2024-12-08 16:56:00,51,5912,19,32,4380.49,7462.10,0.00
2024-12-08 16:56:00,51,5913,19,32,4393.51,7463.00,0.00
2024-12-08 16:56:00,52,5913,19,33,4309.02,7463.02,0.00
2024-12-08 16:56:01,52,5914,19,33,4327.22,7464.00,0.00
2024-12-08 16:56:01,53,5914,20,33,4245.57,7464.02,0.00
2024-12-08 16:56:01,52,5914,20,32,4324.36,7464.04,0.00
2024-12-08 16:56:01,52,5914,20,32,4334.72,7465.00,0.00
2024-12-08 16:56:01,53,5914,20,33,4252.93,7465.02,0.00
2024-12-08 16:56:01,53,5915,20,33,4242.09,7466.00,0.00
2024-12-08 16:56:01,54,5915,21,33,4163.53,7466.02,0.00
2024-12-08 16:56:01,54,5916,21,33,4127.35,7467.00,0.00
2024-12-08 16:56:01,55,5916,21,34,4052.31,7467.02,0.00
2024-12-08 16:56:01,54,5916,21,33,4109.40,7467.07,0.00
2024-12-08 16:56:01,53,5916,20,33,4136.67,7467.62,0.00
2024-12-08 16:56:01,53,5917,20,33,4172.42,7468.00,0.00
2024-12-08 16:56:01,54,5917,21,33,4095.15,7468.02,0.00
2024-12-08 16:56:01,54,5918,21,33,4049.40,7469.00,0.00
2024-12-08 16:56:01,55,5918,21,34,3975.78,7469.02,0.00
2024-12-08 16:56:01,54,5918,21,33,4028.68,7469.07,0.00
2024-12-08 16:56:01,53,5918,20,33,4091.32,7469.15,0.00
2024-12-08 16:56:01,52,5918,20,32,4095.40,7469.64,0.00
2024-12-08 16:56:01,52,5919,20,32,4212.02,7470.00,0.00
2024-12-08 16:56:01,53,5919,20,33,4132.55,7470.02,0.00
2024-12-08 16:56:01,52,5919,19,33,4207.50,7470.08,0.00
2024-12-08 16:56:01,52,5920,19,33,4192.99,7471.00,0.00
2024-12-08 16:56:01,53,5920,20,33,4113.88,7471.02,0.00
2024-12-08 16:56:01,52,5920,20,32,4170.03,7471.08,0.00
2024-12-08 16:56:01,52,5921,20,32,4174.39,7472.00,0.00
2024-12-08 16:56:01,53,5921,20,33,4095.63,7472.02,0.00
2024-12-08 16:56:01,52,5921,19,33,4052.24,7472.48,0.00
2024-12-08 16:56:01,51,5921,18,33,4128.00,7472.53,0.00
2024-12-08 16:56:01,51,5922,18,33,4224.28,7473.00,0.00
2024-12-08 16:56:01,52,5922,19,33,4143.04,7473.02,0.00
2024-12-08 16:56:01,51,5922,19,32,4202.13,7473.08,0.00
2024-12-08 16:56:01,50,5922,18,32,4239.92,7473.26,0.00
2024-12-08 16:56:01,50,5923,18,32,4308.26,7474.00,0.00
2024-12-08 16:56:01,51,5923,19,32,4223.79,7474.02,0.00
2024-12-08 16:56:01,50,5923,19,31,4265.22,7474.10,0.00
2024-12-08 16:56:01,49,5923,18,31,4327.10,7474.23,0.00
2024-12-08 16:56:01,49,5924,18,31,4385.75,7475.00,0.00
2024-12-08 16:56:01,50,5924,19,31,4298.04,7475.02,0.00
2024-12-08 16:56:01,49,5924,19,30,4359.84,7475.08,0.00
2024-12-08 16:56:01,48,5924,18,30,4443.82,7475.08,0.00
2024-12-08 16:56:01,48,5925,18,30,4426.12,7476.00,0.00
2024-12-08 16:56:01,49,5925,19,30,4335.79,7476.02,0.00
2024-12-08 16:56:01,48,5925,18,30,4423.01,7476.04,0.00
2024-12-08 16:56:01,47,5925,17,30,4432.92,7476.30,0.00
2024-12-08 16:56:01,46,5925,16,30,4498.69,7476.61,0.00
2024-12-08 16:56:01,46,5926,16,30,4585.79,7477.00,0.00
2024-12-08 16:56:01,47,5926,17,30,4488.22,7477.02,0.00
2024-12-08 16:56:01,46,5926,17,29,4554.93,7477.07,0.00
2024-12-08 16:56:01,45,5926,17,28,4565.65,7477.76,0.00
2024-12-08 16:56:01,45,5927,17,28,4647.26,7478.00,0.00
2024-12-08 16:56:01,46,5927,17,29,4546.24,7478.02,0.00
2024-12-08 16:56:01,45,5927,16,29,4531.14,7478.42,0.00
2024-12-08 16:56:01,45,5928,16,29,4615.06,7479.00,0.00
2024-12-08 16:56:01,46,5928,16,30,4514.74,7479.02,0.00
2024-12-08 16:56:01,46,5929,16,30,4463.83,7480.00,0.00
2024-12-08 16:56:01,47,5929,17,30,4368.86,7480.02,0.00
2024-12-08 16:56:01,46,5929,17,29,4432.96,7480.09,0.00
2024-12-08 16:56:01,45,5929,16,29,4528.91,7480.11,0.00
2024-12-08 16:56:01,44,5929,16,28,4568.78,7480.66,0.00
2024-12-08 16:56:01,44,5930,16,28,4623.26,7481.00,0.00
2024-12-08 16:56:01,45,5930,16,29,4520.52,7481.02,0.00
2024-12-08 16:56:01,45,5931,16,29,4482.05,7482.00,0.00
2024-12-08 16:56:01,46,5931,17,29,4384.61,7482.02,0.00
2024-12-08 16:56:01,45,5931,17,28,4452.14,7482.09,0.00
2024-12-08 16:56:01,45,5932,17,28,4445.21,7483.00,0.00
2024-12-08 16:56:01,46,5932,17,29,4348.57,7483.02,0.00
2024-12-08 16:56:01,45,5932,17,28,4272.74,7483.67,0.00
2024-12-08 16:56:01,45,5933,17,28,4414.34,7484.00,0.00
2024-12-08 16:56:01,46,5933,17,29,4318.38,7484.02,0.00
2024-12-08 16:56:01,45,5933,17,28,4377.78,7484.09,0.00
2024-12-08 16:56:01,44,5933,16,28,4398.96,7484.34,0.00
2024-12-08 16:56:01,43,5933,15,28,4486.56,7484.54,0.00
2024-12-08 16:56:01,43,5934,15,28,4626.14,7485.00,0.00
2024-12-08 16:56:01,44,5934,16,28,4521.00,7485.02,0.00
2024-12-08 16:56:01,43,5934,16,27,4624.39,7485.02,0.00
2024-12-08 16:56:01,42,5934,15,27,4645.95,7485.83,0.00
2024-12-08 16:56:01,42,5935,15,27,4811.85,7486.00,0.00
2024-12-08 16:56:01,43,5935,15,28,4699.94,7486.02,0.00
2024-12-08 16:56:01,43,5936,15,28,4702.74,7487.00,0.00
2024-12-08 16:56:01,44,5936,16,28,4595.86,7487.02,0.00
2024-12-08 16:56:01,43,5936,16,27,4664.46,7487.07,0.00
2024-12-08 16:56:01,43,5937,16,27,4699.33,7488.00,0.00
2024-12-08 16:56:01,44,5937,17,27,4592.53,7488.02,0.00
2024-12-08 16:56:01,44,5938,17,27,4593.05,7489.00,0.00
2024-12-08 16:56:01,45,5938,17,28,4490.98,7489.02,0.00
2024-12-08 16:56:01,45,5939,17,28,4481.13,7490.00,0.00
2024-12-08 16:56:01,46,5939,17,29,4383.72,7490.02,0.00
2024-12-08 16:56:01,45,5939,17,28,4447.86,7490.07,0.00
2024-12-08 16:56:01,45,5940,17,28,4432.09,7491.00,0.00
2024-12-08 16:56:01,46,5940,17,29,4335.74,7491.02,0.00
2024-12-08 16:56:02,46,5941,17,29,4280.78,7492.00,0.00
2024-12-08 16:56:02,47,5941,17,30,4189.69,7492.02,0.00
2024-12-08 16:56:02,46,5941,17,29,4249.84,7492.07,0.00
2024-12-08 16:56:02,45,5941,16,29,4267.54,7492.69,0.00
2024-12-08 16:56:02,44,5941,15,29,4349.43,7492.86,0.00
2024-12-08 16:56:02,44,5942,15,29,4509.61,7493.00,0.00
2024-12-08 16:56:02,45,5942,15,30,4409.40,7493.02,0.00
2024-12-08 16:56:02,44,5942,14,30,4410.32,7493.64,0.00
2024-12-08 16:56:02,44,5943,14,30,4553.66,7494.00,0.00
2024-12-08 16:56:02,45,5943,14,31,4452.47,7494.02,0.00
2024-12-08 16:56:02,44,5943,14,30,4550.27,7494.05,0.00
2024-12-08 16:56:02,43,5943,14,29,4624.72,7494.05,0.00
2024-12-08 16:56:02,42,5943,13,29,4698.86,7494.48,0.00
2024-12-08 16:56:02,41,5943,12,29,4771.17,7494.76,0.00
2024-12-08 16:56:02,41,5944,12,29,4935.89,7495.00,0.00
2024-12-08 16:56:02,42,5944,12,30,4818.37,7495.02,0.00
2024-12-08 16:56:02,42,5945,12,30,4818.73,7496.00,0.00
2024-12-08 16:56:02,43,5945,13,30,4706.66,7496.02,0.00
2024-12-08 16:56:02,42,5945,13,29,4782.63,7496.05,0.00
2024-12-08 16:56:02,41,5945,12,29,4839.37,7496.32,0.00
2024-12-08 16:56:02,41,5946,12,29,4971.52,7497.00,0.00
2024-12-08 16:56:02,42,5946,13,29,4853.16,7497.02,0.00
2024-12-08 16:56:02,42,5947,13,29,4852.95,7498.00,0.00
2024-12-08 16:56:02,43,5947,14,29,4740.09,7498.02,0.00
2024-12-08 16:56:02,42,5947,14,28,4811.46,7498.05,0.00
2024-12-08 16:56:02,42,5948,14,28,4842.84,7499.00,0.00
2024-12-08 16:56:02,43,5948,14,29,4730.21,7499.02,0.00
2024-12-08 16:56:02,43,5949,14,29,4724.77,7500.00,0.00
2024-12-08 16:56:02,44,5949,14,30,4617.39,7500.02,0.00
2024-12-08 16:56:02,43,5949,14,29,4683.49,7500.05,0.00
2024-12-08 16:56:02,42,5949,13,29,4685.10,7500.52,0.00
2024-12-08 16:56:02,42,5950,13,29,4820.13,7501.00,0.00
2024-12-08 16:56:02,43,5950,13,30,4708.03,7501.02,0.00
2024-12-08 16:56:02,44,5949,14,30,4596.37,7501.09,0.00
2024-12-08 16:56:02,44,5950,14,30,4729.44,7502.00,0.00
2024-12-08 16:56:02,45,5950,15,30,4624.34,7502.02,0.00
2024-12-08 16:56:02,45,5951,15,30,4825.24,7503.00,0.00
2024-12-08 16:56:02,46,5951,15,31,4720.34,7503.02,0.00
2024-12-08 16:56:02,45,5951,14,31,4747.81,7503.53,0.00
2024-12-08 16:56:02,45,5952,14,31,4854.75,7504.00,0.00
2024-12-08 16:56:02,46,5952,15,31,4749.21,7504.02,0.00
2024-12-08 16:56:02,45,5952,14,31,4793.10,7504.33,0.00
2024-12-08 16:56:02,45,5953,14,31,4867.96,7505.00,0.00
2024-12-08 16:56:02,46,5953,14,32,4762.13,7505.02,0.00
2024-12-08 16:56:02,46,5954,14,32,4748.45,7506.00,0.00
2024-12-08 16:56:02,47,5954,15,32,4647.42,7506.02,0.00
2024-12-08 16:56:02,46,5954,15,31,4720.71,7506.04,0.00
2024-12-08 16:56:02,45,5954,14,31,4739.51,7506.91,0.00
2024-12-08 16:56:02,45,5955,14,31,4899.72,7507.00,0.00
2024-12-08 16:56:02,46,5955,14,32,4793.21,7507.02,0.00
2024-12-08 16:56:02,45,5955,13,32,4797.97,7507.07,0.00
2024-12-08 16:56:02,45,5956,13,32,4889.95,7508.00,0.00
2024-12-08 16:56:02,46,5956,13,33,4783.64,7508.02,0.00
2024-12-08 16:56:02,45,5956,13,32,4859.92,7508.04,0.00
2024-12-08 16:56:02,45,5957,13,32,4880.99,7509.00,0.00
2024-12-08 16:56:02,46,5957,13,33,4774.88,7509.02,0.00
2024-12-08 16:56:02,46,5958,13,33,4761.54,7510.00,0.00
2024-12-08 16:56:02,47,5958,13,34,4660.23,7510.02,0.00
2024-12-08 16:56:02,47,5959,13,34,4648.78,7511.00,0.00
2024-12-08 16:56:02,48,5959,13,35,4551.93,7511.02,0.00
2024-12-08 16:56:02,47,5959,12,35,4562.88,7511.51,0.00
2024-12-08 16:56:02,47,5960,12,35,4685.36,7512.00,0.00
2024-12-08 16:56:02,48,5960,12,36,4587.74,7512.02,0.00
2024-12-08 16:56:02,47,5960,12,35,4680.57,7512.06,0.00
2024-12-08 16:56:02,46,5960,11,35,4712.22,7512.35,0.00
2024-12-08 16:56:02,46,5961,11,35,4826.75,7513.00,0.00
2024-12-08 16:56:02,47,5961,12,35,4724.05,7513.02,0.00
2024-12-08 16:56:02,47,5962,12,35,4713.39,7514.00,0.00
2024-12-08 16:56:02,48,5962,13,35,4615.20,7514.02,0.00
2024-12-08 16:56:02,47,5962,13,34,4678.23,7514.06,0.00
2024-12-08 16:56:02,47,5963,13,34,4697.02,7515.00,0.00
2024-12-08 16:56:02,48,5963,14,34,4599.16,7515.02,0.00
2024-12-08 16:56:02,47,5963,13,34,4654.47,7515.02,0.00
2024-12-08 16:56:02,47,5964,13,34,4705.54,7516.00,0.00
2024-12-08 16:56:02,48,5964,14,34,4607.50,7516.02,0.00
2024-12-08 16:56:02,47,5964,14,33,4693.83,7516.04,0.00
2024-12-08 16:56:02,46,5964,13,33,4766.82,7516.41,0.00
2024-12-08 16:56:02,46,5965,13,33,4821.20,7517.00,0.00
2024-12-08 16:56:02,47,5965,13,34,4718.62,7517.02,0.00
2024-12-08 16:56:02,46,5965,13,33,4780.05,7517.13,0.00
2024-12-08 16:56:02,47,5964,13,34,4645.04,7517.62,0.00
2024-12-08 16:56:02,47,5965,13,34,4800.54,7518.00,0.00
2024-12-08 16:56:02,48,5965,13,35,4700.53,7518.02,0.00
2024-12-08 16:56:02,47,5965,13,34,4771.75,7518.04,0.00
2024-12-08 16:56:02,47,5966,13,34,4956.36,7519.00,0.00
2024-12-08 16:56:02,48,5966,14,34,4853.10,7519.02,0.00
2024-12-08 16:56:02,48,5967,14,34,4846.28,7520.00,0.00
2024-12-08 16:56:02,49,5967,14,35,4747.38,7520.02,0.00
2024-12-08 16:56:02,48,5967,14,34,4813.38,7520.06,0.00
2024-12-08 16:56:02,49,5966,14,35,4713.62,7520.12,0.00
2024-12-08 16:56:03,49,5967,14,35,4885.79,7521.00,0.00
2024-12-08 16:56:03,50,5967,14,36,4788.07,7521.02,0.00
2024-12-08 16:56:03,50,5968,14,36,4929.76,7522.00,0.00
2024-12-08 16:56:03,51,5968,14,37,4833.10,7522.02,0.00
2024-12-08 16:56:03,50,5968,14,36,4927.22,7522.04,0.00
2024-12-08 16:56:03,49,5968,14,35,5000.14,7522.04,0.00
2024-12-08 16:56:03,49,5969,14,35,5020.26,7523.00,0.00
2024-12-08 16:56:03,50,5969,15,35,4919.86,7523.02,0.00
2024-12-08 16:56:03,50,5970,15,35,4915.41,7524.00,0.00
2024-12-08 16:56:03,51,5970,16,35,4819.03,7524.02,0.00
2024-12-08 16:56:03,51,5971,16,35,4803.54,7525.00,0.00
2024-12-08 16:56:03,52,5971,17,35,4711.17,7525.02,0.00
2024-12-08 16:56:03,51,5971,17,34,4791.74,7525.08,0.00
2024-12-08 16:56:03,51,5972,17,34,4809.99,7526.00,0.00
2024-12-08 16:56:03,52,5972,18,34,4717.49,7526.02,0.00
2024-12-08 16:56:03,51,5972,17,34,4759.71,7526.10,0.00
2024-12-08 16:56:03,50,5972,16,34,4818.48,7526.54,0.00
2024-12-08 16:56:03,50,5973,16,34,4934.74,7527.00,0.00
2024-12-08 16:56:03,51,5973,17,34,4837.98,7527.02,0.00
2024-12-08 16:56:03,51,5974,17,34,4820.93,7528.00,0.00
2024-12-08 16:56:03,52,5974,18,34,4728.22,7528.02,0.00
2024-12-08 16:56:03,51,5974,18,33,4819.45,7528.02,0.00
2024-12-08 16:56:03,50,5974,18,32,4908.32,7528.06,0.00
2024-12-08 16:56:03,50,5975,18,32,4924.58,7529.00,0.00
2024-12-08 16:56:03,51,5975,19,32,4828.02,7529.02,0.00
2024-12-08 16:56:03,50,5975,18,32,4913.52,7529.04,0.00
2024-12-08 16:56:03,50,5976,18,32,4957.30,7530.00,0.00
2024-12-08 16:56:03,51,5976,19,32,4860.10,7530.02,0.00
2024-12-08 16:56:03,51,5977,19,32,4839.55,7531.00,0.00
2024-12-08 16:56:03,52,5977,19,33,4746.49,7531.02,0.00
2024-12-08 16:56:03,51,5977,19,32,4835.13,7531.04,0.00
2024-12-08 16:56:03,51,5978,19,32,4845.04,7532.00,0.00
2024-12-08 16:56:03,52,5978,20,32,4751.87,7532.02,0.00
2024-12-08 16:56:03,52,5979,20,32,4737.07,7533.00,0.00
2024-12-08 16:56:03,53,5979,21,32,4647.69,7533.02,0.00
2024-12-08 16:56:03,53,5980,21,32,4624.15,7534.00,0.00
2024-12-08 16:56:03,54,5980,22,32,4538.52,7534.02,0.00
2024-12-08 16:56:03,53,5980,22,31,4615.62,7534.04,0.00
2024-12-08 16:56:03,53,5981,22,31,4620.56,7535.00,0.00
2024-12-08 16:56:03,54,5981,22,32,4535.00,7535.02,0.00
2024-12-08 16:56:03,53,5981,21,32,4552.81,7535.43,0.00
2024-12-08 16:56:03,53,5982,21,32,4599.87,7536.00,0.00
2024-12-08 16:56:03,54,5982,21,33,4514.69,7536.02,0.00
2024-12-08 16:56:03,54,5983,21,33,4453.37,7537.00,0.00
2024-12-08 16:56:03,55,5983,21,34,4372.40,7537.02,0.00
2024-12-08 16:56:03,54,5983,21,33,4447.79,7537.04,0.00
2024-12-08 16:56:03,53,5983,21,32,4524.61,7537.09,0.00
2024-12-08 16:56:03,52,5983,20,32,4537.10,7537.54,0.00
2024-12-08 16:56:03,52,5984,20,32,4633.18,7538.00,0.00
2024-12-08 16:56:03,53,5984,21,32,4545.76,7538.02,0.00
2024-12-08 16:56:03,53,5985,21,32,4482.58,7539.00,0.00
2024-12-08 16:56:03,54,5985,21,33,4399.57,7539.02,0.00
2024-12-08 16:56:03,53,5985,20,33,4419.21,7539.34,0.00
2024-12-08 16:56:03,53,5986,20,33,4432.04,7540.00,0.00
2024-12-08 16:56:03,54,5986,21,33,4349.97,7540.02,0.00
2024-12-08 16:56:03,53,5986,21,32,4427.78,7540.04,0.00
2024-12-08 16:56:03,53,5987,21,32,4415.35,7541.00,0.00
2024-12-08 16:56:03,54,5987,22,32,4333.59,7541.02,0.00
2024-12-08 16:56:03,53,5987,21,32,4340.39,7541.23,0.00
2024-12-08 16:56:03,54,5986,21,33,4218.42,7541.50,0.00
2024-12-08 16:56:03,54,5987,21,33,4445.50,7542.00,0.00
2024-12-08 16:56:03,55,5987,22,33,4364.67,7542.02,0.00
2024-12-08 16:56:03,54,5987,22,32,4384.13,7542.33,0.00
2024-12-08 16:56:03,54,5988,22,32,4552.83,7543.00,0.00
2024-12-08 16:56:03,55,5988,22,33,4470.05,7543.02,0.00
2024-12-08 16:56:03,54,5988,21,33,4551.56,7543.02,0.00
2024-12-08 16:56:03,53,5988,21,32,4636.02,7543.02,0.00
2024-12-08 16:56:03,53,5989,21,32,4645.29,7544.00,0.00
2024-12-08 16:56:03,54,5989,21,33,4559.26,7544.02,0.00
2024-12-08 16:56:03,54,5990,21,33,4545.53,7545.00,0.00
2024-12-08 16:56:03,55,5990,22,33,4462.89,7545.02,0.00
2024-12-08 16:56:03,54,5990,22,32,4517.59,7545.02,0.00
2024-12-08 16:56:03,55,5989,23,32,4406.48,7545.44,0.00
2024-12-08 16:56:03,54,5989,22,32,4513.10,7545.70,0.00
2024-12-08 16:56:03,54,5990,22,32,4630.68,7546.00,0.00
2024-12-08 16:56:03,55,5990,23,32,4546.49,7546.02,0.00
2024-12-08 16:56:03,55,5991,23,32,4675.43,7547.00,0.00
2024-12-08 16:56:03,56,5991,24,32,4591.94,7547.02,0.00
2024-12-08 16:56:03,56,5992,24,32,4572.33,7548.00,0.00
2024-12-08 16:56:03,57,5992,25,32,4492.11,7548.02,0.00
2024-12-08 16:56:03,56,5992,25,31,4569.63,7548.02,0.00
2024-12-08 16:56:03,56,5993,25,31,4576.98,7549.00,0.00
2024-12-08 16:56:03,57,5993,26,31,4496.68,7549.02,0.00
2024-12-08 16:56:03,58,5992,27,31,4359.51,7549.50,0.00
2024-12-08 16:56:03,58,5993,27,31,4441.45,7550.00,0.00
2024-12-08 16:56:03,59,5993,27,32,4366.17,7550.02,0.00
2024-12-08 16:56:03,58,5993,27,31,4414.20,7550.02,0.00
2024-12-08 16:56:04,57,5993,26,31,4434.54,7550.56,0.00
2024-12-08 16:56:04,57,5994,26,31,4663.04,7551.00,0.00
2024-12-08 16:56:04,58,5994,27,31,4582.65,7551.02,0.00
2024-12-08 16:56:04,58,5995,27,31,4541.60,7552.00,0.00
2024-12-08 16:56:04,59,5995,28,31,4464.62,7552.02,0.00
2024-12-08 16:56:04,58,5995,28,30,4515.56,7552.02,0.00
2024-12-08 16:56:04,58,5996,28,30,4488.91,7553.00,0.00
2024-12-08 16:56:04,59,5996,28,31,4412.83,7553.02,0.00
2024-12-08 16:56:04,59,5997,28,31,4368.05,7554.00,0.00
2024-12-08 16:56:04,60,5997,29,31,4295.25,7554.02,0.00
2024-12-08 16:56:04,59,5997,29,30,4343.72,7554.02,0.00
2024-12-08 16:56:04,59,5998,29,30,4317.11,7555.00,0.00
2024-12-08 16:56:04,60,5998,30,30,4245.16,7555.02,0.00
2024-12-08 16:56:04,60,5999,30,30,4202.08,7556.00,0.00
2024-12-08 16:56:04,61,5999,31,30,4133.20,7556.02,0.00
2024-12-08 16:56:04,60,5999,31,29,4179.41,7556.02,0.00
2024-12-08 16:56:04,60,6000,31,29,4152.86,7557.00,0.00
2024-12-08 16:56:04,61,6000,31,30,4084.78,7557.02,0.00
2024-12-08 16:56:04,61,6001,31,30,4038.77,7558.00,0.00
2024-12-08 16:56:04,62,6001,31,31,3973.63,7558.02,0.00
2024-12-08 16:56:04,61,6001,31,30,4029.05,7558.02,0.00
2024-12-08 16:56:04,60,6001,30,30,4039.73,7558.63,0.00
2024-12-08 16:56:04,60,6002,30,30,4073.67,7559.00,0.00
2024-12-08 16:56:04,61,6002,30,31,4006.89,7559.02,0.00
2024-12-08 16:56:04,61,6003,30,31,3973.22,7560.00,0.00
2024-12-08 16:56:04,62,6003,30,32,3909.13,7560.02,0.00
2024-12-08 16:56:04,61,6003,30,31,3953.39,7560.02,0.00
2024-12-08 16:56:04,60,6003,29,31,4011.80,7560.02,0.00
2024-12-08 16:56:04,59,6003,28,31,4032.67,7560.51,0.00
2024-12-08 16:56:04,59,6004,28,31,4113.92,7561.00,0.00
2024-12-08 16:56:04,60,6004,29,31,4045.36,7561.02,0.00
2024-12-08 16:56:04,59,6004,28,31,3993.86,7561.63,0.00
2024-12-08 16:56:04,58,6004,27,31,4045.31,7561.81,0.00
2024-12-08 16:56:04,58,6005,27,31,4156.39,7562.00,0.00
2024-12-08 16:56:04,59,6005,27,32,4085.94,7562.02,0.00
2024-12-08 16:56:04,58,6005,27,31,4131.63,7562.04,0.00
2024-12-08 16:56:04,57,6005,27,30,4178.02,7562.33,0.00
2024-12-08 16:56:04,56,6005,26,30,4245.18,7562.41,0.00
2024-12-08 16:56:04,55,6005,25,30,4314.81,7562.51,0.00
2024-12-08 16:56:04,55,6006,25,30,4350.99,7563.00,0.00
2024-12-08 16:56:04,56,6006,25,31,4273.29,7563.02,0.00
2024-12-08 16:56:04,55,6006,24,31,4224.12,7563.87,0.00
2024-12-08 16:56:04,55,6007,24,31,4352.11,7564.00,0.00
2024-12-08 16:56:04,56,6007,24,32,4274.40,7564.02,0.00
2024-12-08 16:56:04,55,6007,24,31,4327.37,7564.04,0.00
2024-12-08 16:56:04,54,6007,23,31,4325.71,7564.48,0.00
2024-12-08 16:56:04,54,6008,23,31,4413.08,7565.00,0.00
2024-12-08 16:56:04,55,6008,23,32,4332.85,7565.02,0.00
2024-12-08 16:56:04,55,6009,23,32,4298.97,7566.00,0.00
2024-12-08 16:56:04,56,6009,24,32,4222.21,7566.02,0.00
2024-12-08 16:56:04,55,6009,24,31,4220.57,7566.04,0.00
2024-12-08 16:56:04,55,6010,24,31,4258.08,7567.00,0.00
2024-12-08 16:56:04,56,6010,24,32,4182.04,7567.02,0.00
2024-12-08 16:56:04,56,6011,24,32,4139.60,7568.00,0.00
2024-12-08 16:56:04,57,6011,25,32,4066.97,7568.02,0.00
2024-12-08 16:56:04,56,6011,25,31,4116.63,7568.04,0.00
2024-12-08 16:56:04,55,6011,24,31,4139.73,7568.55,0.00
2024-12-08 16:56:04,55,6012,24,31,4164.68,7569.00,0.00
2024-12-08 16:56:04,56,6012,24,32,4090.31,7569.02,0.00
2024-12-08 16:56:04,56,6013,24,32,4043.63,7570.00,0.00
2024-12-08 16:56:04,57,6013,24,33,3972.69,7570.02,0.00
2024-12-08 16:56:04,56,6013,24,32,4020.65,7570.04,0.00
2024-12-08 16:56:04,55,6013,23,32,4022.99,7570.66,0.00
2024-12-08 16:56:04,55,6014,23,32,4065.93,7571.00,0.00
2024-12-08 16:56:04,56,6014,23,33,3993.32,7571.02,0.00
2024-12-08 16:56:04,56,6015,23,33,3957.51,7572.00,0.00
2024-12-08 16:56:04,57,6015,24,33,3888.08,7572.02,0.00
2024-12-08 16:56:04,56,6015,24,32,3933.17,7572.04,0.00
2024-12-08 16:56:04,55,6015,23,32,3916.03,7572.73,0.00
2024-12-08 16:56:04,55,6016,23,32,4012.66,7573.00,0.00
2024-12-08 16:56:04,56,6016,23,33,3941.01,7573.02,0.00
2024-12-08 16:56:04,55,6016,22,33,3849.27,7573.93,0.00
2024-12-08 16:56:04,55,6017,22,33,3981.52,7574.00,0.00
2024-12-08 16:56:04,56,6017,22,34,3910.43,7574.02,0.00
2024-12-08 16:56:04,55,6017,22,33,3958.12,7574.04,0.00
2024-12-08 16:56:04,54,6017,21,33,4027.23,7574.09,0.00
2024-12-08 16:56:04,53,6017,21,32,4021.56,7574.74,0.00
2024-12-08 16:56:04,53,6018,21,32,4087.52,7575.00,0.00
2024-12-08 16:56:04,54,6018,22,32,4011.83,7575.02,0.00
2024-12-08 16:56:04,53,6018,21,32,4012.39,7575.30,0.00
2024-12-08 16:56:04,52,6018,20,32,4065.85,7575.58,0.00
2024-12-08 16:56:04,52,6019,20,32,4176.19,7576.00,0.00
2024-12-08 16:56:04,53,6019,21,32,4097.39,7576.02,0.00
2024-12-08 16:56:04,52,6019,21,31,4152.88,7576.04,0.00
2024-12-08 16:56:04,52,6020,21,31,4153.29,7577.00,0.00
2024-12-08 16:56:04,53,6020,21,32,4074.93,7577.02,0.00
2024-12-08 16:56:04,52,6020,20,32,4151.83,7577.02,0.00
2024-12-08 16:56:04,52,6021,20,32,4131.18,7578.00,0.00
2024-12-08 16:56:04,53,6021,20,33,4053.23,7578.02,0.00
2024-12-08 16:56:04,52,6021,20,32,4110.77,7578.02,0.00
2024-12-08 16:56:05,51,6021,19,32,4142.02,7578.57,0.00
2024-12-08 16:56:05,51,6022,19,32,4189.71,7579.00,0.00
2024-12-08 16:56:05,52,6022,20,32,4109.14,7579.02,0.00
2024-12-08 16:56:05,52,6023,20,32,4086.80,7580.00,0.00
2024-12-08 16:56:05,53,6023,21,32,4009.69,7580.02,0.00
2024-12-08 16:56:05,52,6023,21,31,4067.85,7580.02,0.00
2024-12-08 16:56:05,51,6023,20,31,4136.56,7580.12,0.00
2024-12-08 16:56:05,51,6024,20,31,4147.60,7581.00,0.00
2024-12-08 16:56:05,52,6024,21,31,4067.84,7581.02,0.00
2024-12-08 16:56:05,52,6025,21,31,4050.08,7582.00,0.00
2024-12-08 16:56:05,53,6025,22,31,3973.67,7582.02,0.00
2024-12-08 16:56:05,52,6025,22,30,4020.82,7582.06,0.00
2024-12-08 16:56:05,51,6025,21,30,4001.40,7582.82,0.00
2024-12-08 16:56:05,51,6026,21,30,4136.83,7583.00,0.00
2024-12-08 16:56:05,52,6026,22,30,4057.27,7583.02,0.00
2024-12-08 16:56:05,52,6027,22,30,4036.99,7584.00,0.00
2024-12-08 16:56:05,53,6027,23,30,3960.82,7584.02,0.00
2024-12-08 16:56:05,52,6027,23,29,4009.97,7584.06,0.00
2024-12-08 16:56:05,51,6027,22,29,4082.67,7584.14,0.00
2024-12-08 16:56:05,51,6028,22,29,4093.46,7585.00,0.00
2024-12-08 16:56:05,52,6028,22,30,4014.74,7585.02,0.00
2024-12-08 16:56:05,51,6028,21,30,4092.47,7585.02,0.00
2024-12-08 16:56:05,50,6028,20,30,4134.01,7585.12,0.00
2024-12-08 16:56:05,49,6028,20,29,4173.50,7585.51,0.00
2024-12-08 16:56:05,48,6028,19,29,4234.14,7585.67,0.00
2024-12-08 16:56:05,48,6029,19,29,4367.15,7586.00,0.00
2024-12-08 16:56:05,49,6029,20,29,4278.03,7586.02,0.00
2024-12-08 16:56:05,48,6029,20,28,4342.77,7586.04,0.00
2024-12-08 16:56:05,48,6030,20,28,4363.76,7587.00,0.00
2024-12-08 16:56:05,49,6030,21,28,4274.71,7587.02,0.00
2024-12-08 16:56:05,48,6030,20,28,4245.73,7587.77,0.00
2024-12-08 16:56:05,48,6031,20,28,4386.60,7588.00,0.00
2024-12-08 16:56:05,49,6031,20,29,4297.08,7588.02,0.00
2024-12-08 16:56:05,48,6031,19,29,4385.46,7588.02,0.00
2024-12-08 16:56:05,47,6031,19,28,4474.15,7588.06,0.00
2024-12-08 16:56:05,47,6032,19,28,4466.19,7589.00,0.00
2024-12-08 16:56:05,48,6032,19,29,4373.14,7589.02,0.00
2024-12-08 16:56:05,47,6032,19,28,4454.91,7589.11,0.00
2024-12-08 16:56:05,47,6033,19,28,4481.70,7590.00,0.00
2024-12-08 16:56:05,48,6033,20,28,4388.33,7590.02,0.00
2024-12-08 16:56:05,48,6034,20,28,4392.03,7591.00,0.00
2024-12-08 16:56:05,49,6034,21,28,4302.40,7591.02,0.00
2024-12-08 16:56:05,48,6034,20,28,4387.31,7591.08,0.00
2024-12-08 16:56:05,47,6034,19,28,4420.71,7591.40,0.00
2024-12-08 16:56:05,47,6035,19,28,4534.42,7592.00,0.00
2024-12-08 16:56:05,48,6035,20,28,4439.96,7592.02,0.00
2024-12-08 16:56:05,47,6035,20,27,4523.13,7592.09,0.00
2024-12-08 16:56:05,46,6035,20,26,4611.27,7592.17,0.00
2024-12-08 16:56:05,46,6036,20,26,4644.19,7593.00,0.00
2024-12-08 16:56:05,47,6036,21,26,4545.38,7593.02,0.00
2024-12-08 16:56:05,46,6036,20,26,4570.00,7593.26,0.00
2024-12-08 16:56:05,46,6037,20,26,4673.89,7594.00,0.00
2024-12-08 16:56:05,47,6037,21,26,4574.45,7594.02,0.00
2024-12-08 16:56:05,47,6038,21,26,4555.69,7595.00,0.00
2024-12-08 16:56:05,48,6038,21,27,4460.78,7595.02,0.00
2024-12-08 16:56:05,47,6038,21,26,4547.63,7595.09,0.00
2024-12-08 16:56:05,47,6039,21,26,4562.08,7596.00,0.00
2024-12-08 16:56:05,48,6039,22,26,4467.04,7596.02,0.00
2024-12-08 16:56:05,48,6040,22,26,4453.77,7597.00,0.00
2024-12-08 16:56:05,49,6040,23,26,4362.88,7597.02,0.00
2024-12-08 16:56:05,48,6040,23,25,4415.80,7597.08,0.00
2024-12-08 16:56:05,47,6040,22,25,4423.63,7597.72,0.00
2024-12-08 16:56:05,47,6041,22,25,4562.68,7598.00,0.00
2024-12-08 16:56:05,48,6041,23,25,4467.62,7598.02,0.00
2024-12-08 16:56:05,48,6042,23,25,4452.43,7599.00,0.00
2024-12-08 16:56:05,49,6042,24,25,4361.57,7599.02,0.00
2024-12-08 16:56:05,48,6042,24,24,4414.46,7599.08,0.00
2024-12-08 16:56:05,48,6043,24,24,4420.60,7600.00,0.00
2024-12-08 16:56:05,49,6043,25,24,4330.38,7600.02,0.00
2024-12-08 16:56:05,49,6044,25,24,4312.09,7601.00,0.00
2024-12-08 16:56:05,50,6044,25,25,4225.85,7601.02,0.00
2024-12-08 16:56:05,50,6045,25,25,4188.45,7602.00,0.00
2024-12-08 16:56:05,51,6045,25,26,4106.32,7602.02,0.00
2024-12-08 16:56:05,50,6045,25,25,4179.34,7602.10,0.00
2024-12-08 16:56:05,49,6045,24,25,4152.30,7602.82,0.00
2024-12-08 16:56:05,49,6046,24,25,4293.64,7603.00,0.00
2024-12-08 16:56:05,50,6046,25,25,4207.77,7603.02,0.00
2024-12-08 16:56:05,50,6047,25,25,4189.44,7604.00,0.00
2024-12-08 16:56:05,51,6047,25,26,4107.30,7604.02,0.00
2024-12-08 16:56:05,50,6047,25,25,4151.44,7604.10,0.00
2024-12-08 16:56:05,50,6048,25,25,4155.80,7605.00,0.00
2024-12-08 16:56:05,51,6048,25,26,4074.31,7605.02,0.00
2024-12-08 16:56:05,50,6048,24,26,4085.85,7605.12,0.00
2024-12-08 16:56:05,49,6048,24,25,4139.36,7605.14,0.00
2024-12-08 16:56:05,48,6048,24,24,4217.69,7605.25,0.00
2024-12-08 16:56:05,48,6049,24,24,4311.15,7606.00,0.00
2024-12-08 16:56:05,49,6049,25,24,4223.17,7606.02,0.00
2024-12-08 16:56:05,48,6049,24,24,4304.90,7606.08,0.00
2024-12-08 16:56:05,47,6049,23,24,4294.22,7606.75,0.00
2024-12-08 16:56:05,47,6050,23,24,4436.86,7607.00,0.00
2024-12-08 16:56:05,48,6050,23,25,4344.42,7607.02,0.00
2024-12-08 16:56:05,47,6050,22,25,4347.15,7607.64,0.00
2024-12-08 16:56:06,47,6051,22,25,4417.05,7608.00,0.00
2024-12-08 16:56:06,48,6051,23,25,4325.02,7608.02,0.00
2024-12-08 16:56:06,47,6051,23,24,4397.66,7608.15,0.00
2024-12-08 16:56:06,47,6052,23,24,4419.48,7609.00,0.00
2024-12-08 16:56:06,48,6052,23,25,4327.41,7609.02,0.00
2024-12-08 16:56:06,48,6053,23,25,4332.99,7610.00,0.00
2024-12-08 16:56:06,49,6053,24,25,4244.56,7610.02,0.00
2024-12-08 16:56:06,48,6053,23,25,4246.20,7610.52,0.00
2024-12-08 16:56:06,48,6054,23,25,4313.80,7611.00,0.00
2024-12-08 16:56:06,49,6054,24,25,4225.76,7611.02,0.00
2024-12-08 16:56:06,48,6054,24,24,4278.97,7611.21,0.00
2024-12-08 16:56:06,47,6054,23,24,4347.23,7611.49,0.00
2024-12-08 16:56:06,47,6055,23,24,4405.91,7612.00,0.00
2024-12-08 16:56:06,48,6055,24,24,4314.12,7612.02,0.00
2024-12-08 16:56:06,48,6056,24,24,4330.05,7613.00,0.00
2024-12-08 16:56:06,49,6056,24,25,4241.68,7613.02,0.00
2024-12-08 16:56:06,49,6057,24,25,4233.86,7614.00,0.00
2024-12-08 16:56:06,50,6057,25,25,4149.19,7614.02,0.00
2024-12-08 16:56:06,49,6057,25,24,4202.83,7614.20,0.00
2024-12-08 16:56:06,49,6058,25,24,4235.24,7615.00,0.00
2024-12-08 16:56:06,50,6058,25,25,4150.54,7615.02,0.00
2024-12-08 16:56:06,49,6058,24,25,4222.74,7615.18,0.00
2024-12-08 16:56:06,49,6059,24,25,4249.80,7616.00,0.00
2024-12-08 16:56:06,50,6059,24,26,4164.80,7616.02,0.00
2024-12-08 16:56:06,50,6060,24,26,4153.36,7617.00,0.00
2024-12-08 16:56:06,51,6060,24,27,4071.92,7617.02,0.00
2024-12-08 16:56:06,50,6060,24,26,4127.50,7617.18,0.00
2024-12-08 16:56:06,49,6060,23,26,4149.51,7617.55,0.00
2024-12-08 16:56:06,49,6061,23,26,4271.10,7618.00,0.00
2024-12-08 16:56:06,50,6061,24,26,4185.67,7618.02,0.00
2024-12-08 16:56:06,50,6062,24,26,4187.09,7619.00,0.00
2024-12-08 16:56:06,51,6062,24,27,4104.99,7619.02,0.00
2024-12-08 16:56:06,50,6062,23,27,4163.23,7619.12,0.00
2024-12-08 16:56:06,50,6063,23,27,4203.06,7620.00,0.00
2024-12-08 16:56:06,51,6063,23,28,4120.65,7620.02,0.00
2024-12-08 16:56:06,50,6063,23,27,4201.54,7620.02,0.00
2024-12-08 16:56:06,49,6063,23,26,4265.54,7620.14,0.00
2024-12-08 16:56:06,49,6064,23,26,4274.59,7621.00,0.00
2024-12-08 16:56:06,50,6064,24,26,4189.10,7621.02,0.00
2024-12-08 16:56:06,49,6064,24,25,4273.04,7621.02,0.00
2024-12-08 16:56:06,48,6064,23,25,4301.28,7621.29,0.00
2024-12-08 16:56:06,47,6064,22,25,4322.07,7621.55,0.00
2024-12-08 16:56:06,47,6065,22,25,4450.50,7622.00,0.00
2024-12-08 16:56:06,48,6065,22,26,4357.78,7622.02,0.00
2024-12-08 16:56:06,48,6066,22,26,4326.54,7623.00,0.00
2024-12-08 16:56:06,49,6066,22,27,4238.25,7623.02,0.00
2024-12-08 16:56:06,48,6066,22,26,4295.01,7623.13,0.00
2024-12-08 16:56:06,48,6067,22,26,4307.13,7624.00,0.00
2024-12-08 16:56:06,49,6067,23,26,4219.23,7624.02,0.00
2024-12-08 16:56:06,48,6067,23,25,4222.95,7624.38,0.00
2024-12-08 16:56:06,47,6067,22,25,4263.61,7624.77,0.00
2024-12-08 16:56:06,47,6068,22,25,4408.18,7625.00,0.00
2024-12-08 16:56:06,48,6068,23,25,4316.34,7625.02,0.00
2024-12-08 16:56:06,47,6068,22,25,4400.76,7625.06,0.00
2024-12-08 16:56:06,47,6069,22,25,4394.84,7626.00,0.00
2024-12-08 16:56:06,48,6069,22,26,4303.28,7626.02,0.00
2024-12-08 16:56:06,47,6069,22,25,4380.26,7626.11,0.00
2024-12-08 16:56:06,46,6069,21,25,4435.97,7626.61,0.00
2024-12-08 16:56:06,46,6070,21,25,4505.89,7627.00,0.00
2024-12-08 16:56:06,47,6070,22,25,4410.02,7627.02,0.00
2024-12-08 16:56:06,46,6070,21,25,4472.73,7627.04,0.00
2024-12-08 16:56:06,46,6071,21,25,4533.02,7628.00,0.00
2024-12-08 16:56:06,47,6071,22,25,4436.57,7628.02,0.00
2024-12-08 16:56:06,46,6071,21,25,4531.36,7628.02,0.00
2024-12-08 16:56:06,46,6072,21,25,4523.66,7629.00,0.00
2024-12-08 16:56:06,47,6072,22,25,4427.41,7629.02,0.00
2024-12-08 16:56:06,46,6072,22,24,4515.38,7629.07,0.00
2024-12-08 16:56:06,46,6073,22,24,4544.16,7630.00,0.00
2024-12-08 16:56:06,47,6073,23,24,4447.47,7630.02,0.00
2024-12-08 16:56:06,47,6074,23,24,4454.28,7631.00,0.00
2024-12-08 16:56:06,48,6074,23,25,4361.48,7631.02,0.00
2024-12-08 16:56:06,47,6074,22,25,4377.47,7631.60,0.00
2024-12-08 16:56:06,47,6075,22,25,4444.34,7632.00,0.00
2024-12-08 16:56:06,48,6075,23,25,4351.75,7632.02,0.00
2024-12-08 16:56:06,47,6075,23,24,4437.86,7632.06,0.00
2024-12-08 16:56:06,47,6076,23,24,4460.62,7633.00,0.00
2024-12-08 16:56:06,48,6076,23,25,4367.69,7633.02,0.00
2024-12-08 16:56:06,47,6076,23,24,4457.24,7633.06,0.00
2024-12-08 16:56:06,47,6077,23,24,4445.96,7634.00,0.00
2024-12-08 16:56:06,48,6077,24,24,4353.33,7634.02,0.00
2024-12-08 16:56:06,47,6077,23,24,4437.85,7634.06,0.00
2024-12-08 16:56:06,47,6078,23,24,4434.41,7635.00,0.00
2024-12-08 16:56:06,48,6078,23,25,4342.03,7635.02,0.00
2024-12-08 16:56:06,47,6078,22,25,4264.29,7635.81,0.00
2024-12-08 16:56:06,47,6079,22,25,4330.34,7636.00,0.00
2024-12-08 16:56:06,48,6079,23,25,4240.12,7636.02,0.00
2024-12-08 16:56:06,47,6079,23,24,4323.85,7636.06,0.00
2024-12-08 16:56:06,47,6080,23,24,4281.59,7637.00,0.00
2024-12-08 16:56:06,48,6080,23,25,4192.39,7637.02,0.00
2024-12-08 16:56:07,47,6080,23,24,4184.02,7637.75,0.00
2024-12-08 16:56:07,46,6080,22,24,4180.38,7637.96,0.00
2024-12-08 16:56:07,46,6081,22,24,4343.13,7638.00,0.00
2024-12-08 16:56:07,47,6081,23,24,4250.72,7638.02,0.00
2024-12-08 16:56:07,46,6081,23,23,4304.95,7638.07,0.00
2024-12-08 16:56:07,45,6081,23,22,4298.95,7638.78,0.00
2024-12-08 16:56:07,45,6082,23,22,4383.98,7639.00,0.00
2024-12-08 16:56:07,46,6082,23,23,4288.68,7639.02,0.00
2024-12-08 16:56:07,46,6083,23,23,4302.86,7640.00,0.00
2024-12-08 16:56:07,47,6083,24,23,4211.31,7640.02,0.00
2024-12-08 16:56:07,46,6083,23,23,4191.35,7640.30,0.00
2024-12-08 16:56:07,46,6084,23,23,4304.75,7641.00,0.00
2024-12-08 16:56:07,47,6084,23,24,4213.16,7641.02,0.00
2024-12-08 16:56:07,46,6084,23,23,4289.82,7641.11,0.00
2024-12-08 16:56:07,46,6085,23,23,4321.93,7642.00,0.00
2024-12-08 16:56:07,47,6085,23,24,4229.97,7642.02,0.00
2024-12-08 16:56:07,46,6085,22,24,4240.69,7642.65,0.00
2024-12-08 16:56:07,46,6086,22,24,4337.27,7643.00,0.00
2024-12-08 16:56:07,47,6086,23,24,4244.99,7643.02,0.00
2024-12-08 16:56:07,46,6086,22,24,4234.63,7643.76,0.00
2024-12-08 16:56:07,46,6087,22,24,4316.24,7644.00,0.00
2024-12-08 16:56:07,47,6087,22,25,4224.40,7644.02,0.00
2024-12-08 16:56:07,46,6087,22,24,4299.65,7644.13,0.00
2024-12-08 16:56:07,46,6088,22,24,4333.42,7645.00,0.00
2024-12-08 16:56:07,47,6088,22,25,4241.22,7645.02,0.00
2024-12-08 16:56:07,47,6089,22,25,4259.04,7646.00,0.00
2024-12-08 16:56:07,48,6089,23,25,4170.31,7646.02,0.00
2024-12-08 16:56:07,47,6089,22,25,4183.61,7646.38,0.00
2024-12-08 16:56:07,47,6090,22,25,4299.55,7647.00,0.00
2024-12-08 16:56:07,48,6090,22,26,4209.97,7647.02,0.00
2024-12-08 16:56:07,47,6090,22,25,4273.55,7647.17,0.00
2024-12-08 16:56:07,47,6091,22,25,4308.24,7648.00,0.00
2024-12-08 16:56:07,48,6091,22,26,4218.49,7648.02,0.00
2024-12-08 16:56:07,48,6092,22,26,4238.40,7649.00,0.00
2024-12-08 16:56:07,49,6092,22,27,4151.90,7649.02,0.00
2024-12-08 16:56:07,50,6091,22,28,3989.61,7649.70,0.00
2024-12-08 16:56:07,49,6091,21,28,4038.12,7649.84,0.00
2024-12-08 16:56:07,49,6092,21,28,4181.88,7650.00,0.00
2024-12-08 16:56:07,50,6092,22,28,4098.24,7650.02,0.00
2024-12-08 16:56:07,49,6092,21,28,4169.41,7650.14,0.00
2024-12-08 16:56:07,48,6092,21,27,4232.40,7650.21,0.00
2024-12-08 16:56:07,48,6093,21,27,4488.44,7651.00,0.00
2024-12-08 16:56:07,49,6093,22,27,4396.84,7651.02,0.00
2024-12-08 16:56:07,49,6094,22,27,4400.20,7652.00,0.00
2024-12-08 16:56:07,50,6094,22,28,4312.20,7652.02,0.00
2024-12-08 16:56:07,49,6094,21,28,4396.83,7652.06,0.00
2024-12-08 16:56:07,49,6095,21,28,4374.59,7653.00,0.00
2024-12-08 16:56:07,50,6095,22,28,4287.10,7653.02,0.00
2024-12-08 16:56:07,49,6095,22,27,4346.52,7653.18,0.00
2024-12-08 16:56:07,48,6095,21,27,4296.58,7653.96,0.00
2024-12-08 16:56:07,48,6096,21,27,4452.87,7654.00,0.00
2024-12-08 16:56:07,49,6096,22,27,4361.99,7654.02,0.00
2024-12-08 16:56:07,48,6096,21,27,4350.98,7654.42,0.00
2024-12-08 16:56:07,48,6097,21,27,4438.41,7655.00,0.00
2024-12-08 16:56:07,49,6097,22,27,4347.83,7655.02,0.00
2024-12-08 16:56:07,49,6098,22,27,4310.58,7656.00,0.00
2024-12-08 16:56:07,50,6098,23,27,4224.37,7656.02,0.00
2024-12-08 16:56:07,49,6098,23,26,4282.51,7656.20,0.00
2024-12-08 16:56:07,49,6099,23,26,4288.72,7657.00,0.00
2024-12-08 16:56:07,50,6099,24,26,4202.95,7657.02,0.00
2024-12-08 16:56:07,49,6099,23,26,4197.40,7657.74,0.00
2024-12-08 16:56:07,49,6100,23,26,4279.31,7658.00,0.00
2024-12-08 16:56:07,50,6100,24,26,4193.73,7658.02,0.00
2024-12-08 16:56:07,50,6101,24,26,4166.08,7659.00,0.00
2024-12-08 16:56:07,51,6101,25,26,4084.39,7659.02,0.00
2024-12-08 16:56:07,50,6101,25,25,4164.55,7659.02,0.00
2024-12-08 16:56:07,49,6101,25,24,4226.14,7659.18,0.00
2024-12-08 16:56:07,49,6102,25,24,4241.31,7660.00,0.00
2024-12-08 16:56:07,50,6102,25,25,4156.48,7660.02,0.00
2024-12-08 16:56:07,49,6102,25,24,4239.74,7660.02,0.00
2024-12-08 16:56:07,49,6103,25,24,4134.77,7661.00,0.00
2024-12-08 16:56:07,50,6103,26,24,4052.07,7661.02,0.00
2024-12-08 16:56:07,49,6103,25,24,4073.81,7661.08,0.00
2024-12-08 16:56:07,48,6103,25,23,4054.76,7661.79,0.00
2024-12-08 16:56:07,48,6104,25,23,4198.56,7662.00,0.00
2024-12-08 16:56:07,49,6104,25,24,4112.87,7662.02,0.00
2024-12-08 16:56:07,48,6104,25,23,4179.43,7662.15,0.00
2024-12-08 16:56:07,48,6105,25,23,4201.99,7663.00,0.00
2024-12-08 16:56:07,49,6105,25,24,4116.24,7663.02,0.00
2024-12-08 16:56:07,48,6105,25,23,4074.00,7663.65,0.00
2024-12-08 16:56:07,48,6106,25,23,4206.77,7664.00,0.00
2024-12-08 16:56:07,49,6106,25,24,4120.92,7664.02,0.00
2024-12-08 16:56:07,48,6106,24,24,4198.82,7664.13,0.00
2024-12-08 16:56:07,47,6106,23,24,4252.73,7664.15,0.00
2024-12-08 16:56:07,47,6107,23,24,4347.00,7665.00,0.00
2024-12-08 16:56:07,48,6107,24,24,4256.44,7665.02,0.00
2024-12-08 16:56:07,47,6107,24,23,4330.72,7665.13,0.00
2024-12-08 16:56:07,46,6107,23,23,4378.30,7665.30,0.00
2024-12-08 16:56:07,46,6108,23,23,4486.65,7666.00,0.00
2024-12-08 16:56:07,47,6108,24,23,4391.19,7666.02,0.00
2024-12-08 16:56:08,47,6109,24,23,4398.67,7667.00,0.00
2024-12-08 16:56:08,48,6109,25,23,4307.03,7667.02,0.00
2024-12-08 16:56:08,47,6109,24,23,4282.41,7667.34,0.00
2024-12-08 16:56:08,47,6110,24,23,4390.98,7668.00,0.00
2024-12-08 16:56:08,48,6110,24,24,4299.50,7668.02,0.00
2024-12-08 16:56:08,47,6110,24,23,4373.06,7668.13,0.00
2024-12-08 16:56:08,47,6111,24,23,4399.64,7669.00,0.00
2024-12-08 16:56:08,48,6111,25,23,4307.98,7669.02,0.00
2024-12-08 16:56:08,47,6111,24,23,4304.54,7669.55,0.00
2024-12-08 16:56:08,47,6112,24,23,4428.13,7670.00,0.00
2024-12-08 16:56:08,48,6112,24,24,4335.88,7670.02,0.00
2024-12-08 16:56:08,48,6113,24,24,4315.62,7671.00,0.00
2024-12-08 16:56:08,49,6113,24,25,4227.55,7671.02,0.00
2024-12-08 16:56:08,48,6113,24,24,4298.07,7671.15,0.00
2024-12-08 16:56:08,48,6114,24,24,4316.51,7672.00,0.00
2024-12-08 16:56:08,49,6114,25,24,4228.42,7672.02,0.00
2024-12-08 16:56:08,48,6114,24,24,4252.75,7672.42,0.00
2024-12-08 16:56:08,48,6115,24,24,4311.36,7673.00,0.00
2024-12-08 16:56:08,49,6115,25,24,4223.38,7673.02,0.00
2024-12-08 16:56:08,49,6116,25,24,4197.23,7674.00,0.00
2024-12-08 16:56:08,50,6116,25,25,4113.28,7674.02,0.00
2024-12-08 16:56:08,49,6116,25,24,4183.16,7674.14,0.00
2024-12-08 16:56:08,48,6116,24,24,4215.57,7674.69,0.00
2024-12-08 16:56:08,48,6117,24,24,4287.75,7675.00,0.00
2024-12-08 16:56:08,49,6117,25,24,4200.25,7675.02,0.00
2024-12-08 16:56:08,48,6117,24,24,4165.11,7675.90,0.00
2024-12-08 16:56:08,48,6118,24,24,4317.10,7676.00,0.00
2024-12-08 16:56:08,49,6118,24,25,4228.99,7676.02,0.00
2024-12-08 16:56:08,49,6119,24,25,4216.53,7677.00,0.00
2024-12-08 16:56:08,50,6119,24,26,4132.20,7677.02,0.00
2024-12-08 16:56:08,49,6119,24,25,4205.58,7677.14,0.00
2024-12-08 16:56:08,49,6120,24,25,4232.90,7678.00,0.00
2024-12-08 16:56:08,50,6120,25,25,4148.24,7678.02,0.00
2024-12-08 16:56:08,50,6121,25,25,4150.70,7679.00,0.00
2024-12-08 16:56:08,51,6121,25,26,4069.31,7679.02,0.00
2024-12-08 16:56:08,50,6121,25,25,4109.25,7679.14,0.00
2024-12-08 16:56:08,50,6122,25,25,4133.01,7680.00,0.00
2024-12-08 16:56:08,51,6122,25,26,4051.98,7680.02,0.00
2024-12-08 16:56:08,51,6123,25,26,4052.29,7681.00,0.00
2024-12-08 16:56:08,52,6123,25,27,3974.36,7681.02,0.00
2024-12-08 16:56:08,51,6123,25,26,4013.15,7681.14,0.00
2024-12-08 16:56:08,50,6123,24,26,4050.23,7681.54,0.00
2024-12-08 16:56:08,50,6124,24,26,4167.69,7682.00,0.00
2024-12-08 16:56:08,51,6124,25,26,4085.97,7682.02,0.00
2024-12-08 16:56:08,50,6124,24,26,4135.43,7682.10,0.00
2024-12-08 16:56:08,50,6125,24,26,4186.27,7683.00,0.00
2024-12-08 16:56:08,51,6125,25,26,4104.18,7683.02,0.00
2024-12-08 16:56:08,50,6125,25,25,4147.86,7683.12,0.00
2024-12-08 16:56:08,50,6126,25,25,4168.19,7684.00,0.00
2024-12-08 16:56:08,51,6126,25,26,4086.46,7684.02,0.00
2024-12-08 16:56:08,50,6126,24,26,4166.66,7684.02,0.00
2024-12-08 16:56:08,50,6127,24,26,4171.93,7685.00,0.00
2024-12-08 16:56:08,51,6127,24,27,4090.13,7685.02,0.00
2024-12-08 16:56:08,51,6128,24,27,4070.31,7686.00,0.00
2024-12-08 16:56:08,52,6128,24,28,3992.03,7686.02,0.00
2024-12-08 16:56:08,51,6128,23,28,4068.80,7686.02,0.00
2024-12-08 16:56:08,50,6128,23,27,4133.28,7686.12,0.00
2024-12-08 16:56:08,49,6128,22,27,4212.96,7686.12,0.00
2024-12-08 16:56:08,49,6129,22,27,4291.19,7687.00,0.00
2024-12-08 16:56:08,50,6129,23,27,4205.36,7687.02,0.00
2024-12-08 16:56:08,49,6129,22,27,4284.92,7687.08,0.00
2024-12-08 16:56:08,49,6130,22,27,4326.74,7688.00,0.00
2024-12-08 16:56:08,50,6130,22,28,4240.21,7688.02,0.00
2024-12-08 16:56:08,50,6131,22,28,4212.16,7689.00,0.00
2024-12-08 16:56:08,51,6131,22,29,4129.57,7689.02,0.00
2024-12-08 16:56:08,50,6131,21,29,4207.55,7689.08,0.00
2024-12-08 16:56:08,49,6131,21,28,4285.58,7689.08,0.00
2024-12-08 16:56:08,49,6132,21,28,4291.77,7690.00,0.00
2024-12-08 16:56:08,50,6132,22,28,4205.93,7690.02,0.00
2024-12-08 16:56:08,49,6132,21,28,4290.20,7690.02,0.00
2024-12-08 16:56:08,48,6132,20,28,4331.52,7690.08,0.00
2024-12-08 16:56:08,48,6133,20,28,4401.62,7691.00,0.00
2024-12-08 16:56:08,49,6133,20,29,4311.79,7691.02,0.00
2024-12-08 16:56:08,48,6133,20,28,4394.67,7691.06,0.00
2024-12-08 16:56:08,47,6133,19,28,4461.25,7691.36,0.00
2024-12-08 16:56:08,47,6134,19,28,4510.78,7692.00,0.00
2024-12-08 16:56:08,48,6134,19,29,4416.80,7692.02,0.00
2024-12-08 16:56:08,47,6134,18,29,4456.14,7692.30,0.00
2024-12-08 16:56:08,47,6135,18,29,4479.54,7693.00,0.00
2024-12-08 16:56:08,48,6135,18,30,4386.21,7693.02,0.00
2024-12-08 16:56:08,47,6135,17,30,4366.89,7693.30,0.00
2024-12-08 16:56:08,47,6136,17,30,4431.05,7694.00,0.00
2024-12-08 16:56:08,48,6136,17,31,4338.74,7694.02,0.00
2024-12-08 16:56:08,47,6136,17,30,4421.23,7694.06,0.00
2024-12-08 16:56:08,46,6136,16,30,4458.30,7694.28,0.00
2024-12-08 16:56:08,46,6137,16,30,4522.97,7695.00,0.00
2024-12-08 16:56:08,47,6137,16,31,4426.74,7695.02,0.00
2024-12-08 16:56:08,46,6137,15,31,4396.81,7695.59,0.00
2024-12-08 16:56:08,45,6137,15,30,4483.58,7695.67,0.00
2024-12-08 16:56:08,45,6138,15,30,4629.20,7696.00,0.00
2024-12-08 16:56:09,46,6138,16,30,4528.57,7696.02,0.00
2024-12-08 16:56:09,45,6138,15,30,4571.95,7696.27,0.00
2024-12-08 16:56:09,45,6139,15,30,4687.05,7697.00,0.00
2024-12-08 16:56:09,46,6139,15,31,4585.16,7697.02,0.00
2024-12-08 16:56:09,45,6139,14,31,4685.34,7697.02,0.00
2024-12-08 16:56:09,44,6139,14,30,4784.83,7697.05,0.00
2024-12-08 16:56:09,44,6140,14,30,4816.94,7698.00,0.00
2024-12-08 16:56:09,45,6140,14,31,4709.90,7698.02,0.00
2024-12-08 16:56:09,45,6141,14,31,4715.54,7699.00,0.00
2024-12-08 16:56:09,46,6141,14,32,4613.03,7699.02,0.00
2024-12-08 16:56:09,45,6141,13,32,4642.30,7699.49,0.00
2024-12-08 16:56:09,45,6142,13,32,4773.23,7700.00,0.00
2024-12-08 16:56:09,46,6142,13,33,4669.47,7700.02,0.00
2024-12-08 16:56:09,45,6142,13,32,4768.10,7700.04,0.00
2024-12-08 16:56:09,44,6142,12,32,4787.43,7700.46,0.00
2024-12-08 16:56:09,44,6143,12,32,4917.35,7701.00,0.00
2024-12-08 16:56:09,45,6143,12,33,4808.07,7701.02,0.00
2024-12-08 16:56:09,45,6144,12,33,4805.05,7702.00,0.00
2024-12-08 16:56:09,46,6144,12,34,4700.59,7702.02,0.00
2024-12-08 16:56:09,45,6144,12,33,4767.39,7702.04,0.00
2024-12-08 16:56:09,44,6144,11,33,4770.64,7702.89,0.00
2024-12-08 16:56:09,44,6145,11,33,4937.05,7703.00,0.00
2024-12-08 16:56:09,45,6145,11,34,4827.33,7703.02,0.00
2024-12-08 16:56:09,44,6145,10,34,4854.84,7703.21,0.00
2024-12-08 16:56:09,44,6146,10,34,4960.83,7704.00,0.00
2024-12-08 16:56:09,45,6146,10,35,4850.59,7704.02,0.00
2024-12-08 16:56:09,44,6146,9,35,4941.57,7704.02,0.00
2024-12-08 16:56:09,45,6145,9,36,4756.72,7704.60,0.00
2024-12-08 16:56:09,45,6146,9,36,4939.68,7705.00,0.00
2024-12-08 16:56:09,46,6146,9,37,4832.29,7705.02,0.00
2024-12-08 16:56:09,45,6146,9,36,4937.97,7705.02,0.00
2024-12-08 16:56:09,44,6146,8,36,4996.55,7705.61,0.00
2024-12-08 16:56:09,44,6147,8,36,5302.30,7706.00,0.00
2024-12-08 16:56:09,45,6147,8,37,5184.47,7706.02,0.00
2024-12-08 16:56:09,45,6148,8,37,5151.93,7707.00,0.00
2024-12-08 16:56:09,46,6148,9,37,5039.93,7707.02,0.00
2024-12-08 16:56:09,45,6148,8,37,5101.80,7707.09,0.00
2024-12-08 16:56:09,44,6148,7,37,5141.69,7707.64,0.00
2024-12-08 16:56:09,44,6149,7,37,5284.34,7708.00,0.00
2024-12-08 16:56:09,45,6149,8,37,5166.91,7708.02,0.00
2024-12-08 16:56:09,44,6149,8,36,5280.85,7708.05,0.00
2024-12-08 16:56:09,44,6150,8,36,5309.82,7709.00,0.00
2024-12-08 16:56:09,45,6150,8,37,5191.83,7709.02,0.00
2024-12-08 16:56:09,45,6151,8,37,5171.37,7710.00,0.00
2024-12-08 16:56:09,46,6151,8,38,5058.95,7710.02,0.00
2024-12-08 16:56:09,45,6151,8,37,5135.40,7710.04,0.00
2024-12-08 16:56:09,45,6152,8,37,5152.37,7711.00,0.00
2024-12-08 16:56:09,46,6152,8,38,5040.36,7711.02,0.00
2024-12-08 16:56:09,45,6152,7,38,5004.94,7711.96,0.00
2024-12-08 16:56:09,45,6153,7,38,5172.91,7712.00,0.00
2024-12-08 16:56:09,46,6153,8,38,5060.46,7712.02,0.00
2024-12-08 16:56:09,45,6153,8,37,5135.22,7712.04,0.00
2024-12-08 16:56:09,45,6154,8,37,5157.68,7713.00,0.00
2024-12-08 16:56:09,46,6154,8,38,5045.55,7713.02,0.00
2024-12-08 16:56:09,46,6155,8,38,5030.22,7714.00,0.00
2024-12-08 16:56:09,47,6155,8,39,4923.19,7714.02,0.00
2024-12-08 16:56:09,46,6155,7,39,4889.18,7714.89,0.00
2024-12-08 16:56:09,46,6156,7,39,5048.59,7715.00,0.00
2024-12-08 16:56:09,47,6156,8,39,4941.17,7715.02,0.00
2024-12-08 16:56:09,46,6156,8,38,5031.83,7715.07,0.00
2024-12-08 16:56:09,46,6157,8,38,5037.15,7716.00,0.00
2024-12-08 16:56:09,47,6157,9,38,4929.98,7716.02,0.00
2024-12-08 16:56:09,46,6157,8,38,4906.28,7716.37,0.00
2024-12-08 16:56:09,46,6158,8,38,5025.30,7717.00,0.00
2024-12-08 16:56:09,47,6158,8,39,4918.38,7717.02,0.00
2024-12-08 16:56:09,46,6158,8,38,4969.33,7717.17,0.00
2024-12-08 16:56:09,46,6159,8,38,5004.18,7718.00,0.00
2024-12-08 16:56:09,47,6159,9,38,4897.70,7718.02,0.00
2024-12-08 16:56:09,46,6159,9,37,4990.77,7718.07,0.00
2024-12-08 16:56:09,46,6160,9,37,5016.22,7719.00,0.00
2024-12-08 16:56:09,47,6160,9,38,4909.49,7719.02,0.00
2024-12-08 16:56:09,46,6160,8,38,4930.74,7719.26,0.00
2024-12-08 16:56:09,46,6161,8,38,5037.86,7720.00,0.00
2024-12-08 16:56:09,47,6161,9,38,4930.67,7720.02,0.00
2024-12-08 16:56:09,46,6161,8,38,4900.51,7720.94,0.00
2024-12-08 16:56:09,46,6162,8,38,5063.37,7721.00,0.00
2024-12-08 16:56:09,47,6162,8,39,4955.64,7721.02,0.00
2024-12-08 16:56:09,46,6162,8,38,5053.31,7721.07,0.00
2024-12-08 16:56:09,46,6163,8,38,5076.74,7722.00,0.00
2024-12-08 16:56:09,47,6163,8,39,4968.73,7722.02,0.00
2024-12-08 16:56:09,47,6164,8,39,4969.59,7723.00,0.00
2024-12-08 16:56:09,48,6164,8,40,4866.05,7723.02,0.00
2024-12-08 16:56:09,48,6165,8,40,4848.61,7724.00,0.00
2024-12-08 16:56:09,49,6165,8,41,4749.66,7724.02,0.00
2024-12-08 16:56:09,48,6165,8,40,4826.11,7724.15,0.00
2024-12-08 16:56:09,47,6165,7,40,4831.87,7724.85,0.00
2024-12-08 16:56:09,47,6166,7,40,4984.84,7725.00,0.00
2024-12-08 16:56:09,48,6166,8,40,4880.99,7725.02,0.00
2024-12-08 16:56:10,47,6166,7,40,4858.24,7725.79,0.00
2024-12-08 16:56:10,47,6167,7,40,5006.36,7726.00,0.00
2024-12-08 16:56:10,48,6167,7,41,4902.06,7726.02,0.00
2024-12-08 16:56:10,47,6167,6,41,4966.92,7726.09,0.00
2024-12-08 16:56:10,47,6167,6,41,4987.11,7727.00,0.00
2024-12-08 16:56:10,48,6167,6,42,4883.21,7727.02,0.00
2024-12-08 16:56:10,47,6167,6,41,4985.47,7727.02,0.00
2024-12-08 16:56:10,47,6168,6,41,4999.98,7728.00,0.00
2024-12-08 16:56:10,48,6168,7,41,4895.82,7728.02,0.00
2024-12-08 16:56:10,47,6168,6,41,4963.81,7728.06,0.00
2024-12-08 16:56:10,46,6168,5,41,4962.71,7728.96,0.00
2024-12-08 16:56:10,46,6169,5,41,5127.40,7729.00,0.00
2024-12-08 16:56:10,47,6169,6,41,5018.30,7729.02,0.00
2024-12-08 16:56:10,46,6169,6,40,5107.23,7729.02,0.00
2024-12-08 16:56:10,46,6170,6,40,5120.91,7730.00,0.00
2024-12-08 16:56:10,47,6170,7,40,5011.95,7730.02,0.00
2024-12-08 16:56:10,47,6171,7,40,4990.37,7731.00,0.00
2024-12-08 16:56:10,48,6171,7,41,4886.41,7731.02,0.00
2024-12-08 16:56:10,47,6171,7,40,4955.83,7731.04,0.00
2024-12-08 16:56:10,47,6172,7,40,4966.22,7732.00,0.00
2024-12-08 16:56:10,48,6172,8,40,4862.76,7732.02,0.00
2024-12-08 16:56:10,47,6172,8,39,4906.55,7732.17,0.00
2024-12-08 16:56:10,47,6173,8,39,4941.69,7733.00,0.00
2024-12-08 16:56:10,48,6173,8,40,4838.74,7733.02,0.00
2024-12-08 16:56:10,47,6173,8,39,4936.75,7733.04,0.00
2024-12-08 16:56:10,46,6173,7,39,4946.04,7733.94,0.00
2024-12-08 16:56:10,46,6174,7,39,5109.16,7734.00,0.00
2024-12-08 16:56:10,47,6174,8,39,5000.45,7734.02,0.00
2024-12-08 16:56:10,47,6175,8,39,4994.01,7735.00,0.00
2024-12-08 16:56:10,48,6175,9,39,4889.97,7735.02,0.00
2024-12-08 16:56:10,48,6176,9,39,4879.32,7736.00,0.00
2024-12-08 16:56:10,49,6176,9,40,4779.74,7736.02,0.00
2024-12-08 16:56:10,48,6176,9,39,4876.09,7736.04,0.00
2024-12-08 16:56:10,48,6177,9,39,4899.29,7737.00,0.00
2024-12-08 16:56:10,49,6177,9,40,4799.31,7737.02,0.00
2024-12-08 16:56:10,48,6177,8,40,4898.19,7737.02,0.00
2024-12-08 16:56:10,48,6178,8,40,4889.87,7738.00,0.00
2024-12-08 16:56:10,49,6178,8,41,4790.07,7738.02,0.00
2024-12-08 16:56:10,48,6178,8,40,4857.62,7738.02,0.00
2024-12-08 16:56:10,47,6178,7,40,4873.52,7738.85,0.00
2024-12-08 16:56:10,47,6179,7,40,5026.75,7739.00,0.00
2024-12-08 16:56:10,48,6179,7,41,4922.03,7739.02,0.00
2024-12-08 16:56:10,48,6180,7,41,4911.64,7740.00,0.00
2024-12-08 16:56:10,49,6180,8,41,4811.40,7740.02,0.00
2024-12-08 16:56:10,48,6180,8,40,4877.78,7740.02,0.00
2024-12-08 16:56:10,48,6181,8,40,4899.37,7741.00,0.00
2024-12-08 16:56:10,49,6181,9,40,4799.39,7741.02,0.00
2024-12-08 16:56:10,48,6181,8,40,4818.83,7741.65,0.00
2024-12-08 16:56:10,48,6182,8,40,4952.97,7742.00,0.00
2024-12-08 16:56:10,49,6182,9,40,4851.89,7742.02,0.00
2024-12-08 16:56:10,48,6182,9,39,4920.71,7742.02,0.00
2024-12-08 16:56:10,48,6183,9,39,4942.32,7743.00,0.00
2024-12-08 16:56:10,49,6183,9,40,4841.45,7743.02,0.00
2024-12-08 16:56:10,49,6184,9,40,4837.36,7744.00,0.00
2024-12-08 16:56:10,50,6184,9,41,4740.62,7744.02,0.00
2024-12-08 16:56:10,49,6184,8,41,4716.71,7744.82,0.00
2024-12-08 16:56:10,49,6185,8,41,4860.69,7745.00,0.00
2024-12-08 16:56:10,50,6185,8,42,4763.47,7745.02,0.00
2024-12-08 16:56:10,49,6185,8,41,4849.64,7745.08,0.00
2024-12-08 16:56:10,50,6184,8,42,4723.50,7745.44,0.00
2024-12-08 16:56:10,50,6185,8,42,4832.37,7746.00,0.00
2024-12-08 16:56:10,51,6185,9,42,4737.62,7746.02,0.00
2024-12-08 16:56:10,50,6185,8,42,4720.89,7746.78,0.00
2024-12-08 16:56:10,50,6186,8,42,5013.89,7747.00,0.00
2024-12-08 16:56:10,51,6186,9,42,4915.57,7747.02,0.00
2024-12-08 16:56:10,51,6187,9,42,4865.07,7748.00,0.00
2024-12-08 16:56:10,52,6187,10,42,4771.52,7748.02,0.00
2024-12-08 16:56:10,51,6187,10,41,4857.49,7748.08,0.00
2024-12-08 16:56:10,51,6188,10,41,4840.74,7749.00,0.00
2024-12-08 16:56:10,52,6188,10,42,4747.65,7749.02,0.00
2024-12-08 16:56:10,53,6187,10,43,4531.47,7749.57,0.00
2024-12-08 16:56:10,53,6188,10,43,4703.08,7750.00,0.00
2024-12-08 16:56:10,54,6188,11,43,4615.99,7750.02,0.00
2024-12-08 16:56:10,53,6188,10,43,4702.30,7750.02,0.00
2024-12-08 16:56:10,53,6189,10,43,4799.86,7751.00,0.00
2024-12-08 16:56:10,54,6189,10,44,4710.97,7751.02,0.00
2024-12-08 16:56:10,54,6190,10,44,4614.03,7752.00,0.00
2024-12-08 16:56:10,55,6190,11,44,4530.14,7752.02,0.00
2024-12-08 16:56:10,54,6190,11,43,4582.46,7752.06,0.00
2024-12-08 16:56:10,53,6190,11,42,4667.46,7752.06,0.00
2024-12-08 16:56:10,52,6190,11,41,4708.25,7752.48,0.00
2024-12-08 16:56:10,52,6191,11,41,4757.83,7753.00,0.00
2024-12-08 16:56:10,53,6191,12,41,4668.06,7753.02,0.00
2024-12-08 16:56:10,52,6191,12,40,4704.82,7753.27,0.00
2024-12-08 16:56:10,52,6192,12,40,4745.32,7754.00,0.00
2024-12-08 16:56:10,53,6192,13,40,4655.79,7754.02,0.00
2024-12-08 16:56:10,52,6192,13,39,4712.53,7754.06,0.00
2024-12-08 16:56:10,52,6193,13,39,4726.25,7755.00,0.00
2024-12-08 16:56:10,53,6193,14,39,4637.08,7755.02,0.00
2024-12-08 16:56:11,54,6192,14,40,4549.77,7755.07,0.00
2024-12-08 16:56:11,54,6193,14,40,4636.27,7756.00,0.00
2024-12-08 16:56:11,55,6193,15,40,4551.97,7756.02,0.00
2024-12-08 16:56:11,54,6193,15,39,4600.63,7756.07,0.00
2024-12-08 16:56:11,54,6194,15,39,4759.21,7757.00,0.00
2024-12-08 16:56:11,55,6194,16,39,4672.68,7757.02,0.00
2024-12-08 16:56:11,54,6194,15,39,4644.32,7757.82,0.00
2024-12-08 16:56:11,54,6195,15,39,4773.75,7758.00,0.00
2024-12-08 16:56:11,55,6195,16,39,4686.95,7758.02,0.00
2024-12-08 16:56:11,55,6196,16,39,4667.81,7759.00,0.00
2024-12-08 16:56:11,56,6196,16,40,4584.45,7759.02,0.00
2024-12-08 16:56:11,55,6196,16,39,4665.58,7759.02,0.00
2024-12-08 16:56:11,55,6197,16,39,4674.65,7760.00,0.00
2024-12-08 16:56:11,56,6197,16,40,4591.17,7760.02,0.00
2024-12-08 16:56:11,56,6198,16,40,4615.33,7761.00,0.00
2024-12-08 16:56:11,57,6198,16,41,4534.36,7761.02,0.00
2024-12-08 16:56:11,57,6199,16,41,4551.39,7762.00,0.00
2024-12-08 16:56:11,58,6199,17,41,4472.92,7762.02,0.00
2024-12-08 16:56:11,58,6200,17,41,4473.60,7763.00,0.00
2024-12-08 16:56:11,59,6200,17,42,4397.77,7763.02,0.00
2024-12-08 16:56:11,59,6201,17,42,4376.84,7764.00,0.00
2024-12-08 16:56:11,60,6201,17,43,4303.89,7764.02,0.00
2024-12-08 16:56:11,59,6201,17,42,4361.05,7764.02,0.00
2024-12-08 16:56:11,59,6202,17,42,4364.24,7765.00,0.00
2024-12-08 16:56:11,60,6202,18,42,4291.51,7765.02,0.00
2024-12-08 16:56:11,59,6202,18,41,4348.77,7765.02,0.00
2024-12-08 16:56:11,59,6203,18,41,4351.96,7766.00,0.00
2024-12-08 16:56:11,60,6203,19,41,4279.43,7766.02,0.00
2024-12-08 16:56:11,59,6203,19,40,4336.17,7766.02,0.00
2024-12-08 16:56:11,59,6204,19,40,4339.36,7767.00,0.00
2024-12-08 16:56:11,60,6204,20,40,4267.03,7767.02,0.00
2024-12-08 16:56:11,60,6205,20,40,4244.99,7768.00,0.00
2024-12-08 16:56:11,61,6205,21,40,4175.40,7768.02,0.00
2024-12-08 16:56:11,60,6205,21,39,4230.75,7768.02,0.00
2024-12-08 16:56:11,60,6206,21,39,4228.18,7769.00,0.00
2024-12-08 16:56:11,61,6206,22,39,4158.87,7769.02,0.00
2024-12-08 16:56:11,60,6206,21,39,4150.58,7769.63,0.00
2024-12-08 16:56:11,60,6207,21,39,4244.87,7770.00,0.00
2024-12-08 16:56:11,61,6207,22,39,4175.28,7770.02,0.00
2024-12-08 16:56:11,60,6207,22,38,4231.92,7770.02,0.00
2024-12-08 16:56:11,60,6208,22,38,4224.47,7771.00,0.00
2024-12-08 16:56:11,61,6208,23,38,4155.22,7771.02,0.00
2024-12-08 16:56:11,60,6208,22,38,4106.89,7771.60,0.00
2024-12-08 16:56:11,60,6209,22,38,4193.66,7772.00,0.00
2024-12-08 16:56:11,61,6209,22,39,4124.91,7772.02,0.00
2024-12-08 16:56:11,60,6209,22,38,4182.00,7772.02,0.00
2024-12-08 16:56:11,60,6210,22,38,4169.06,7773.00,0.00
2024-12-08 16:56:11,61,6210,22,39,4100.72,7773.02,0.00
2024-12-08 16:56:11,60,6210,21,39,4069.52,7773.48,0.00
2024-12-08 16:56:11,60,6211,21,39,4140.10,7774.00,0.00
2024-12-08 16:56:11,61,6211,22,39,4072.23,7774.02,0.00
2024-12-08 16:56:11,60,6211,22,38,4129.73,7774.02,0.00
2024-12-08 16:56:11,59,6211,21,38,4105.44,7774.66,0.00
2024-12-08 16:56:11,58,6211,20,38,4170.08,7774.74,0.00
2024-12-08 16:56:11,58,6212,20,38,4283.39,7775.00,0.00
2024-12-08 16:56:11,59,6212,21,38,4210.79,7775.02,0.00
2024-12-08 16:56:11,58,6212,20,38,4197.93,7775.72,0.00
2024-12-08 16:56:11,58,6213,20,38,4310.75,7776.00,0.00
2024-12-08 16:56:11,59,6213,20,39,4237.69,7776.02,0.00
2024-12-08 16:56:11,58,6213,20,38,4301.37,7776.02,0.00
2024-12-08 16:56:11,57,6213,19,38,4326.66,7776.67,0.00
2024-12-08 16:56:11,57,6214,19,38,4382.85,7777.00,0.00
2024-12-08 16:56:11,58,6214,19,39,4307.28,7777.02,0.00
2024-12-08 16:56:11,57,6214,18,39,4305.62,7777.35,0.00
2024-12-08 16:56:11,57,6215,18,39,4392.02,7778.00,0.00
2024-12-08 16:56:11,58,6215,18,40,4316.30,7778.02,0.00
2024-12-08 16:56:11,57,6215,18,39,4383.83,7778.02,0.00
2024-12-08 16:56:11,56,6215,17,39,4424.72,7778.30,0.00
2024-12-08 16:56:11,56,6216,17,39,4509.92,7779.00,0.00
2024-12-08 16:56:11,57,6216,18,39,4430.80,7779.02,0.00
2024-12-08 16:56:11,57,6217,18,39,4409.53,7780.00,0.00
2024-12-08 16:56:11,58,6217,19,39,4333.50,7780.02,0.00
2024-12-08 16:56:11,57,6217,19,38,4402.71,7780.02,0.00
2024-12-08 16:56:11,57,6218,19,38,4408.73,7781.00,0.00
2024-12-08 16:56:11,58,6218,19,39,4332.72,7781.02,0.00
2024-12-08 16:56:11,58,6219,19,39,4310.47,7782.00,0.00
2024-12-08 16:56:11,59,6219,19,40,4237.41,7782.02,0.00
2024-12-08 16:56:11,58,6219,19,39,4305.10,7782.02,0.00
2024-12-08 16:56:11,58,6220,19,39,4308.37,7783.00,0.00
2024-12-08 16:56:11,59,6220,20,39,4235.34,7783.02,0.00
2024-12-08 16:56:11,59,6221,20,39,4241.94,7784.00,0.00
2024-12-08 16:56:12,60,6221,21,39,4171.24,7784.02,0.00
2024-12-08 16:56:12,59,6221,20,39,4205.14,7784.14,0.00
2024-12-08 16:56:12,58,6221,19,39,4233.94,7784.64,0.00
2024-12-08 16:56:12,58,6222,19,39,4302.00,7785.00,0.00
2024-12-08 16:56:12,59,6222,19,40,4229.09,7785.02,0.00
2024-12-08 16:56:12,58,6222,19,39,4273.82,7785.02,0.00
2024-12-08 16:56:12,58,6223,19,39,4277.50,7786.00,0.00
2024-12-08 16:56:12,59,6223,19,40,4205.00,7786.02,0.00
2024-12-08 16:56:12,59,6224,19,40,4181.78,7787.00,0.00
2024-12-08 16:56:12,60,6224,19,41,4112.09,7787.02,0.00
2024-12-08 16:56:12,59,6224,19,40,4177.82,7787.02,0.00
2024-12-08 16:56:12,59,6225,19,40,4179.83,7788.00,0.00
2024-12-08 16:56:12,60,6225,19,41,4110.17,7788.02,0.00
2024-12-08 16:56:12,59,6225,18,41,4096.84,7788.68,0.00
2024-12-08 16:56:12,59,6226,18,41,4151.18,7789.00,0.00
2024-12-08 16:56:12,60,6226,18,42,4082.00,7789.02,0.00
2024-12-08 16:56:12,59,6226,18,41,4148.54,7789.02,0.00
2024-12-08 16:56:12,58,6226,17,41,4157.31,7789.71,0.00
2024-12-08 16:56:12,58,6227,17,41,4269.01,7790.00,0.00
2024-12-08 16:56:12,59,6227,17,42,4196.66,7790.02,0.00
2024-12-08 16:56:12,58,6227,16,42,4132.36,7790.67,0.00
2024-12-08 16:56:12,57,6227,15,42,4203.49,7790.68,0.00
2024-12-08 16:56:12,57,6228,15,42,4315.82,7791.00,0.00
2024-12-08 16:56:12,58,6228,15,43,4241.41,7791.02,0.00
2024-12-08 16:56:12,57,6228,15,42,4314.45,7791.02,0.00
2024-12-08 16:56:12,56,6228,14,42,4286.58,7791.63,0.00
2024-12-08 16:56:12,56,6229,14,42,4396.78,7792.00,0.00
2024-12-08 16:56:12,57,6229,14,43,4319.65,7792.02,0.00
2024-12-08 16:56:12,56,6229,13,43,4287.36,7792.48,0.00
2024-12-08 16:56:12,56,6230,13,43,4384.82,7793.00,0.00
2024-12-08 16:56:12,57,6230,14,43,4307.90,7793.02,0.00
2024-12-08 16:56:12,56,6230,14,42,4383.43,7793.02,0.00
2024-12-08 16:56:12,56,6231,14,42,4369.88,7794.00,0.00
2024-12-08 16:56:12,57,6231,14,43,4293.22,7794.02,0.00
2024-12-08 16:56:12,56,6231,14,42,4340.65,7794.02,0.00
2024-12-08 16:56:12,55,6231,13,42,4376.60,7794.25,0.00
2024-12-08 16:56:12,55,6232,13,42,4404.01,7795.00,0.00
2024-12-08 16:56:12,56,6232,13,43,4325.37,7795.02,0.00
2024-12-08 16:56:12,56,6233,13,43,4305.04,7796.00,0.00
2024-12-08 16:56:12,57,6233,13,44,4229.51,7796.02,0.00
2024-12-08 16:56:12,56,6233,13,43,4302.26,7796.02,0.00
2024-12-08 16:56:12,56,6234,13,43,4309.12,7797.00,0.00
2024-12-08 16:56:12,57,6234,14,43,4233.52,7797.02,0.00
2024-12-08 16:56:12,56,6234,13,43,4256.27,7797.23,0.00
2024-12-08 16:56:12,56,6235,13,43,4335.15,7798.00,0.00
2024-12-08 16:56:12,57,6235,13,44,4259.10,7798.02,0.00
2024-12-08 16:56:12,56,6235,13,43,4332.37,7798.02,0.00
2024-12-08 16:56:12,56,6236,13,43,4339.20,7799.00,0.00
2024-12-08 16:56:12,57,6236,14,43,4263.07,7799.02,0.00
2024-12-08 16:56:12,57,6237,14,43,4240.97,7800.00,0.00
2024-12-08 16:56:12,58,6237,14,44,4167.85,7800.02,0.00
2024-12-08 16:56:12,57,6237,14,43,4236.86,7800.02,0.00
2024-12-08 16:56:12,56,6237,13,43,4263.65,7800.64,0.00
2024-12-08 16:56:12,56,6238,13,43,4319.63,7801.00,0.00
2024-12-08 16:56:12,57,6238,14,43,4243.85,7801.02,0.00
2024-12-08 16:56:12,56,6238,13,43,4187.57,7801.64,0.00
2024-12-08 16:56:12,56,6239,13,43,4299.29,7802.00,0.00
2024-12-08 16:56:12,57,6239,13,44,4223.86,7802.02,0.00
2024-12-08 16:56:12,56,6239,13,43,4296.50,7802.02,0.00
2024-12-08 16:56:12,56,6240,13,43,4304.02,7803.00,0.00
2024-12-08 16:56:12,57,6240,14,43,4228.51,7803.02,0.00
2024-12-08 16:56:12,57,6241,14,43,4207.15,7804.00,0.00
2024-12-08 16:56:12,58,6241,14,44,4134.61,7804.02,0.00
2024-12-08 16:56:12,57,6241,14,43,4205.78,7804.02,0.00
2024-12-08 16:56:12,57,6242,14,43,4211.80,7805.00,0.00
2024-12-08 16:56:12,58,6242,14,44,4139.18,7805.02,0.00
2024-12-08 16:56:12,58,6243,14,44,4116.24,7806.00,0.00
2024-12-08 16:56:12,59,6243,14,45,4046.47,7806.02,0.00
2024-12-08 16:56:12,58,6243,14,44,4114.89,7806.02,0.00
2024-12-08 16:56:12,57,6243,13,44,4163.36,7806.28,0.00
2024-12-08 16:56:12,56,6243,12,44,4171.18,7806.89,0.00
2024-12-08 16:56:12,56,6244,12,44,4302.30,7807.00,0.00
2024-12-08 16:56:12,57,6244,12,45,4226.82,7807.02,0.00
2024-12-08 16:56:12,56,6244,12,44,4273.02,7807.02,0.00
2024-12-08 16:56:12,55,6244,11,44,4293.45,7807.60,0.00
2024-12-08 16:56:12,55,6245,11,44,4404.48,7808.00,0.00
2024-12-08 16:56:12,56,6245,12,44,4325.83,7808.02,0.00
2024-12-08 16:56:12,55,6245,12,43,4359.32,7808.22,0.00
2024-12-08 16:56:12,55,6246,12,43,4382.34,7809.00,0.00
2024-12-08 16:56:12,56,6246,12,44,4304.08,7809.02,0.00
2024-12-08 16:56:12,55,6246,12,43,4378.08,7809.02,0.00
2024-12-08 16:56:12,55,6247,12,43,4381.64,7810.00,0.00
2024-12-08 16:56:12,56,6247,12,44,4303.40,7810.02,0.00
2024-12-08 16:56:12,56,6248,12,44,4269.22,7811.00,0.00
2024-12-08 16:56:12,57,6248,12,45,4194.32,7811.02,0.00
2024-12-08 16:56:12,56,6248,12,44,4265.04,7811.02,0.00
2024-12-08 16:56:12,55,6248,11,44,4217.05,7811.96,0.00
2024-12-08 16:56:12,55,6249,11,44,4356.26,7812.00,0.00
2024-12-08 16:56:12,56,6249,11,45,4278.47,7812.02,0.00
2024-12-08 16:56:12,55,6249,11,44,4295.92,7812.29,0.00
2024-12-08 16:56:13,55,6250,11,44,4310.07,7813.00,0.00
2024-12-08 16:56:13,56,6250,11,45,4233.11,7813.02,0.00
2024-12-08 16:56:13,55,6250,11,44,4304.39,7813.02,0.00
2024-12-08 16:56:13,54,6250,10,44,4330.90,7813.69,0.00
2024-12-08 16:56:13,53,6250,9,44,4365.87,7813.85,0.00
2024-12-08 16:56:13,53,6251,9,44,4501.63,7814.00,0.00
2024-12-08 16:56:13,54,6251,9,45,4418.27,7814.02,0.00
2024-12-08 16:56:13,53,6251,8,45,4377.46,7814.81,0.00
2024-12-08 16:56:13,53,6252,8,45,4510.33,7815.00,0.00
2024-12-08 16:56:13,54,6252,9,45,4426.81,7815.02,0.00
2024-12-08 16:56:13,53,6252,8,45,4467.86,7815.17,0.00
2024-12-08 16:56:13,53,6253,8,45,4467.55,7816.00,0.00
2024-12-08 16:56:13,54,6253,9,45,4384.81,7816.02,0.00
2024-12-08 16:56:13,53,6253,9,44,4464.60,7816.02,0.00
2024-12-08 16:56:13,52,6253,9,43,4474.14,7816.71,0.00
2024-12-08 16:56:13,52,6254,9,43,4542.02,7817.00,0.00
2024-12-08 16:56:13,53,6254,10,43,4456.32,7817.02,0.00
2024-12-08 16:56:13,52,6254,10,42,4539.01,7817.02,0.00
2024-12-08 16:56:13,52,6255,10,42,4553.13,7818.00,0.00
2024-12-08 16:56:13,53,6255,11,42,4467.22,7818.02,0.00
2024-12-08 16:56:13,52,6255,10,42,4410.61,7818.69,0.00
2024-12-08 16:56:13,52,6256,10,42,4537.17,7819.00,0.00
2024-12-08 16:56:13,53,6256,11,42,4451.56,7819.02,0.00
2024-12-08 16:56:13,52,6256,11,41,4535.67,7819.02,0.00
2024-12-08 16:56:13,52,6257,11,41,4549.78,7820.00,0.00
2024-12-08 16:56:13,53,6257,12,41,4463.93,7820.02,0.00
2024-12-08 16:56:13,52,6257,11,41,4491.20,7820.25,0.00
2024-12-08 16:56:13,52,6258,11,41,4583.45,7821.00,0.00
2024-12-08 16:56:13,53,6258,11,42,4496.97,7821.02,0.00
2024-12-08 16:56:13,52,6258,11,41,4572.93,7821.06,0.00
2024-12-08 16:56:13,52,6259,11,41,4590.05,7822.00,0.00
2024-12-08 16:56:13,53,6259,12,41,4503.45,7822.02,0.00
2024-12-08 16:56:13,52,6259,11,41,4493.93,7822.42,0.00
2024-12-08 16:56:13,52,6260,11,41,4599.67,7823.00,0.00
2024-12-08 16:56:13,53,6260,12,41,4512.88,7823.02,0.00
2024-12-08 16:56:13,52,6260,12,40,4592.15,7823.06,0.00
2024-12-08 16:56:13,52,6261,12,40,4606.93,7824.00,0.00
2024-12-08 16:56:13,53,6261,13,40,4520.01,7824.02,0.00
2024-12-08 16:56:13,53,6261,13,40,4498.61,7825.00,0.00
2024-12-08 16:56:13,54,6261,14,40,4415.30,7825.02,0.00
2024-12-08 16:56:13,53,6261,14,39,4488.28,7825.06,0.00
2024-12-08 16:56:13,53,6262,14,39,4497.03,7826.00,0.00
2024-12-08 16:56:13,54,6262,14,40,4413.75,7826.02,0.00
2024-12-08 16:56:13,53,6262,13,40,4433.17,7826.26,0.00
2024-12-08 16:56:13,53,6263,13,40,4518.16,7827.00,0.00
2024-12-08 16:56:13,54,6263,14,40,4434.49,7827.02,0.00
2024-12-08 16:56:13,53,6263,14,39,4507.83,7827.06,0.00
2024-12-08 16:56:13,52,6263,13,39,4570.72,7827.08,0.00
2024-12-08 16:56:13,52,6264,13,39,4643.92,7828.00,0.00
2024-12-08 16:56:13,53,6264,13,40,4556.30,7828.02,0.00
2024-12-08 16:56:13,52,6264,12,40,4603.31,7828.15,0.00
2024-12-08 16:56:13,52,6265,12,40,4681.87,7829.00,0.00
2024-12-08 16:56:13,53,6265,12,41,4593.53,7829.02,0.00
2024-12-08 16:56:13,52,6265,12,40,4668.32,7829.06,0.00
2024-12-08 16:56:13,52,6266,12,40,4679.01,7830.00,0.00
2024-12-08 16:56:13,53,6266,12,41,4590.72,7830.02,0.00
2024-12-08 16:56:13,53,6267,12,41,4567.53,7831.00,0.00
2024-12-08 16:56:13,54,6267,12,42,4482.94,7831.02,0.00
2024-12-08 16:56:13,53,6267,12,41,4551.28,7831.06,0.00
2024-12-08 16:56:13,53,6268,12,41,4560.53,7832.00,0.00
2024-12-08 16:56:13,54,6268,13,41,4476.07,7832.02,0.00
2024-12-08 16:56:13,53,6268,12,41,4430.97,7832.92,0.00
2024-12-08 16:56:13,53,6269,12,41,4572.91,7833.00,0.00
2024-12-08 16:56:13,54,6269,12,42,4488.22,7833.02,0.00
2024-12-08 16:56:13,53,6269,12,41,4552.22,7833.08,0.00
2024-12-08 16:56:13,53,6270,12,41,4563.44,7834.00,0.00
2024-12-08 16:56:13,54,6270,12,42,4478.93,7834.02,0.00
2024-12-08 16:56:13,54,6271,12,42,4457.19,7835.00,0.00
2024-12-08 16:56:13,55,6271,13,42,4376.15,7835.02,0.00
2024-12-08 16:56:13,54,6271,13,41,4438.34,7835.07,0.00
2024-12-08 16:56:13,53,6271,12,41,4469.33,7835.66,0.00
2024-12-08 16:56:13,52,6271,11,41,4503.90,7835.96,0.00
2024-12-08 16:56:13,52,6272,11,41,4651.60,7836.00,0.00
2024-12-08 16:56:13,53,6272,11,42,4563.83,7836.02,0.00
2024-12-08 16:56:13,53,6273,11,42,4548.73,7837.00,0.00
2024-12-08 16:56:13,54,6273,12,42,4464.50,7837.02,0.00
2024-12-08 16:56:13,53,6273,12,41,4520.65,7837.08,0.00
2024-12-08 16:56:13,52,6273,11,41,4532.38,7837.77,0.00
2024-12-08 16:56:13,52,6274,11,41,4665.22,7838.00,0.00
2024-12-08 16:56:13,53,6274,12,41,4577.19,7838.02,0.00
2024-12-08 16:56:13,52,6274,12,40,4565.04,7838.21,0.00
2024-12-08 16:56:13,52,6275,12,40,4651.07,7839.00,0.00
2024-12-08 16:56:13,53,6275,12,41,4563.31,7839.02,0.00
2024-12-08 16:56:13,52,6275,12,40,4623.94,7839.08,0.00
2024-12-08 16:56:13,51,6275,11,40,4713.81,7839.08,0.00
2024-12-08 16:56:13,50,6275,10,40,4755.90,7839.68,0.00
2024-12-08 16:56:13,50,6276,10,40,4887.87,7840.00,0.00
2024-12-08 16:56:13,51,6276,11,40,4792.03,7840.02,0.00
2024-12-08 16:56:13,51,6277,11,40,4777.08,7841.00,0.00
2024-12-08 16:56:13,52,6277,11,41,4685.22,7841.02,0.00
2024-12-08 16:56:13,51,6277,11,40,4753.29,7841.06,0.00
2024-12-08 16:56:13,50,6277,10,40,4796.82,7841.66,0.00
2024-12-08 16:56:14,50,6278,10,40,4864.55,7842.00,0.00
2024-12-08 16:56:14,51,6278,10,41,4769.16,7842.02,0.00
2024-12-08 16:56:14,50,6278,10,40,4837.88,7842.06,0.00
2024-12-08 16:56:14,50,6279,10,40,4853.44,7843.00,0.00
2024-12-08 16:56:14,51,6279,10,41,4758.28,7843.02,0.00
2024-12-08 16:56:14,50,6279,10,40,4851.87,7843.02,0.00
2024-12-08 16:56:14,50,6280,10,40,4829.32,7844.00,0.00
2024-12-08 16:56:14,51,6280,11,40,4734.63,7844.02,0.00
2024-12-08 16:56:14,50,6280,11,39,4827.75,7844.02,0.00
2024-12-08 16:56:14,49,6280,11,38,4903.87,7844.02,0.00
2024-12-08 16:56:14,49,6281,11,38,4906.28,7845.00,0.00
2024-12-08 16:56:14,50,6281,11,39,4808.15,7845.02,0.00
2024-12-08 16:56:14,50,6282,11,39,4771.35,7846.00,0.00
2024-12-08 16:56:14,51,6282,11,40,4677.80,7846.02,0.00
2024-12-08 16:56:14,50,6282,11,39,4750.96,7846.02,0.00
2024-12-08 16:56:14,49,6282,11,38,4819.26,7846.16,0.00
2024-12-08 16:56:14,49,6283,11,38,4850.25,7847.00,0.00
2024-12-08 16:56:14,50,6283,12,38,4753.24,7847.02,0.00
2024-12-08 16:56:14,49,6283,11,38,4702.92,7847.57,0.00
2024-12-08 16:56:14,49,6284,11,38,4829.76,7848.00,0.00
2024-12-08 16:56:14,50,6284,12,38,4733.17,7848.02,0.00
2024-12-08 16:56:14,49,6284,12,37,4804.14,7848.04,0.00
2024-12-08 16:56:14,49,6285,12,37,4818.86,7849.00,0.00
2024-12-08 16:56:14,50,6285,12,38,4722.48,7849.02,0.00
2024-12-08 16:56:14,49,6285,11,38,4686.46,7849.92,0.00
2024-12-08 16:56:14,49,6286,11,38,4840.31,7850.00,0.00
2024-12-08 16:56:14,50,6286,12,38,4743.50,7850.02,0.00
2024-12-08 16:56:14,49,6286,12,37,4811.47,7850.04,0.00
2024-12-08 16:56:14,48,6286,11,37,4837.67,7850.77,0.00
2024-12-08 16:56:14,48,6287,11,37,4983.41,7851.00,0.00
2024-12-08 16:56:14,49,6287,12,37,4881.70,7851.02,0.00
2024-12-08 16:56:14,49,6288,12,37,4867.69,7852.00,0.00
2024-12-08 16:56:14,50,6288,12,38,4770.34,7852.02,0.00
2024-12-08 16:56:14,49,6288,12,37,4840.46,7852.04,0.00
2024-12-08 16:56:14,48,6288,11,37,4843.49,7852.92,0.00
2024-12-08 16:56:14,48,6289,11,37,5000.62,7853.00,0.00
2024-12-08 16:56:14,49,6289,12,37,4898.56,7853.02,0.00
2024-12-08 16:56:14,48,6289,12,36,4960.48,7853.06,0.00
2024-12-08 16:56:14,48,6290,12,36,4985.65,7854.00,0.00
2024-12-08 16:56:14,49,6290,12,37,4883.90,7854.02,0.00
2024-12-08 16:56:14,48,6290,12,36,4959.48,7854.04,0.00
2024-12-08 16:56:14,48,6291,12,36,4983.01,7855.00,0.00
2024-12-08 16:56:14,49,6291,13,36,4881.32,7855.02,0.00
2024-12-08 16:56:14,49,6292,13,36,4867.18,7856.00,0.00
2024-12-08 16:56:14,50,6292,14,36,4769.84,7856.02,0.00
2024-12-08 16:56:14,49,6292,14,35,4834.84,7856.04,0.00
2024-12-08 16:56:14,49,6293,14,35,4856.30,7857.00,0.00
2024-12-08 16:56:14,50,6293,15,35,4759.17,7857.02,0.00
2024-12-08 16:56:14,50,6294,15,35,4734.83,7858.00,0.00
2024-12-08 16:56:14,51,6294,16,35,4641.99,7858.02,0.00
2024-12-08 16:56:14,50,6294,16,34,4694.73,7858.04,0.00
2024-12-08 16:56:14,50,6295,16,34,4714.19,7859.00,0.00
2024-12-08 16:56:14,51,6295,17,34,4621.75,7859.02,0.00
2024-12-08 16:56:14,50,6295,17,33,4712.25,7859.02,0.00
2024-12-08 16:56:14,50,6296,17,33,4700.01,7860.00,0.00
2024-12-08 16:56:14,51,6296,17,34,4607.85,7860.02,0.00
2024-12-08 16:56:14,50,6296,17,33,4676.43,7860.02,0.00
2024-12-08 16:56:14,49,6296,16,33,4720.89,7860.65,0.00
2024-12-08 16:56:14,49,6297,16,33,4790.12,7861.00,0.00
2024-12-08 16:56:14,50,6297,17,33,4694.32,7861.02,0.00
2024-12-08 16:56:14,50,6298,17,33,4680.76,7862.00,0.00
2024-12-08 16:56:14,51,6298,17,34,4588.98,7862.02,0.00
2024-12-08 16:56:14,50,6298,17,33,4658.75,7862.02,0.00
2024-12-08 16:56:14,50,6299,17,33,4676.64,7863.00,0.00
2024-12-08 16:56:14,51,6299,17,34,4584.94,7863.02,0.00
2024-12-08 16:56:14,51,6300,17,34,4570.38,7864.00,0.00
2024-12-08 16:56:14,52,6300,18,34,4482.49,7864.02,0.00
2024-12-08 16:56:14,51,6300,18,33,4547.25,7864.02,0.00
2024-12-08 16:56:14,50,6300,17,33,4540.67,7864.56,0.00
2024-12-08 16:56:15,50,6301,17,33,4662.80,7865.00,0.00
2024-12-08 16:56:15,51,6301,18,33,4571.37,7865.02,0.00
2024-12-08 16:56:15,51,6302,18,33,4555.21,7866.00,0.00
2024-12-08 16:56:15,52,6302,18,34,4467.61,7866.02,0.00
2024-12-08 16:56:15,51,6302,18,33,4532.08,7866.02,0.00
2024-12-08 16:56:15,51,6303,18,33,4543.73,7867.00,0.00
2024-12-08 16:56:15,52,6303,18,34,4456.35,7867.02,0.00
2024-12-08 16:56:15,52,6304,18,34,4439.41,7868.00,0.00
2024-12-08 16:56:15,53,6304,18,35,4355.64,7868.02,0.00
2024-12-08 16:56:15,52,6304,18,34,4416.71,7868.02,0.00
2024-12-08 16:56:15,51,6304,17,34,4414.75,7868.80,0.00
2024-12-08 16:56:16,51,6305,17,34,4553.76,7869.00,0.00
2024-12-08 16:56:16,52,6305,18,34,4466.19,7869.02,0.00
2024-12-08 16:56:16,52,6306,18,34,4448.43,7870.00,0.00
2024-12-08 16:56:16,53,6306,18,35,4364.49,7870.02,0.00
2024-12-08 16:56:16,52,6306,18,34,4425.73,7870.02,0.00
2024-12-08 16:56:16,52,6307,18,34,4432.83,7871.00,0.00
2024-12-08 16:56:16,53,6307,18,35,4349.19,7871.02,0.00
2024-12-08 16:56:16,52,6307,17,35,4375.64,7871.21,0.00
2024-12-08 16:56:17,52,6308,17,35,4458.36,7872.00,0.00
2024-12-08 16:56:17,53,6308,17,36,4374.24,7872.02,0.00
2024-12-08 16:56:17,52,6308,17,35,4437.16,7872.02,0.00
2024-12-08 16:56:17,51,6308,16,35,4470.70,7872.61,0.00
2024-12-08 16:56:19,51,6309,16,35,4594.46,7873.00,0.00
2024-12-08 16:56:19,52,6309,16,36,4506.11,7873.02,0.00
2024-12-08 16:56:25,52,6310,16,36,4485.32,7874.00,0.00
2024-12-08 16:56:25,53,6310,17,36,4400.70,7874.02,0.00
2024-12-08 16:56:25,52,6310,17,35,4465.64,7874.02,0.00
2024-12-08 16:56:25,53,6309,17,36,4362.16,7874.30,0.00
2024-12-08 16:56:25,52,6309,16,36,4446.85,7874.85,0.00
2024-12-08 16:56:25,52,6310,16,36,4586.30,7875.00,0.00
2024-12-08 16:56:25,53,6310,17,36,4499.77,7875.02,0.00
2024-12-08 16:56:25,53,6311,17,36,4629.34,7876.00,0.00
2024-12-08 16:56:25,54,6311,17,37,4543.61,7876.02,0.00
2024-12-08 16:56:25,53,6311,17,36,4611.51,7876.02,0.00
2024-12-08 16:56:25,53,6312,17,36,4619.53,7877.00,0.00
2024-12-08 16:56:25,54,6312,17,37,4533.98,7877.02,0.00
2024-12-08 16:56:25,54,6313,17,37,4513.28,7878.00,0.00
2024-12-08 16:56:25,55,6313,17,38,4431.22,7878.02,0.00
2024-12-08 16:56:25,54,6313,17,37,4495.77,7878.02,0.00
2024-12-08 16:56:25,53,6313,16,37,4475.42,7878.92,0.00
2024-12-08 16:56:25,53,6314,16,37,4618.18,7879.00,0.00
2024-12-08 16:56:25,54,6314,16,38,4532.66,7879.02,0.00
2024-12-08 16:56:25,53,6314,15,38,4524.55,7879.11,0.00
2024-12-08 16:56:25,52,6314,14,38,4611.56,7879.12,0.00
2024-12-08 16:56:25,52,6315,14,38,4690.75,7880.00,0.00
2024-12-08 16:56:25,53,6315,15,38,4602.24,7880.02,0.00
2024-12-08 16:56:25,52,6315,15,37,4674.08,7880.02,0.00
2024-12-08 16:56:26,52,6316,15,37,4686.12,7881.00,0.00
2024-12-08 16:56:26,53,6316,15,38,4597.71,7881.02,0.00
2024-12-08 16:56:26,53,6317,15,38,4579.04,7882.00,0.00
2024-12-08 16:56:26,54,6317,15,39,4494.24,7882.02,0.00
2024-12-08 16:56:26,53,6317,15,38,4564.16,7882.02,0.00
2024-12-08 16:56:26,53,6318,15,38,4576.17,7883.00,0.00
2024-12-08 16:56:26,54,6318,15,39,4491.43,7883.02,0.00
2024-12-08 16:56:26,53,6318,14,39,4454.45,7883.55,0.00
2024-12-08 16:56:26,53,6319,14,39,4567.83,7884.00,0.00
2024-12-08 16:56:26,54,6319,15,39,4483.24,7884.02,0.00
2024-12-08 16:56:26,53,6319,15,38,4554.44,7884.02,0.00
2024-12-08 16:56:26,52,6319,15,37,4618.00,7884.31,0.00
2024-12-08 16:56:26,51,6319,14,37,4656.06,7884.43,0.00
2024-12-08 16:56:26,51,6320,14,37,4724.73,7885.00,0.00
2024-12-08 16:56:26,52,6320,15,37,4633.87,7885.02,0.00
2024-12-08 16:56:26,51,6320,14,37,4686.10,7885.10,0.00
2024-12-08 16:56:26,51,6321,14,37,4656.21,7886.00,0.00
2024-12-08 16:56:26,52,6321,15,37,4566.67,7886.02,0.00
2024-12-08 16:56:26,51,6321,15,36,4643.84,7886.02,0.00
2024-12-08 16:56:26,50,6321,15,35,4641.74,7886.72,0.00
2024-12-08 16:56:26,50,6322,15,35,4714.50,7887.00,0.00
2024-12-08 16:56:26,51,6322,15,36,4622.06,7887.02,0.00
2024-12-08 16:56:26,51,6323,15,36,4607.18,7888.00,0.00
2024-12-08 16:56:26,52,6323,15,37,4518.58,7888.02,0.00
2024-12-08 16:56:26,51,6323,15,36,4596.36,7888.02,0.00
2024-12-08 16:56:26,50,6323,14,36,4586.02,7888.58,0.00
2024-12-08 16:56:26,50,6324,14,36,4710.97,7889.00,0.00
2024-12-08 16:56:26,51,6324,15,36,4618.59,7889.02,0.00
2024-12-08 16:56:26,50,6324,14,36,4588.13,7889.52,0.00
2024-12-08 16:56:26,50,6325,14,36,4708.41,7890.00,0.00
2024-12-08 16:56:26,51,6325,15,36,4616.09,7890.02,0.00
2024-12-08 16:56:26,50,6325,15,35,4689.47,7890.02,0.00
2024-12-08 16:56:26,49,6325,14,35,4728.82,7890.02,0.00
2024-12-08 16:56:26,49,6326,14,35,4813.16,7891.00,0.00
2024-12-08 16:56:26,50,6326,14,36,4716.90,7891.02,0.00
2024-12-08 16:56:26,50,6327,14,36,4706.96,7892.00,0.00
2024-12-08 16:56:26,51,6327,14,37,4614.67,7892.02,0.00
2024-12-08 16:56:26,50,6327,14,36,4683.28,7892.02,0.00
2024-12-08 16:56:26,49,6327,13,36,4726.92,7892.29,0.00
2024-12-08 16:56:26,49,6328,13,36,4832.10,7893.00,0.00
2024-12-08 16:56:26,50,6328,14,36,4735.45,7893.02,0.00
2024-12-08 16:56:26,49,6328,13,36,4745.45,7893.65,0.00
2024-12-08 16:56:26,49,6329,13,36,4879.43,7894.00,0.00
2024-12-08 16:56:26,50,6329,14,36,4781.84,7894.02,0.00
2024-12-08 16:56:26,50,6330,14,36,4800.05,7895.00,0.00
2024-12-08 16:56:26,51,6330,15,36,4705.93,7895.02,0.00
2024-12-08 16:56:26,51,6331,15,36,4697.66,7896.00,0.00
2024-12-08 16:56:26,52,6331,15,37,4607.32,7896.02,0.00
2024-12-08 16:56:26,51,6331,15,36,4668.25,7896.02,0.00
2024-12-08 16:56:27,51,6332,15,36,4682.47,7897.00,0.00
2024-12-08 16:56:27,52,6332,15,37,4592.42,7897.02,0.00
2024-12-08 16:56:27,52,6333,15,37,4575.19,7898.00,0.00
2024-12-08 16:56:27,53,6333,15,38,4488.86,7898.02,0.00
2024-12-08 16:56:27,52,6333,15,37,4556.96,7898.02,0.00
2024-12-08 16:56:27,52,6334,15,37,4567.68,7899.00,0.00
2024-12-08 16:56:27,53,6334,16,37,4481.50,7899.02,0.00
2024-12-08 16:56:27,52,6334,15,37,4470.76,7899.10,0.00
2024-12-08 16:56:27,52,6335,15,37,4551.82,7900.00,0.00
2024-12-08 16:56:27,53,6335,15,38,4465.94,7900.02,0.00
2024-12-08 16:56:27,52,6335,15,37,4549.38,7900.02,0.00
2024-12-08 16:56:27,52,6336,15,37,4563.63,7901.00,0.00
2024-12-08 16:56:27,53,6336,15,38,4477.52,7901.02,0.00
2024-12-08 16:56:27,52,6336,14,38,4486.27,7901.62,0.00
2024-12-08 16:56:27,52,6337,14,38,4549.37,7902.00,0.00
2024-12-08 16:56:27,53,6337,15,38,4463.53,7902.02,0.00
2024-12-08 16:56:27,52,6337,15,37,4534.18,7902.02,0.00
2024-12-08 16:56:27,51,6337,14,37,4562.47,7902.69,0.00
2024-12-08 16:56:27,51,6338,14,37,4692.86,7903.00,0.00
2024-12-08 16:56:27,52,6338,14,38,4602.61,7903.02,0.00
2024-12-08 16:56:27,52,6339,14,38,4586.60,7904.00,0.00
2024-12-08 16:56:27,53,6339,14,39,4500.06,7904.02,0.00
2024-12-08 16:56:27,52,6339,14,38,4571.40,7904.02,0.00
2024-12-08 16:56:27,52,6340,14,38,4585.66,7905.00,0.00
2024-12-08 16:56:27,53,6340,14,39,4499.14,7905.02,0.00
2024-12-08 16:56:27,52,6340,13,39,4446.11,7905.64,0.00
2024-12-08 16:56:27,52,6341,13,39,4569.51,7906.00,0.00
2024-12-08 16:56:27,53,6341,14,39,4483.30,7906.02,0.00
2024-12-08 16:56:27,52,6341,14,38,4555.83,7906.02,0.00
2024-12-08 16:56:27,51,6341,13,38,4546.36,7906.94,0.00
2024-12-08 16:56:27,51,6342,13,38,4696.79,7907.00,0.00
2024-12-08 16:56:27,52,6342,13,39,4606.46,7907.02,0.00
2024-12-08 16:56:27,52,6343,13,39,4590.32,7908.00,0.00
2024-12-08 16:56:27,53,6343,13,40,4503.71,7908.02,0.00
2024-12-08 16:56:27,52,6343,13,39,4576.63,7908.02,0.00
2024-12-08 16:56:27,51,6343,12,39,4593.90,7908.78,0.00
2024-12-08 16:56:27,51,6344,12,39,4732.09,7909.00,0.00
2024-12-08 16:56:27,52,6344,13,39,4641.09,7909.02,0.00
2024-12-08 16:56:27,52,6345,13,39,4626.13,7910.00,0.00
2024-12-08 16:56:27,53,6345,14,39,4538.84,7910.02,0.00
2024-12-08 16:56:27,52,6345,14,38,4610.91,7910.02,0.00
2024-12-08 16:56:27,52,6346,14,38,4625.13,7911.00,0.00
2024-12-08 16:56:27,53,6346,14,39,4537.87,7911.02,0.00
2024-12-08 16:56:27,53,6347,14,39,4522.85,7912.00,0.00
2024-12-08 16:56:27,54,6347,14,40,4439.09,7912.02,0.00
2024-12-08 16:56:27,53,6347,14,39,4506.43,7912.02,0.00
2024-12-08 16:56:27,52,6347,13,39,4544.49,7912.64,0.00
2024-12-08 16:56:27,52,6348,13,39,4605.21,7913.00,0.00
2024-12-08 16:56:27,53,6348,14,39,4518.32,7913.02,0.00
2024-12-08 16:56:27,53,6349,14,39,4499.75,7914.00,0.00
2024-12-08 16:56:27,54,6349,15,39,4416.42,7914.02,0.00
2024-12-08 16:56:27,53,6349,15,38,4484.82,7914.02,0.00
2024-12-08 16:56:27,52,6349,14,38,4565.01,7914.10,0.00
2024-12-08 16:56:27,52,6350,14,38,4579.77,7915.00,0.00
2024-12-08 16:56:27,53,6350,14,39,4493.36,7915.02,0.00
2024-12-08 16:56:27,53,6351,14,39,4467.48,7916.00,0.00
2024-12-08 16:56:27,54,6351,14,40,4384.75,7916.02,0.00
2024-12-08 16:56:27,53,6351,14,39,4452.54,7916.02,0.00
2024-12-08 16:56:27,52,6351,13,39,4532.11,7916.10,0.00
2024-12-08 16:56:27,51,6351,12,39,4502.33,7916.96,0.00
2024-12-08 16:56:28,51,6352,12,39,4654.48,7917.00,0.00
2024-12-08 16:56:28,52,6352,13,39,4564.97,7917.02,0.00
2024-12-08 16:56:28,52,6353,13,39,4516.28,7918.00,0.00
2024-12-08 16:56:28,53,6353,14,39,4431.06,7918.02,0.00
2024-12-08 16:56:28,52,6353,14,38,4502.57,7918.02,0.00
2024-12-08 16:56:28,52,6354,14,38,4475.66,7919.00,0.00
2024-12-08 16:56:28,53,6354,14,39,4391.21,7919.02,0.00
2024-12-08 16:56:28,52,6354,13,39,4435.05,7919.08,0.00
2024-12-08 16:56:28,52,6355,13,39,4470.19,7920.00,0.00
2024-12-08 16:56:28,53,6355,13,40,4385.84,7920.02,0.00
2024-12-08 16:56:28,52,6355,13,39,4454.96,7920.02,0.00
2024-12-08 16:56:28,51,6355,12,39,4539.22,7920.06,0.00
2024-12-08 16:56:28,50,6355,11,39,4457.03,7920.84,0.00
2024-12-08 16:56:28,50,6356,11,39,4602.90,7921.00,0.00
2024-12-08 16:56:28,51,6356,11,40,4512.64,7921.02,0.00
2024-12-08 16:56:28,51,6357,11,40,4486.51,7922.00,0.00
2024-12-08 16:56:28,52,6357,11,41,4400.23,7922.02,0.00
2024-12-08 16:56:28,51,6357,11,40,4469.42,7922.02,0.00
2024-12-08 16:56:28,51,6358,11,40,4472.42,7923.00,0.00
2024-12-08 16:56:28,52,6358,12,40,4386.41,7923.02,0.00
2024-12-08 16:56:28,51,6358,11,40,4332.02,7923.90,0.00
2024-12-08 16:56:28,51,6359,11,40,4479.70,7924.00,0.00
2024-12-08 16:56:28,52,6359,11,41,4393.55,7924.02,0.00
2024-12-08 16:56:28,51,6359,11,40,4462.61,7924.02,0.00
2024-12-08 16:56:28,50,6359,11,39,4496.74,7924.62,0.00
2024-12-08 16:56:28,50,6360,11,39,4562.01,7925.00,0.00
2024-12-08 16:56:28,51,6360,12,39,4472.56,7925.02,0.00
2024-12-08 16:56:28,50,6360,11,39,4440.84,7925.52,0.00
2024-12-08 16:56:28,50,6361,11,39,4561.65,7926.00,0.00
2024-12-08 16:56:28,51,6361,11,40,4472.21,7926.02,0.00
2024-12-08 16:56:28,50,6361,11,39,4537.88,7926.02,0.00
2024-12-08 16:56:28,50,6362,11,39,4555.89,7927.00,0.00
2024-12-08 16:56:28,51,6362,11,40,4466.56,7927.02,0.00
2024-12-08 16:56:28,50,6362,10,40,4454.05,7927.42,0.00
2024-12-08 16:56:28,50,6363,10,40,4567.02,7928.00,0.00
2024-12-08 16:56:28,51,6363,10,41,4477.47,7928.02,0.00
2024-12-08 16:56:28,50,6363,10,40,4543.23,7928.02,0.00
2024-12-08 16:56:28,49,6363,9,40,4542.51,7928.53,0.00
2024-12-08 16:56:28,49,6364,9,40,4667.44,7929.00,0.00
2024-12-08 16:56:28,50,6364,9,41,4574.10,7929.02,0.00
2024-12-08 16:56:28,49,6364,8,41,4586.31,7929.61,0.00
2024-12-08 16:56:28,49,6365,8,41,4659.04,7930.00,0.00
2024-12-08 16:56:28,50,6365,8,42,4565.86,7930.02,0.00
2024-12-08 16:56:28,49,6365,8,41,4636.38,7930.02,0.00
2024-12-08 16:56:28,48,6365,7,41,4725.72,7930.08,0.00
2024-12-08 16:56:28,47,6365,6,41,4727.63,7930.92,0.00
2024-12-08 16:56:28,47,6366,6,41,4889.69,7931.00,0.00
2024-12-08 16:56:28,48,6366,6,42,4787.82,7931.02,0.00
2024-12-08 16:56:28,47,6366,5,42,4792.63,7931.70,0.00
2024-12-08 16:56:28,47,6367,5,42,4938.02,7932.00,0.00
2024-12-08 16:56:28,48,6367,5,43,4835.14,7932.02,0.00
2024-12-08 16:56:28,47,6367,5,42,4912.70,7932.02,0.00
2024-12-08 16:56:28,46,6367,4,42,4972.10,7932.41,0.00
2024-12-08 16:56:28,46,6368,4,42,5098.45,7933.00,0.00
2024-12-08 16:56:28,47,6368,5,42,4989.97,7933.02,0.00
2024-12-08 16:56:28,46,6368,4,42,5013.24,7933.30,0.00
2024-12-08 16:56:28,46,6369,4,42,5130.99,7934.00,0.00
2024-12-08 16:56:28,47,6369,5,42,5021.82,7934.02,0.00
2024-12-08 16:56:28,46,6369,5,41,5106.84,7934.02,0.00
2024-12-08 16:56:28,46,6370,5,41,5124.83,7935.00,0.00
2024-12-08 16:56:28,47,6370,5,42,5015.79,7935.02,0.00
2024-12-08 16:56:28,47,6371,5,42,4995.87,7936.00,0.00
2024-12-08 16:56:28,48,6371,6,42,4891.79,7936.02,0.00
2024-12-08 16:56:28,47,6371,6,41,4964.21,7936.04,0.00
2024-12-08 16:56:28,47,6372,6,41,4982.27,7937.00,0.00
2024-12-08 16:56:28,48,6372,6,42,4878.47,7937.02,0.00
2024-12-08 16:56:28,48,6373,6,42,4854.28,7938.00,0.00
2024-12-08 16:56:28,49,6373,7,42,4755.21,7938.02,0.00
2024-12-08 16:56:28,48,6373,7,41,4823.99,7938.04,0.00
2024-12-08 16:56:28,47,6373,6,41,4866.67,7938.62,0.00
2024-12-08 16:56:28,46,6373,5,41,4954.05,7938.72,0.00
2024-12-08 16:56:28,46,6374,5,41,5104.44,7939.00,0.00
2024-12-08 16:56:28,47,6374,6,41,4995.83,7939.02,0.00
2024-12-08 16:56:28,46,6374,5,41,5014.54,7939.52,0.00
2024-12-08 16:56:28,46,6375,5,41,5080.53,7940.00,0.00
2024-12-08 16:56:28,47,6375,5,42,4972.43,7940.02,0.00
2024-12-08 16:56:28,46,6375,5,41,5051.17,7940.04,0.00
2024-12-08 16:56:29,46,6376,5,41,5079.42,7941.00,0.00
2024-12-08 16:56:29,47,6376,5,42,4971.35,7941.02,0.00
2024-12-08 16:56:29,46,6376,5,41,5078.78,7941.02,0.00
2024-12-08 16:56:29,46,6377,5,41,5070.79,7942.00,0.00
2024-12-08 16:56:29,47,6377,6,41,4962.90,7942.02,0.00
2024-12-08 16:56:29,46,6377,6,40,5048.35,7942.02,0.00
2024-12-08 16:56:29,46,6378,6,40,5074.88,7943.00,0.00
2024-12-08 16:56:29,47,6378,7,40,4966.91,7943.02,0.00
2024-12-08 16:56:29,47,6379,7,40,4957.39,7944.00,0.00
2024-12-08 16:56:29,48,6379,8,40,4854.11,7944.02,0.00
2024-12-08 16:56:29,47,6379,8,39,4935.42,7944.02,0.00
2024-12-08 16:56:29,47,6380,8,39,4959.71,7945.00,0.00
2024-12-08 16:56:29,48,6380,9,39,4856.38,7945.02,0.00
2024-12-08 16:56:29,47,6380,8,39,4831.77,7945.89,0.00
2024-12-08 16:56:29,47,6381,8,39,4992.45,7946.00,0.00
2024-12-08 16:56:29,48,6381,8,40,4888.44,7946.02,0.00
2024-12-08 16:56:29,47,6381,8,39,4972.16,7946.02,0.00
2024-12-08 16:56:29,47,6382,8,39,4996.46,7947.00,0.00
2024-12-08 16:56:29,48,6382,8,40,4892.37,7947.02,0.00
2024-12-08 16:56:29,48,6383,8,40,4881.39,7948.00,0.00
2024-12-08 16:56:29,49,6383,8,41,4781.77,7948.02,0.00
2024-12-08 16:56:29,48,6383,8,40,4863.18,7948.02,0.00
2024-12-08 16:56:29,47,6383,7,40,4862.40,7948.96,0.00
2024-12-08 16:56:29,47,6384,7,40,5028.16,7949.00,0.00
2024-12-08 16:56:29,48,6384,7,41,4923.41,7949.02,0.00
2024-12-08 16:56:29,48,6385,7,41,4912.44,7950.00,0.00
2024-12-08 16:56:29,49,6385,8,41,4812.18,7950.02,0.00
2024-12-08 16:56:29,48,6385,8,40,4895.87,7950.02,0.00
2024-12-08 16:56:29,47,6385,7,40,4907.54,7950.89,0.00
2024-12-08 16:56:29,47,6386,7,40,5068.34,7951.00,0.00
2024-12-08 16:56:29,48,6386,8,40,4962.75,7951.02,0.00
2024-12-08 16:56:29,48,6387,8,40,4951.77,7952.00,0.00
2024-12-08 16:56:29,49,6387,9,40,4850.72,7952.02,0.00
2024-12-08 16:56:29,48,6387,9,39,4935.21,7952.02,0.00
2024-12-08 16:56:29,48,6388,9,39,4957.37,7953.00,0.00
2024-12-08 16:56:29,49,6388,9,40,4856.20,7953.02,0.00
2024-12-08 16:56:29,49,6389,9,40,4843.82,7954.00,0.00
2024-12-08 16:56:29,50,6389,9,41,4746.94,7954.02,0.00
2024-12-08 16:56:29,49,6389,9,40,4829.21,7954.02,0.00
2024-12-08 16:56:29,48,6389,8,40,4826.01,7954.96,0.00
2024-12-08 16:56:29,48,6390,8,40,4988.45,7955.00,0.00
2024-12-08 16:56:29,49,6390,8,41,4886.64,7955.02,0.00
2024-12-08 16:56:29,48,6390,7,41,4841.29,7955.65,0.00
2024-12-08 16:56:29,48,6391,7,41,4979.13,7956.00,0.00
2024-12-08 16:56:29,49,6391,7,42,4877.51,7956.02,0.00
2024-12-08 16:56:29,48,6391,7,41,4965.87,7956.02,0.00
2024-12-08 16:56:29,47,6391,6,41,4950.01,7956.68,0.00
2024-12-08 16:56:29,47,6392,6,41,5094.17,7957.00,0.00
2024-12-08 16:56:29,48,6392,6,42,4988.04,7957.02,0.00
2024-12-08 16:56:29,47,6392,5,42,4947.21,7957.64,0.00
2024-12-08 16:56:29,47,6393,5,42,5088.04,7958.00,0.00
2024-12-08 16:56:29,48,6393,6,42,4982.04,7958.02,0.00
2024-12-08 16:56:29,48,6394,6,42,4972.31,7959.00,0.00
2024-12-08 16:56:29,49,6394,7,42,4870.83,7959.02,0.00
2024-12-08 16:56:29,48,6394,7,41,4935.85,7959.10,0.00
2024-12-08 16:56:29,48,6395,7,41,4964.64,7960.00,0.00
2024-12-08 16:56:29,49,6395,7,42,4863.32,7960.02,0.00
2024-12-08 16:56:29,49,6396,7,42,4853.92,7961.00,0.00
2024-12-08 16:56:29,50,6396,7,43,4756.84,7961.02,0.00
2024-12-08 16:56:29,49,6396,7,42,4816.58,7961.12,0.00
2024-12-08 16:56:29,48,6396,6,42,4864.86,7961.69,0.00
2024-12-08 16:56:29,48,6397,6,42,5006.11,7962.00,0.00
2024-12-08 16:56:29,49,6397,6,43,4903.94,7962.02,0.00
2024-12-08 16:56:30,49,6398,6,43,4903.76,7963.00,0.00
2024-12-08 16:56:30,50,6398,7,43,4805.68,7963.02,0.00
2024-12-08 16:56:30,50,6399,7,43,4791.95,7964.00,0.00
2024-12-08 16:56:30,51,6399,8,43,4697.99,7964.02,0.00
2024-12-08 16:56:30,51,6400,8,43,4692.15,7965.00,0.00
2024-12-08 16:56:30,52,6400,8,44,4601.91,7965.02,0.00
2024-12-08 16:56:30,51,6400,8,43,4653.13,7965.14,0.00
2024-12-08 16:56:30,51,6401,8,43,4678.68,7966.00,0.00
2024-12-08 16:56:30,52,6401,9,43,4588.70,7966.02,0.00
2024-12-08 16:56:30,51,6401,9,42,4663.10,7966.18,0.00
2024-12-08 16:56:30,51,6402,9,42,4691.76,7967.00,0.00
2024-12-08 16:56:30,52,6402,10,42,4601.54,7967.02,0.00
2024-12-08 16:56:30,52,6403,10,42,4597.45,7968.00,0.00
2024-12-08 16:56:30,53,6403,10,43,4510.71,7968.02,0.00
2024-12-08 16:56:30,52,6403,10,42,4553.05,7968.17,0.00
2024-12-08 16:56:30,52,6404,10,42,4579.64,7969.00,0.00
2024-12-08 16:56:30,53,6404,10,43,4493.23,7969.02,0.00
2024-12-08 16:56:30,53,6405,10,43,4491.86,7970.00,0.00
2024-12-08 16:56:30,54,6405,11,43,4408.68,7970.02,0.00
2024-12-08 16:56:30,54,6406,11,43,4393.98,7971.00,0.00
2024-12-08 16:56:30,55,6406,12,43,4314.09,7971.02,0.00
2024-12-08 16:56:30,54,6406,12,42,4389.56,7971.06,0.00
2024-12-08 16:56:30,54,6407,12,42,4403.39,7972.00,0.00
2024-12-08 16:56:30,55,6407,12,43,4323.33,7972.02,0.00
2024-12-08 16:56:30,54,6407,12,42,4369.44,7972.06,0.00
2024-12-08 16:56:30,54,6408,12,42,4383.27,7973.00,0.00
2024-12-08 16:56:30,55,6408,12,43,4303.58,7973.02,0.00
2024-12-08 16:56:30,54,6408,12,42,4365.56,7973.07,0.00
2024-12-08 16:56:30,54,6409,12,42,4380.87,7974.00,0.00
2024-12-08 16:56:30,55,6409,12,43,4301.21,7974.02,0.00
2024-12-08 16:56:30,55,6410,12,43,4284.88,7975.00,0.00
2024-12-08 16:56:30,56,6410,13,43,4208.36,7975.02,0.00
2024-12-08 16:56:30,55,6410,13,42,4266.04,7975.07,0.00
2024-12-08 16:56:30,54,6410,12,42,4247.52,7975.94,0.00
2024-12-08 16:56:30,54,6411,12,42,4390.83,7976.00,0.00
2024-12-08 16:56:30,55,6411,12,43,4311.00,7976.02,0.00
2024-12-08 16:56:30,54,6411,12,42,4373.10,7976.02,0.00
2024-12-08 16:56:30,54,6412,12,42,4383.99,7977.00,0.00
2024-12-08 16:56:30,55,6412,12,43,4304.28,7977.02,0.00
2024-12-08 16:56:30,55,6413,12,43,4287.60,7978.00,0.00
2024-12-08 16:56:30,56,6413,13,43,4211.04,7978.02,0.00
2024-12-08 16:56:30,55,6413,13,42,4273.10,7978.06,0.00
2024-12-08 16:56:30,55,6414,13,42,4285.24,7979.00,0.00
2024-12-08 16:56:30,56,6414,13,43,4208.72,7979.02,0.00
2024-12-08 16:56:30,55,6414,12,43,4205.76,7979.66,0.00
2024-12-08 16:56:30,54,6414,11,43,4233.39,7979.94,0.00
2024-12-08 16:56:30,54,6415,11,43,4376.78,7980.00,0.00
2024-12-08 16:56:30,55,6415,11,44,4297.20,7980.02,0.00
2024-12-08 16:56:30,54,6415,11,43,4356.09,7980.06,0.00
2024-12-08 16:56:30,53,6415,10,43,4361.12,7980.55,0.00
2024-12-08 16:56:30,53,6416,10,43,4415.54,7981.00,0.00
2024-12-08 16:56:30,54,6416,11,43,4333.77,7981.02,0.00
2024-12-08 16:56:30,53,6416,11,42,4394.47,7981.06,0.00
2024-12-08 16:56:30,53,6417,11,42,4360.23,7982.00,0.00
2024-12-08 16:56:30,54,6417,11,43,4279.48,7982.02,0.00
2024-12-08 16:56:30,53,6417,10,43,4290.73,7982.42,0.00
2024-12-08 16:56:30,53,6418,10,43,4343.60,7983.00,0.00
2024-12-08 16:56:30,54,6418,10,44,4263.17,7983.02,0.00
2024-12-08 16:56:30,53,6418,10,43,4321.01,7983.06,0.00
2024-12-08 16:56:30,52,6418,9,43,4330.99,7983.75,0.00
2024-12-08 16:56:30,52,6419,9,43,4464.76,7984.00,0.00
2024-12-08 16:56:30,53,6419,9,44,4380.52,7984.02,0.00
2024-12-08 16:56:30,53,6420,9,44,4368.96,7985.00,0.00
2024-12-08 16:56:30,54,6420,9,45,4288.06,7985.02,0.00
2024-12-08 16:56:30,53,6420,9,44,4347.87,7985.04,0.00
2024-12-08 16:56:31,53,6421,9,44,4360.72,7986.00,0.00
2024-12-08 16:56:31,54,6421,9,45,4279.96,7986.02,0.00
2024-12-08 16:56:31,53,6421,9,44,4342.64,7986.04,0.00
2024-12-08 16:56:31,52,6421,8,44,4360.08,7986.69,0.00
2024-12-08 16:56:31,52,6422,8,44,4489.34,7987.00,0.00
2024-12-08 16:56:31,53,6422,9,44,4404.63,7987.02,0.00
2024-12-08 16:56:31,52,6422,8,44,4404.64,7987.64,0.00
2024-12-08 16:56:31,52,6423,8,44,4529.34,7988.00,0.00
2024-12-08 16:56:31,53,6423,8,45,4443.88,7988.02,0.00
2024-12-08 16:56:31,52,6423,8,44,4527.80,7988.02,0.00
2024-12-08 16:56:31,51,6423,8,43,4597.79,7988.02,0.00
2024-12-08 16:56:31,51,6424,8,43,4613.49,7989.00,0.00
2024-12-08 16:56:31,52,6424,9,43,4524.77,7989.02,0.00
2024-12-08 16:56:31,51,6424,8,43,4525.35,7989.69,0.00
2024-12-08 16:56:31,51,6425,8,43,4657.20,7990.00,0.00
2024-12-08 16:56:31,52,6425,9,43,4567.64,7990.02,0.00
2024-12-08 16:56:31,51,6425,9,42,4639.97,7990.02,0.00
2024-12-08 16:56:31,50,6425,8,42,4691.07,7990.52,0.00
2024-12-08 16:56:31,50,6426,8,42,4748.97,7991.00,0.00
2024-12-08 16:56:31,51,6426,8,43,4655.85,7991.02,0.00
2024-12-08 16:56:31,51,6427,8,43,4639.84,7992.00,0.00
2024-12-08 16:56:31,52,6427,8,44,4550.61,7992.02,0.00
2024-12-08 16:56:31,51,6427,8,43,4624.17,7992.02,0.00
2024-12-08 16:56:31,50,6427,7,43,4671.31,7992.56,0.00
2024-12-08 16:56:31,49,6427,6,43,4713.10,7992.92,0.00
2024-12-08 16:56:31,49,6428,6,43,4869.75,7993.00,0.00
2024-12-08 16:56:31,50,6428,7,43,4772.36,7993.02,0.00
2024-12-08 16:56:31,49,6428,6,43,4809.47,7993.25,0.00
2024-12-08 16:56:31,49,6429,6,43,4912.03,7994.00,0.00
2024-12-08 16:56:31,50,6429,6,44,4813.79,7994.02,0.00
2024-12-08 16:56:31,49,6429,6,43,4897.34,7994.02,0.00
2024-12-08 16:56:31,49,6430,6,43,4916.94,7995.00,0.00
2024-12-08 16:56:31,50,6430,7,43,4818.60,7995.02,0.00
2024-12-08 16:56:31,50,6431,7,43,4804.56,7996.00,0.00
2024-12-08 16:56:31,51,6431,8,43,4710.35,7996.02,0.00
2024-12-08 16:56:31,50,6431,8,42,4790.16,7996.02,0.00
2024-12-08 16:56:31,50,6432,8,42,4808.36,7997.00,0.00
2024-12-08 16:56:31,51,6432,8,43,4714.07,7997.02,0.00
2024-12-08 16:56:31,50,6432,7,43,4730.10,7997.32,0.00
2024-12-08 16:56:31,50,6433,7,43,4835.30,7998.00,0.00
2024-12-08 16:56:31,51,6433,8,43,4740.49,7998.02,0.00
2024-12-08 16:56:31,50,6433,8,42,4820.91,7998.02,0.00
2024-12-08 16:56:31,50,6434,8,42,4837.04,7999.00,0.00
2024-12-08 16:56:31,51,6434,8,43,4742.20,7999.02,0.00
2024-12-08 16:56:31,50,6434,7,43,4744.56,7999.68,0.00
2024-12-08 16:56:31,50,6435,7,43,4879.20,8000.00,0.00
2024-12-08 16:56:31,51,6435,7,44,4783.53,8000.02,0.00
2024-12-08 16:56:31,51,6436,7,44,4764.55,8001.00,0.00
2024-12-08 16:56:31,52,6436,8,44,4672.92,8001.02,0.00
2024-12-08 16:56:31,51,6436,8,43,4747.30,8001.06,0.00
2024-12-08 16:56:31,51,6437,8,43,4762.34,8002.00,0.00
2024-12-08 16:56:31,52,6437,9,43,4670.76,8002.02,0.00
2024-12-08 16:56:31,52,6438,9,43,4650.54,8003.00,0.00
2024-12-08 16:56:31,53,6438,10,43,4562.80,8003.02,0.00
2024-12-08 16:56:31,52,6438,10,42,4639.77,8003.04,0.00
2024-12-08 16:56:31,52,6439,10,42,4652.82,8004.00,0.00
2024-12-08 16:56:31,53,6439,11,42,4565.03,8004.02,0.00
2024-12-08 16:56:31,52,6439,11,41,4646.66,8004.02,0.00
2024-12-08 16:56:31,52,6440,11,41,4658.26,8005.00,0.00
2024-12-08 16:56:31,53,6440,12,41,4570.37,8005.02,0.00
2024-12-08 16:56:31,53,6441,12,41,4549.48,8006.00,0.00
2024-12-08 16:56:31,54,6441,12,42,4465.23,8006.02,0.00
2024-12-08 16:56:31,53,6441,12,41,4541.92,8006.02,0.00
2024-12-08 16:56:31,53,6442,12,41,4550.85,8007.00,0.00
2024-12-08 16:56:31,54,6442,13,41,4466.57,8007.02,0.00
2024-12-08 16:56:31,54,6443,13,41,4445.64,8008.00,0.00
2024-12-08 16:56:31,55,6443,14,41,4364.81,8008.02,0.00
2024-12-08 16:56:31,54,6443,14,40,4439.71,8008.02,0.00
2024-12-08 16:56:31,54,6444,14,40,4450.64,8009.00,0.00
2024-12-08 16:56:31,55,6444,15,40,4369.72,8009.02,0.00
2024-12-08 16:56:31,55,6445,15,40,4349.88,8010.00,0.00
2024-12-08 16:56:31,56,6445,15,41,4272.20,8010.02,0.00
2024-12-08 16:56:31,55,6445,15,40,4345.51,8010.02,0.00
2024-12-08 16:56:32,55,6446,15,40,4354.79,8011.00,0.00
2024-12-08 16:56:32,56,6446,15,41,4277.03,8011.02,0.00
2024-12-08 16:56:32,56,6447,15,41,4256.10,8012.00,0.00
2024-12-08 16:56:32,57,6447,15,42,4181.43,8012.02,0.00
2024-12-08 16:56:32,56,6447,15,41,4250.38,8012.02,0.00
2024-12-08 16:56:32,55,6447,14,41,4266.84,8012.71,0.00
2024-12-08 16:56:32,55,6448,14,41,4389.39,8013.00,0.00
2024-12-08 16:56:32,56,6448,14,42,4311.01,8013.02,0.00
2024-12-08 16:56:32,55,6448,13,42,4306.68,8013.67,0.00
2024-12-08 16:56:32,55,6449,13,42,4368.08,8014.00,0.00
2024-12-08 16:56:32,56,6449,14,42,4290.08,8014.02,0.00
2024-12-08 16:56:32,55,6449,14,41,4362.25,8014.02,0.00
2024-12-08 16:56:32,56,6448,15,41,4272.95,8014.20,0.00
2024-12-08 16:56:32,55,6448,14,41,4375.28,8014.93,0.00
2024-12-08 16:56:32,55,6449,14,41,4515.23,8015.00,0.00
2024-12-08 16:56:32,56,6449,14,42,4434.60,8015.02,0.00
2024-12-08 16:56:32,56,6450,14,42,4556.83,8016.00,0.00
2024-12-08 16:56:32,57,6450,15,42,4476.88,8016.02,0.00
2024-12-08 16:56:32,56,6450,15,41,4549.67,8016.02,0.00
2024-12-08 16:56:32,56,6451,15,41,4557.40,8017.00,0.00
2024-12-08 16:56:32,57,6451,15,42,4477.44,8017.02,0.00
2024-12-08 16:56:32,56,6451,14,42,4461.86,8017.75,0.00
2024-12-08 16:56:32,56,6452,14,42,4585.17,8018.00,0.00
2024-12-08 16:56:32,57,6452,14,43,4504.73,8018.02,0.00
2024-12-08 16:56:32,56,6452,14,42,4579.44,8018.02,0.00
2024-12-08 16:56:32,55,6452,13,42,4609.11,8018.67,0.00
2024-12-08 16:56:32,54,6452,12,42,4650.09,8018.93,0.00
2024-12-08 16:56:32,54,6453,12,42,4792.71,8019.00,0.00
2024-12-08 16:56:32,55,6453,13,42,4705.57,8019.02,0.00
2024-12-08 16:56:32,55,6454,13,42,4675.40,8020.00,0.00
2024-12-08 16:56:32,56,6454,14,42,4591.92,8020.02,0.00
2024-12-08 16:56:32,55,6454,14,41,4665.20,8020.02,0.00
2024-12-08 16:56:32,55,6455,14,41,4652.85,8021.00,0.00
2024-12-08 16:56:32,56,6455,14,42,4569.76,8021.02,0.00
2024-12-08 16:56:32,56,6456,14,42,4522.07,8022.00,0.00
2024-12-08 16:56:32,57,6456,15,42,4442.74,8022.02,0.00
2024-12-08 16:56:32,56,6456,15,41,4513.48,8022.02,0.00
2024-12-08 16:56:32,56,6457,15,41,4490.85,8023.00,0.00
2024-12-08 16:56:32,57,6457,16,41,4412.06,8023.02,0.00
2024-12-08 16:56:32,57,6458,16,41,4358.24,8024.00,0.00
2024-12-08 16:56:32,58,6458,16,42,4283.10,8024.02,0.00
2024-12-08 16:56:32,57,6458,16,41,4351.20,8024.02,0.00
2024-12-08 16:56:32,56,6458,15,41,4354.05,8024.84,0.00
2024-12-08 16:56:32,56,6459,15,41,4427.24,8025.00,0.00
2024-12-08 16:56:32,57,6459,16,41,4349.57,8025.02,0.00
2024-12-08 16:56:32,57,6460,16,41,4327.58,8026.00,0.00
2024-12-08 16:56:32,58,6460,16,42,4252.97,8026.02,0.00
2024-12-08 16:56:32,57,6460,16,41,4321.95,8026.02,0.00
2024-12-08 16:56:32,56,6460,15,41,4346.42,8026.68,0.00
2024-12-08 16:56:32,56,6461,15,41,4406.84,8027.00,0.00
2024-12-08 16:56:32,57,6461,16,41,4329.53,8027.02,0.00
2024-12-08 16:56:32,57,6462,16,41,4209.39,8028.00,0.00
2024-12-08 16:56:32,58,6462,16,42,4136.81,8028.02,0.00
2024-12-08 16:56:32,57,6462,16,41,4200.94,8028.02,0.00
2024-12-08 16:56:32,56,6462,16,40,4249.70,8028.04,0.00
2024-12-08 16:56:32,56,6463,16,40,4258.83,8029.00,0.00
2024-12-08 16:56:32,57,6463,16,41,4184.11,8029.02,0.00
2024-12-08 16:56:32,57,6464,16,41,4162.09,8030.00,0.00
2024-12-08 16:56:32,58,6464,17,41,4090.33,8030.02,0.00
2024-12-08 16:56:32,57,6464,17,40,4155.05,8030.02,0.00
2024-12-08 16:56:32,56,6464,16,40,4133.65,8030.93,0.00
2024-12-08 16:56:32,56,6465,16,40,4271.36,8031.00,0.00
2024-12-08 16:56:32,57,6465,16,41,4196.43,8031.02,0.00
2024-12-08 16:56:32,56,6465,15,41,4212.64,8031.25,0.00
2024-12-08 16:56:32,56,6466,15,41,4296.28,8032.00,0.00
2024-12-08 16:56:32,57,6466,16,41,4220.90,8032.02,0.00
2024-12-08 16:56:32,56,6466,16,40,4289.11,8032.02,0.00
2024-12-08 16:56:32,55,6466,15,40,4311.75,8032.38,0.00
2024-12-08 16:56:32,55,6467,15,40,4408.53,8033.00,0.00
2024-12-08 16:56:32,56,6467,16,40,4329.80,8033.02,0.00
2024-12-08 16:56:32,56,6468,16,40,4308.82,8034.00,0.00
2024-12-08 16:56:32,57,6468,17,40,4233.23,8034.02,0.00
2024-12-08 16:56:32,56,6468,17,39,4303.08,8034.02,0.00
2024-12-08 16:56:32,56,6469,17,39,4310.79,8035.00,0.00
2024-12-08 16:56:33,57,6469,18,39,4235.17,8035.02,0.00
2024-12-08 16:56:33,56,6469,17,39,4195.01,8035.88,0.00
2024-12-08 16:56:33,56,6470,17,39,4328.55,8036.00,0.00
2024-12-08 16:56:33,57,6470,18,39,4252.61,8036.02,0.00
2024-12-08 16:56:33,56,6470,18,38,4321.38,8036.02,0.00
2024-12-08 16:56:33,56,6471,18,38,4329.09,8037.00,0.00
2024-12-08 16:56:33,57,6471,18,39,4253.14,8037.02,0.00
2024-12-08 16:56:33,57,6472,18,39,4231.11,8038.00,0.00
2024-12-08 16:56:33,58,6472,18,40,4158.16,8038.02,0.00
2024-12-08 16:56:33,57,6472,18,39,4225.47,8038.02,0.00
2024-12-08 16:56:33,57,6473,18,39,4231.63,8039.00,0.00
2024-12-08 16:56:33,58,6473,19,39,4158.67,8039.02,0.00
2024-12-08 16:56:33,57,6473,18,39,4120.05,8039.53,0.00
2024-12-08 16:56:33,57,6474,18,39,4223.32,8040.00,0.00
2024-12-08 16:56:33,58,6474,19,39,4150.51,8040.02,0.00
2024-12-08 16:56:33,57,6474,19,38,4219.09,8040.02,0.00
2024-12-08 16:56:33,56,6474,18,38,4232.31,8040.70,0.00
2024-12-08 16:56:33,56,6475,18,38,4294.26,8041.00,0.00
2024-12-08 16:56:33,57,6475,18,39,4218.92,8041.02,0.00
2024-12-08 16:56:33,56,6475,17,39,4168.76,8041.86,0.00
2024-12-08 16:56:33,56,6476,17,39,4300.97,8042.00,0.00
2024-12-08 16:56:33,57,6476,17,40,4225.51,8042.02,0.00
2024-12-08 16:56:33,56,6476,17,39,4295.22,8042.02,0.00
2024-12-08 16:56:33,55,6476,17,38,4367.54,8042.06,0.00
2024-12-08 16:56:33,54,6476,16,38,4366.94,8042.85,0.00
2024-12-08 16:56:33,54,6477,16,38,4504.08,8043.00,0.00
2024-12-08 16:56:33,55,6477,16,39,4422.19,8043.02,0.00
2024-12-08 16:56:33,55,6478,16,39,4402.26,8044.00,0.00
2024-12-08 16:56:33,56,6478,17,39,4323.65,8044.02,0.00
2024-12-08 16:56:33,55,6478,17,38,4394.95,8044.02,0.00
2024-12-08 16:56:33,54,6478,16,38,4446.63,8044.26,0.00
2024-12-08 16:56:33,54,6479,16,38,4536.48,8045.00,0.00
2024-12-08 16:56:33,55,6479,17,38,4454.00,8045.02,0.00
2024-12-08 16:56:33,55,6480,17,38,4434.08,8046.00,0.00
2024-12-08 16:56:33,56,6480,17,39,4354.90,8046.02,0.00
2024-12-08 16:56:33,55,6480,17,38,4428.22,8046.02,0.00
2024-12-08 16:56:33,55,6481,17,38,4437.55,8047.00,0.00
2024-12-08 16:56:33,56,6481,18,38,4358.31,8047.02,0.00
2024-12-08 16:56:33,56,6482,18,38,4337.30,8048.00,0.00
2024-12-08 16:56:33,57,6482,18,39,4261.20,8048.02,0.00
2024-12-08 16:56:33,56,6482,18,38,4328.67,8048.02,0.00
2024-12-08 16:56:33,56,6483,18,38,4336.40,8049.00,0.00
2024-12-08 16:56:33,57,6483,19,38,4260.32,8049.02,0.00
2024-12-08 16:56:33,57,6484,19,38,4238.25,8050.00,0.00
2024-12-08 16:56:33,58,6484,20,38,4165.18,8050.02,0.00
2024-12-08 16:56:33,57,6484,20,37,4231.19,8050.02,0.00
2024-12-08 16:56:33,57,6485,20,37,4237.37,8051.00,0.00
2024-12-08 16:56:33,58,6485,20,38,4164.31,8051.02,0.00
2024-12-08 16:56:33,57,6485,19,38,4125.99,8051.54,0.00
2024-12-08 16:56:33,57,6486,19,38,4230.83,8052.00,0.00
2024-12-08 16:56:33,58,6486,19,39,4157.88,8052.02,0.00
2024-12-08 16:56:33,57,6486,19,38,4223.77,8052.02,0.00
2024-12-08 16:56:33,56,6486,18,38,4226.04,8052.48,0.00
2024-12-08 16:56:33,56,6487,18,38,4328.49,8053.00,0.00
2024-12-08 16:56:33,57,6487,19,38,4252.55,8053.02,0.00
2024-12-08 16:56:33,57,6488,19,38,4231.10,8054.00,0.00
2024-12-08 16:56:33,58,6488,20,38,4158.15,8054.02,0.00
2024-12-08 16:56:33,57,6488,20,37,4225.45,8054.02,0.00
2024-12-08 16:56:33,56,6488,19,37,4247.97,8054.66,0.00
2024-12-08 16:56:33,56,6489,19,37,4307.19,8055.00,0.00
2024-12-08 16:56:33,57,6489,20,37,4231.62,8055.02,0.00
2024-12-08 16:56:33,57,6490,20,37,4205.14,8056.00,0.00
2024-12-08 16:56:33,58,6490,20,38,4132.63,8056.02,0.00
2024-12-08 16:56:33,57,6490,20,37,4199.48,8056.02,0.00
2024-12-08 16:56:33,56,6490,19,37,4246.39,8056.20,0.00
2024-12-08 16:56:33,55,6490,18,37,4288.66,8056.64,0.00
2024-12-08 16:56:33,55,6491,18,37,4347.52,8057.00,0.00
2024-12-08 16:56:33,56,6491,19,37,4269.88,8057.02,0.00
2024-12-08 16:56:33,56,6492,19,37,4233.04,8058.00,0.00
2024-12-08 16:56:33,57,6492,19,38,4158.77,8058.02,0.00
2024-12-08 16:56:33,56,6492,19,37,4228.72,8058.02,0.00
2024-12-08 16:56:33,55,6492,19,36,4294.24,8058.07,0.00
2024-12-08 16:56:33,55,6493,19,36,4307.95,8059.00,0.00
2024-12-08 16:56:33,56,6493,19,37,4231.02,8059.02,0.00
2024-12-08 16:56:33,55,6493,18,37,4242.09,8059.29,0.00
2024-12-08 16:56:33,55,6494,18,37,4331.93,8060.00,0.00
2024-12-08 16:56:33,56,6494,19,37,4254.57,8060.02,0.00
2024-12-08 16:56:33,55,6494,19,36,4327.53,8060.02,0.00
2024-12-08 16:56:34,55,6495,19,36,4336.86,8061.00,0.00
2024-12-08 16:56:34,56,6495,20,36,4259.42,8061.02,0.00
2024-12-08 16:56:34,55,6495,19,36,4240.28,8061.44,0.00
2024-12-08 16:56:34,55,6496,19,36,4341.80,8062.00,0.00
2024-12-08 16:56:34,56,6496,19,37,4264.27,8062.02,0.00
2024-12-08 16:56:34,55,6496,19,36,4338.87,8062.02,0.00
2024-12-08 16:56:34,54,6496,18,36,4405.83,8062.19,0.00
2024-12-08 16:56:34,54,6497,18,36,4430.22,8063.00,0.00
2024-12-08 16:56:34,55,6497,19,36,4349.67,8063.02,0.00
2024-12-08 16:56:34,55,6498,19,36,4329.68,8064.00,0.00
2024-12-08 16:56:34,56,6498,19,37,4252.36,8064.02,0.00
2024-12-08 16:56:34,55,6498,19,36,4328.21,8064.02,0.00
2024-12-08 16:56:34,54,6498,18,36,4396.46,8064.17,0.00
2024-12-08 16:56:34,54,6499,18,36,4419.27,8065.00,0.00
2024-12-08 16:56:34,55,6499,18,37,4338.92,8065.02,0.00
2024-12-08 16:56:34,55,6500,18,37,4318.93,8066.00,0.00
2024-12-08 16:56:34,56,6500,19,37,4241.81,8066.02,0.00
2024-12-08 16:56:34,55,6500,19,36,4317.46,8066.02,0.00
2024-12-08 16:56:34,54,6500,18,36,4300.81,8066.93,0.00
2024-12-08 16:56:34,54,6501,18,36,4444.27,8067.00,0.00
2024-12-08 16:56:34,55,6501,18,37,4363.47,8067.02,0.00
2024-12-08 16:56:34,55,6502,18,37,4343.47,8068.00,0.00
2024-12-08 16:56:34,56,6502,19,37,4265.91,8068.02,0.00
2024-12-08 16:56:34,55,6502,19,36,4342.00,8068.02,0.00
2024-12-08 16:56:34,55,6503,19,36,4351.34,8069.00,0.00
2024-12-08 16:56:34,56,6503,19,37,4273.64,8069.02,0.00
2024-12-08 16:56:34,56,6504,19,37,4252.56,8070.00,0.00
2024-12-08 16:56:34,57,6504,19,38,4177.95,8070.02,0.00
2024-12-08 16:56:34,56,6504,19,37,4249.67,8070.02,0.00
2024-12-08 16:56:34,55,6504,18,37,4243.73,8070.85,0.00
2024-12-08 16:56:34,55,6505,18,37,4378.84,8071.00,0.00
2024-12-08 16:56:34,56,6505,18,38,4300.64,8071.02,0.00
2024-12-08 16:56:34,55,6505,17,38,4296.31,8071.67,0.00
2024-12-08 16:56:34,54,6505,16,38,4332.70,8071.93,0.00
2024-12-08 16:56:34,54,6506,16,38,4476.25,8072.00,0.00
2024-12-08 16:56:34,55,6506,16,39,4394.87,8072.02,0.00
2024-12-08 16:56:34,54,6506,16,38,4474.76,8072.02,0.00
2024-12-08 16:56:34,54,6507,16,38,4485.78,8073.00,0.00
2024-12-08 16:56:34,55,6507,16,39,4404.22,8073.02,0.00
2024-12-08 16:56:34,54,6507,15,39,4376.84,8073.48,0.00
2024-12-08 16:56:34,54,6508,15,39,4484.84,8074.00,0.00
2024-12-08 16:56:34,55,6508,15,40,4403.30,8074.02,0.00
2024-12-08 16:56:34,54,6508,15,39,4483.34,8074.02,0.00
2024-12-08 16:56:34,54,6509,15,39,4494.37,8075.00,0.00
2024-12-08 16:56:34,55,6509,15,40,4412.65,8075.02,0.00
2024-12-08 16:56:34,54,6509,14,40,4348.14,8075.70,0.00
2024-12-08 16:56:34,54,6510,14,40,4473.99,8076.00,0.00
2024-12-08 16:56:34,55,6510,14,41,4392.64,8076.02,0.00
2024-12-08 16:56:34,54,6510,14,40,4471.00,8076.02,0.00
2024-12-08 16:56:34,53,6510,13,40,4471.76,8076.51,0.00
2024-12-08 16:56:34,53,6511,13,40,4584.87,8077.00,0.00
2024-12-08 16:56:34,54,6511,13,41,4499.97,8077.02,0.00
2024-12-08 16:56:34,53,6511,12,41,4470.78,8077.51,0.00
2024-12-08 16:56:34,53,6512,12,41,4583.92,8078.00,0.00
2024-12-08 16:56:34,54,6512,12,42,4499.03,8078.02,0.00
2024-12-08 16:56:34,53,6512,12,41,4580.87,8078.02,0.00
2024-12-08 16:56:34,53,6513,12,41,4588.91,8079.00,0.00
2024-12-08 16:56:34,54,6513,12,42,4503.93,8079.02,0.00
2024-12-08 16:56:34,53,6513,12,41,4560.09,8079.02,0.00
2024-12-08 16:56:34,52,6513,11,41,4607.39,8079.02,0.00
2024-12-08 16:56:34,52,6514,11,41,4684.10,8080.00,0.00
2024-12-08 16:56:34,53,6514,11,42,4595.72,8080.02,0.00
2024-12-08 16:56:34,52,6514,10,42,4614.27,8080.29,0.00
2024-12-08 16:56:34,52,6515,10,42,4705.77,8081.00,0.00
2024-12-08 16:56:34,53,6515,10,43,4616.98,8081.02,0.00
2024-12-08 16:56:34,52,6515,10,42,4696.45,8081.02,0.00
2024-12-08 16:56:34,52,6516,10,42,4682.28,8082.00,0.00
2024-12-08 16:56:34,53,6516,10,43,4593.93,8082.02,0.00
2024-12-08 16:56:34,52,6516,9,43,4637.35,8082.17,0.00
2024-12-08 16:56:34,51,6516,8,43,4687.14,8082.33,0.00
2024-12-08 16:56:34,51,6517,8,43,4746.89,8083.00,0.00
2024-12-08 16:56:34,52,6517,9,43,4655.61,8083.02,0.00
2024-12-08 16:56:34,51,6517,9,42,4734.21,8083.02,0.00
2024-12-08 16:56:34,50,6517,8,42,4777.47,8083.64,0.00
2024-12-08 16:56:34,50,6518,8,42,4848.44,8084.00,0.00
2024-12-08 16:56:34,51,6518,8,43,4753.37,8084.02,0.00
2024-12-08 16:56:34,50,6518,8,42,4733.84,8084.92,0.00
2024-12-08 16:56:34,50,6519,8,42,4824.46,8085.00,0.00
2024-12-08 16:56:34,51,6519,9,42,4729.86,8085.02,0.00
2024-12-08 16:56:34,50,6519,9,41,4813.14,8085.02,0.00
2024-12-08 16:56:34,50,6520,9,41,4831.52,8086.00,0.00
2024-12-08 16:56:34,51,6520,9,42,4736.78,8086.02,0.00
2024-12-08 16:56:34,50,6520,8,42,4763.67,8086.24,0.00
2024-12-08 16:56:35,50,6521,8,42,4864.47,8087.00,0.00
2024-12-08 16:56:35,51,6521,9,42,4769.08,8087.02,0.00
2024-12-08 16:56:35,50,6521,9,41,4854.76,8087.02,0.00
2024-12-08 16:56:35,50,6522,9,41,4873.16,8088.00,0.00
2024-12-08 16:56:35,51,6522,9,42,4777.60,8088.02,0.00
2024-12-08 16:56:35,50,6522,8,42,4742.67,8088.92,0.00
2024-12-08 16:56:35,50,6523,8,42,4898.02,8089.00,0.00
2024-12-08 16:56:35,51,6523,8,43,4801.98,8089.02,0.00
2024-12-08 16:56:35,50,6523,8,42,4889.94,8089.02,0.00
2024-12-08 16:56:35,50,6524,8,42,4908.34,8090.00,0.00
2024-12-08 16:56:35,51,6524,9,42,4812.10,8090.02,0.00
2024-12-08 16:56:35,50,6524,8,42,4777.81,8090.92,0.00
2024-12-08 16:56:35,50,6525,8,42,4933.22,8091.00,0.00
2024-12-08 16:56:35,51,6525,9,42,4836.49,8091.02,0.00
2024-12-08 16:56:35,50,6525,9,41,4925.13,8091.02,0.00
2024-12-08 16:56:35,50,6526,9,41,4943.54,8092.00,0.00
2024-12-08 16:56:35,51,6526,10,41,4846.61,8092.02,0.00
2024-12-08 16:56:35,51,6527,10,41,4831.34,8093.00,0.00
2024-12-08 16:56:35,52,6527,11,41,4738.43,8093.02,0.00
2024-12-08 16:56:35,51,6527,11,40,4820.23,8093.04,0.00
2024-12-08 16:56:35,51,6528,11,40,4838.28,8094.00,0.00
2024-12-08 16:56:35,52,6528,11,41,4745.24,8094.02,0.00
2024-12-08 16:56:35,52,6529,11,41,4728.70,8095.00,0.00
2024-12-08 16:56:35,53,6529,12,41,4639.48,8095.02,0.00
2024-12-08 16:56:35,52,6529,12,40,4716.25,8095.04,0.00
2024-12-08 16:56:35,52,6530,12,40,4690.13,8096.00,0.00
2024-12-08 16:56:35,53,6530,12,41,4601.63,8096.02,0.00
2024-12-08 16:56:35,53,6531,12,41,4530.29,8097.00,0.00
2024-12-08 16:56:35,54,6531,13,41,4446.40,8097.02,0.00
2024-12-08 16:56:35,53,6531,13,40,4516.55,8097.04,0.00
2024-12-08 16:56:35,52,6531,13,39,4524.65,8097.67,0.00
2024-12-08 16:56:35,52,6532,13,39,4591.85,8098.00,0.00
2024-12-08 16:56:35,53,6532,14,39,4505.21,8098.02,0.00
2024-12-08 16:56:35,53,6533,14,39,4488.95,8099.00,0.00
2024-12-08 16:56:35,54,6533,14,40,4405.82,8099.02,0.00
2024-12-08 16:56:35,53,6533,14,39,4475.20,8099.04,0.00
2024-12-08 16:56:35,53,6534,14,39,4489.50,8100.00,0.00
2024-12-08 16:56:35,54,6534,15,39,4406.37,8100.02,0.00
2024-12-08 16:56:35,54,6535,15,39,4390.76,8101.00,0.00
2024-12-08 16:56:35,55,6535,16,39,4310.93,8101.02,0.00
2024-12-08 16:56:35,54,6535,16,38,4377.27,8101.04,0.00
2024-12-08 16:56:35,54,6536,16,38,4389.81,8102.00,0.00
2024-12-08 16:56:35,55,6536,16,39,4309.99,8102.02,0.00
2024-12-08 16:56:35,55,6537,16,39,4293.76,8103.00,0.00
2024-12-08 16:56:35,56,6537,17,39,4217.09,8103.02,0.00
2024-12-08 16:56:35,55,6537,17,38,4281.98,8103.04,0.00
2024-12-08 16:56:35,55,6538,17,38,4292.82,8104.00,0.00
2024-12-08 16:56:35,56,6538,18,38,4216.16,8104.02,0.00
2024-12-08 16:56:35,55,6538,17,38,4225.73,8104.27,0.00
2024-12-08 16:56:35,55,6539,17,38,4314.59,8105.00,0.00
2024-12-08 16:56:35,56,6539,18,38,4237.55,8105.02,0.00
2024-12-08 16:56:35,55,6539,18,37,4302.81,8105.04,0.00
2024-12-08 16:56:35,55,6540,18,37,4313.65,8106.00,0.00
2024-12-08 16:56:35,56,6540,19,37,4236.62,8106.02,0.00
2024-12-08 16:56:35,56,6541,19,37,4224.32,8107.00,0.00
2024-12-08 16:56:35,57,6541,19,38,4150.21,8107.02,0.00
2024-12-08 16:56:35,56,6541,19,37,4206.95,8107.04,0.00
2024-12-08 16:56:35,55,6541,18,37,4232.16,8107.66,0.00
2024-12-08 16:56:35,55,6542,18,37,4292.81,8108.00,0.00
2024-12-08 16:56:35,56,6542,19,37,4216.15,8108.02,0.00
2024-12-08 16:56:35,55,6542,18,37,4254.51,8108.13,0.00
2024-12-08 16:56:35,54,6542,17,37,4309.31,8108.24,0.00
2024-12-08 16:56:35,54,6542,17,37,4398.37,8109.00,0.00
2024-12-08 16:56:35,55,6542,17,38,4318.40,8109.02,0.00
2024-12-08 16:56:35,54,6542,17,37,4381.85,8109.04,0.00
2024-12-08 16:56:35,54,6543,17,37,4394.41,8110.00,0.00
2024-12-08 16:56:35,55,6543,17,38,4314.51,8110.02,0.00
2024-12-08 16:56:35,54,6543,16,38,4355.39,8110.13,0.00
2024-12-08 16:56:36,54,6544,16,38,4382.99,8111.00,0.00
2024-12-08 16:56:36,55,6544,16,39,4303.30,8111.02,0.00
2024-12-08 16:56:36,54,6544,16,38,4364.97,8111.04,0.00
2024-12-08 16:56:36,53,6544,15,38,4398.69,8111.62,0.00
2024-12-08 16:56:36,52,6544,14,38,4481.72,8111.64,0.00
2024-12-08 16:56:36,51,6544,13,38,4507.71,8111.96,0.00
2024-12-08 16:56:36,51,6545,13,38,4663.60,8112.00,0.00
2024-12-08 16:56:36,52,6545,14,38,4573.92,8112.02,0.00
2024-12-08 16:56:36,52,6546,14,38,4559.33,8113.00,0.00
2024-12-08 16:56:36,53,6546,15,38,4473.31,8113.02,0.00
2024-12-08 16:56:36,52,6546,15,37,4542.17,8113.04,0.00
2024-12-08 16:56:36,52,6547,15,37,4558.33,8114.00,0.00
2024-12-08 16:56:36,53,6547,16,37,4472.33,8114.02,0.00
2024-12-08 16:56:36,53,6548,16,37,4456.63,8115.00,0.00
2024-12-08 16:56:36,54,6548,17,37,4374.10,8115.02,0.00
2024-12-08 16:56:36,53,6548,17,36,4441.32,8115.04,0.00
2024-12-08 16:56:36,52,6548,16,36,4475.56,8115.65,0.00
2024-12-08 16:56:36,52,6549,16,36,4541.33,8116.00,0.00
2024-12-08 16:56:36,53,6549,17,36,4455.65,8116.02,0.00
2024-12-08 16:56:36,52,6549,16,36,4400.71,8116.62,0.00
2024-12-08 16:56:36,52,6550,16,36,4525.83,8117.00,0.00
2024-12-08 16:56:36,53,6550,16,37,4440.44,8117.02,0.00
2024-12-08 16:56:36,52,6550,16,36,4524.27,8117.02,0.00
2024-12-08 16:56:36,51,6550,16,35,4597.06,8117.02,0.00
2024-12-08 16:56:36,51,6551,16,35,4613.55,8118.00,0.00
2024-12-08 16:56:36,52,6551,17,35,4524.83,8118.02,0.00
2024-12-08 16:56:36,52,6552,17,35,4510.66,8119.00,0.00
2024-12-08 16:56:36,53,6552,18,35,4425.55,8119.02,0.00
2024-12-08 16:56:36,52,6552,18,34,4495.04,8119.02,0.00
2024-12-08 16:56:36,52,6553,18,34,4509.65,8120.00,0.00
2024-12-08 16:56:36,53,6553,19,34,4424.56,8120.02,0.00
2024-12-08 16:56:36,53,6554,19,34,4412.35,8121.00,0.00
2024-12-08 16:56:36,54,6554,20,34,4330.64,8121.02,0.00
2024-12-08 16:56:36,53,6554,20,33,4395.50,8121.02,0.00
2024-12-08 16:56:36,52,6554,19,33,4433.10,8121.60,0.00
2024-12-08 16:56:36,52,6555,19,33,4494.26,8122.00,0.00
2024-12-08 16:56:36,53,6555,20,33,4409.47,8122.02,0.00
2024-12-08 16:56:36,52,6555,19,33,4375.09,8122.85,0.00
2024-12-08 16:56:36,52,6556,19,33,4518.92,8123.00,0.00
2024-12-08 16:56:36,53,6556,19,34,4433.66,8123.02,0.00
2024-12-08 16:56:36,52,6556,19,33,4503.30,8123.02,0.00
2024-12-08 16:56:36,52,6557,19,33,4517.92,8124.00,0.00
2024-12-08 16:56:36,53,6557,19,34,4432.67,8124.02,0.00
2024-12-08 16:56:36,52,6557,18,34,4437.54,8124.62,0.00
2024-12-08 16:56:36,52,6558,18,34,4507.27,8125.00,0.00
2024-12-08 16:56:36,53,6558,19,34,4422.22,8125.02,0.00
2024-12-08 16:56:36,52,6558,19,33,4486.96,8125.04,0.00
2024-12-08 16:56:36,52,6559,19,33,4503.13,8126.00,0.00
2024-12-08 16:56:36,53,6559,19,34,4418.17,8126.02,0.00
2024-12-08 16:56:36,53,6560,19,34,4407.26,8127.00,0.00
2024-12-08 16:56:36,54,6560,20,34,4325.64,8127.02,0.00
2024-12-08 16:56:36,53,6560,20,33,4387.33,8127.04,0.00
2024-12-08 16:56:36,52,6560,19,33,4429.54,8127.56,0.00
2024-12-08 16:56:36,51,6560,18,33,4510.06,8127.65,0.00
2024-12-08 16:56:36,50,6560,17,33,4545.95,8127.92,0.00
2024-12-08 16:56:36,50,6561,17,33,4702.07,8128.00,0.00
2024-12-08 16:56:36,51,6561,18,33,4609.87,8128.02,0.00
2024-12-08 16:56:36,51,6562,18,33,4597.20,8129.00,0.00
2024-12-08 16:56:36,52,6562,19,33,4508.79,8129.02,0.00
2024-12-08 16:56:36,51,6562,19,32,4578.08,8129.04,0.00
2024-12-08 16:56:36,50,6562,18,32,4663.16,8129.12,0.00
2024-12-08 16:56:36,49,6562,17,32,4717.65,8129.61,0.00
2024-12-08 16:56:36,49,6563,17,32,4785.97,8130.00,0.00
2024-12-08 16:56:36,50,6563,18,32,4690.25,8130.02,0.00
2024-12-08 16:56:36,50,6564,18,32,4677.76,8131.00,0.00
2024-12-08 16:56:36,51,6564,19,32,4586.04,8131.02,0.00
2024-12-08 16:56:36,50,6564,19,31,4656.63,8131.04,0.00
2024-12-08 16:56:36,50,6565,19,31,4676.71,8132.00,0.00
2024-12-08 16:56:36,51,6565,20,31,4585.01,8132.02,0.00
2024-12-08 16:56:36,50,6565,19,31,4583.20,8132.68,0.00
2024-12-08 16:56:36,50,6566,19,31,4720.07,8133.00,0.00
2024-12-08 16:56:36,51,6566,19,32,4627.52,8133.02,0.00
2024-12-08 16:56:36,50,6566,19,31,4698.93,8133.04,0.00
2024-12-08 16:56:37,50,6567,19,31,4719.03,8134.00,0.00
2024-12-08 16:56:37,51,6567,19,32,4626.50,8134.02,0.00
2024-12-08 16:56:37,51,6568,19,32,4611.12,8135.00,0.00
2024-12-08 16:56:37,52,6568,19,33,4522.44,8135.02,0.00
2024-12-08 16:56:37,51,6568,19,32,4591.98,8135.04,0.00
2024-12-08 16:56:37,51,6569,19,32,4610.09,8136.00,0.00
2024-12-08 16:56:37,52,6569,19,33,4521.43,8136.02,0.00
2024-12-08 16:56:37,52,6570,19,33,4506.82,8137.00,0.00
2024-12-08 16:56:37,53,6570,20,33,4421.78,8137.02,0.00
2024-12-08 16:56:37,52,6570,20,32,4488.04,8137.04,0.00
2024-12-08 16:56:37,51,6570,19,32,4495.97,8137.47,0.00
2024-12-08 16:56:37,51,6571,19,32,4612.82,8138.00,0.00
2024-12-08 16:56:37,52,6571,19,33,4524.11,8138.02,0.00
2024-12-08 16:56:37,52,6572,19,33,4510.58,8139.00,0.00
2024-12-08 16:56:37,53,6572,20,33,4425.48,8139.02,0.00
2024-12-08 16:56:37,52,6572,20,32,4491.81,8139.04,0.00
2024-12-08 16:56:37,51,6572,19,32,4498.90,8139.80,0.00
2024-12-08 16:56:37,52,6571,20,32,4410.83,8139.85,0.00
2024-12-08 16:56:37,52,6572,20,32,4630.10,8140.00,0.00
2024-12-08 16:56:37,53,6572,21,32,4542.74,8140.02,0.00
2024-12-08 16:56:37,53,6573,21,32,4682.60,8141.00,0.00
2024-12-08 16:56:37,54,6573,22,32,4595.88,8141.02,0.00
2024-12-08 16:56:37,53,6573,22,31,4665.70,8141.04,0.00
2024-12-08 16:56:37,53,6574,22,31,4680.10,8142.00,0.00
2024-12-08 16:56:37,54,6574,23,31,4593.43,8142.02,0.00
2024-12-08 16:56:37,54,6575,23,31,4576.67,8143.00,0.00
2024-12-08 16:56:37,55,6575,24,31,4493.46,8143.02,0.00
2024-12-08 16:56:37,54,6575,24,30,4561.59,8143.04,0.00
2024-12-08 16:56:37,54,6576,24,30,4574.21,8144.00,0.00
2024-12-08 16:56:37,55,6576,25,30,4491.05,8144.02,0.00
2024-12-08 16:56:37,54,6576,24,30,4559.13,8144.02,0.00
2024-12-08 16:56:37,53,6576,23,30,4569.42,8144.57,0.00
2024-12-08 16:56:37,53,6577,23,30,4688.06,8145.00,0.00
2024-12-08 16:56:37,54,6577,23,31,4601.25,8145.02,0.00
2024-12-08 16:56:37,53,6577,23,30,4675.77,8145.02,0.00
2024-12-08 16:56:37,53,6578,23,30,4688.64,8146.00,0.00
2024-12-08 16:56:37,54,6578,24,30,4601.81,8146.02,0.00
2024-12-08 16:56:37,53,6578,23,30,4614.37,8146.30,0.00
2024-12-08 16:56:37,53,6579,23,30,4711.68,8147.00,0.00
2024-12-08 16:56:37,54,6579,23,31,4624.42,8147.02,0.00
2024-12-08 16:56:37,53,6579,23,30,4700.92,8147.02,0.00
2024-12-08 16:56:37,53,6580,23,30,4713.79,8148.00,0.00
2024-12-08 16:56:37,54,6580,23,31,4626.50,8148.02,0.00
2024-12-08 16:56:37,54,6581,23,31,4607.45,8149.00,0.00
2024-12-08 16:56:37,55,6581,23,32,4523.68,8149.02,0.00
2024-12-08 16:56:37,54,6581,23,31,4598.39,8149.02,0.00
2024-12-08 16:56:37,53,6581,22,31,4577.82,8149.60,0.00
2024-12-08 16:56:37,53,6582,22,31,4699.57,8150.00,0.00
2024-12-08 16:56:37,54,6582,22,32,4612.54,8150.02,0.00
2024-12-08 16:56:37,53,6582,21,32,4602.84,8150.40,0.00
2024-12-08 16:56:37,53,6583,21,32,4707.84,8151.00,0.00
2024-12-08 16:56:37,54,6583,21,33,4620.66,8151.02,0.00
2024-12-08 16:56:37,53,6583,21,32,4695.54,8151.04,0.00
2024-12-08 16:56:37,52,6583,20,32,4674.84,8151.62,0.00
2024-12-08 16:56:37,52,6584,20,32,4800.53,8152.00,0.00
2024-12-08 16:56:37,53,6584,20,33,4709.95,8152.02,0.00
2024-12-08 16:56:37,52,6584,19,33,4698.78,8152.40,0.00
2024-12-08 16:56:37,52,6585,19,33,4807.39,8153.00,0.00
2024-12-08 16:56:37,53,6585,19,34,4716.68,8153.02,0.00
2024-12-08 16:56:37,52,6585,19,33,4796.42,8153.04,0.00
2024-12-08 16:56:37,51,6585,18,33,4782.04,8153.59,0.00
2024-12-08 16:56:37,51,6586,18,33,4849.35,8154.00,0.00
2024-12-08 16:56:37,52,6586,19,33,4756.10,8154.02,0.00
2024-12-08 16:56:37,51,6586,18,33,4742.27,8154.18,0.00
2024-12-08 16:56:37,50,6586,17,33,4762.64,8154.82,0.00
2024-12-08 16:56:37,50,6587,17,33,4862.18,8155.00,0.00
2024-12-08 16:56:37,51,6587,18,33,4766.85,8155.02,0.00
2024-12-08 16:56:37,50,6587,18,32,4850.77,8155.04,0.00
2024-12-08 16:56:37,50,6588,18,32,4817.89,8156.00,0.00
2024-12-08 16:56:37,51,6588,18,33,4723.42,8156.02,0.00
2024-12-08 16:56:37,50,6588,18,32,4677.34,8156.80,0.00
2024-12-08 16:56:37,50,6589,18,32,4759.06,8157.00,0.00
2024-12-08 16:56:37,51,6589,19,32,4665.75,8157.02,0.00
2024-12-08 16:56:37,50,6589,19,31,4749.27,8157.04,0.00
2024-12-08 16:56:37,50,6590,19,31,4769.43,8158.00,0.00
2024-12-08 16:56:37,51,6590,20,31,4675.91,8158.02,0.00
2024-12-08 16:56:37,50,6590,19,31,4677.27,8158.66,0.00
2024-12-08 16:56:37,50,6591,19,31,4812.95,8159.00,0.00
2024-12-08 16:56:37,51,6591,19,32,4718.58,8159.02,0.00
2024-12-08 16:56:37,50,6591,19,31,4804.80,8159.04,0.00
2024-12-08 16:56:38,50,6592,19,31,4824.97,8160.00,0.00
2024-12-08 16:56:38,51,6592,19,32,4730.36,8160.02,0.00
2024-12-08 16:56:38,51,6593,19,32,4714.94,8161.00,0.00
2024-12-08 16:56:38,52,6593,19,33,4624.27,8161.02,0.00
2024-12-08 16:56:38,51,6593,19,32,4706.94,8161.04,0.00
2024-12-08 16:56:38,51,6594,19,32,4725.12,8162.00,0.00
2024-12-08 16:56:38,52,6594,20,32,4634.25,8162.02,0.00
2024-12-08 16:56:38,52,6595,20,32,4617.55,8163.00,0.00
2024-12-08 16:56:38,53,6595,21,32,4530.43,8163.02,0.00
2024-12-08 16:56:38,52,6595,21,31,4609.70,8163.04,0.00
2024-12-08 16:56:38,51,6595,20,31,4602.70,8163.55,0.00
2024-12-08 16:56:38,51,6596,20,31,4726.28,8164.00,0.00
2024-12-08 16:56:38,52,6596,21,31,4635.39,8164.02,0.00
2024-12-08 16:56:38,52,6597,21,31,4618.68,8165.00,0.00
2024-12-08 16:56:38,53,6597,21,32,4531.54,8165.02,0.00
2024-12-08 16:56:38,52,6597,21,31,4610.83,8165.04,0.00
2024-12-08 16:56:38,51,6597,20,31,4693.27,8165.14,0.00
2024-12-08 16:56:38,50,6597,19,31,4694.28,8165.56,0.00
2024-12-08 16:56:38,50,6598,19,31,4821.98,8166.00,0.00
2024-12-08 16:56:38,51,6598,20,31,4727.43,8166.02,0.00
2024-12-08 16:56:38,51,6599,20,31,4712.00,8167.00,0.00
2024-12-08 16:56:38,52,6599,21,31,4621.38,8167.02,0.00
2024-12-08 16:56:38,51,6599,21,30,4705.60,8167.04,0.00
2024-12-08 16:56:38,51,6600,21,30,4723.79,8168.00,0.00
2024-12-08 16:56:38,52,6600,22,30,4632.95,8168.02,0.00
2024-12-08 16:56:38,51,6600,21,30,4607.82,8168.82,0.00
2024-12-08 16:56:38,51,6601,21,30,4753.71,8169.00,0.00
2024-12-08 16:56:38,52,6601,21,31,4662.30,8169.02,0.00
2024-12-08 16:56:38,51,6601,21,30,4742.50,8169.04,0.00
2024-12-08 16:56:38,51,6602,21,30,4758.79,8170.00,0.00
2024-12-08 16:56:38,52,6602,22,30,4667.27,8170.02,0.00
2024-12-08 16:56:38,52,6603,22,30,4648.54,8171.00,0.00
2024-12-08 16:56:38,53,6603,23,30,4560.83,8171.02,0.00
2024-12-08 16:56:38,52,6603,23,29,4637.54,8171.04,0.00
2024-12-08 16:56:38,52,6604,23,29,4652.69,8172.00,0.00
2024-12-08 16:56:38,53,6604,23,30,4564.90,8172.02,0.00
2024-12-08 16:56:38,53,6605,23,30,4546.15,8173.00,0.00
2024-12-08 16:56:38,54,6605,24,30,4461.96,8173.02,0.00
2024-12-08 16:56:38,53,6605,24,29,4533.81,8173.04,0.00
2024-12-08 16:56:38,53,6606,24,29,4547.72,8174.00,0.00
2024-12-08 16:56:38,54,6606,25,29,4463.50,8174.02,0.00
2024-12-08 16:56:38,54,6607,25,29,4446.79,8175.00,0.00
2024-12-08 16:56:38,55,6607,25,30,4365.94,8175.02,0.00
2024-12-08 16:56:38,54,6607,25,29,4445.28,8175.02,0.00
2024-12-08 16:56:38,53,6607,25,28,4516.81,8175.02,0.00
2024-12-08 16:56:38,52,6607,24,28,4595.84,8175.10,0.00
2024-12-08 16:56:38,51,6607,23,28,4639.75,8175.65,0.00
2024-12-08 16:56:38,51,6608,23,28,4707.32,8176.00,0.00
2024-12-08 16:56:38,52,6608,23,29,4616.79,8176.02,0.00
2024-12-08 16:56:38,52,6609,23,29,4603.73,8177.00,0.00
2024-12-08 16:56:38,53,6609,23,30,4516.87,8177.02,0.00
2024-12-08 16:56:38,52,6609,23,29,4581.72,8177.04,0.00
2024-12-08 16:56:38,51,6609,22,29,4659.82,8177.10,0.00
2024-12-08 16:56:38,51,6610,22,29,4746.96,8178.00,0.00
2024-12-08 16:56:38,52,6610,22,30,4655.67,8178.02,0.00
2024-12-08 16:56:38,52,6611,22,30,4641.82,8179.00,0.00
2024-12-08 16:56:38,53,6611,23,30,4554.24,8179.02,0.00
2024-12-08 16:56:38,52,6611,23,29,4621.38,8179.04,0.00
2024-12-08 16:56:38,51,6611,22,29,4646.65,8179.35,0.00
2024-12-08 16:56:38,51,6612,22,29,4754.53,8180.00,0.00
2024-12-08 16:56:38,52,6612,23,29,4663.10,8180.02,0.00
2024-12-08 16:56:38,52,6613,23,29,4648.94,8181.00,0.00
2024-12-08 16:56:38,53,6613,23,30,4561.23,8181.02,0.00
2024-12-08 16:56:38,52,6613,23,29,4630.07,8181.04,0.00
2024-12-08 16:56:38,52,6614,23,29,4646.36,8182.00,0.00
2024-12-08 16:56:38,53,6614,23,30,4558.70,8182.02,0.00
2024-12-08 16:56:38,52,6614,22,30,4610.75,8182.06,0.00
2024-12-08 16:56:38,51,6614,21,30,4653.33,8182.63,0.00
2024-12-08 16:56:38,51,6615,21,30,4729.00,8183.00,0.00
2024-12-08 16:56:38,52,6615,21,31,4638.06,8183.02,0.00
2024-12-08 16:56:38,51,6615,21,30,4703.33,8183.04,0.00
2024-12-08 16:56:38,51,6616,21,30,4721.55,8184.00,0.00
2024-12-08 16:56:38,52,6616,21,31,4630.76,8184.02,0.00
2024-12-08 16:56:38,52,6617,21,31,4626.40,8185.00,0.00
2024-12-08 16:56:38,53,6617,22,31,4539.11,8185.02,0.00
2024-12-08 16:56:38,52,6617,22,30,4593.35,8185.06,0.00
2024-12-08 16:56:38,51,6617,21,30,4640.32,8185.14,0.00
2024-12-08 16:56:39,51,6618,21,30,4730.73,8186.00,0.00
2024-12-08 16:56:39,52,6618,21,31,4639.76,8186.02,0.00
2024-12-08 16:56:39,52,6619,21,31,4629.31,8187.00,0.00
2024-12-08 16:56:39,53,6619,22,31,4541.96,8187.02,0.00
2024-12-08 16:56:39,52,6619,22,30,4605.70,8187.06,0.00
2024-12-08 16:56:39,51,6619,21,30,4691.19,8187.06,0.00
2024-12-08 16:56:39,52,6618,21,31,4579.04,8187.37,0.00
2024-12-08 16:56:39,51,6618,20,31,4707.52,8187.61,0.00
2024-12-08 16:56:39,51,6619,20,31,4836.25,8188.00,0.00
2024-12-08 16:56:39,52,6619,21,31,4743.24,8188.02,0.00
2024-12-08 16:56:39,52,6620,21,31,4895.37,8189.00,0.00
2024-12-08 16:56:39,53,6620,21,32,4803.00,8189.02,0.00
2024-12-08 16:56:39,52,6620,21,31,4863.88,8189.06,0.00
2024-12-08 16:56:39,52,6621,21,31,4881.79,8190.00,0.00
2024-12-08 16:56:39,53,6621,22,31,4789.68,8190.02,0.00
2024-12-08 16:56:39,52,6621,21,31,4877.13,8190.06,0.00
2024-12-08 16:56:39,52,6622,21,31,4879.04,8191.00,0.00
2024-12-08 16:56:39,53,6622,22,31,4786.98,8191.02,0.00
2024-12-08 16:56:39,53,6623,22,31,4769.02,8192.00,0.00
2024-12-08 16:56:39,54,6623,23,31,4680.70,8192.02,0.00
2024-12-08 16:56:39,53,6623,23,30,4762.84,8192.06,0.00
2024-12-08 16:56:39,53,6624,23,30,4778.87,8193.00,0.00
2024-12-08 16:56:39,54,6624,24,30,4690.38,8193.02,0.00
2024-12-08 16:56:39,53,6624,23,30,4721.72,8193.15,0.00
2024-12-08 16:56:39,53,6625,23,30,4807.29,8194.00,0.00
2024-12-08 16:56:39,54,6625,24,30,4718.26,8194.02,0.00
2024-12-08 16:56:39,53,6625,24,29,4771.73,8194.06,0.00
2024-12-08 16:56:39,53,6626,24,29,4787.77,8195.00,0.00
2024-12-08 16:56:39,54,6626,25,29,4699.11,8195.02,0.00
2024-12-08 16:56:39,54,6627,25,29,4692.15,8196.00,0.00
2024-12-08 16:56:39,55,6627,26,29,4606.84,8196.02,0.00
2024-12-08 16:56:39,54,6627,26,28,4658.77,8196.06,0.00
2024-12-08 16:56:39,54,6628,26,28,4672.99,8197.00,0.00
2024-12-08 16:56:39,55,6628,27,28,4588.03,8197.02,0.00
2024-12-08 16:56:39,55,6629,27,28,4580.66,8198.00,0.00
2024-12-08 16:56:39,56,6629,28,28,4498.86,8198.02,0.00
2024-12-08 16:56:39,55,6629,28,27,4549.36,8198.06,0.00
2024-12-08 16:56:39,55,6630,28,27,4561.84,8199.00,0.00
2024-12-08 16:56:39,56,6630,28,28,4480.38,8199.02,0.00
2024-12-08 16:56:39,55,6630,27,28,4503.95,8199.09,0.00
2024-12-08 16:56:39,54,6630,26,28,4557.11,8199.46,0.00
2024-12-08 16:56:39,54,6631,26,28,4665.29,8200.00,0.00
2024-12-08 16:56:39,55,6631,27,28,4580.46,8200.02,0.00
2024-12-08 16:56:39,54,6631,27,27,4633.40,8200.06,0.00
2024-12-08 16:56:39,53,6631,26,27,4685.45,8200.49,0.00
2024-12-08 16:56:39,53,6632,26,27,4736.78,8201.00,0.00
2024-12-08 16:56:39,54,6632,27,27,4649.06,8201.02,0.00
2024-12-08 16:56:39,53,6632,26,27,4732.90,8201.06,0.00
2024-12-08 16:56:39,53,6633,26,27,4738.29,8202.00,0.00
2024-12-08 16:56:39,54,6633,27,27,4650.54,8202.02,0.00
2024-12-08 16:56:39,53,6633,26,27,4676.19,8202.40,0.00
2024-12-08 16:56:39,53,6634,26,27,4719.68,8203.00,0.00
2024-12-08 16:56:39,54,6634,26,28,4632.28,8203.02,0.00
2024-12-08 16:56:39,53,6634,26,27,4707.30,8203.08,0.00
2024-12-08 16:56:39,52,6634,25,27,4766.97,8203.44,0.00
2024-12-08 16:56:39,52,6635,25,27,4815.56,8204.00,0.00
2024-12-08 16:56:39,53,6635,26,27,4724.70,8204.02,0.00
2024-12-08 16:56:39,53,6636,26,27,4722.43,8205.00,0.00
2024-12-08 16:56:39,54,6636,26,28,4634.98,8205.02,0.00
2024-12-08 16:56:39,54,6637,26,28,4613.10,8206.00,0.00
2024-12-08 16:56:39,55,6637,26,29,4529.23,8206.02,0.00
2024-12-08 16:56:39,54,6637,26,28,4603.99,8206.07,0.00
2024-12-08 16:56:40,54,6638,26,28,4615.43,8207.00,0.00
2024-12-08 16:56:40,55,6638,27,28,4531.51,8207.02,0.00
2024-12-08 16:56:40,54,6638,27,27,4613.91,8207.02,0.00
2024-12-08 16:56:40,53,6638,26,27,4699.42,8207.04,0.00
2024-12-08 16:56:40,52,6638,25,27,4646.50,8207.96,0.00
2024-12-08 16:56:40,52,6639,25,27,4801.20,8208.00,0.00
2024-12-08 16:56:40,53,6639,25,28,4710.62,8208.02,0.00
2024-12-08 16:56:40,53,6640,25,28,4680.02,8209.00,0.00
2024-12-08 16:56:40,54,6640,25,29,4593.36,8209.02,0.00
2024-12-08 16:56:40,53,6640,25,28,4676.93,8209.04,0.00
2024-12-08 16:56:40,53,6641,25,28,4671.66,8210.00,0.00
2024-12-08 16:56:40,54,6641,25,29,4585.15,8210.02,0.00
2024-12-08 16:56:40,54,6642,25,29,4582.06,8211.00,0.00
2024-12-08 16:56:40,55,6642,26,29,4498.75,8211.02,0.00
2024-12-08 16:56:40,54,6642,26,28,4441.02,8211.56,0.00
2024-12-08 16:56:40,53,6642,25,28,4518.66,8211.64,0.00
2024-12-08 16:56:40,53,6643,25,28,4644.41,8212.00,0.00
2024-12-08 16:56:40,54,6643,25,29,4558.40,8212.02,0.00
2024-12-08 16:56:40,54,6644,25,29,4548.09,8213.00,0.00
2024-12-08 16:56:40,55,6644,25,30,4465.40,8213.02,0.00
2024-12-08 16:56:40,54,6644,25,29,4523.75,8213.04,0.00
2024-12-08 16:56:40,54,6645,25,29,4536.47,8214.00,0.00
2024-12-08 16:56:40,55,6645,26,29,4453.99,8214.02,0.00
2024-12-08 16:56:40,54,6645,25,29,4413.72,8214.89,0.00
2024-12-08 16:56:40,54,6646,25,29,4556.80,8215.00,0.00
2024-12-08 16:56:40,55,6646,26,29,4473.95,8215.02,0.00
2024-12-08 16:56:40,54,6646,26,28,4529.42,8215.04,0.00
2024-12-08 16:56:40,53,6646,25,28,4611.79,8215.08,0.00
2024-12-08 16:56:40,53,6647,25,28,4629.39,8216.00,0.00
2024-12-08 16:56:40,54,6647,25,29,4543.66,8216.02,0.00
2024-12-08 16:56:40,53,6647,24,29,4528.79,8216.40,0.00
2024-12-08 16:56:40,53,6648,24,29,4634.61,8217.00,0.00
2024-12-08 16:56:40,54,6648,25,29,4548.78,8217.02,0.00
2024-12-08 16:56:40,53,6648,25,28,4608.25,8217.04,0.00
2024-12-08 16:56:40,52,6648,24,28,4600.33,8217.48,0.00
2024-12-08 16:56:40,53,6647,25,28,4513.53,8217.51,0.00
2024-12-08 16:56:40,53,6648,25,28,4673.57,8218.00,0.00
2024-12-08 16:56:40,54,6648,25,29,4587.02,8218.02,0.00
2024-12-08 16:56:40,54,6649,25,29,4727.71,8219.00,0.00
2024-12-08 16:56:40,55,6649,26,29,4641.75,8219.02,0.00
2024-12-08 16:56:40,54,6649,26,28,4703.36,8219.04,0.00
2024-12-08 16:56:40,53,6649,25,28,4682.38,8219.91,0.00
2024-12-08 16:56:40,53,6650,25,28,4829.79,8220.00,0.00
2024-12-08 16:56:40,54,6650,25,29,4740.35,8220.02,0.00
2024-12-08 16:56:40,54,6651,25,29,4725.44,8221.00,0.00
2024-12-08 16:56:40,55,6651,25,30,4639.52,8221.02,0.00
2024-12-08 16:56:40,54,6651,24,30,4723.92,8221.02,0.00
2024-12-08 16:56:40,53,6651,24,29,4788.23,8221.02,0.00
2024-12-08 16:56:40,52,6651,23,29,4822.45,8221.60,0.00
2024-12-08 16:56:40,51,6651,22,29,4910.60,8221.67,0.00
2024-12-08 16:56:40,51,6652,22,29,5044.68,8222.00,0.00
2024-12-08 16:56:40,52,6652,23,29,4947.67,8222.02,0.00
2024-12-08 16:56:40,52,6653,23,29,4932.16,8223.00,0.00
2024-12-08 16:56:40,53,6653,23,30,4839.10,8223.02,0.00
2024-12-08 16:56:40,52,6653,23,29,4903.70,8223.04,0.00
2024-12-08 16:56:40,52,6654,23,29,4915.03,8224.00,0.00
2024-12-08 16:56:40,53,6654,24,29,4822.29,8224.02,0.00
2024-12-08 16:56:40,53,6655,24,29,4809.62,8225.00,0.00
2024-12-08 16:56:40,54,6655,24,30,4720.56,8225.02,0.00
2024-12-08 16:56:40,53,6655,24,29,4783.24,8225.04,0.00
2024-12-08 16:56:40,52,6655,23,29,4872.32,8225.06,0.00
2024-12-08 16:56:40,51,6655,22,29,4967.86,8225.06,0.00
2024-12-08 16:56:40,51,6656,22,29,4984.84,8226.00,0.00
2024-12-08 16:56:40,52,6656,23,29,4888.98,8226.02,0.00
2024-12-08 16:56:40,51,6656,22,29,4905.14,8226.24,0.00
2024-12-08 16:56:40,51,6657,22,29,5002.78,8227.00,0.00
2024-12-08 16:56:40,52,6657,22,30,4906.58,8227.02,0.00
2024-12-08 16:56:40,51,6657,22,29,4976.97,8227.04,0.00
2024-12-08 16:56:40,51,6658,22,29,4993.39,8228.00,0.00
2024-12-08 16:56:40,52,6658,22,30,4897.36,8228.02,0.00
2024-12-08 16:56:40,51,6658,21,30,4992.62,8228.02,0.00
2024-12-08 16:56:40,50,6658,20,30,5010.60,8228.52,0.00
2024-12-08 16:56:40,50,6659,20,30,5136.05,8229.00,0.00
2024-12-08 16:56:40,51,6659,20,31,5035.34,8229.02,0.00
2024-12-08 16:56:40,50,6659,20,30,5108.07,8229.02,0.00
2024-12-08 16:56:40,50,6660,20,30,5125.20,8230.00,0.00
2024-12-08 16:56:40,51,6660,21,30,5024.71,8230.02,0.00
2024-12-08 16:56:40,51,6661,21,30,5013.94,8231.00,0.00
2024-12-08 16:56:40,52,6661,22,30,4917.51,8231.02,0.00
2024-12-08 16:56:40,51,6661,22,29,4981.67,8231.04,0.00
2024-12-08 16:56:40,50,6661,21,29,5079.65,8231.04,0.00
2024-12-08 16:56:40,50,6662,21,29,5095.79,8232.00,0.00
2024-12-08 16:56:40,51,6662,22,29,4995.87,8232.02,0.00
2024-12-08 16:56:41,51,6663,22,29,4984.85,8233.00,0.00
2024-12-08 16:56:41,52,6663,22,30,4888.99,8233.02,0.00
2024-12-08 16:56:41,51,6663,22,29,4950.96,8233.04,0.00
2024-12-08 16:56:41,51,6664,22,29,4964.87,8234.00,0.00
2024-12-08 16:56:41,52,6664,22,30,4869.39,8234.02,0.00
2024-12-08 16:56:41,51,6664,21,30,4841.76,8234.78,0.00
2024-12-08 16:56:41,51,6665,21,30,4985.63,8235.00,0.00
2024-12-08 16:56:41,52,6665,21,31,4889.75,8235.02,0.00
2024-12-08 16:56:41,51,6665,21,30,4950.11,8235.04,0.00
2024-12-08 16:56:41,51,6666,21,30,4964.51,8236.00,0.00
2024-12-08 16:56:41,52,6666,21,31,4869.04,8236.02,0.00
2024-12-08 16:56:41,52,6667,21,31,4859.79,8237.00,0.00
2024-12-08 16:56:41,53,6667,22,31,4768.10,8237.02,0.00
2024-12-08 16:56:41,52,6667,22,30,4826.53,8237.04,0.00
2024-12-08 16:56:41,51,6667,21,30,4888.95,8237.20,0.00
2024-12-08 16:56:41,50,6667,20,30,4956.18,8237.52,0.00
2024-12-08 16:56:41,50,6668,20,30,5081.76,8238.00,0.00
2024-12-08 16:56:41,51,6668,20,31,4982.12,8238.02,0.00
2024-12-08 16:56:41,51,6669,20,31,4972.85,8239.00,0.00
2024-12-08 16:56:41,52,6669,20,32,4877.22,8239.02,0.00
2024-12-08 16:56:41,51,6669,20,31,4940.55,8239.04,0.00
2024-12-08 16:56:41,51,6670,20,31,4958.91,8240.00,0.00
2024-12-08 16:56:41,52,6670,21,31,4863.55,8240.02,0.00
2024-12-08 16:56:41,52,6671,21,31,4855.54,8241.00,0.00
2024-12-08 16:56:41,53,6671,21,32,4763.92,8241.02,0.00
2024-12-08 16:56:41,52,6671,21,31,4825.43,8241.04,0.00
2024-12-08 16:56:41,52,6672,21,31,4841.86,8242.00,0.00
2024-12-08 16:56:41,53,6672,22,31,4750.51,8242.02,0.00
2024-12-08 16:56:41,53,6673,22,31,4744.14,8243.00,0.00
2024-12-08 16:56:41,54,6673,23,31,4656.29,8243.02,0.00
2024-12-08 16:56:41,53,6673,23,30,4713.04,8243.04,0.00
2024-12-08 16:56:41,52,6673,23,29,4794.86,8243.14,0.00
2024-12-08 16:56:41,52,6674,23,29,4819.17,8244.00,0.00
2024-12-08 16:56:41,53,6674,24,29,4728.25,8244.02,0.00
2024-12-08 16:56:41,52,6674,23,29,4781.12,8244.02,0.00
2024-12-08 16:56:41,52,6675,23,29,4827.68,8245.00,0.00
2024-12-08 16:56:41,53,6675,23,30,4736.60,8245.02,0.00
2024-12-08 16:56:41,52,6675,23,29,4799.14,8245.02,0.00
2024-12-08 16:56:41,51,6675,22,29,4835.60,8245.26,0.00
2024-12-08 16:56:41,51,6676,22,29,4936.35,8246.00,0.00
2024-12-08 16:56:41,52,6676,23,29,4841.42,8246.02,0.00
2024-12-08 16:56:41,52,6677,23,29,4833.23,8247.00,0.00
2024-12-08 16:56:41,53,6677,24,29,4742.04,8247.02,0.00
2024-12-08 16:56:41,52,6677,24,28,4806.27,8247.02,0.00
2024-12-08 16:56:41,52,6678,24,28,4821.13,8248.00,0.00
2024-12-08 16:56:41,53,6678,25,28,4730.16,8248.02,0.00
2024-12-08 16:56:41,52,6678,24,28,4701.04,8248.81,0.00
2024-12-08 16:56:41,52,6679,24,28,4843.94,8249.00,0.00
2024-12-08 16:56:41,53,6679,24,29,4752.55,8249.02,0.00
2024-12-08 16:56:41,52,6679,24,28,4818.56,8249.02,0.00
2024-12-08 16:56:41,51,6679,23,28,4868.31,8249.55,0.00
2024-12-08 16:56:41,51,6680,23,28,4928.48,8250.00,0.00
2024-12-08 16:56:41,52,6680,23,29,4833.71,8250.02,0.00
2024-12-08 16:56:41,52,6681,23,29,4856.61,8251.00,0.00
2024-12-08 16:56:41,53,6681,24,29,4764.97,8251.02,0.00
2024-12-08 16:56:41,53,6682,24,29,4766.04,8252.00,0.00
2024-12-08 16:56:41,54,6682,24,30,4677.78,8252.02,0.00
2024-12-08 16:56:41,53,6682,23,30,4731.80,8252.06,0.00
2024-12-08 16:56:41,53,6683,23,30,4747.93,8253.00,0.00
2024-12-08 16:56:41,54,6683,23,31,4660.01,8253.02,0.00
2024-12-08 16:56:41,53,6683,23,30,4738.60,8253.04,0.00
2024-12-08 16:56:41,53,6684,23,30,4753.18,8254.00,0.00
2024-12-08 16:56:41,54,6684,24,30,4665.16,8254.02,0.00
2024-12-08 16:56:41,53,6684,23,30,4750.07,8254.06,0.00
2024-12-08 16:56:41,52,6684,22,30,4772.54,8254.50,0.00
2024-12-08 16:56:41,52,6685,22,30,4846.84,8255.00,0.00
2024-12-08 16:56:41,53,6685,22,31,4755.39,8255.02,0.00
2024-12-08 16:56:41,52,6685,21,31,4720.90,8255.77,0.00
2024-12-08 16:56:41,52,6686,21,31,4860.79,8256.00,0.00
2024-12-08 16:56:41,53,6686,22,31,4769.07,8256.02,0.00
2024-12-08 16:56:41,52,6686,21,31,4856.04,8256.08,0.00
2024-12-08 16:56:41,51,6686,21,30,4941.56,8256.12,0.00
2024-12-08 16:56:41,51,6687,21,30,4966.41,8257.00,0.00
2024-12-08 16:56:41,52,6687,21,31,4870.90,8257.02,0.00
2024-12-08 16:56:41,52,6688,21,31,4871.26,8258.00,0.00
2024-12-08 16:56:41,53,6688,21,32,4779.35,8258.02,0.00
2024-12-08 16:56:41,52,6688,20,32,4868.77,8258.04,0.00
2024-12-08 16:56:41,51,6688,19,32,4880.53,8258.55,0.00
2024-12-08 16:56:41,51,6689,19,32,5005.55,8259.00,0.00
2024-12-08 16:56:41,52,6689,19,33,4909.29,8259.02,0.00
2024-12-08 16:56:41,51,6689,19,32,4991.00,8259.10,0.00
2024-12-08 16:56:42,51,6690,19,32,5014.26,8260.00,0.00
2024-12-08 16:56:42,52,6690,20,32,4917.83,8260.02,0.00
2024-12-08 16:56:42,52,6691,20,32,4916.39,8261.00,0.00
2024-12-08 16:56:42,53,6691,20,33,4823.63,8261.02,0.00
2024-12-08 16:56:42,53,6692,20,33,4805.51,8262.00,0.00
2024-12-08 16:56:42,54,6692,20,34,4716.52,8262.02,0.00
2024-12-08 16:56:42,53,6692,20,33,4793.06,8262.10,0.00
2024-12-08 16:56:42,53,6693,20,33,4812.33,8263.00,0.00
2024-12-08 16:56:42,54,6693,21,33,4723.21,8263.02,0.00
2024-12-08 16:56:42,53,6693,20,33,4675.67,8263.96,0.00
2024-12-08 16:56:42,53,6694,20,33,4828.50,8264.00,0.00
2024-12-08 16:56:42,54,6694,21,33,4739.08,8264.02,0.00
2024-12-08 16:56:42,54,6695,21,33,4719.76,8265.00,0.00
2024-12-08 16:56:42,55,6695,21,34,4633.95,8265.02,0.00
2024-12-08 16:56:42,54,6695,21,33,4710.60,8265.09,0.00
2024-12-08 16:56:42,54,6696,21,33,4727.98,8266.00,0.00
2024-12-08 16:56:42,55,6696,22,33,4642.02,8266.02,0.00
2024-12-08 16:56:42,54,6696,21,33,4605.16,8266.57,0.00
2024-12-08 16:56:42,54,6697,21,33,4723.34,8267.00,0.00
2024-12-08 16:56:42,55,6697,22,33,4637.47,8267.02,0.00
2024-12-08 16:56:42,54,6697,21,33,4636.07,8267.28,0.00
2024-12-08 16:56:42,54,6698,21,33,4729.94,8268.00,0.00
2024-12-08 16:56:42,55,6698,22,33,4643.94,8268.02,0.00
2024-12-08 16:56:42,54,6698,22,32,4722.31,8268.09,0.00
2024-12-08 16:56:42,54,6699,22,32,4739.70,8269.00,0.00
2024-12-08 16:56:42,55,6699,23,32,4653.53,8269.02,0.00
2024-12-08 16:56:42,55,6700,23,32,4645.65,8270.00,0.00
2024-12-08 16:56:42,56,6700,23,33,4562.69,8270.02,0.00
2024-12-08 16:56:42,55,6700,23,32,4609.58,8270.09,0.00
2024-12-08 16:56:42,54,6700,22,32,4645.60,8270.59,0.00
2024-12-08 16:56:42,54,6701,22,32,4765.36,8271.00,0.00
2024-12-08 16:56:42,55,6701,22,33,4678.71,8271.02,0.00
2024-12-08 16:56:42,54,6701,21,33,4630.59,8271.67,0.00
2024-12-08 16:56:42,54,6702,21,33,4756.46,8272.00,0.00
2024-12-08 16:56:42,55,6702,21,34,4669.98,8272.02,0.00
2024-12-08 16:56:42,54,6702,21,33,4721.24,8272.09,0.00
2024-12-08 16:56:42,53,6702,20,33,4712.49,8272.53,0.00
2024-12-08 16:56:42,54,6701,21,33,4611.54,8272.72,0.00
2024-12-08 16:56:42,54,6702,21,33,4766.51,8273.00,0.00
2024-12-08 16:56:42,55,6702,21,34,4679.85,8273.02,0.00
2024-12-08 16:56:42,54,6702,20,34,4718.48,8273.19,0.00
2024-12-08 16:56:42,54,6703,20,34,4958.03,8274.00,0.00
2024-12-08 16:56:42,55,6703,21,34,4867.89,8274.02,0.00
2024-12-08 16:56:42,54,6703,21,33,4922.80,8274.09,0.00
2024-12-08 16:56:42,53,6703,20,33,4923.81,8274.55,0.00
2024-12-08 16:56:42,53,6704,20,33,5042.82,8275.00,0.00
2024-12-08 16:56:42,54,6704,21,33,4949.44,8275.02,0.00
2024-12-08 16:56:42,54,6705,21,33,4937.74,8276.00,0.00
2024-12-08 16:56:42,55,6705,22,33,4847.96,8276.02,0.00
2024-12-08 16:56:42,54,6705,22,32,4904.04,8276.09,0.00
2024-12-08 16:56:42,54,6706,22,32,4921.48,8277.00,0.00
2024-12-08 16:56:42,55,6706,22,33,4832.00,8277.02,0.00
2024-12-08 16:56:42,54,6706,21,33,4892.36,8277.04,0.00
2024-12-08 16:56:42,54,6707,21,33,4935.87,8278.00,0.00
2024-12-08 16:56:42,55,6707,22,33,4846.13,8278.02,0.00
2024-12-08 16:56:42,54,6707,21,33,4923.61,8278.02,0.00
2024-12-08 16:56:42,53,6707,21,32,4982.15,8278.08,0.00
2024-12-08 16:56:42,53,6708,21,32,5062.41,8279.00,0.00
2024-12-08 16:56:42,54,6708,21,33,4968.66,8279.02,0.00
2024-12-08 16:56:42,54,6709,21,33,4957.83,8280.00,0.00
2024-12-08 16:56:42,55,6709,22,33,4867.69,8280.02,0.00
2024-12-08 16:56:42,54,6709,21,33,4949.98,8280.06,0.00
2024-12-08 16:56:42,53,6709,21,32,5012.14,8280.08,0.00
2024-12-08 16:56:42,53,6710,21,32,5092.42,8281.00,0.00
2024-12-08 16:56:42,54,6710,21,33,4998.11,8281.02,0.00
2024-12-08 16:56:42,53,6710,20,33,5062.73,8281.04,0.00
2024-12-08 16:56:42,53,6711,20,33,5108.66,8282.00,0.00
2024-12-08 16:56:42,54,6711,20,34,5014.05,8282.02,0.00
2024-12-08 16:56:42,53,6711,20,33,5075.85,8282.06,0.00
2024-12-08 16:56:42,53,6712,20,33,5092.08,8283.00,0.00
2024-12-08 16:56:42,54,6712,20,34,4997.78,8283.02,0.00
2024-12-08 16:56:42,53,6712,19,34,4973.51,8283.47,0.00
2024-12-08 16:56:42,53,6713,19,34,5086.45,8284.00,0.00
2024-12-08 16:56:42,54,6713,19,35,4992.25,8284.02,0.00
2024-12-08 16:56:42,53,6713,19,34,5055.19,8284.06,0.00
2024-12-08 16:56:43,52,6713,18,34,5108.10,8284.60,0.00
2024-12-08 16:56:43,52,6714,18,34,5234.28,8285.00,0.00
2024-12-08 16:56:43,53,6714,18,35,5135.52,8285.02,0.00
2024-12-08 16:56:43,52,6714,17,35,5121.74,8285.37,0.00
2024-12-08 16:56:43,52,6715,17,35,5228.98,8286.00,0.00
2024-12-08 16:56:43,53,6715,18,35,5130.32,8286.02,0.00
2024-12-08 16:56:43,52,6715,18,34,5197.12,8286.06,0.00
2024-12-08 16:56:43,51,6715,17,34,5281.19,8286.16,0.00
2024-12-08 16:56:43,51,6716,17,34,5374.40,8287.00,0.00
2024-12-08 16:56:43,52,6716,18,34,5271.05,8287.02,0.00
2024-12-08 16:56:43,51,6716,17,34,5325.69,8287.14,0.00
2024-12-08 16:56:43,51,6717,17,34,5417.30,8288.00,0.00
2024-12-08 16:56:43,52,6717,18,34,5313.12,8288.02,0.00
2024-12-08 16:56:43,51,6717,18,33,5384.81,8288.06,0.00
2024-12-08 16:56:43,51,6718,18,33,5404.95,8289.00,0.00
2024-12-08 16:56:43,52,6718,18,34,5301.01,8289.02,0.00
2024-12-08 16:56:43,52,6719,18,34,5284.84,8290.00,0.00
2024-12-08 16:56:43,53,6719,18,35,5185.12,8290.02,0.00
2024-12-08 16:56:43,52,6719,18,34,5252.96,8290.06,0.00
2024-12-08 16:56:43,52,6720,18,34,5271.12,8291.00,0.00
2024-12-08 16:56:43,53,6720,18,35,5171.67,8291.02,0.00
2024-12-08 16:56:43,52,6720,17,35,5138.64,8291.92,0.00
2024-12-08 16:56:43,52,6720,17,35,5291.77,8292.00,0.00
2024-12-08 16:56:43,53,6720,18,35,5191.92,8292.02,0.00
2024-12-08 16:56:43,52,6720,18,34,5261.48,8292.06,0.00
2024-12-08 16:56:43,52,6721,18,34,5279.65,8293.00,0.00
2024-12-08 16:56:43,53,6721,19,34,5180.03,8293.02,0.00
2024-12-08 16:56:43,54,6720,20,34,5019.81,8293.46,0.00
2024-12-08 16:56:43,54,6721,20,34,5114.54,8294.00,0.00
2024-12-08 16:56:43,55,6721,21,34,5021.55,8294.02,0.00
2024-12-08 16:56:43,54,6721,21,33,5086.90,8294.06,0.00
2024-12-08 16:56:43,54,6721,21,33,5254.95,8295.00,0.00
2024-12-08 16:56:43,55,6721,21,34,5159.40,8295.02,0.00
2024-12-08 16:56:43,55,6722,21,34,5142.26,8296.00,0.00
2024-12-08 16:56:43,56,6722,21,35,5050.43,8296.02,0.00
2024-12-08 16:56:43,55,6722,20,35,5140.75,8296.02,0.00
2024-12-08 16:56:43,54,6722,20,34,5206.77,8296.04,0.00
2024-12-08 16:56:43,54,6723,20,34,5219.68,8297.00,0.00
2024-12-08 16:56:43,55,6723,20,35,5124.78,8297.02,0.00
2024-12-08 16:56:43,54,6723,19,35,5099.98,8297.83,0.00
2024-12-08 16:56:43,54,6724,19,35,5239.94,8298.00,0.00
2024-12-08 16:56:43,55,6724,19,36,5144.67,8298.02,0.00
2024-12-08 16:56:43,54,6724,19,35,5212.29,8298.04,0.00
2024-12-08 16:56:43,54,6725,19,35,5225.21,8299.00,0.00
2024-12-08 16:56:43,55,6725,19,36,5130.20,8299.02,0.00
2024-12-08 16:56:43,54,6725,18,36,5147.15,8299.57,0.00
2024-12-08 16:56:43,54,6726,18,36,5206.31,8300.00,0.00
2024-12-08 16:56:43,55,6726,18,37,5111.65,8300.02,0.00
2024-12-08 16:56:43,54,6726,18,36,5180.18,8300.04,0.00
2024-12-08 16:56:43,54,6727,18,36,5193.10,8301.00,0.00
2024-12-08 16:56:43,55,6727,19,36,5098.68,8301.02,0.00
2024-12-08 16:56:43,55,6728,19,36,5078.96,8302.00,0.00
2024-12-08 16:56:43,56,6728,20,36,4988.26,8302.02,0.00
2024-12-08 16:56:43,55,6728,20,35,5054.81,8302.04,0.00
2024-12-08 16:56:43,55,6729,20,35,5065.98,8303.00,0.00
2024-12-08 16:56:43,56,6729,21,35,4975.52,8303.02,0.00
2024-12-08 16:56:43,56,6730,21,35,4956.27,8304.00,0.00
2024-12-08 16:56:43,57,6730,22,35,4869.32,8304.02,0.00
2024-12-08 16:56:43,56,6730,22,34,4932.54,8304.04,0.00
2024-12-08 16:56:43,56,6731,22,34,4942.03,8305.00,0.00
2024-12-08 16:56:43,57,6731,22,35,4855.33,8305.02,0.00
2024-12-08 16:56:43,57,6732,22,35,4834.86,8306.00,0.00
2024-12-08 16:56:43,58,6732,22,36,4751.50,8306.02,0.00
2024-12-08 16:56:43,57,6732,22,35,4813.01,8306.04,0.00
2024-12-08 16:56:43,56,6732,21,35,4793.38,8306.96,0.00
2024-12-08 16:56:43,56,6733,21,35,4938.77,8307.00,0.00
2024-12-08 16:56:43,57,6733,22,35,4852.13,8307.02,0.00
2024-12-08 16:56:43,57,6734,22,35,4832.52,8308.00,0.00
2024-12-08 16:56:43,58,6734,22,36,4749.20,8308.02,0.00
2024-12-08 16:56:43,57,6734,22,35,4810.65,8308.04,0.00
2024-12-08 16:56:43,56,6734,21,35,4785.63,8308.66,0.00
2024-12-08 16:56:43,56,6734,21,35,4906.05,8309.00,0.00
2024-12-08 16:56:43,57,6734,22,35,4819.98,8309.02,0.00
2024-12-08 16:56:43,56,6734,21,35,4851.15,8309.04,0.00
2024-12-08 16:56:44,56,6735,21,35,4890.32,8310.00,0.00
2024-12-08 16:56:44,57,6735,21,36,4804.52,8310.02,0.00
2024-12-08 16:56:44,56,6735,21,35,4865.09,8310.04,0.00
2024-12-08 16:56:44,56,6736,21,35,4874.58,8311.00,0.00
2024-12-08 16:56:44,57,6736,21,36,4789.06,8311.02,0.00
2024-12-08 16:56:44,57,6737,21,36,4775.30,8312.00,0.00
2024-12-08 16:56:44,58,6737,22,36,4692.97,8312.02,0.00
2024-12-08 16:56:44,57,6737,22,35,4747.59,8312.04,0.00
2024-12-08 16:56:44,57,6738,22,35,4755.46,8313.00,0.00
2024-12-08 16:56:44,58,6738,22,36,4673.47,8313.02,0.00
2024-12-08 16:56:44,58,6739,22,36,4624.09,8314.00,0.00
2024-12-08 16:56:44,59,6739,23,36,4545.72,8314.02,0.00
2024-12-08 16:56:44,58,6739,23,35,4598.29,8314.03,0.00
2024-12-08 16:56:44,57,6739,22,35,4604.30,8314.40,0.00
2024-12-08 16:56:44,57,6740,22,35,4661.68,8315.00,0.00
2024-12-08 16:56:44,58,6740,22,36,4581.30,8315.02,0.00
2024-12-08 16:56:44,57,6740,21,36,4557.52,8315.46,0.00
2024-12-08 16:56:44,57,6741,21,36,4618.39,8316.00,0.00
2024-12-08 16:56:44,58,6741,22,36,4538.76,8316.02,0.00
2024-12-08 16:56:44,57,6741,22,35,4592.13,8316.04,0.00
2024-12-08 16:56:44,56,6741,21,35,4626.69,8316.61,0.00
2024-12-08 16:56:44,55,6741,20,35,4708.90,8316.64,0.00
2024-12-08 16:56:44,54,6741,20,34,4792.42,8316.67,0.00
2024-12-08 16:56:44,53,6741,19,34,4851.86,8316.77,0.00
2024-12-08 16:56:44,53,6742,19,34,4990.14,8317.00,0.00
2024-12-08 16:56:44,54,6742,19,35,4897.73,8317.02,0.00
2024-12-08 16:56:44,53,6742,18,35,4988.57,8317.02,0.00
2024-12-08 16:56:44,53,6743,18,35,4977.49,8318.00,0.00
2024-12-08 16:56:44,54,6743,18,36,4885.31,8318.02,0.00
2024-12-08 16:56:44,53,6743,18,35,4952.38,8318.02,0.00
2024-12-08 16:56:44,53,6744,18,35,4965.53,8319.00,0.00
2024-12-08 16:56:44,54,6744,18,36,4873.58,8319.02,0.00
2024-12-08 16:56:44,54,6745,18,36,4879.89,8320.00,0.00
2024-12-08 16:56:44,55,6745,18,37,4791.17,8320.02,0.00
2024-12-08 16:56:44,54,6745,17,37,4789.49,8320.24,0.00
2024-12-08 16:56:44,54,6746,17,37,4880.91,8321.00,0.00
2024-12-08 16:56:44,55,6746,18,37,4792.17,8321.02,0.00
2024-12-08 16:56:44,54,6746,18,36,4862.42,8321.02,0.00
2024-12-08 16:56:44,53,6746,17,36,4913.44,8321.28,0.00
2024-12-08 16:56:44,53,6747,17,36,5011.29,8322.00,0.00
2024-12-08 16:56:44,54,6747,17,37,4918.48,8322.02,0.00
2024-12-08 16:56:44,53,6747,16,37,4926.82,8322.66,0.00
2024-12-08 16:56:44,53,6748,16,37,4999.08,8323.00,0.00
2024-12-08 16:56:44,54,6748,16,38,4906.50,8323.02,0.00
2024-12-08 16:56:44,53,6748,16,37,4973.96,8323.04,0.00
2024-12-08 16:56:44,52,6748,15,37,4993.43,8323.75,0.00
2024-12-08 16:56:44,52,6749,15,37,5132.90,8324.00,0.00
2024-12-08 16:56:44,53,6749,15,38,5036.05,8324.02,0.00
2024-12-08 16:56:44,53,6750,15,38,5020.88,8325.00,0.00
2024-12-08 16:56:44,54,6750,16,38,4927.91,8325.02,0.00
2024-12-08 16:56:44,53,6750,16,37,4997.33,8325.04,0.00
2024-12-08 16:56:44,52,6750,15,37,5088.66,8325.10,0.00
2024-12-08 16:56:44,52,6751,15,37,5110.05,8326.00,0.00
2024-12-08 16:56:44,53,6751,15,38,5013.63,8326.02,0.00
2024-12-08 16:56:44,53,6752,15,38,4997.94,8327.00,0.00
2024-12-08 16:56:44,54,6752,15,39,4905.38,8327.02,0.00
2024-12-08 16:56:44,53,6752,15,38,4975.95,8327.04,0.00
2024-12-08 16:56:44,53,6753,15,38,4990.68,8328.00,0.00
2024-12-08 16:56:44,54,6753,16,38,4898.26,8328.02,0.00
2024-12-08 16:56:44,53,6753,15,38,4951.43,8328.11,0.00
2024-12-08 16:56:44,52,6753,14,38,4945.29,8328.96,0.00
2024-12-08 16:56:44,52,6754,14,38,5102.28,8329.00,0.00
2024-12-08 16:56:44,53,6754,15,38,5006.01,8329.02,0.00
2024-12-08 16:56:44,52,6754,15,37,5079.86,8329.04,0.00
2024-12-08 16:56:44,51,6754,14,37,5129.21,8329.63,0.00
2024-12-08 16:56:44,51,6755,14,37,5196.48,8330.00,0.00
2024-12-08 16:56:44,52,6755,14,38,5096.55,8330.02,0.00
2024-12-08 16:56:44,51,6755,13,38,5131.22,8330.24,0.00
2024-12-08 16:56:44,51,6756,13,38,5231.41,8331.00,0.00
2024-12-08 16:56:44,52,6756,14,38,5130.80,8331.02,0.00
2024-12-08 16:56:44,52,6757,14,38,5122.97,8332.00,0.00
2024-12-08 16:56:44,53,6757,14,39,5026.31,8332.02,0.00
2024-12-08 16:56:44,53,6758,14,39,5008.04,8333.00,0.00
2024-12-08 16:56:44,54,6758,15,39,4915.30,8333.02,0.00
2024-12-08 16:56:44,53,6758,15,38,5004.90,8333.04,0.00
2024-12-08 16:56:45,53,6759,15,38,5019.65,8334.00,0.00
2024-12-08 16:56:45,54,6759,15,39,4926.70,8334.02,0.00
2024-12-08 16:56:45,53,6759,14,39,4982.64,8334.08,0.00
2024-12-08 16:56:45,52,6759,13,39,5023.43,8334.37,0.00
2024-12-08 16:56:45,52,6760,13,39,5131.28,8335.00,0.00
2024-12-08 16:56:45,53,6760,14,39,5034.46,8335.02,0.00
2024-12-08 16:56:45,52,6760,14,38,5112.05,8335.04,0.00
2024-12-08 16:56:45,52,6761,14,38,5128.69,8336.00,0.00
2024-12-08 16:56:45,53,6761,15,38,5031.92,8336.02,0.00
2024-12-08 16:56:45,53,6762,15,38,5014.20,8337.00,0.00
2024-12-08 16:56:45,54,6762,15,39,4921.35,8337.02,0.00
2024-12-08 16:56:45,53,6762,15,38,4989.04,8337.06,0.00
2024-12-08 16:56:45,53,6763,15,38,5005.36,8338.00,0.00
2024-12-08 16:56:45,54,6763,15,39,4912.67,8338.02,0.00
2024-12-08 16:56:45,53,6763,14,39,4906.28,8338.11,0.00
2024-12-08 16:56:45,53,6764,14,39,4990.23,8339.00,0.00
2024-12-08 16:56:45,54,6764,14,40,4897.82,8339.02,0.00
2024-12-08 16:56:45,53,6764,14,39,4966.64,8339.06,0.00
2024-12-08 16:56:45,52,6764,13,39,4955.68,8339.56,0.00
2024-12-08 16:56:45,52,6765,13,39,5079.50,8340.00,0.00
2024-12-08 16:56:45,53,6765,13,40,4983.66,8340.02,0.00
2024-12-08 16:56:45,52,6765,12,40,5052.24,8340.02,0.00
2024-12-08 16:56:45,52,6766,12,40,5099.36,8341.00,0.00
2024-12-08 16:56:45,53,6766,12,41,5003.14,8341.02,0.00
2024-12-08 16:56:45,53,6767,12,41,4984.86,8342.00,0.00
2024-12-08 16:56:45,54,6767,13,41,4892.54,8342.02,0.00
2024-12-08 16:56:45,53,6767,13,40,4962.83,8342.06,0.00
2024-12-08 16:56:45,52,6767,12,40,4962.26,8342.54,0.00
2024-12-08 16:56:45,52,6768,12,40,5084.54,8343.00,0.00
2024-12-08 16:56:45,53,6768,13,40,4988.60,8343.02,0.00
2024-12-08 16:56:45,53,6769,13,40,4973.01,8344.00,0.00
2024-12-08 16:56:45,54,6769,14,40,4880.91,8344.02,0.00
2024-12-08 16:56:45,53,6769,14,39,4947.82,8344.06,0.00
2024-12-08 16:56:45,52,6769,13,39,4978.02,8344.71,0.00
2024-12-08 16:56:45,52,6770,13,39,5114.64,8345.00,0.00
2024-12-08 16:56:45,53,6770,13,40,5018.14,8345.02,0.00
2024-12-08 16:56:45,52,6770,12,40,5041.33,8345.23,0.00
2024-12-08 16:56:45,52,6771,12,40,5138.17,8346.00,0.00
2024-12-08 16:56:45,53,6771,13,40,5041.22,8346.02,0.00
2024-12-08 16:56:45,52,6771,13,39,5112.49,8346.06,0.00
2024-12-08 16:56:45,52,6772,13,39,5130.76,8347.00,0.00
2024-12-08 16:56:45,53,6772,14,39,5033.95,8347.02,0.00
2024-12-08 16:56:45,53,6773,14,39,5018.08,8348.00,0.00
2024-12-08 16:56:45,54,6773,15,39,4925.15,8348.02,0.00
2024-12-08 16:56:45,53,6773,15,38,4992.88,8348.06,0.00
2024-12-08 16:56:45,53,6774,15,38,5009.23,8349.00,0.00
2024-12-08 16:56:45,54,6774,16,38,4916.47,8349.02,0.00
2024-12-08 16:56:45,54,6775,16,38,4899.82,8350.00,0.00
2024-12-08 16:56:45,55,6775,17,38,4810.74,8350.02,0.00
2024-12-08 16:56:45,54,6775,17,37,4876.63,8350.06,0.00
2024-12-08 16:56:45,53,6775,16,37,4921.14,8350.62,0.00
2024-12-08 16:56:45,53,6776,16,37,4984.44,8351.00,0.00
2024-12-08 16:56:45,54,6776,17,37,4892.14,8351.02,0.00
2024-12-08 16:56:45,53,6776,16,37,4899.67,8351.64,0.00
2024-12-08 16:56:45,53,6777,16,37,4966.16,8352.00,0.00
2024-12-08 16:56:45,54,6777,17,37,4874.19,8352.02,0.00
2024-12-08 16:56:45,53,6777,17,36,4963.01,8352.04,0.00
2024-12-08 16:56:45,52,6777,17,35,5039.18,8352.04,0.00
2024-12-08 16:56:45,51,6777,16,35,5036.98,8352.92,0.00
2024-12-08 16:56:45,51,6778,16,35,5194.25,8353.00,0.00
2024-12-08 16:56:45,52,6778,16,36,5094.36,8353.02,0.00
2024-12-08 16:56:45,52,6779,16,36,5077.30,8354.00,0.00
2024-12-08 16:56:45,53,6779,16,37,4981.50,8354.02,0.00
2024-12-08 16:56:45,52,6779,16,36,5058.02,8354.04,0.00
2024-12-08 16:56:45,52,6780,16,36,5074.69,8355.00,0.00
2024-12-08 16:56:45,53,6780,16,37,4978.94,8355.02,0.00
2024-12-08 16:56:45,53,6781,16,37,4960.62,8356.00,0.00
2024-12-08 16:56:45,54,6781,16,38,4868.76,8356.02,0.00
2024-12-08 16:56:45,53,6781,16,37,4943.28,8356.04,0.00
2024-12-08 16:56:45,52,6781,15,37,4985.65,8356.65,0.00
2024-12-08 16:56:45,52,6782,15,37,5117.69,8357.00,0.00
2024-12-08 16:56:45,53,6782,15,38,5021.13,8357.02,0.00
2024-12-08 16:56:46,53,6783,15,38,5002.89,8358.00,0.00
2024-12-08 16:56:46,54,6783,15,39,4910.24,8358.02,0.00
2024-12-08 16:56:46,53,6783,15,38,4982.39,8358.04,0.00
2024-12-08 16:56:46,53,6784,15,38,4997.18,8359.00,0.00
2024-12-08 16:56:46,54,6784,16,38,4904.64,8359.02,0.00
2024-12-08 16:56:46,53,6784,15,38,4898.11,8359.74,0.00
2024-12-08 16:56:46,53,6785,15,38,5033.98,8360.00,0.00
2024-12-08 16:56:46,54,6785,15,39,4940.75,8360.02,0.00
2024-12-08 16:56:46,53,6785,15,38,5015.05,8360.04,0.00
2024-12-08 16:56:46,53,6786,15,38,5029.85,8361.00,0.00
2024-12-08 16:56:46,54,6786,15,39,4936.70,8361.02,0.00
2024-12-08 16:56:46,54,6787,15,39,4864.00,8362.00,0.00
2024-12-08 16:56:46,55,6787,16,39,4775.56,8362.02,0.00
2024-12-08 16:56:46,54,6787,16,38,4846.97,8362.04,0.00
2024-12-08 16:56:46,53,6787,15,38,4883.54,8362.68,0.00
2024-12-08 16:56:46,52,6787,14,38,4871.50,8362.96,0.00
2024-12-08 16:56:46,52,6788,14,38,5029.13,8363.00,0.00
2024-12-08 16:56:46,53,6788,15,38,4934.25,8363.02,0.00
2024-12-08 16:56:46,52,6788,14,38,4835.47,8363.81,0.00
2024-12-08 16:56:46,52,6789,14,38,4980.40,8364.00,0.00
2024-12-08 16:56:46,53,6789,15,38,4886.43,8364.02,0.00
2024-12-08 16:56:46,52,6789,15,37,4959.49,8364.04,0.00
2024-12-08 16:56:46,52,6790,15,37,4976.17,8365.00,0.00
2024-12-08 16:56:46,53,6790,15,38,4882.28,8365.02,0.00
2024-12-08 16:56:46,52,6790,14,38,4875.42,8365.73,0.00
2024-12-08 16:56:46,52,6791,14,38,5013.99,8366.00,0.00
2024-12-08 16:56:46,53,6791,15,38,4919.39,8366.02,0.00
2024-12-08 16:56:46,52,6791,14,38,5012.39,8366.02,0.00
2024-12-08 16:56:46,51,6791,14,37,5090.98,8366.02,0.00
2024-12-08 16:56:46,51,6792,14,37,5108.00,8367.00,0.00
2024-12-08 16:56:46,52,6792,14,38,5009.77,8367.02,0.00
2024-12-08 16:56:46,52,6793,14,38,4992.66,8368.00,0.00
2024-12-08 16:56:46,53,6793,15,38,4898.46,8368.02,0.00
2024-12-08 16:56:46,52,6793,15,37,4974.96,8368.02,0.00
2024-12-08 16:56:46,51,6793,14,37,5012.19,8368.69,0.00
2024-12-08 16:56:46,51,6794,14,37,5150.28,8369.00,0.00
2024-12-08 16:56:46,52,6794,14,38,5051.24,8369.02,0.00
2024-12-08 16:56:46,52,6795,14,38,5034.14,8370.00,0.00
2024-12-08 16:56:46,53,6795,15,38,4939.15,8370.02,0.00
2024-12-08 16:56:46,52,6795,15,37,5018.04,8370.02,0.00
2024-12-08 16:56:46,52,6796,15,37,5032.97,8371.00,0.00
2024-12-08 16:56:46,53,6796,15,38,4938.01,8371.02,0.00
2024-12-08 16:56:46,53,6797,15,38,4918.15,8372.00,0.00
2024-12-08 16:56:46,54,6797,16,38,4827.07,8372.02,0.00
2024-12-08 16:56:46,53,6797,16,37,4903.93,8372.02,0.00
2024-12-08 16:56:46,52,6797,15,37,4987.01,8372.14,0.00
2024-12-08 16:56:46,51,6797,14,37,4993.28,8372.57,0.00
2024-12-08 16:56:46,51,6798,14,37,5121.67,8373.00,0.00
2024-12-08 16:56:46,52,6798,14,38,5023.18,8373.02,0.00
2024-12-08 16:56:46,51,6798,13,38,5069.13,8373.02,0.00
2024-12-08 16:56:46,51,6799,13,38,5117.41,8374.00,0.00
2024-12-08 16:56:46,52,6799,14,38,5018.99,8374.02,0.00
2024-12-08 16:56:46,51,6799,14,37,5097.70,8374.02,0.00
2024-12-08 16:56:46,50,6799,13,37,5133.56,8374.38,0.00
2024-12-08 16:56:46,50,6800,13,37,5249.59,8375.00,0.00
2024-12-08 16:56:46,51,6800,14,37,5146.66,8375.02,0.00
2024-12-08 16:56:46,51,6801,14,37,5129.62,8376.00,0.00
2024-12-08 16:56:46,52,6801,14,38,5030.98,8376.02,0.00
2024-12-08 16:56:46,51,6801,14,37,5111.56,8376.02,0.00
2024-12-08 16:56:46,51,6802,14,37,5127.58,8377.00,0.00
2024-12-08 16:56:46,52,6802,15,37,5028.97,8377.02,0.00
2024-12-08 16:56:46,52,6803,15,37,4971.12,8378.00,0.00
2024-12-08 16:56:46,53,6803,16,37,4877.32,8378.02,0.00
2024-12-08 16:56:46,52,6803,16,36,4953.39,8378.02,0.00
2024-12-08 16:56:46,52,6804,16,36,4918.62,8379.00,0.00
2024-12-08 16:56:46,53,6804,16,37,4825.82,8379.02,0.00
2024-12-08 16:56:46,52,6804,15,37,4770.96,8379.77,0.00
2024-12-08 16:56:46,52,6805,15,37,4849.97,8380.00,0.00
2024-12-08 16:56:46,53,6805,15,38,4758.46,8380.02,0.00
2024-12-08 16:56:46,52,6805,15,37,4832.25,8380.02,0.00
2024-12-08 16:56:46,51,6805,14,37,4863.28,8380.71,0.00
2024-12-08 16:56:46,51,6806,14,37,4937.44,8381.00,0.00
2024-12-08 16:56:46,52,6806,15,37,4842.49,8381.02,0.00
2024-12-08 16:56:46,52,6807,15,37,4825.34,8382.00,0.00
2024-12-08 16:56:46,53,6807,15,38,4734.29,8382.02,0.00
2024-12-08 16:56:46,52,6807,15,37,4809.22,8382.02,0.00
2024-12-08 16:56:46,51,6807,14,37,4847.98,8382.67,0.00
2024-12-08 16:56:46,51,6808,14,37,4918.90,8383.00,0.00
2024-12-08 16:56:46,52,6808,15,37,4824.30,8383.02,0.00
2024-12-08 16:56:47,51,6808,14,37,4875.31,8383.14,0.00
2024-12-08 16:56:47,50,6808,13,37,4894.46,8383.84,0.00
2024-12-08 16:56:47,50,6809,13,37,5048.82,8384.00,0.00
2024-12-08 16:56:47,51,6809,14,37,4949.83,8384.02,0.00
2024-12-08 16:56:47,50,6809,14,36,5032.06,8384.02,0.00
2024-12-08 16:56:47,50,6810,14,36,5051.10,8385.00,0.00
2024-12-08 16:56:47,51,6810,14,37,4952.06,8385.02,0.00
2024-12-08 16:56:47,51,6811,14,37,4936.21,8386.00,0.00
2024-12-08 16:56:47,52,6811,14,38,4841.28,8386.02,0.00
2024-12-08 16:56:47,51,6811,14,37,4919.77,8386.02,0.00
2024-12-08 16:56:47,50,6811,13,37,4916.39,8386.92,0.00
2024-12-08 16:56:47,50,6812,13,37,5077.47,8387.00,0.00
2024-12-08 16:56:47,51,6812,13,38,4977.91,8387.02,0.00
2024-12-08 16:56:47,51,6813,13,38,4923.22,8388.00,0.00
2024-12-08 16:56:47,52,6813,14,38,4828.54,8388.02,0.00
2024-12-08 16:56:47,51,6813,14,37,4906.77,8388.02,0.00
2024-12-08 16:56:47,51,6814,14,37,4879.63,8389.00,0.00
2024-12-08 16:56:47,52,6814,15,37,4785.79,8389.02,0.00
2024-12-08 16:56:47,51,6814,14,37,4697.07,8389.92,0.00
2024-12-08 16:56:47,51,6815,14,37,4855.06,8390.00,0.00
2024-12-08 16:56:47,52,6815,14,38,4761.69,8390.02,0.00
2024-12-08 16:56:47,51,6815,14,37,4840.25,8390.02,0.00
2024-12-08 16:56:47,50,6815,13,37,4883.37,8390.64,0.00
2024-12-08 16:56:47,50,6816,13,37,4954.11,8391.00,0.00
2024-12-08 16:56:47,51,6816,13,38,4856.97,8391.02,0.00
2024-12-08 16:56:47,51,6817,13,38,4838.96,8392.00,0.00
2024-12-08 16:56:47,52,6817,13,39,4745.91,8392.02,0.00
2024-12-08 16:56:47,51,6817,13,38,4825.80,8392.02,0.00
2024-12-08 16:56:47,50,6817,12,38,4795.88,8392.68,0.00
2024-12-08 16:56:47,50,6818,12,38,4937.11,8393.00,0.00
2024-12-08 16:56:47,51,6818,12,39,4840.31,8393.02,0.00
2024-12-08 16:56:47,50,6818,11,39,4785.04,8393.64,0.00
2024-12-08 16:56:47,50,6819,11,39,4922.97,8394.00,0.00
2024-12-08 16:56:47,51,6819,12,39,4826.44,8394.02,0.00
2024-12-08 16:56:47,50,6819,12,38,4911.22,8394.02,0.00
2024-12-08 16:56:47,49,6819,11,38,4946.34,8394.37,0.00
2024-12-08 16:56:47,49,6820,11,38,5065.00,8395.00,0.00
2024-12-08 16:56:47,50,6820,12,38,4963.71,8395.02,0.00
2024-12-08 16:56:47,49,6820,11,38,4959.94,8395.71,0.00
2024-12-08 16:56:47,49,6821,11,38,5107.53,8396.00,0.00
2024-12-08 16:56:47,50,6821,12,38,5005.38,8396.02,0.00
2024-12-08 16:56:47,49,6821,12,37,5095.53,8396.02,0.00
2024-12-08 16:56:47,49,6822,12,37,5111.34,8397.00,0.00
2024-12-08 16:56:47,50,6822,13,37,5009.11,8397.02,0.00
2024-12-08 16:56:47,50,6823,13,37,4988.50,8398.00,0.00
2024-12-08 16:56:47,51,6823,13,38,4890.69,8398.02,0.00
2024-12-08 16:56:47,50,6823,13,37,4978.43,8398.02,0.00
2024-12-08 16:56:47,50,6824,13,37,4991.36,8399.00,0.00
2024-12-08 16:56:47,51,6824,13,38,4893.49,8399.02,0.00
2024-12-08 16:56:47,51,6825,13,38,4873.48,8400.00,0.00
2024-12-08 16:56:47,52,6825,14,38,4779.76,8400.02,0.00
2024-12-08 16:56:47,51,6825,14,37,4865.24,8400.02,0.00
2024-12-08 16:56:47,50,6825,13,37,4854.96,8400.94,0.00
2024-12-08 16:56:47,50,6826,13,37,5017.97,8401.00,0.00
2024-12-08 16:56:47,51,6826,14,37,4919.58,8401.02,0.00
2024-12-08 16:56:47,51,6827,14,37,4903.40,8402.00,0.00
2024-12-08 16:56:47,52,6827,15,37,4809.11,8402.02,0.00
2024-12-08 16:56:47,51,6827,15,36,4895.17,8402.02,0.00
2024-12-08 16:56:47,51,6828,15,36,4912.23,8403.00,0.00
2024-12-08 16:56:47,52,6828,15,37,4817.76,8403.02,0.00
2024-12-08 16:56:47,52,6829,15,37,4800.39,8404.00,0.00
2024-12-08 16:56:47,53,6829,16,37,4709.82,8404.02,0.00
2024-12-08 16:56:47,52,6829,16,36,4793.93,8404.02,0.00
2024-12-08 16:56:47,52,6830,16,36,4807.22,8405.00,0.00
2024-12-08 16:56:47,53,6830,17,36,4716.52,8405.02,0.00
2024-12-08 16:56:47,52,6830,16,36,4680.99,8405.52,0.00
2024-12-08 16:56:47,52,6831,16,36,4802.57,8406.00,0.00
2024-12-08 16:56:47,53,6831,17,36,4711.95,8406.02,0.00
2024-12-08 16:56:47,52,6831,17,35,4789.64,8406.04,0.00
2024-12-08 16:56:47,52,6832,17,35,4804.82,8407.00,0.00
2024-12-08 16:56:47,53,6832,18,35,4714.17,8407.02,0.00
2024-12-08 16:56:47,53,6833,18,35,4695.38,8408.00,0.00
2024-12-08 16:56:47,54,6833,18,36,4608.43,8408.02,0.00
2024-12-08 16:56:47,53,6833,18,35,4682.69,8408.04,0.00
2024-12-08 16:56:47,53,6834,18,35,4695.82,8409.00,0.00
2024-12-08 16:56:47,54,6834,18,36,4608.86,8409.02,0.00
2024-12-08 16:56:47,53,6834,17,36,4572.14,8409.85,0.00
2024-12-08 16:56:47,53,6835,17,36,4718.22,8410.00,0.00
2024-12-08 16:56:47,54,6835,18,36,4630.84,8410.02,0.00
2024-12-08 16:56:47,53,6835,18,35,4697.08,8410.06,0.00
2024-12-08 16:56:47,52,6835,17,35,4702.06,8410.85,0.00
2024-12-08 16:56:48,52,6836,17,35,4850.98,8411.00,0.00
2024-12-08 16:56:48,53,6836,17,36,4759.46,8411.02,0.00
2024-12-08 16:56:48,54,6835,18,36,4596.37,8411.48,0.00
2024-12-08 16:56:48,54,6836,18,36,4699.56,8412.00,0.00
2024-12-08 16:56:48,55,6836,19,36,4614.11,8412.02,0.00
2024-12-08 16:56:48,54,6836,19,35,4677.04,8412.06,0.00
2024-12-08 16:56:48,53,6836,18,35,4658.94,8412.60,0.00
2024-12-08 16:56:48,53,6837,18,35,4943.36,8413.00,0.00
2024-12-08 16:56:48,54,6837,19,35,4851.81,8413.02,0.00
2024-12-08 16:56:48,53,6837,18,35,4931.98,8413.04,0.00
2024-12-08 16:56:48,53,6838,18,35,4863.70,8414.00,0.00
2024-12-08 16:56:48,54,6838,19,35,4773.63,8414.02,0.00
2024-12-08 16:56:48,53,6838,19,34,4855.35,8414.04,0.00
2024-12-08 16:56:48,53,6839,19,34,4823.34,8415.00,0.00
2024-12-08 16:56:48,54,6839,20,34,4734.02,8415.02,0.00
2024-12-08 16:56:48,54,6840,20,34,4710.97,8416.00,0.00
2024-12-08 16:56:48,55,6840,20,35,4625.32,8416.02,0.00
2024-12-08 16:56:48,54,6840,20,34,4701.62,8416.04,0.00
2024-12-08 16:56:48,54,6841,20,34,4712.91,8417.00,0.00
2024-12-08 16:56:48,55,6841,20,35,4627.22,8417.02,0.00
2024-12-08 16:56:48,55,6842,20,35,4606.34,8418.00,0.00
2024-12-08 16:56:48,56,6842,21,35,4524.09,8418.02,0.00
2024-12-08 16:56:48,55,6842,21,34,4598.69,8418.04,0.00
2024-12-08 16:56:48,54,6842,20,34,4587.69,8418.91,0.00
2024-12-08 16:56:48,54,6843,20,34,4735.86,8419.00,0.00
2024-12-08 16:56:48,55,6843,20,35,4649.75,8419.02,0.00
2024-12-08 16:56:48,54,6843,19,35,4700.29,8419.06,0.00
2024-12-08 16:56:48,54,6844,19,35,4777.25,8420.00,0.00
2024-12-08 16:56:48,55,6844,20,35,4690.39,8420.02,0.00
2024-12-08 16:56:48,55,6845,20,35,4676.72,8421.00,0.00
2024-12-08 16:56:48,56,6845,21,35,4593.21,8421.02,0.00
2024-12-08 16:56:48,55,6845,21,34,4673.07,8421.04,0.00
2024-12-08 16:56:48,55,6846,21,34,4684.34,8422.00,0.00
2024-12-08 16:56:48,56,6846,22,34,4600.69,8422.02,0.00
2024-12-08 16:56:48,56,6847,22,34,4582.98,8423.00,0.00
2024-12-08 16:56:48,57,6847,23,34,4502.58,8423.02,0.00
2024-12-08 16:56:48,56,6847,23,33,4563.43,8423.05,0.00
2024-12-08 16:56:48,56,6848,23,33,4574.50,8424.00,0.00
2024-12-08 16:56:48,57,6848,24,33,4494.25,8424.02,0.00
2024-12-08 16:56:48,56,6848,24,32,4574.40,8424.02,0.00
2024-12-08 16:56:48,55,6848,24,31,4639.20,8424.04,0.00
2024-12-08 16:56:48,55,6849,24,31,4650.47,8425.00,0.00
2024-12-08 16:56:48,56,6849,25,31,4567.43,8425.02,0.00
2024-12-08 16:56:48,55,6849,24,31,4525.09,8425.55,0.00
2024-12-08 16:56:48,55,6850,24,31,4637.98,8426.00,0.00
2024-12-08 16:56:48,56,6850,25,31,4555.16,8426.02,0.00
2024-12-08 16:56:48,55,6850,25,30,4621.13,8426.04,0.00
2024-12-08 16:56:48,55,6851,25,30,4627.56,8427.00,0.00
2024-12-08 16:56:48,56,6851,26,30,4544.92,8427.02,0.00
2024-12-08 16:56:48,56,6852,26,30,4517.65,8428.00,0.00
2024-12-08 16:56:48,57,6852,26,31,4438.39,8428.02,0.00
2024-12-08 16:56:48,56,6852,26,30,4502.60,8428.04,0.00
2024-12-08 16:56:48,56,6853,26,30,4504.22,8429.00,0.00
2024-12-08 16:56:48,57,6853,26,31,4425.20,8429.02,0.00
2024-12-08 16:56:48,57,6854,26,31,4396.50,8430.00,0.00
2024-12-08 16:56:48,58,6854,27,31,4320.70,8430.02,0.00
2024-12-08 16:56:48,57,6854,27,30,4383.19,8430.04,0.00
2024-12-08 16:56:48,56,6854,26,30,4369.60,8430.52,0.00
2024-12-08 16:56:48,56,6855,26,30,4472.32,8431.00,0.00
2024-12-08 16:56:48,57,6855,27,30,4393.86,8431.02,0.00
2024-12-08 16:56:48,57,6856,27,30,4366.74,8432.00,0.00
2024-12-08 16:56:48,58,6856,27,31,4291.45,8432.02,0.00
2024-12-08 16:56:48,57,6856,27,30,4354.90,8432.04,0.00
2024-12-08 16:56:48,57,6857,27,30,4358.26,8433.00,0.00
2024-12-08 16:56:48,58,6857,27,31,4283.11,8433.02,0.00
2024-12-08 16:56:48,57,6857,26,31,4259.29,8433.44,0.00
2024-12-08 16:56:48,57,6858,26,31,4356.15,8434.00,0.00
2024-12-08 16:56:48,58,6858,27,31,4281.05,8434.02,0.00
2024-12-08 16:56:48,57,6858,27,30,4344.32,8434.04,0.00
2024-12-08 16:56:48,56,6858,26,30,4313.55,8434.95,0.00
2024-12-08 16:56:48,56,6859,26,30,4459.69,8435.00,0.00
2024-12-08 16:56:48,57,6859,26,31,4381.45,8435.02,0.00
2024-12-08 16:56:48,56,6859,25,31,4395.78,8435.41,0.00
2024-12-08 16:56:49,56,6860,25,31,4434.40,8436.00,0.00
2024-12-08 16:56:49,57,6860,25,32,4356.60,8436.02,0.00
2024-12-08 16:56:49,56,6860,25,31,4423.85,8436.04,0.00
2024-12-08 16:56:49,55,6860,24,31,4422.21,8436.45,0.00
2024-12-08 16:56:49,55,6861,24,31,4524.45,8437.00,0.00
2024-12-08 16:56:49,56,6861,24,32,4443.66,8437.02,0.00
2024-12-08 16:56:49,55,6861,23,32,4479.97,8437.04,0.00
2024-12-08 16:56:49,54,6861,22,32,4520.78,8437.15,0.00
2024-12-08 16:56:49,54,6862,22,32,4599.52,8438.00,0.00
2024-12-08 16:56:49,55,6862,22,33,4515.89,8438.02,0.00
2024-12-08 16:56:49,54,6862,21,33,4579.20,8438.02,0.00
2024-12-08 16:56:49,53,6862,21,32,4652.87,8438.02,0.00
2024-12-08 16:56:49,53,6863,21,32,4723.62,8439.00,0.00
2024-12-08 16:56:49,54,6863,21,33,4636.15,8439.02,0.00
2024-12-08 16:56:49,54,6864,21,33,4610.83,8440.00,0.00
2024-12-08 16:56:49,55,6864,22,33,4527.00,8440.02,0.00
2024-12-08 16:56:49,54,6864,22,32,4598.33,8440.02,0.00
2024-12-08 16:56:49,53,6864,21,32,4598.55,8440.77,0.00
2024-12-08 16:56:49,53,6865,21,32,4738.89,8441.00,0.00
2024-12-08 16:56:49,54,6865,22,32,4651.13,8441.02,0.00
2024-12-08 16:56:49,54,6866,22,32,4624.61,8442.00,0.00
2024-12-08 16:56:49,55,6866,22,33,4540.52,8442.02,0.00
2024-12-08 16:56:49,54,6866,22,32,4612.10,8442.02,0.00
2024-12-08 16:56:49,54,6867,22,32,4613.18,8443.00,0.00
2024-12-08 16:56:49,55,6867,22,33,4529.31,8443.02,0.00
2024-12-08 16:56:49,54,6867,21,33,4524.96,8443.63,0.00
2024-12-08 16:56:49,54,6868,21,33,4585.68,8444.00,0.00
2024-12-08 16:56:49,55,6868,21,34,4502.30,8444.02,0.00
2024-12-08 16:56:49,54,6868,21,33,4573.17,8444.02,0.00
2024-12-08 16:56:49,53,6868,20,33,4651.53,8444.11,0.00
2024-12-08 16:56:49,52,6868,19,33,4670.25,8444.69,0.00
2024-12-08 16:56:49,52,6869,19,33,4806.91,8445.00,0.00
2024-12-08 16:56:49,53,6869,20,33,4716.22,8445.02,0.00
2024-12-08 16:56:49,52,6869,19,33,4665.36,8445.48,0.00
2024-12-08 16:56:49,52,6870,19,33,4776.45,8446.00,0.00
2024-12-08 16:56:49,53,6870,20,33,4686.33,8446.02,0.00
2024-12-08 16:56:49,52,6870,20,32,4763.46,8446.02,0.00
2024-12-08 16:56:49,51,6870,19,32,4774.87,8446.45,0.00
2024-12-08 16:56:49,50,6870,18,32,4856.08,8446.58,0.00
2024-12-08 16:56:49,50,6871,18,32,4989.87,8447.00,0.00
2024-12-08 16:56:49,51,6871,18,33,4892.03,8447.02,0.00
2024-12-08 16:56:49,51,6872,18,33,4915.72,8448.00,0.00
2024-12-08 16:56:49,52,6872,19,33,4821.19,8448.02,0.00
2024-12-08 16:56:49,52,6873,19,33,4821.57,8449.00,0.00
2024-12-08 16:56:49,53,6873,20,33,4730.60,8449.02,0.00
2024-12-08 16:56:49,52,6873,19,33,4738.02,8449.62,0.00
2024-12-08 16:56:49,52,6874,19,33,4803.33,8450.00,0.00
2024-12-08 16:56:49,53,6874,20,33,4712.70,8450.02,0.00
2024-12-08 16:56:49,52,6874,20,32,4800.08,8450.02,0.00
2024-12-08 16:56:49,51,6874,19,32,4884.30,8450.14,0.00
2024-12-08 16:56:49,51,6875,19,32,4813.09,8451.00,0.00
2024-12-08 16:56:49,52,6875,20,32,4720.53,8451.02,0.00
2024-12-08 16:56:49,51,6875,20,31,4601.08,8451.78,0.00
2024-12-08 16:56:49,51,6876,20,31,4748.73,8452.00,0.00
2024-12-08 16:56:49,52,6876,21,31,4657.41,8452.02,0.00
2024-12-08 16:56:49,51,6876,21,30,4735.47,8452.02,0.00
2024-12-08 16:56:49,51,6877,21,30,4752.60,8453.00,0.00
2024-12-08 16:56:49,52,6877,22,30,4661.21,8453.02,0.00
2024-12-08 16:56:49,51,6877,21,30,4671.48,8453.29,0.00
2024-12-08 16:56:49,51,6878,21,30,4778.03,8454.00,0.00
2024-12-08 16:56:49,52,6878,22,30,4686.15,8454.02,0.00
2024-12-08 16:56:49,51,6878,22,29,4766.43,8454.02,0.00
2024-12-08 16:56:49,51,6879,22,29,4783.57,8455.00,0.00
2024-12-08 16:56:49,52,6879,23,29,4691.58,8455.02,0.00
2024-12-08 16:56:49,51,6879,22,29,4654.73,8455.88,0.00
2024-12-08 16:56:49,51,6880,22,29,4810.67,8456.00,0.00
2024-12-08 16:56:49,52,6880,23,29,4718.15,8456.02,0.00
2024-12-08 16:56:49,51,6880,23,28,4799.06,8456.02,0.00
2024-12-08 16:56:49,51,6881,23,28,4816.21,8457.00,0.00
2024-12-08 16:56:49,52,6881,24,28,4723.59,8457.02,0.00
2024-12-08 16:56:49,52,6882,24,28,4706.25,8458.00,0.00
2024-12-08 16:56:49,53,6882,24,29,4617.46,8458.02,0.00
2024-12-08 16:56:49,52,6882,24,28,4693.24,8458.02,0.00
2024-12-08 16:56:49,52,6883,24,28,4708.44,8459.00,0.00
2024-12-08 16:56:49,53,6883,25,28,4619.60,8459.02,0.00
2024-12-08 16:56:49,53,6884,25,28,4601.57,8460.00,0.00
2024-12-08 16:56:49,54,6884,26,28,4516.36,8460.02,0.00
2024-12-08 16:56:49,53,6884,26,27,4590.40,8460.02,0.00
2024-12-08 16:56:50,53,6885,26,27,4603.71,8461.00,0.00
2024-12-08 16:56:50,54,6885,27,27,4518.46,8461.02,0.00
2024-12-08 16:56:50,53,6885,26,27,4551.07,8461.17,0.00
2024-12-08 16:56:50,53,6886,26,27,4640.98,8462.00,0.00
2024-12-08 16:56:50,54,6886,26,28,4555.03,8462.02,0.00
2024-12-08 16:56:50,53,6886,26,27,4631.40,8462.02,0.00
2024-12-08 16:56:50,53,6887,26,27,4644.72,8463.00,0.00
2024-12-08 16:56:50,54,6887,27,27,4558.70,8463.02,0.00
2024-12-08 16:56:50,53,6887,26,27,4554.26,8463.32,0.00
2024-12-08 16:56:50,53,6888,26,27,4613.87,8464.00,0.00
2024-12-08 16:56:50,54,6888,26,28,4528.43,8464.02,0.00
2024-12-08 16:56:50,53,6888,26,27,4602.69,8464.02,0.00
2024-12-08 16:56:50,53,6889,26,27,4569.58,8465.00,0.00
2024-12-08 16:56:50,54,6889,26,28,4484.96,8465.02,0.00
2024-12-08 16:56:50,53,6889,26,27,4464.43,8465.55,0.00
2024-12-08 16:56:50,52,6889,25,27,4488.44,8465.58,0.00
2024-12-08 16:56:50,52,6890,25,27,4615.71,8466.00,0.00
2024-12-08 16:56:50,53,6890,25,28,4528.62,8466.02,0.00
2024-12-08 16:56:50,52,6890,25,27,4605.94,8466.02,0.00
2024-12-08 16:56:50,52,6891,25,27,4621.14,8467.00,0.00
2024-12-08 16:56:50,53,6891,25,28,4533.95,8467.02,0.00
2024-12-08 16:56:50,52,6891,24,28,4580.46,8467.12,0.00
2024-12-08 16:56:50,51,6891,23,28,4592.03,8467.82,0.00
2024-12-08 16:56:50,51,6892,23,28,4743.25,8468.00,0.00
2024-12-08 16:56:50,52,6892,23,29,4652.04,8468.02,0.00
2024-12-08 16:56:50,51,6892,23,28,4734.95,8468.02,0.00
2024-12-08 16:56:50,50,6892,22,28,4758.66,8468.38,0.00
2024-12-08 16:56:50,50,6893,22,28,4875.95,8469.00,0.00
2024-12-08 16:56:50,51,6893,22,29,4780.35,8469.02,0.00
2024-12-08 16:56:50,50,6893,21,29,4763.43,8469.42,0.00
2024-12-08 16:56:50,50,6894,21,29,4884.11,8470.00,0.00
2024-12-08 16:56:50,51,6894,21,30,4788.35,8470.02,0.00
2024-12-08 16:56:50,50,6894,21,29,4877.34,8470.02,0.00
2024-12-08 16:56:50,49,6894,20,29,4952.73,8470.18,0.00
2024-12-08 16:56:50,49,6895,20,29,5056.99,8471.00,0.00
2024-12-08 16:56:50,50,6895,20,30,4955.85,8471.02,0.00
2024-12-08 16:56:50,50,6896,20,30,4941.18,8472.00,0.00
2024-12-08 16:56:50,51,6896,20,31,4844.30,8472.02,0.00
2024-12-08 16:56:50,50,6896,20,30,4929.32,8472.02,0.00
2024-12-08 16:56:50,50,6897,20,30,4948.54,8473.00,0.00
2024-12-08 16:56:50,51,6897,20,31,4851.51,8473.02,0.00
2024-12-08 16:56:50,50,6897,19,31,4903.94,8473.14,0.00
2024-12-08 16:56:50,49,6897,18,31,4933.25,8473.41,0.00
2024-12-08 16:56:50,49,6898,18,31,5056.45,8474.00,0.00
2024-12-08 16:56:50,50,6898,19,31,4955.32,8474.02,0.00
2024-12-08 16:56:50,49,6898,19,30,5046.07,8474.02,0.00
2024-12-08 16:56:50,48,6898,18,30,5027.93,8474.63,0.00
2024-12-08 16:56:50,48,6899,18,30,5173.00,8475.00,0.00
2024-12-08 16:56:50,49,6899,18,31,5067.43,8475.02,0.00
2024-12-08 16:56:50,48,6899,17,31,5085.02,8475.63,0.00
2024-12-08 16:56:50,48,6900,17,31,5159.48,8476.00,0.00
2024-12-08 16:56:50,49,6900,17,32,5054.18,8476.02,0.00
2024-12-08 16:56:50,48,6900,17,31,5145.35,8476.02,0.00
2024-12-08 16:56:50,48,6901,17,31,5168.92,8477.00,0.00
2024-12-08 16:56:50,49,6901,17,32,5063.43,8477.02,0.00
2024-12-08 16:56:50,48,6901,16,32,5070.03,8477.06,0.00
2024-12-08 16:56:50,48,6902,16,32,5167.76,8478.00,0.00
2024-12-08 16:56:50,49,6902,16,33,5062.30,8478.02,0.00
2024-12-08 16:56:50,48,6902,16,32,5148.33,8478.02,0.00
2024-12-08 16:56:50,48,6903,16,32,5171.90,8479.00,0.00
2024-12-08 16:56:50,49,6903,17,32,5066.36,8479.02,0.00
2024-12-08 16:56:50,48,6903,16,32,5032.89,8479.92,0.00
2024-12-08 16:56:50,48,6904,16,32,5202.55,8480.00,0.00
2024-12-08 16:56:50,49,6904,17,32,5096.37,8480.02,0.00
2024-12-08 16:56:50,48,6904,17,31,5184.88,8480.02,0.00
2024-12-08 16:56:50,48,6905,17,31,5208.46,8481.00,0.00
2024-12-08 16:56:50,49,6905,18,31,5102.17,8481.02,0.00
2024-12-08 16:56:50,49,6906,18,31,5088.92,8482.00,0.00
2024-12-08 16:56:50,50,6906,18,32,4987.14,8482.02,0.00
2024-12-08 16:56:50,49,6906,18,31,5071.61,8482.02,0.00
2024-12-08 16:56:50,49,6907,18,31,5092.98,8483.00,0.00
2024-12-08 16:56:50,50,6907,19,31,4991.12,8483.02,0.00
2024-12-08 16:56:50,49,6907,18,31,5053.18,8483.08,0.00
2024-12-08 16:56:50,49,6908,18,31,5082.88,8484.00,0.00
2024-12-08 16:56:50,50,6908,18,32,4981.22,8484.02,0.00
2024-12-08 16:56:50,49,6908,18,31,5060.37,8484.02,0.00
2024-12-08 16:56:50,48,6908,17,31,5158.75,8484.08,0.00
2024-12-08 16:56:50,47,6908,16,31,5222.17,8484.60,0.00
2024-12-08 16:56:50,47,6909,16,31,5368.73,8485.00,0.00
2024-12-08 16:56:50,48,6909,17,31,5256.88,8485.02,0.00
2024-12-08 16:56:50,47,6909,16,31,5220.95,8485.55,0.00
2024-12-08 16:56:50,47,6910,16,31,5363.94,8486.00,0.00
2024-12-08 16:56:50,48,6910,17,31,5252.19,8486.02,0.00
2024-12-08 16:56:50,47,6910,17,30,5342.28,8486.02,0.00
2024-12-08 16:56:51,47,6911,17,30,5368.19,8487.00,0.00
2024-12-08 16:56:51,48,6911,17,31,5256.35,8487.02,0.00
2024-12-08 16:56:51,47,6911,16,31,5281.93,8487.30,0.00
2024-12-08 16:56:51,47,6912,16,31,5403.42,8488.00,0.00
2024-12-08 16:56:51,48,6912,16,32,5290.85,8488.02,0.00
2024-12-08 16:56:51,47,6912,16,31,5381.75,8488.02,0.00
2024-12-08 16:56:51,47,6913,16,31,5407.67,8489.00,0.00
2024-12-08 16:56:51,48,6913,17,31,5295.01,8489.02,0.00
2024-12-08 16:56:51,47,6913,16,31,5295.84,8489.38,0.00
2024-12-08 16:56:51,47,6914,16,31,5424.56,8490.00,0.00
2024-12-08 16:56:51,48,6914,16,32,5311.55,8490.02,0.00
2024-12-08 16:56:51,47,6914,16,31,5388.44,8490.04,0.00
2024-12-08 16:56:51,47,6915,16,31,5416.17,8491.00,0.00
2024-12-08 16:56:51,48,6915,16,32,5303.33,8491.02,0.00
2024-12-08 16:56:51,48,6916,16,32,5293.85,8492.00,0.00
2024-12-08 16:56:51,49,6916,17,32,5185.81,8492.02,0.00
2024-12-08 16:56:51,48,6916,17,31,5260.24,8492.04,0.00
2024-12-08 16:56:51,47,6916,16,31,5260.21,8492.96,0.00
2024-12-08 16:56:51,47,6917,16,31,5437.32,8493.00,0.00
2024-12-08 16:56:51,48,6917,17,31,5324.05,8493.02,0.00
2024-12-08 16:56:51,48,6918,17,31,5316.46,8494.00,0.00
2024-12-08 16:56:51,49,6918,18,31,5207.97,8494.02,0.00
2024-12-08 16:56:51,48,6918,18,30,5281.08,8494.04,0.00
2024-12-08 16:56:51,48,6918,18,30,5306.47,8495.00,0.00
2024-12-08 16:56:51,49,6918,18,31,5198.18,8495.02,0.00
2024-12-08 16:56:51,49,6919,18,31,5190.69,8496.00,0.00
2024-12-08 16:56:51,50,6919,19,31,5086.88,8496.02,0.00
2024-12-08 16:56:51,49,6919,19,30,5157.75,8496.04,0.00
2024-12-08 16:56:51,49,6920,19,30,5180.90,8497.00,0.00
2024-12-08 16:56:51,50,6920,20,30,5077.28,8497.02,0.00
2024-12-08 16:56:51,50,6921,20,30,5071.29,8498.00,0.00
2024-12-08 16:56:51,51,6921,20,31,4971.85,8498.02,0.00
2024-12-08 16:56:51,50,6921,20,30,5039.00,8498.04,0.00
2024-12-08 16:56:51,50,6922,20,30,5059.98,8499.00,0.00
2024-12-08 16:56:51,51,6922,20,31,4960.77,8499.02,0.00
2024-12-08 16:56:51,50,6922,19,31,4907.35,8499.96,0.00
2024-12-08 16:56:51,50,6923,19,31,5073.97,8500.00,0.00
2024-12-08 16:56:51,51,6923,19,32,4974.48,8500.02,0.00
2024-12-08 16:56:51,50,6923,19,31,5043.38,8500.04,0.00
2024-12-08 16:56:51,50,6924,19,31,5064.12,8501.00,0.00
2024-12-08 16:56:51,51,6924,20,31,4964.82,8501.02,0.00
2024-12-08 16:56:51,51,6925,20,31,4953.80,8502.00,0.00
2024-12-08 16:56:51,52,6925,21,31,4858.54,8502.02,0.00
2024-12-08 16:56:51,51,6925,21,30,4925.47,8502.04,0.00
2024-12-08 16:56:51,50,6925,20,30,4976.05,8502.60,0.00
2024-12-08 16:56:51,50,6926,20,30,5039.27,8503.00,0.00
2024-12-08 16:56:51,51,6926,20,31,4940.46,8503.02,0.00
2024-12-08 16:56:51,50,6926,19,31,4956.01,8503.26,0.00
2024-12-08 16:56:51,50,6926,19,31,5056.89,8504.00,0.00
2024-12-08 16:56:51,51,6926,20,31,4957.73,8504.02,0.00
2024-12-08 16:56:51,50,6926,20,30,5022.88,8504.04,0.00
2024-12-08 16:56:51,49,6926,19,30,5010.54,8504.57,0.00
2024-12-08 16:56:51,49,6927,19,30,5139.66,8505.00,0.00
2024-12-08 16:56:51,50,6927,19,31,5036.87,8505.02,0.00
2024-12-08 16:56:51,50,6928,19,31,5022.26,8506.00,0.00
2024-12-08 16:56:51,51,6928,20,31,4923.78,8506.02,0.00
2024-12-08 16:56:51,50,6928,20,30,4989.94,8506.04,0.00
2024-12-08 16:56:51,50,6929,20,30,5001.79,8507.00,0.00
2024-12-08 16:56:51,51,6929,21,30,4903.72,8507.02,0.00
2024-12-08 16:56:51,51,6930,21,30,4889.25,8508.00,0.00
2024-12-08 16:56:51,52,6930,21,31,4795.22,8508.02,0.00
2024-12-08 16:56:51,51,6930,21,30,4859.22,8508.04,0.00
2024-12-08 16:56:51,51,6931,21,30,4870.28,8509.00,0.00
2024-12-08 16:56:51,52,6931,21,31,4776.62,8509.02,0.00
2024-12-08 16:56:51,52,6932,21,31,4766.11,8510.00,0.00
2024-12-08 16:56:51,53,6932,21,32,4676.18,8510.02,0.00
2024-12-08 16:56:51,52,6932,20,32,4757.68,8510.04,0.00
2024-12-08 16:56:51,51,6932,20,31,4820.94,8510.04,0.00
2024-12-08 16:56:51,50,6932,19,31,4913.96,8510.06,0.00
2024-12-08 16:56:51,50,6933,19,31,4999.73,8511.00,0.00
2024-12-08 16:56:51,51,6933,20,31,4901.70,8511.02,0.00
2024-12-08 16:56:51,51,6934,20,31,4904.93,8512.00,0.00
2024-12-08 16:56:51,52,6934,21,31,4810.60,8512.02,0.00
2024-12-08 16:56:51,51,6934,20,31,4901.60,8512.06,0.00
2024-12-08 16:56:51,51,6935,20,31,4887.95,8513.00,0.00
2024-12-08 16:56:51,52,6935,21,31,4793.95,8513.02,0.00
2024-12-08 16:56:51,51,6935,20,31,4884.62,8513.06,0.00
2024-12-08 16:56:51,50,6935,20,30,4970.40,8513.08,0.00
2024-12-08 16:56:51,49,6935,19,30,4963.87,8513.84,0.00
2024-12-08 16:56:51,49,6936,19,30,5123.85,8514.00,0.00
2024-12-08 16:56:51,50,6936,19,31,5021.37,8514.02,0.00
2024-12-08 16:56:51,49,6936,18,31,5006.57,8514.45,0.00
2024-12-08 16:56:52,49,6937,18,31,5133.81,8515.00,0.00
2024-12-08 16:56:52,50,6937,18,32,5031.14,8515.02,0.00
2024-12-08 16:56:52,50,6938,18,32,5016.40,8516.00,0.00
2024-12-08 16:56:52,51,6938,18,33,4918.04,8516.02,0.00
2024-12-08 16:56:52,50,6938,18,32,4997.68,8516.10,0.00
2024-12-08 16:56:52,49,6938,17,32,5014.71,8516.47,0.00
2024-12-08 16:56:52,49,6939,17,32,5143.71,8517.00,0.00
2024-12-08 16:56:52,50,6939,17,33,5040.83,8517.02,0.00
2024-12-08 16:56:52,50,6940,17,33,5047.05,8518.00,0.00
2024-12-08 16:56:52,51,6940,18,33,4948.09,8518.02,0.00
2024-12-08 16:56:52,50,6940,17,33,4976.87,8518.44,0.00
2024-12-08 16:56:52,50,6941,17,33,5099.95,8519.00,0.00
2024-12-08 16:56:52,51,6941,18,33,4999.95,8519.02,0.00
2024-12-08 16:56:52,50,6941,18,32,5082.92,8519.10,0.00
2024-12-08 16:56:52,50,6942,18,32,5109.07,8520.00,0.00
2024-12-08 16:56:52,51,6942,19,32,5008.89,8520.02,0.00
2024-12-08 16:56:52,50,6942,18,32,5102.26,8520.08,0.00
2024-12-08 16:56:52,49,6942,17,32,5133.10,8520.53,0.00
2024-12-08 16:56:52,49,6943,17,32,5217.36,8521.00,0.00
2024-12-08 16:56:52,50,6943,17,33,5113.01,8521.02,0.00
2024-12-08 16:56:52,50,6944,17,33,5096.23,8522.00,0.00
2024-12-08 16:56:52,51,6944,17,34,4996.30,8522.02,0.00
2024-12-08 16:56:52,50,6944,17,33,5084.31,8522.08,0.00
2024-12-08 16:56:52,49,6944,16,33,5148.65,8522.53,0.00
2024-12-08 16:56:52,49,6945,16,33,5206.17,8523.00,0.00
2024-12-08 16:56:52,50,6945,16,34,5102.04,8523.02,0.00
2024-12-08 16:56:52,49,6945,15,34,5204.43,8523.02,0.00
2024-12-08 16:56:52,49,6946,15,34,5194.46,8524.00,0.00
2024-12-08 16:56:52,50,6946,15,35,5090.57,8524.02,0.00
2024-12-08 16:56:52,49,6946,14,35,5039.39,8524.94,0.00
2024-12-08 16:56:52,49,6947,14,35,5208.19,8525.00,0.00
2024-12-08 16:56:52,50,6947,15,35,5104.03,8525.02,0.00
2024-12-08 16:56:52,49,6947,15,34,5201.24,8525.06,0.00
2024-12-08 16:56:52,48,6947,14,34,5213.74,8525.44,0.00
2024-12-08 16:56:52,48,6948,14,34,5326.83,8526.00,0.00
2024-12-08 16:56:52,49,6948,14,35,5218.12,8526.02,0.00
2024-12-08 16:56:52,49,6949,14,35,5193.90,8527.00,0.00
2024-12-08 16:56:52,50,6949,15,35,5090.02,8527.02,0.00
2024-12-08 16:56:52,49,6949,15,34,5153.89,8527.06,0.00
2024-12-08 16:56:52,49,6950,15,34,5157.38,8528.00,0.00
2024-12-08 16:56:52,50,6950,15,35,5054.23,8528.02,0.00
2024-12-08 16:56:52,49,6950,14,35,5046.33,8528.71,0.00
2024-12-08 16:56:52,49,6951,14,35,5174.28,8529.00,0.00
2024-12-08 16:56:52,50,6951,15,35,5070.79,8529.02,0.00
2024-12-08 16:56:52,49,6951,15,34,5135.99,8529.06,0.00
2024-12-08 16:56:52,49,6952,15,34,5138.94,8530.00,0.00
2024-12-08 16:56:52,50,6952,15,35,5036.16,8530.02,0.00
2024-12-08 16:56:52,50,6953,15,35,5010.38,8531.00,0.00
2024-12-08 16:56:52,51,6953,15,36,4912.14,8531.02,0.00
2024-12-08 16:56:52,50,6953,15,35,4974.56,8531.06,0.00
2024-12-08 16:56:52,49,6953,14,35,4974.27,8531.49,0.00
2024-12-08 16:56:52,49,6954,14,35,5086.28,8532.00,0.00
2024-12-08 16:56:52,50,6954,14,36,4984.56,8532.02,0.00
2024-12-08 16:56:52,49,6954,14,35,4986.37,8532.67,0.00
2024-12-08 16:56:52,49,6955,14,35,5073.87,8533.00,0.00
2024-12-08 16:56:52,50,6955,14,36,4972.39,8533.02,0.00
2024-12-08 16:56:52,49,6955,14,35,5039.05,8533.06,0.00
2024-12-08 16:56:52,48,6955,13,35,5104.81,8533.52,0.00
2024-12-08 16:56:52,47,6955,12,35,5144.53,8533.89,0.00
2024-12-08 16:56:52,47,6956,12,35,5317.11,8534.00,0.00
2024-12-08 16:56:52,48,6956,12,36,5206.34,8534.02,0.00
2024-12-08 16:56:52,47,6956,11,36,5192.02,8534.47,0.00
2024-12-08 16:56:52,47,6957,11,36,5328.63,8535.00,0.00
2024-12-08 16:56:52,48,6957,11,37,5217.62,8535.02,0.00
2024-12-08 16:56:52,47,6957,11,36,5294.13,8535.06,0.00
2024-12-08 16:56:52,46,6957,10,36,5349.97,8535.35,0.00
2024-12-08 16:56:52,46,6958,10,36,5480.36,8536.00,0.00
2024-12-08 16:56:52,47,6958,10,37,5363.76,8536.02,0.00
2024-12-08 16:56:52,47,6959,10,37,5354.56,8537.00,0.00
2024-12-08 16:56:52,48,6959,10,38,5243.01,8537.02,0.00
2024-12-08 16:56:52,47,6959,10,37,5321.88,8537.06,0.00
2024-12-08 16:56:52,47,6960,10,37,5351.56,8538.00,0.00
2024-12-08 16:56:52,48,6960,10,38,5240.07,8538.02,0.00
2024-12-08 16:56:52,48,6961,10,38,5230.99,8539.00,0.00
2024-12-08 16:56:52,49,6961,11,38,5124.24,8539.02,0.00
2024-12-08 16:56:52,48,6961,11,37,5200.76,8539.06,0.00
2024-12-08 16:56:52,47,6961,10,37,5225.19,8539.43,0.00
2024-12-08 16:56:53,47,6962,10,37,5358.26,8540.00,0.00
2024-12-08 16:56:53,48,6962,11,37,5246.63,8540.02,0.00
2024-12-08 16:56:53,48,6963,11,37,5238.20,8541.00,0.00
2024-12-08 16:56:53,49,6963,12,37,5131.30,8541.02,0.00
2024-12-08 16:56:53,48,6963,12,36,5207.96,8541.06,0.00
2024-12-08 16:56:53,48,6964,12,36,5235.26,8542.00,0.00
2024-12-08 16:56:53,49,6964,12,37,5128.41,8542.02,0.00
2024-12-08 16:56:53,48,6964,11,37,5190.79,8542.13,0.00
2024-12-08 16:56:53,48,6965,11,37,5226.50,8543.00,0.00
2024-12-08 16:56:53,49,6965,11,38,5119.84,8543.02,0.00
2024-12-08 16:56:53,48,6965,11,37,5198.03,8543.06,0.00
2024-12-08 16:56:53,47,6965,10,37,5197.13,8543.94,0.00
2024-12-08 16:56:53,47,6966,10,37,5373.50,8544.00,0.00
2024-12-08 16:56:53,48,6966,10,38,5261.55,8544.02,0.00
2024-12-08 16:56:53,48,6967,10,38,5249.70,8545.00,0.00
2024-12-08 16:56:53,49,6967,11,38,5142.57,8545.02,0.00
2024-12-08 16:56:53,48,6967,11,37,5223.00,8545.06,0.00
2024-12-08 16:56:53,47,6967,10,37,5210.82,8545.64,0.00
2024-12-08 16:56:53,47,6968,10,37,5362.03,8546.00,0.00
2024-12-08 16:56:53,48,6968,11,37,5250.32,8546.02,0.00
2024-12-08 16:56:53,48,6969,11,37,5238.47,8547.00,0.00
2024-12-08 16:56:53,49,6969,11,38,5131.56,8547.02,0.00
2024-12-08 16:56:53,48,6969,11,37,5213.54,8547.06,0.00
2024-12-08 16:56:53,48,6970,11,37,5240.86,8548.00,0.00
2024-12-08 16:56:53,49,6970,11,38,5133.91,8548.02,0.00
2024-12-08 16:56:53,48,6970,10,38,5107.02,8548.40,0.00
2024-12-08 16:56:53,48,6971,10,38,5233.91,8549.00,0.00
2024-12-08 16:56:53,49,6971,11,38,5127.09,8549.02,0.00
2024-12-08 16:56:53,48,6971,10,38,5232.13,8549.02,0.00
2024-12-08 16:56:53,47,6971,10,37,5316.17,8549.04,0.00
2024-12-08 16:56:53,47,6972,10,37,5344.07,8550.00,0.00
2024-12-08 16:56:53,48,6972,10,38,5232.74,8550.02,0.00
2024-12-08 16:56:53,47,6972,9,38,5187.10,8550.60,0.00
2024-12-08 16:56:53,47,6973,9,38,5334.79,8551.00,0.00
2024-12-08 16:56:53,48,6973,10,38,5223.65,8551.02,0.00
2024-12-08 16:56:53,47,6973,10,37,5307.50,8551.04,0.00
2024-12-08 16:56:53,46,6973,9,37,5333.57,8551.44,0.00
2024-12-08 16:56:53,46,6974,9,37,5471.58,8552.00,0.00
2024-12-08 16:56:53,47,6974,9,38,5355.17,8552.02,0.00
2024-12-08 16:56:53,47,6975,9,38,5345.61,8553.00,0.00
2024-12-08 16:56:53,48,6975,9,39,5234.24,8553.02,0.00
2024-12-08 16:56:53,47,6975,9,38,5316.49,8553.04,0.00
2024-12-08 16:56:53,46,6975,8,38,5354.14,8553.39,0.00
2024-12-08 16:56:53,46,6976,8,38,5488.49,8554.00,0.00
2024-12-08 16:56:53,47,6976,9,38,5371.72,8554.02,0.00
2024-12-08 16:56:53,46,6976,8,38,5482.91,8554.02,0.00
2024-12-08 16:56:53,46,6977,8,38,5548.13,8555.00,0.00
2024-12-08 16:56:53,47,6977,8,39,5430.08,8555.02,0.00
2024-12-08 16:56:53,46,6977,8,38,5522.09,8555.02,0.00
2024-12-08 16:56:53,46,6978,8,38,5548.95,8556.00,0.00
2024-12-08 16:56:53,47,6978,9,38,5430.89,8556.02,0.00
2024-12-08 16:56:53,47,6979,9,38,5418.11,8557.00,0.00
2024-12-08 16:56:53,48,6979,9,39,5305.23,8557.02,0.00
2024-12-08 16:56:53,47,6979,9,38,5392.62,8557.02,0.00
2024-12-08 16:56:53,47,6980,9,38,5416.14,8558.00,0.00
2024-12-08 16:56:53,48,6980,10,38,5303.31,8558.02,0.00
2024-12-08 16:56:53,47,6980,9,38,5299.31,8558.77,0.00
2024-12-08 16:56:53,47,6981,9,38,5459.64,8559.00,0.00
2024-12-08 16:56:53,48,6981,10,38,5345.90,8559.02,0.00
2024-12-08 16:56:53,47,6981,10,37,5435.97,8559.02,0.00
2024-12-08 16:56:53,47,6982,10,37,5461.35,8560.00,0.00
2024-12-08 16:56:53,48,6982,10,38,5347.57,8560.02,0.00
2024-12-08 16:56:53,48,6983,10,38,5335.71,8561.00,0.00
2024-12-08 16:56:53,49,6983,10,39,5226.82,8561.02,0.00
2024-12-08 16:56:53,48,6983,10,38,5308.96,8561.02,0.00
2024-12-08 16:56:53,48,6984,10,38,5331.97,8562.00,0.00
2024-12-08 16:56:53,49,6984,11,38,5223.15,8562.02,0.00
2024-12-08 16:56:53,48,6984,10,38,5176.85,8562.58,0.00
2024-12-08 16:56:53,48,6985,10,38,5319.87,8563.00,0.00
2024-12-08 16:56:53,49,6985,11,38,5211.30,8563.02,0.00
2024-12-08 16:56:53,48,6985,11,37,5291.32,8563.02,0.00
2024-12-08 16:56:53,48,6986,11,37,5312.62,8564.00,0.00
2024-12-08 16:56:53,49,6986,11,38,5204.19,8564.02,0.00
2024-12-08 16:56:54,49,6987,11,38,5189.84,8565.00,0.00
2024-12-08 16:56:54,50,6987,11,39,5086.04,8565.02,0.00
2024-12-08 16:56:54,49,6987,11,38,5163.62,8565.02,0.00
2024-12-08 16:56:54,48,6987,10,38,5215.97,8565.63,0.00
2024-12-08 16:56:54,48,6988,10,38,5291.19,8566.00,0.00
2024-12-08 16:56:54,49,6988,10,39,5183.21,8566.02,0.00
2024-12-08 16:56:54,48,6988,9,39,5156.82,8566.88,0.00
2024-12-08 16:56:54,48,6989,9,39,5324.66,8567.00,0.00
2024-12-08 16:56:54,49,6989,10,39,5216.00,8567.02,0.00
2024-12-08 16:56:54,48,6989,10,38,5299.68,8567.02,0.00
2024-12-08 16:56:54,48,6990,10,38,5323.50,8568.00,0.00
2024-12-08 16:56:54,49,6990,11,38,5214.86,8568.02,0.00
2024-12-08 16:56:54,49,6991,11,38,5203.03,8569.00,0.00
2024-12-08 16:56:54,50,6991,11,39,5098.97,8569.02,0.00
2024-12-08 16:56:54,49,6991,11,38,5176.80,8569.02,0.00
2024-12-08 16:56:54,49,6992,11,38,5198.39,8570.00,0.00
2024-12-08 16:56:54,50,6992,12,38,5094.43,8570.02,0.00
2024-12-08 16:56:54,50,6993,12,38,5082.81,8571.00,0.00
2024-12-08 16:56:54,51,6993,12,39,4983.15,8571.02,0.00
2024-12-08 16:56:54,50,6993,12,38,5057.10,8571.02,0.00
2024-12-08 16:56:54,49,6993,11,38,5153.33,8571.08,0.00
2024-12-08 16:56:54,49,6994,11,38,5180.15,8572.00,0.00
2024-12-08 16:56:54,50,6994,11,39,5076.55,8572.02,0.00
2024-12-08 16:56:54,49,6994,10,39,5056.16,8572.45,0.00
2024-12-08 16:56:54,49,6995,10,39,5184.26,8573.00,0.00
2024-12-08 16:56:54,50,6995,10,40,5080.57,8573.02,0.00
2024-12-08 16:56:54,49,6995,10,39,5156.26,8573.02,0.00
2024-12-08 16:56:54,49,6996,10,39,5177.86,8574.00,0.00
2024-12-08 16:56:54,50,6996,11,39,5074.30,8574.02,0.00
2024-12-08 16:56:54,50,6997,11,39,5063.12,8575.00,0.00
2024-12-08 16:56:54,51,6997,11,40,4963.85,8575.02,0.00
2024-12-08 16:56:54,50,6997,11,39,5037.40,8575.02,0.00
2024-12-08 16:56:54,49,6997,10,39,5086.05,8575.61,0.00
2024-12-08 16:56:54,49,6998,10,39,5228.08,8576.00,0.00
2024-12-08 16:56:54,50,6998,10,40,5123.51,8576.02,0.00
2024-12-08 16:56:54,50,6999,10,40,5111.09,8577.00,0.00
2024-12-08 16:56:54,51,6999,10,41,5010.88,8577.02,0.00
2024-12-08 16:56:54,50,6999,10,40,5087.08,8577.02,0.00
2024-12-08 16:56:54,50,7000,10,40,5106.54,8578.00,0.00
2024-12-08 16:56:54,51,7000,10,41,5006.41,8578.02,0.00
2024-12-08 16:56:54,50,7000,10,40,5091.25,8578.02,0.00
2024-12-08 16:56:54,50,7001,10,40,5110.71,8579.00,0.00
2024-12-08 16:56:54,51,7001,10,41,5010.50,8579.02,0.00
2024-12-08 16:56:54,50,7001,9,41,4978.85,8579.50,0.00
2024-12-08 16:56:54,50,7002,9,41,5107.88,8580.00,0.00
2024-12-08 16:56:54,51,7002,9,42,5007.72,8580.02,0.00
2024-12-08 16:56:54,50,7002,8,42,4963.00,8580.60,0.00
2024-12-08 16:56:54,50,7003,8,42,5100.58,8581.00,0.00
2024-12-08 16:56:54,51,7003,8,43,5000.56,8581.02,0.00
2024-12-08 16:56:54,50,7003,8,42,5069.69,8581.04,0.00
2024-12-08 16:56:54,51,7002,8,43,4933.49,8581.51,0.00
2024-12-08 16:56:54,50,7002,7,43,5074.64,8581.56,0.00
2024-12-08 16:56:54,50,7003,7,43,5208.83,8582.00,0.00
2024-12-08 16:56:54,51,7003,8,43,5106.69,8582.02,0.00
2024-12-08 16:56:54,50,7003,7,43,5118.37,8582.62,0.00
2024-12-08 16:56:54,50,7004,7,43,5429.35,8583.00,0.00
2024-12-08 16:56:54,51,7004,8,43,5322.89,8583.02,0.00
2024-12-08 16:56:54,50,7004,8,42,5395.02,8583.04,0.00
2024-12-08 16:56:54,49,7004,7,42,5458.14,8583.59,0.00
2024-12-08 16:56:54,49,7005,7,42,5528.54,8584.00,0.00
2024-12-08 16:56:54,50,7005,8,42,5417.97,8584.02,0.00
2024-12-08 16:56:54,49,7005,8,41,5505.76,8584.02,0.00
2024-12-08 16:56:54,49,7006,8,41,5527.43,8585.00,0.00
2024-12-08 16:56:54,50,7006,9,41,5416.88,8585.02,0.00
2024-12-08 16:56:54,49,7006,8,41,5413.92,8585.41,0.00
2024-12-08 16:56:54,49,7007,8,41,5538.78,8586.00,0.00
2024-12-08 16:56:54,50,7007,9,41,5428.00,8586.02,0.00
2024-12-08 16:56:54,49,7007,9,40,5508.99,8586.02,0.00
2024-12-08 16:56:54,49,7008,9,40,5530.66,8587.00,0.00
2024-12-08 16:56:54,50,7008,9,41,5420.05,8587.02,0.00
2024-12-08 16:56:54,50,7009,9,41,5405.22,8588.00,0.00
2024-12-08 16:56:54,51,7009,10,41,5299.23,8588.02,0.00
2024-12-08 16:56:54,50,7009,10,40,5377.74,8588.02,0.00
2024-12-08 16:56:54,49,7009,9,40,5370.37,8588.57,0.00
2024-12-08 16:56:54,49,7010,9,40,5509.16,8589.00,0.00
2024-12-08 16:56:54,50,7010,10,40,5398.98,8589.02,0.00
2024-12-08 16:56:54,50,7011,10,40,5384.14,8590.00,0.00
2024-12-08 16:56:54,51,7011,10,41,5278.57,8590.02,0.00
2024-12-08 16:56:54,50,7011,10,40,5358.37,8590.02,0.00
2024-12-08 16:56:54,50,7012,10,40,5377.90,8591.00,0.00
2024-12-08 16:56:54,51,7012,10,41,5272.45,8591.02,0.00
2024-12-08 16:56:55,51,7013,10,41,5256.22,8592.00,0.00
2024-12-08 16:56:55,52,7013,10,42,5155.13,8592.02,0.00
2024-12-08 16:56:55,51,7013,10,41,5230.94,8592.02,0.00
2024-12-08 16:56:55,51,7014,10,41,5248.40,8593.00,0.00
2024-12-08 16:56:55,52,7014,11,41,5147.47,8593.02,0.00
2024-12-08 16:56:55,52,7015,11,41,5131.20,8594.00,0.00
2024-12-08 16:56:55,53,7015,11,42,5034.38,8594.02,0.00
2024-12-08 16:56:55,52,7015,11,41,5106.40,8594.02,0.00
2024-12-08 16:56:55,52,7016,11,41,5121.88,8595.00,0.00
2024-12-08 16:56:55,53,7016,11,42,5025.24,8595.02,0.00
2024-12-08 16:56:55,53,7017,11,42,5010.12,8596.00,0.00
2024-12-08 16:56:55,54,7017,12,42,4917.34,8596.02,0.00
2024-12-08 16:56:55,53,7017,12,41,4985.79,8596.02,0.00
2024-12-08 16:56:55,52,7017,11,41,5032.98,8596.58,0.00
2024-12-08 16:56:55,52,7018,11,41,5094.02,8597.00,0.00
2024-12-08 16:56:55,53,7018,12,41,4997.91,8597.02,0.00
2024-12-08 16:56:55,53,7019,12,41,4978.43,8598.00,0.00
2024-12-08 16:56:55,54,7019,13,41,4886.24,8598.02,0.00
2024-12-08 16:56:55,53,7019,13,40,4955.72,8598.02,0.00
2024-12-08 16:56:55,53,7020,13,40,4964.74,8599.00,0.00
2024-12-08 16:56:55,54,7020,13,41,4872.80,8599.02,0.00
2024-12-08 16:56:55,54,7021,13,41,4850.53,8600.00,0.00
2024-12-08 16:56:55,55,7021,13,42,4762.34,8600.02,0.00
2024-12-08 16:56:55,54,7021,13,41,4829.83,8600.02,0.00
2024-12-08 16:56:55,54,7022,13,41,4836.62,8601.00,0.00
2024-12-08 16:56:55,55,7022,14,41,4748.69,8601.02,0.00
2024-12-08 16:56:55,55,7023,14,41,4726.62,8602.00,0.00
2024-12-08 16:56:55,56,7023,14,42,4642.22,8602.02,0.00
2024-12-08 16:56:55,55,7023,14,41,4707.85,8602.02,0.00
2024-12-08 16:56:55,54,7023,13,41,4709.56,8602.78,0.00
2024-12-08 16:56:55,54,7024,13,41,4849.91,8603.00,0.00
2024-12-08 16:56:55,55,7024,14,41,4761.73,8603.02,0.00
2024-12-08 16:56:55,54,7024,13,41,4761.69,8603.65,0.00
2024-12-08 16:56:55,54,7025,13,41,4830.83,8604.00,0.00
2024-12-08 16:56:55,55,7025,13,42,4742.99,8604.02,0.00
2024-12-08 16:56:55,54,7025,13,41,4813.30,8604.02,0.00
2024-12-08 16:56:55,53,7025,12,41,4802.85,8604.89,0.00
2024-12-08 16:56:55,53,7026,12,41,4955.54,8605.00,0.00
2024-12-08 16:56:55,54,7026,13,41,4863.77,8605.02,0.00
2024-12-08 16:56:55,54,7027,13,41,4844.65,8606.00,0.00
2024-12-08 16:56:55,55,7027,13,42,4756.57,8606.02,0.00
2024-12-08 16:56:55,54,7027,13,41,4828.72,8606.02,0.00
2024-12-08 16:56:55,53,7027,12,41,4863.67,8606.66,0.00
2024-12-08 16:56:55,53,7028,12,41,4932.11,8607.00,0.00
2024-12-08 16:56:55,54,7028,12,42,4840.77,8607.02,0.00
2024-12-08 16:56:55,54,7029,12,42,4820.61,8608.00,0.00
2024-12-08 16:56:55,55,7029,13,42,4732.96,8608.02,0.00
2024-12-08 16:56:55,54,7029,13,41,4806.27,8608.02,0.00
2024-12-08 16:56:55,53,7029,12,41,4787.04,8608.96,0.00
2024-12-08 16:56:55,53,7030,12,41,4946.25,8609.00,0.00
2024-12-08 16:56:55,54,7030,12,42,4854.65,8609.02,0.00
2024-12-08 16:56:55,54,7031,12,42,4834.49,8610.00,0.00
2024-12-08 16:56:55,55,7031,13,42,4746.59,8610.02,0.00
2024-12-08 16:56:55,54,7031,13,41,4821.73,8610.02,0.00
2024-12-08 16:56:55,53,7031,12,41,4832.13,8610.79,0.00
2024-12-08 16:56:55,53,7032,12,41,4976.89,8611.00,0.00
2024-12-08 16:56:55,54,7032,13,41,4884.72,8611.02,0.00
2024-12-08 16:56:55,53,7032,12,41,4889.28,8611.32,0.00
2024-12-08 16:56:55,52,7032,11,41,4954.56,8611.65,0.00
2024-12-08 16:56:55,52,7033,11,41,5090.62,8612.00,0.00
2024-12-08 16:56:55,53,7033,12,41,4994.57,8612.02,0.00
2024-12-08 16:56:55,52,7033,12,40,5079.03,8612.02,0.00
2024-12-08 16:56:55,52,7034,12,40,5094.53,8613.00,0.00
2024-12-08 16:56:55,53,7034,13,40,4998.40,8613.02,0.00
2024-12-08 16:56:55,52,7034,12,40,5005.21,8613.33,0.00
2024-12-08 16:56:55,52,7035,12,40,5113.34,8614.00,0.00
2024-12-08 16:56:55,53,7035,13,40,5016.86,8614.02,0.00
2024-12-08 16:56:55,52,7035,13,39,5098.43,8614.02,0.00
2024-12-08 16:56:55,52,7036,13,39,5113.93,8615.00,0.00
2024-12-08 16:56:55,53,7036,14,39,5017.44,8615.02,0.00
2024-12-08 16:56:55,53,7037,14,39,4998.52,8616.00,0.00
2024-12-08 16:56:55,54,7037,14,40,4905.95,8616.02,0.00
2024-12-08 16:56:55,53,7037,14,39,4985.51,8616.02,0.00
2024-12-08 16:56:55,53,7038,14,39,4999.10,8617.00,0.00
2024-12-08 16:56:55,54,7038,14,40,4906.52,8617.02,0.00
2024-12-08 16:56:55,54,7039,14,40,4886.34,8618.00,0.00
2024-12-08 16:56:55,55,7039,14,41,4797.50,8618.02,0.00
2024-12-08 16:56:55,54,7039,14,40,4875.17,8618.02,0.00
2024-12-08 16:56:55,54,7040,14,40,4886.91,8619.00,0.00
2024-12-08 16:56:55,55,7040,14,41,4798.06,8619.02,0.00
2024-12-08 16:56:55,54,7040,13,41,4758.10,8619.89,0.00
2024-12-08 16:56:56,54,7041,13,41,4908.23,8620.00,0.00
2024-12-08 16:56:56,55,7041,13,42,4818.99,8620.02,0.00
2024-12-08 16:56:56,54,7041,13,41,4895.46,8620.02,0.00
2024-12-08 16:56:56,53,7041,12,41,4933.27,8620.64,0.00
2024-12-08 16:56:56,53,7042,12,41,5000.23,8621.00,0.00
2024-12-08 16:56:56,54,7042,12,42,4907.63,8621.02,0.00
2024-12-08 16:56:56,53,7042,11,42,4884.94,8621.49,0.00
2024-12-08 16:56:56,53,7043,11,42,5004.06,8622.00,0.00
2024-12-08 16:56:56,54,7043,12,42,4911.39,8622.02,0.00
2024-12-08 16:56:56,53,7043,12,41,4992.67,8622.02,0.00
2024-12-08 16:56:56,52,7043,11,41,4989.46,8622.56,0.00
2024-12-08 16:56:56,52,7044,11,41,5117.47,8623.00,0.00
2024-12-08 16:56:56,53,7044,12,41,5020.91,8623.02,0.00
2024-12-08 16:56:56,53,7045,12,41,5001.97,8624.00,0.00
2024-12-08 16:56:56,54,7045,13,41,4909.34,8624.02,0.00
2024-12-08 16:56:56,53,7045,13,40,5000.07,8624.02,0.00
2024-12-08 16:56:56,53,7046,13,40,5013.67,8625.00,0.00
2024-12-08 16:56:56,54,7046,13,41,4920.82,8625.02,0.00
2024-12-08 16:56:56,54,7047,13,41,4932.51,8626.00,0.00
2024-12-08 16:56:56,55,7047,13,42,4842.82,8626.02,0.00
2024-12-08 16:56:56,55,7048,13,42,4828.99,8627.00,0.00
2024-12-08 16:56:56,56,7048,13,43,4742.76,8627.02,0.00
2024-12-08 16:56:56,55,7048,13,42,4805.47,8627.02,0.00
2024-12-08 16:56:56,55,7049,13,42,4815.43,8628.00,0.00
2024-12-08 16:56:56,56,7049,14,42,4729.44,8628.02,0.00
2024-12-08 16:56:56,55,7049,13,42,4716.96,8628.73,0.00
2024-12-08 16:56:56,55,7050,13,42,4850.51,8629.00,0.00
2024-12-08 16:56:56,56,7050,13,43,4763.89,8629.02,0.00
2024-12-08 16:56:56,55,7050,13,42,4837.96,8629.04,0.00
2024-12-08 16:56:56,55,7051,13,42,4849.50,8630.00,0.00
2024-12-08 16:56:56,56,7051,13,43,4762.90,8630.02,0.00
2024-12-08 16:56:56,55,7051,12,43,4741.86,8630.73,0.00
2024-12-08 16:56:56,55,7052,12,43,4875.45,8631.00,0.00
2024-12-08 16:56:56,56,7052,13,43,4788.39,8631.02,0.00
2024-12-08 16:56:56,55,7052,13,42,4862.90,8631.04,0.00
2024-12-08 16:56:56,54,7052,12,42,4854.26,8631.72,0.00
2024-12-08 16:56:56,54,7053,12,42,4990.35,8632.00,0.00
2024-12-08 16:56:56,55,7053,12,43,4899.62,8632.02,0.00
2024-12-08 16:56:56,55,7054,12,43,4876.22,8633.00,0.00
2024-12-08 16:56:56,56,7054,12,44,4789.15,8633.02,0.00
2024-12-08 16:56:56,55,7054,12,43,4862.10,8633.04,0.00
2024-12-08 16:56:56,54,7054,11,43,4891.33,8633.69,0.00
2024-12-08 16:56:56,54,7055,11,43,5024.29,8634.00,0.00
2024-12-08 16:56:56,55,7055,12,43,4932.94,8634.02,0.00
2024-12-08 16:56:56,55,7056,12,43,4907.09,8635.00,0.00
2024-12-08 16:56:56,56,7056,12,44,4819.46,8635.02,0.00
2024-12-08 16:56:56,55,7056,12,43,4894.53,8635.04,0.00
2024-12-08 16:56:56,54,7056,11,43,4876.55,8635.61,0.00
2024-12-08 16:56:56,54,7057,11,43,5003.19,8636.00,0.00
2024-12-08 16:56:56,55,7057,12,43,4912.23,8636.02,0.00
2024-12-08 16:56:56,55,7058,12,43,4886.72,8637.00,0.00
2024-12-08 16:56:56,56,7058,13,43,4799.46,8637.02,0.00
2024-12-08 16:56:56,55,7058,13,42,4872.59,8637.04,0.00
2024-12-08 16:56:56,55,7059,13,42,4879.49,8638.00,0.00
2024-12-08 16:56:56,56,7059,14,42,4792.36,8638.02,0.00
2024-12-08 16:56:56,56,7060,14,42,4766.76,8639.00,0.00
2024-12-08 16:56:56,57,7060,14,43,4683.13,8639.02,0.00
2024-12-08 16:56:56,56,7060,14,42,4754.42,8639.04,0.00
2024-12-08 16:56:56,55,7060,14,41,4824.85,8639.18,0.00
2024-12-08 16:56:56,55,7061,14,41,4848.92,8640.00,0.00
2024-12-08 16:56:56,56,7061,15,41,4762.34,8640.02,0.00
2024-12-08 16:56:56,56,7062,15,41,4739.74,8641.00,0.00
2024-12-08 16:56:56,57,7062,15,42,4656.59,8641.02,0.00
2024-12-08 16:56:56,56,7062,15,41,4728.94,8641.04,0.00
2024-12-08 16:56:56,56,7063,15,41,4738.75,8642.00,0.00
2024-12-08 16:56:56,57,7063,16,41,4655.61,8642.02,0.00
2024-12-08 16:56:56,56,7063,15,41,4651.08,8642.66,0.00
2024-12-08 16:56:56,56,7064,15,41,4715.37,8643.00,0.00
2024-12-08 16:56:56,57,7064,15,42,4632.64,8643.02,0.00
2024-12-08 16:56:56,56,7064,15,41,4703.02,8643.04,0.00
2024-12-08 16:56:56,56,7065,15,41,4712.82,8644.00,0.00
2024-12-08 16:56:56,57,7065,15,42,4630.14,8644.02,0.00
2024-12-08 16:56:56,56,7065,14,42,4665.03,8644.21,0.00
2024-12-08 16:56:56,56,7066,14,42,4690.21,8645.00,0.00
2024-12-08 16:56:56,57,7066,15,42,4607.93,8645.02,0.00
2024-12-08 16:56:56,56,7066,15,41,4677.86,8645.04,0.00
2024-12-08 16:56:56,55,7066,14,41,4748.82,8645.20,0.00
2024-12-08 16:56:56,54,7066,13,41,4777.05,8645.76,0.00
2024-12-08 16:56:56,54,7067,13,41,4916.51,8646.00,0.00
2024-12-08 16:56:56,55,7067,13,42,4827.12,8646.02,0.00
2024-12-08 16:56:56,55,7068,13,42,4805.67,8647.00,0.00
2024-12-08 16:56:56,56,7068,13,43,4719.85,8647.02,0.00
2024-12-08 16:56:56,55,7068,13,42,4794.66,8647.04,0.00
2024-12-08 16:56:56,54,7068,12,42,4787.84,8647.89,0.00
2024-12-08 16:56:57,54,7069,12,42,4938.47,8648.00,0.00
2024-12-08 16:56:57,55,7069,12,43,4848.68,8648.02,0.00
2024-12-08 16:56:57,55,7070,12,43,4827.22,8649.00,0.00
2024-12-08 16:56:57,56,7070,12,44,4741.02,8649.02,0.00
2024-12-08 16:56:57,55,7070,12,43,4817.79,8649.04,0.00
2024-12-08 16:56:57,55,7071,12,43,4829.35,8650.00,0.00
2024-12-08 16:56:57,56,7071,12,44,4743.11,8650.02,0.00
2024-12-08 16:56:57,56,7072,12,44,4720.49,8651.00,0.00
2024-12-08 16:56:57,57,7072,12,45,4637.67,8651.02,0.00
2024-12-08 16:56:57,56,7072,12,44,4711.22,8651.04,0.00
2024-12-08 16:56:57,56,7073,12,44,4720.01,8652.00,0.00
2024-12-08 16:56:57,57,7073,12,45,4637.20,8652.02,0.00
2024-12-08 16:56:57,57,7074,12,45,4610.54,8653.00,0.00
2024-12-08 16:56:57,58,7074,12,46,4531.04,8653.02,0.00
2024-12-08 16:56:57,57,7074,12,45,4609.02,8653.02,0.00
2024-12-08 16:56:57,56,7074,12,44,4685.14,8653.02,0.00
2024-12-08 16:56:57,55,7074,11,44,4676.15,8653.53,0.00
2024-12-08 16:56:57,55,7075,11,44,4790.39,8654.00,0.00
2024-12-08 16:56:57,56,7075,12,44,4704.85,8654.02,0.00
2024-12-08 16:56:57,55,7075,11,44,4700.61,8654.67,0.00
2024-12-08 16:56:57,54,7075,10,44,4763.69,8654.80,0.00
2024-12-08 16:56:57,54,7076,10,44,4906.50,8655.00,0.00
2024-12-08 16:56:57,55,7076,10,45,4817.29,8655.02,0.00
2024-12-08 16:56:57,54,7076,10,44,4901.69,8655.02,0.00
2024-12-08 16:56:57,54,7077,10,44,4913.48,8656.00,0.00
2024-12-08 16:56:57,55,7077,10,45,4824.14,8656.02,0.00
2024-12-08 16:56:57,54,7077,9,45,4795.05,8656.50,0.00
2024-12-08 16:56:57,54,7078,9,45,4912.44,8657.00,0.00
2024-12-08 16:56:57,55,7078,9,46,4823.12,8657.02,0.00
2024-12-08 16:56:57,54,7078,9,45,4907.63,8657.02,0.00
2024-12-08 16:56:57,53,7078,8,45,4966.57,8657.26,0.00
2024-12-08 16:56:57,53,7079,8,45,5066.72,8658.00,0.00
2024-12-08 16:56:57,54,7079,8,46,4972.89,8658.02,0.00
2024-12-08 16:56:57,53,7079,7,46,4912.58,8658.66,0.00
2024-12-08 16:56:57,53,7080,7,46,5046.81,8659.00,0.00
2024-12-08 16:56:57,54,7080,8,46,4953.35,8659.02,0.00
2024-12-08 16:56:57,53,7080,8,45,5043.55,8659.02,0.00
2024-12-08 16:56:57,53,7081,8,45,5057.20,8660.00,0.00
2024-12-08 16:56:57,54,7081,8,46,4963.55,8660.02,0.00
2024-12-08 16:56:57,53,7081,7,46,5004.97,8660.21,0.00
2024-12-08 16:56:57,53,7082,7,46,5100.27,8661.00,0.00
2024-12-08 16:56:57,54,7082,8,46,5005.82,8661.02,0.00
2024-12-08 16:56:57,53,7082,8,45,5098.64,8661.02,0.00
2024-12-08 16:56:57,52,7082,7,45,5109.45,8661.48,0.00
2024-12-08 16:56:57,52,7083,7,45,5231.44,8662.00,0.00
2024-12-08 16:56:57,53,7083,7,46,5132.74,8662.02,0.00
2024-12-08 16:56:57,52,7083,7,45,5198.13,8662.02,0.00
2024-12-08 16:56:57,52,7084,7,45,5213.72,8663.00,0.00
2024-12-08 16:56:57,53,7084,7,46,5115.35,8663.02,0.00
2024-12-08 16:56:57,52,7084,6,46,5145.50,8663.27,0.00
2024-12-08 16:56:57,52,7085,6,46,5249.31,8664.00,0.00
2024-12-08 16:56:57,53,7085,7,46,5150.27,8664.02,0.00
2024-12-08 16:56:57,52,7085,7,45,5242.65,8664.02,0.00
2024-12-08 16:56:57,52,7086,7,45,5258.25,8665.00,0.00
2024-12-08 16:56:57,53,7086,8,45,5159.04,8665.02,0.00
2024-12-08 16:56:57,52,7086,7,45,5123.52,8665.54,0.00
2024-12-08 16:56:57,51,7086,6,45,5215.54,8665.63,0.00
2024-12-08 16:56:57,51,7087,6,45,5353.48,8666.00,0.00
2024-12-08 16:56:57,52,7087,7,45,5250.53,8666.02,0.00
2024-12-08 16:56:57,51,7087,7,44,5344.98,8666.02,0.00
2024-12-08 16:56:57,51,7088,7,44,5362.59,8667.00,0.00
2024-12-08 16:56:57,52,7088,8,44,5259.46,8667.02,0.00
2024-12-08 16:56:57,52,7089,8,44,5241.73,8668.00,0.00
2024-12-08 16:56:57,53,7089,8,45,5142.83,8668.02,0.00
2024-12-08 16:56:57,52,7089,8,44,5235.07,8668.02,0.00
2024-12-08 16:56:57,52,7090,8,44,5250.68,8669.00,0.00
2024-12-08 16:56:57,53,7090,8,45,5151.61,8669.02,0.00
2024-12-08 16:56:57,53,7091,8,45,5132.57,8670.00,0.00
2024-12-08 16:56:57,54,7091,9,45,5037.52,8670.02,0.00
2024-12-08 16:56:57,53,7091,9,44,5127.66,8670.02,0.00
2024-12-08 16:56:57,52,7091,8,44,5115.13,8670.96,0.00
2024-12-08 16:56:57,52,7092,8,44,5278.57,8671.00,0.00
2024-12-08 16:56:57,53,7092,8,45,5178.97,8671.02,0.00
2024-12-08 16:56:57,53,7093,8,45,5159.93,8672.00,0.00
2024-12-08 16:56:57,54,7093,8,46,5064.38,8672.02,0.00
2024-12-08 16:56:57,53,7093,8,45,5155.02,8672.02,0.00
2024-12-08 16:56:57,53,7094,8,45,5168.71,8673.00,0.00
2024-12-08 16:56:57,54,7094,8,46,5072.99,8673.02,0.00
2024-12-08 16:56:57,54,7095,8,46,5052.70,8674.00,0.00
2024-12-08 16:56:57,55,7095,9,46,4960.83,8674.02,0.00
2024-12-08 16:56:57,54,7095,9,45,5049.48,8674.02,0.00
2024-12-08 16:56:58,54,7096,9,45,5061.31,8675.00,0.00
2024-12-08 16:56:58,55,7096,9,46,4969.29,8675.02,0.00
2024-12-08 16:56:58,55,7097,9,46,4909.36,8676.00,0.00
2024-12-08 16:56:58,56,7097,10,46,4821.69,8676.02,0.00
2024-12-08 16:56:58,55,7097,10,45,4903.05,8676.02,0.00
2024-12-08 16:56:58,54,7097,9,45,4926.75,8676.72,0.00
2024-12-08 16:56:58,55,7096,9,46,4832.48,8676.80,0.00
2024-12-08 16:56:58,55,7097,9,46,4988.46,8677.00,0.00
2024-12-08 16:56:58,56,7097,9,47,4899.38,8677.02,0.00
2024-12-08 16:56:58,56,7098,9,47,4945.17,8678.00,0.00
2024-12-08 16:56:58,57,7098,10,47,4858.41,8678.02,0.00
2024-12-08 16:56:58,56,7098,10,46,4940.52,8678.02,0.00
2024-12-08 16:56:58,56,7099,10,46,4846.97,8679.00,0.00
2024-12-08 16:56:58,57,7099,11,46,4761.93,8679.02,0.00
2024-12-08 16:56:58,56,7099,11,45,4737.35,8679.73,0.00
2024-12-08 16:56:58,55,7099,10,45,4796.71,8679.84,0.00
2024-12-08 16:56:58,54,7099,10,44,4816.67,8679.96,0.00
2024-12-08 16:56:58,54,7100,10,44,4974.21,8680.00,0.00
2024-12-08 16:56:58,55,7100,11,44,4883.77,8680.02,0.00
2024-12-08 16:56:58,54,7100,11,43,4969.39,8680.02,0.00
2024-12-08 16:56:58,54,7101,11,43,4981.22,8681.00,0.00
2024-12-08 16:56:58,55,7101,11,44,4890.65,8681.02,0.00
2024-12-08 16:56:58,55,7102,11,44,4869.11,8682.00,0.00
2024-12-08 16:56:58,56,7102,12,44,4782.17,8682.02,0.00
2024-12-08 16:56:58,55,7102,12,43,4864.38,8682.02,0.00
2024-12-08 16:56:58,55,7103,12,43,4874.41,8683.00,0.00
2024-12-08 16:56:58,56,7103,12,44,4787.37,8683.02,0.00
2024-12-08 16:56:58,55,7103,11,44,4794.01,8683.33,0.00
2024-12-08 16:56:58,55,7104,11,44,4893.92,8684.00,0.00
2024-12-08 16:56:58,56,7104,12,44,4806.53,8684.02,0.00
2024-12-08 16:56:58,55,7104,12,43,4889.18,8684.02,0.00
2024-12-08 16:56:58,54,7104,11,43,4920.57,8684.69,0.00
2024-12-08 16:56:58,54,7105,11,43,4989.95,8685.00,0.00
2024-12-08 16:56:58,55,7105,11,44,4899.22,8685.02,0.00
2024-12-08 16:56:58,55,7106,11,44,4877.67,8686.00,0.00
2024-12-08 16:56:58,56,7106,11,45,4790.57,8686.02,0.00
2024-12-08 16:56:58,55,7106,11,44,4874.52,8686.02,0.00
2024-12-08 16:56:58,54,7106,10,44,4908.82,8686.67,0.00
2024-12-08 16:56:58,54,7107,10,44,4976.62,8687.00,0.00
2024-12-08 16:56:58,55,7107,10,45,4886.13,8687.02,0.00
2024-12-08 16:56:58,54,7107,9,45,4838.92,8687.93,0.00
2024-12-08 16:56:58,54,7108,9,45,4993.43,8688.00,0.00
2024-12-08 16:56:58,55,7108,9,46,4902.64,8688.02,0.00
2024-12-08 16:56:58,54,7108,9,45,4990.21,8688.02,0.00
2024-12-08 16:56:58,53,7108,8,45,5003.48,8688.77,0.00
2024-12-08 16:56:58,53,7109,8,45,5147.92,8689.00,0.00
2024-12-08 16:56:58,54,7109,9,45,5052.59,8689.02,0.00
2024-12-08 16:56:58,54,7110,9,45,5028.24,8690.00,0.00
2024-12-08 16:56:58,55,7110,10,45,4936.82,8690.02,0.00
2024-12-08 16:56:58,54,7110,10,44,5016.98,8690.02,0.00
2024-12-08 16:56:58,54,7111,10,44,5026.71,8691.00,0.00
2024-12-08 16:56:58,55,7111,11,44,4935.32,8691.02,0.00
2024-12-08 16:56:58,54,7111,10,44,4883.76,8691.63,0.00
2024-12-08 16:56:58,54,7112,10,44,5012.81,8692.00,0.00
2024-12-08 16:56:58,55,7112,11,44,4921.66,8692.02,0.00
2024-12-08 16:56:58,54,7112,11,43,5003.15,8692.02,0.00
2024-12-08 16:56:58,54,7113,11,43,5014.99,8693.00,0.00
2024-12-08 16:56:58,55,7113,12,43,4923.81,8693.02,0.00
2024-12-08 16:56:58,55,7114,12,43,4902.25,8694.00,0.00
2024-12-08 16:56:58,56,7114,13,43,4814.71,8694.02,0.00
2024-12-08 16:56:58,55,7114,13,42,4894.34,8694.02,0.00
2024-12-08 16:56:58,55,7115,13,42,4904.39,8695.00,0.00
2024-12-08 16:56:58,56,7115,13,43,4816.81,8695.02,0.00
2024-12-08 16:56:58,56,7116,13,43,4794.07,8696.00,0.00
2024-12-08 16:56:58,57,7116,14,43,4709.97,8696.02,0.00
2024-12-08 16:56:58,56,7116,14,42,4787.86,8696.02,0.00
2024-12-08 16:56:58,55,7116,13,42,4816.74,8696.67,0.00
2024-12-08 16:56:58,54,7116,12,42,4853.00,8696.96,0.00
2024-12-08 16:56:58,54,7117,12,42,5010.86,8697.00,0.00
2024-12-08 16:56:58,55,7117,12,43,4919.75,8697.02,0.00
2024-12-08 16:56:58,54,7117,11,43,4892.57,8697.54,0.00
2024-12-08 16:56:58,54,7118,11,43,5013.71,8698.00,0.00
2024-12-08 16:56:58,55,7118,12,43,4922.55,8698.02,0.00
2024-12-08 16:56:58,54,7118,12,42,5008.88,8698.02,0.00
2024-12-08 16:56:58,54,7119,12,42,5018.07,8699.00,0.00
2024-12-08 16:56:58,55,7119,13,42,4926.83,8699.02,0.00
2024-12-08 16:56:58,55,7120,13,42,4900.54,8700.00,0.00
2024-12-08 16:56:58,56,7120,13,43,4813.03,8700.02,0.00
2024-12-08 16:56:59,55,7120,13,42,4897.37,8700.02,0.00
2024-12-08 16:56:59,55,7121,13,42,4900.53,8701.00,0.00
2024-12-08 16:56:59,56,7121,13,43,4813.02,8701.02,0.00
2024-12-08 16:56:59,56,7122,13,43,4780.79,8702.00,0.00
2024-12-08 16:56:59,57,7122,14,43,4696.91,8702.02,0.00
2024-12-08 16:56:59,56,7122,14,42,4774.57,8702.02,0.00
2024-12-08 16:56:59,55,7122,13,42,4739.10,8702.96,0.00
2024-12-08 16:56:59,55,7123,13,42,4894.19,8703.00,0.00
2024-12-08 16:56:59,56,7123,13,43,4806.79,8703.02,0.00
2024-12-08 16:56:59,55,7123,13,42,4853.53,8703.06,0.00
2024-12-08 16:56:59,55,7124,13,42,4866.74,8704.00,0.00
2024-12-08 16:56:59,56,7124,14,42,4779.83,8704.02,0.00
2024-12-08 16:56:59,55,7124,14,41,4861.99,8704.02,0.00
2024-12-08 16:56:59,55,7125,14,41,4872.05,8705.00,0.00
2024-12-08 16:56:59,56,7125,15,41,4785.05,8705.02,0.00
2024-12-08 16:56:59,55,7125,14,41,4761.66,8705.80,0.00
2024-12-08 16:56:59,55,7126,14,41,4902.68,8706.00,0.00
2024-12-08 16:56:59,56,7126,15,41,4815.13,8706.02,0.00
2024-12-08 16:56:59,55,7126,15,40,4899.52,8706.02,0.00
2024-12-08 16:56:59,55,7127,15,40,4909.58,8707.00,0.00
2024-12-08 16:56:59,56,7127,15,41,4821.91,8707.02,0.00
2024-12-08 16:56:59,56,7128,15,41,4799.13,8708.00,0.00
2024-12-08 16:56:59,57,7128,16,41,4714.94,8708.02,0.00
2024-12-08 16:56:59,56,7128,16,40,4794.47,8708.02,0.00
2024-12-08 16:56:59,56,7129,16,40,4802.80,8709.00,0.00
2024-12-08 16:56:59,57,7129,16,41,4718.54,8709.02,0.00
2024-12-08 16:56:59,57,7130,16,41,4694.63,8710.00,0.00
2024-12-08 16:56:59,58,7130,17,41,4613.69,8710.02,0.00
2024-12-08 16:56:59,57,7130,17,40,4690.05,8710.02,0.00
2024-12-08 16:56:59,56,7130,16,40,4649.71,8710.71,0.00
2024-12-08 16:56:59,56,7131,16,40,4780.57,8711.00,0.00
2024-12-08 16:56:59,57,7131,17,40,4696.70,8711.02,0.00
2024-12-08 16:56:59,56,7131,17,39,4763.05,8711.02,0.00
2024-12-08 16:56:59,56,7132,17,39,4771.37,8712.00,0.00
2024-12-08 16:56:59,57,7132,18,39,4687.67,8712.02,0.00
2024-12-08 16:56:59,57,7133,18,39,4663.75,8713.00,0.00
2024-12-08 16:56:59,58,7133,19,39,4583.34,8713.02,0.00
2024-12-08 16:56:59,57,7133,19,38,4659.16,8713.02,0.00
2024-12-08 16:56:59,57,7134,19,38,4665.81,8714.00,0.00
2024-12-08 16:56:59,58,7134,20,38,4585.36,8714.02,0.00
2024-12-08 16:56:59,57,7134,19,38,4553.08,8714.81,0.00
2024-12-08 16:56:59,57,7135,19,38,4689.28,8715.00,0.00
2024-12-08 16:56:59,58,7135,19,39,4608.43,8715.02,0.00
2024-12-08 16:56:59,57,7135,19,38,4681.63,8715.02,0.00
2024-12-08 16:56:59,56,7135,18,38,4748.18,8715.21,0.00
2024-12-08 16:56:59,56,7136,18,38,4773.56,8716.00,0.00
2024-12-08 16:56:59,57,7136,18,39,4689.82,8716.02,0.00
2024-12-08 16:56:59,56,7136,17,39,4636.88,8716.63,0.00
2024-12-08 16:56:59,56,7137,17,39,4760.10,8717.00,0.00
2024-12-08 16:56:59,57,7137,18,39,4676.59,8717.02,0.00
2024-12-08 16:56:59,56,7137,18,38,4752.32,8717.02,0.00
2024-12-08 16:56:59,55,7137,17,38,4740.93,8717.89,0.00
2024-12-08 16:56:59,55,7138,17,38,4890.00,8718.00,0.00
2024-12-08 16:56:59,56,7138,17,39,4802.68,8718.02,0.00
2024-12-08 16:56:59,56,7139,17,39,4779.88,8719.00,0.00
2024-12-08 16:56:59,57,7139,18,39,4696.02,8719.02,0.00
2024-12-08 16:56:59,56,7139,18,38,4772.09,8719.02,0.00
2024-12-08 16:56:59,55,7139,17,38,4743.44,8719.65,0.00
2024-12-08 16:56:59,55,7140,17,38,4872.10,8720.00,0.00
2024-12-08 16:56:59,56,7140,17,39,4785.10,8720.02,0.00
2024-12-08 16:56:59,55,7140,16,39,4769.40,8720.75,0.00
2024-12-08 16:56:59,55,7141,16,39,4905.96,8721.00,0.00
2024-12-08 16:56:59,56,7141,16,40,4818.35,8721.02,0.00
2024-12-08 16:56:59,55,7141,16,39,4899.61,8721.02,0.00
2024-12-08 16:56:59,55,7142,16,39,4909.69,8722.00,0.00
2024-12-08 16:56:59,56,7142,17,39,4822.02,8722.02,0.00
2024-12-08 16:56:59,55,7142,16,39,4800.45,8722.49,0.00
2024-12-08 16:56:59,55,7143,16,39,4915.01,8723.00,0.00
2024-12-08 16:56:59,56,7143,16,40,4827.24,8723.02,0.00
2024-12-08 16:56:59,55,7143,16,39,4908.67,8723.02,0.00
2024-12-08 16:56:59,55,7144,16,39,4918.75,8724.00,0.00
2024-12-08 16:57:00,56,7144,16,40,4830.91,8724.02,0.00
2024-12-08 16:57:00,56,7145,16,40,4808.10,8725.00,0.00
2024-12-08 16:57:00,57,7145,16,41,4723.74,8725.02,0.00
2024-12-08 16:57:00,56,7145,16,40,4803.42,8725.02,0.00
2024-12-08 16:57:00,56,7146,16,40,4811.76,8726.00,0.00
2024-12-08 16:57:00,57,7146,17,40,4727.35,8726.02,0.00
2024-12-08 16:57:00,57,7147,17,40,4703.39,8727.00,0.00
2024-12-08 16:57:00,58,7147,17,41,4622.30,8727.02,0.00
2024-12-08 16:57:00,57,7147,17,40,4700.33,8727.02,0.00
2024-12-08 16:57:00,57,7148,17,40,4706.99,8728.00,0.00
2024-12-08 16:57:00,58,7148,18,40,4625.84,8728.02,0.00
2024-12-08 16:57:00,57,7148,17,40,4592.34,8728.51,0.00
2024-12-08 16:57:00,57,7149,17,40,4702.94,8729.00,0.00
2024-12-08 16:57:00,58,7149,17,41,4621.85,8729.02,0.00
2024-12-08 16:57:00,57,7149,17,40,4701.41,8729.02,0.00
2024-12-08 16:57:00,57,7150,17,40,4708.07,8730.00,0.00
2024-12-08 16:57:00,58,7150,18,40,4626.90,8730.02,0.00
2024-12-08 16:57:00,57,7150,18,39,4675.91,8730.02,0.00
2024-12-08 16:57:00,56,7150,17,39,4670.76,8730.52,0.00
2024-12-08 16:57:00,56,7151,17,39,4784.90,8731.00,0.00
2024-12-08 16:57:00,57,7151,18,39,4700.95,8731.02,0.00
2024-12-08 16:57:00,56,7151,18,38,4752.16,8731.02,0.00
2024-12-08 16:57:00,56,7152,18,38,4760.50,8732.00,0.00
2024-12-08 16:57:00,57,7152,19,38,4676.98,8732.02,0.00
2024-12-08 16:57:00,56,7152,19,37,4727.75,8732.02,0.00
2024-12-08 16:57:00,56,7153,19,37,4736.09,8733.00,0.00
2024-12-08 16:57:00,57,7153,19,38,4653.00,8733.02,0.00
2024-12-08 16:57:00,56,7153,19,37,4703.34,8733.02,0.00
2024-12-08 16:57:00,55,7153,18,37,4731.99,8733.65,0.00
2024-12-08 16:57:00,55,7154,18,37,4797.35,8734.00,0.00
2024-12-08 16:57:00,56,7154,19,37,4711.68,8734.02,0.00
2024-12-08 16:57:00,56,7155,19,37,4688.82,8735.00,0.00
2024-12-08 16:57:00,57,7155,19,38,4606.56,8735.02,0.00
2024-12-08 16:57:00,56,7155,19,37,4687.26,8735.02,0.00
2024-12-08 16:57:00,56,7156,19,37,4695.60,8736.00,0.00
2024-12-08 16:57:00,57,7156,19,38,4613.22,8736.02,0.00
2024-12-08 16:57:00,56,7156,19,37,4662.84,8736.02,0.00
2024-12-08 16:57:00,56,7157,19,37,4671.17,8737.00,0.00
2024-12-08 16:57:00,57,7157,19,38,4589.22,8737.02,0.00
2024-12-08 16:57:00,56,7157,19,37,4638.41,8737.02,0.00
2024-12-08 16:57:00,55,7157,18,37,4665.84,8737.65,0.00
2024-12-08 16:57:00,55,7158,18,37,4731.23,8738.00,0.00
2024-12-08 16:57:00,56,7158,18,38,4646.74,8738.02,0.00
2024-12-08 16:57:00,55,7158,18,37,4697.86,8738.02,0.00
2024-12-08 16:57:00,54,7158,17,37,4768.73,8738.19,0.00
2024-12-08 16:57:00,54,7159,17,37,4859.85,8739.00,0.00
2024-12-08 16:57:00,55,7159,18,37,4771.49,8739.02,0.00
2024-12-08 16:57:00,54,7159,17,37,4737.06,8739.50,0.00
2024-12-08 16:57:00,54,7160,17,37,4855.55,8740.00,0.00
2024-12-08 16:57:00,55,7160,17,38,4767.27,8740.02,0.00
2024-12-08 16:57:00,54,7160,17,37,4853.94,8740.02,0.00
2024-12-08 16:57:00,53,7160,16,37,4932.37,8740.17,0.00
2024-12-08 16:57:00,53,7161,16,37,4959.28,8741.00,0.00
2024-12-08 16:57:00,54,7161,16,38,4867.44,8741.02,0.00
2024-12-08 16:57:00,54,7162,16,38,4846.95,8742.00,0.00
2024-12-08 16:57:00,55,7162,16,39,4758.82,8742.02,0.00
2024-12-08 16:57:00,54,7162,16,38,4845.33,8742.02,0.00
2024-12-08 16:57:00,53,7162,15,38,4861.04,8742.42,0.00
2024-12-08 16:57:00,53,7163,15,38,4975.26,8743.00,0.00
2024-12-08 16:57:00,54,7163,15,39,4883.13,8743.02,0.00
2024-12-08 16:57:00,53,7163,14,39,4833.64,8743.57,0.00
2024-12-08 16:57:00,52,7163,13,39,4923.26,8743.62,0.00
2024-12-08 16:57:00,52,7164,13,39,5058.07,8744.00,0.00
2024-12-08 16:57:00,53,7164,14,39,4962.63,8744.02,0.00
2024-12-08 16:57:00,52,7164,14,38,5049.66,8744.02,0.00
2024-12-08 16:57:00,51,7164,13,38,5074.98,8744.14,0.00
2024-12-08 16:57:00,51,7165,13,38,5171.55,8745.00,0.00
2024-12-08 16:57:00,52,7165,14,38,5072.10,8745.02,0.00
2024-12-08 16:57:00,52,7166,14,38,5054.18,8746.00,0.00
2024-12-08 16:57:00,53,7166,14,39,4958.81,8746.02,0.00
2024-12-08 16:57:00,52,7166,14,38,5047.45,8746.02,0.00
2024-12-08 16:57:00,52,7167,14,38,5063.16,8747.00,0.00
2024-12-08 16:57:00,53,7167,14,39,4967.63,8747.02,0.00
2024-12-08 16:57:00,52,7167,13,39,4917.36,8747.96,0.00
2024-12-08 16:57:00,52,7168,13,39,5082.25,8748.00,0.00
2024-12-08 16:57:00,53,7168,14,39,4986.36,8748.02,0.00
2024-12-08 16:57:00,52,7168,14,38,5075.52,8748.02,0.00
2024-12-08 16:57:00,52,7169,14,38,5091.24,8749.00,0.00
2024-12-08 16:57:00,53,7169,14,39,4995.18,8749.02,0.00
2024-12-08 16:57:00,53,7170,14,39,4975.94,8750.00,0.00
2024-12-08 16:57:00,54,7170,14,40,4883.79,8750.02,0.00
2024-12-08 16:57:00,53,7170,14,39,4970.99,8750.02,0.00
2024-12-08 16:57:00,53,7171,14,39,4984.77,8751.00,0.00
2024-12-08 16:57:00,54,7171,14,40,4892.45,8751.02,0.00
2024-12-08 16:57:01,54,7172,14,40,4871.94,8752.00,0.00
2024-12-08 16:57:01,55,7172,15,40,4783.36,8752.02,0.00
2024-12-08 16:57:01,54,7172,15,39,4868.70,8752.02,0.00
2024-12-08 16:57:01,53,7172,14,39,4945.75,8752.17,0.00
2024-12-08 16:57:01,52,7172,13,39,4997.37,8752.65,0.00
2024-12-08 16:57:01,52,7173,13,39,5135.65,8753.00,0.00
2024-12-08 16:57:01,53,7173,13,40,5038.75,8753.02,0.00
2024-12-08 16:57:01,52,7173,12,40,4996.45,8753.92,0.00
2024-12-08 16:57:01,52,7174,12,40,5158.12,8754.00,0.00
2024-12-08 16:57:01,53,7174,13,40,5060.80,8754.02,0.00
2024-12-08 16:57:01,52,7174,13,39,5154.76,8754.02,0.00
2024-12-08 16:57:01,52,7175,13,39,5170.50,8755.00,0.00
2024-12-08 16:57:01,53,7175,14,39,5072.94,8755.02,0.00
2024-12-08 16:57:01,53,7176,14,39,5053.70,8756.00,0.00
2024-12-08 16:57:01,54,7176,14,40,4960.11,8756.02,0.00
2024-12-08 16:57:01,53,7176,14,39,5050.39,8756.02,0.00
2024-12-08 16:57:01,53,7177,14,39,5064.19,8757.00,0.00
2024-12-08 16:57:01,54,7177,15,39,4970.40,8757.02,0.00
2024-12-08 16:57:01,54,7178,15,39,4949.89,8758.00,0.00
2024-12-08 16:57:01,55,7178,16,39,4859.89,8758.02,0.00
2024-12-08 16:57:01,54,7178,16,38,4943.40,8758.02,0.00
2024-12-08 16:57:01,54,7179,16,38,4955.32,8759.00,0.00
2024-12-08 16:57:01,55,7179,17,38,4865.22,8759.02,0.00
2024-12-08 16:57:01,55,7180,17,38,4843.48,8760.00,0.00
2024-12-08 16:57:01,56,7180,17,39,4756.99,8760.02,0.00
2024-12-08 16:57:01,55,7180,17,38,4837.11,8760.02,0.00
2024-12-08 16:57:01,55,7181,17,38,4847.22,8761.00,0.00
2024-12-08 16:57:01,56,7181,17,39,4760.66,8761.02,0.00
2024-12-08 16:57:01,55,7181,16,39,4713.65,8761.56,0.00
2024-12-08 16:57:01,55,7182,16,39,4835.03,8762.00,0.00
2024-12-08 16:57:01,56,7182,17,39,4748.69,8762.02,0.00
2024-12-08 16:57:01,55,7182,17,38,4828.66,8762.02,0.00
2024-12-08 16:57:01,54,7182,16,38,4898.65,8762.17,0.00
2024-12-08 16:57:01,54,7183,16,38,4988.42,8763.00,0.00
2024-12-08 16:57:01,55,7183,17,38,4897.72,8763.02,0.00
2024-12-08 16:57:01,55,7184,17,38,4875.97,8764.00,0.00
2024-12-08 16:57:01,56,7184,17,39,4788.90,8764.02,0.00
2024-12-08 16:57:01,55,7184,17,38,4871.19,8764.02,0.00
2024-12-08 16:57:01,55,7185,17,38,4881.31,8765.00,0.00
2024-12-08 16:57:01,56,7185,17,39,4794.14,8765.02,0.00
2024-12-08 16:57:01,55,7185,16,39,4790.79,8765.67,0.00
2024-12-08 16:57:01,55,7186,16,39,4857.96,8766.00,0.00
2024-12-08 16:57:01,56,7186,17,39,4771.21,8766.02,0.00
2024-12-08 16:57:01,55,7186,17,38,4854.77,8766.02,0.00
2024-12-08 16:57:01,54,7186,16,38,4833.19,8766.96,0.00
2024-12-08 16:57:01,54,7187,16,38,4992.32,8767.00,0.00
2024-12-08 16:57:01,55,7187,16,39,4901.55,8767.02,0.00
2024-12-08 16:57:01,55,7188,16,39,4879.79,8768.00,0.00
2024-12-08 16:57:01,56,7188,17,39,4792.65,8768.02,0.00
2024-12-08 16:57:01,55,7188,17,38,4878.19,8768.02,0.00
2024-12-08 16:57:01,56,7187,18,38,4731.94,8768.73,0.00
2024-12-08 16:57:01,55,7187,17,38,4813.28,8768.87,0.00
2024-12-08 16:57:01,55,7188,17,38,4961.66,8769.00,0.00
2024-12-08 16:57:01,56,7188,17,39,4873.06,8769.02,0.00
2024-12-08 16:57:01,55,7188,16,39,4866.14,8769.38,0.00
2024-12-08 16:57:01,55,7189,16,39,5131.25,8770.00,0.00
2024-12-08 16:57:01,56,7189,16,40,5039.62,8770.02,0.00
2024-12-08 16:57:01,55,7189,16,39,5121.68,8770.02,0.00
2024-12-08 16:57:01,55,7190,16,39,5131.83,8771.00,0.00
2024-12-08 16:57:01,56,7190,17,39,5040.19,8771.02,0.00
2024-12-08 16:57:01,55,7190,16,39,5033.10,8771.40,0.00
2024-12-08 16:57:01,55,7191,16,39,5140.39,8772.00,0.00
2024-12-08 16:57:01,56,7191,16,40,5048.60,8772.02,0.00
2024-12-08 16:57:01,55,7191,16,39,5130.82,8772.02,0.00
2024-12-08 16:57:01,54,7191,15,39,5217.74,8772.11,0.00
2024-12-08 16:57:01,53,7191,14,39,5266.85,8772.66,0.00
2024-12-08 16:57:01,53,7192,14,39,5336.63,8773.00,0.00
2024-12-08 16:57:01,54,7192,15,39,5237.80,8773.02,0.00
2024-12-08 16:57:01,53,7192,14,39,5244.07,8773.36,0.00
2024-12-08 16:57:01,53,7193,14,39,5353.79,8774.00,0.00
2024-12-08 16:57:01,54,7193,15,39,5254.65,8774.02,0.00
2024-12-08 16:57:01,53,7193,15,38,5342.20,8774.02,0.00
2024-12-08 16:57:01,53,7194,15,38,5356.06,8775.00,0.00
2024-12-08 16:57:01,54,7194,15,39,5256.87,8775.02,0.00
2024-12-08 16:57:01,53,7194,14,39,5314.69,8775.11,0.00
2024-12-08 16:57:01,53,7195,14,39,5336.80,8776.00,0.00
2024-12-08 16:57:01,54,7195,15,39,5237.97,8776.02,0.00
2024-12-08 16:57:01,53,7195,15,38,5326.86,8776.02,0.00
2024-12-08 16:57:01,53,7196,15,38,5340.72,8777.00,0.00
2024-12-08 16:57:01,54,7196,15,39,5241.82,8777.02,0.00
2024-12-08 16:57:01,53,7196,14,39,5249.97,8777.66,0.00
2024-12-08 16:57:01,53,7197,14,39,5319.80,8778.00,0.00
2024-12-08 16:57:01,54,7197,14,40,5221.28,8778.02,0.00
2024-12-08 16:57:01,53,7197,14,39,5309.86,8778.02,0.00
2024-12-08 16:57:02,53,7198,14,39,5323.72,8779.00,0.00
2024-12-08 16:57:02,54,7198,14,40,5225.13,8779.02,0.00
2024-12-08 16:57:02,53,7198,13,40,5224.49,8779.38,0.00
2024-12-08 16:57:02,53,7199,13,40,5335.92,8780.00,0.00
2024-12-08 16:57:02,54,7199,13,41,5237.10,8780.02,0.00
2024-12-08 16:57:02,53,7199,13,40,5322.67,8780.02,0.00
2024-12-08 16:57:02,53,7200,13,40,5336.53,8781.00,0.00
2024-12-08 16:57:02,54,7200,14,40,5237.70,8781.02,0.00
2024-12-08 16:57:02,54,7201,14,40,5217.16,8782.00,0.00
2024-12-08 16:57:02,55,7201,14,41,5122.30,8782.02,0.00
2024-12-08 16:57:02,54,7201,14,40,5204.15,8782.02,0.00
2024-12-08 16:57:02,54,7202,14,40,5216.12,8783.00,0.00
2024-12-08 16:57:02,55,7202,15,40,5121.28,8783.02,0.00
2024-12-08 16:57:02,54,7202,14,40,5162.51,8783.19,0.00
2024-12-08 16:57:02,54,7203,14,40,5254.13,8784.00,0.00
2024-12-08 16:57:02,55,7203,15,40,5158.60,8784.02,0.00
2024-12-08 16:57:02,54,7203,15,39,5232.99,8784.04,0.00
2024-12-08 16:57:02,53,7203,14,39,5229.23,8784.55,0.00
2024-12-08 16:57:02,53,7204,14,39,5355.53,8785.00,0.00
2024-12-08 16:57:02,54,7204,15,39,5256.36,8785.02,0.00
2024-12-08 16:57:02,54,7205,15,39,5235.80,8786.00,0.00
2024-12-08 16:57:02,55,7205,15,40,5140.61,8786.02,0.00
2024-12-08 16:57:02,54,7205,15,39,5216.28,8786.04,0.00
2024-12-08 16:57:02,54,7206,15,39,5229.89,8787.00,0.00
2024-12-08 16:57:02,55,7206,15,40,5134.80,8787.02,0.00
2024-12-08 16:57:02,54,7206,14,40,5118.04,8787.78,0.00
2024-12-08 16:57:02,54,7207,14,40,5261.41,8788.00,0.00
2024-12-08 16:57:02,55,7207,15,40,5165.74,8788.02,0.00
2024-12-08 16:57:02,54,7207,15,39,5241.88,8788.04,0.00
2024-12-08 16:57:02,54,7208,15,39,5255.49,8789.00,0.00
2024-12-08 16:57:02,55,7208,16,39,5159.94,8789.02,0.00
2024-12-08 16:57:02,55,7209,16,39,5138.26,8790.00,0.00
2024-12-08 16:57:02,56,7209,16,40,5046.50,8790.02,0.00
2024-12-08 16:57:02,55,7209,16,39,5119.08,8790.04,0.00
2024-12-08 16:57:02,55,7210,16,39,5130.85,8791.00,0.00
2024-12-08 16:57:02,56,7210,17,39,5039.23,8791.02,0.00
2024-12-08 16:57:02,55,7210,16,39,5025.74,8791.75,0.00
2024-12-08 16:57:02,55,7211,16,39,5163.41,8792.00,0.00
2024-12-08 16:57:02,56,7211,16,40,5071.20,8792.02,0.00
2024-12-08 16:57:02,55,7211,16,39,5145.83,8792.04,0.00
2024-12-08 16:57:02,54,7211,15,39,5186.00,8792.67,0.00
2024-12-08 16:57:02,54,7212,15,39,5254.63,8793.00,0.00
2024-12-08 16:57:02,55,7212,16,39,5159.09,8793.02,0.00
2024-12-08 16:57:02,55,7213,16,39,5137.29,8794.00,0.00
2024-12-08 16:57:02,56,7213,17,39,5045.56,8794.02,0.00
2024-12-08 16:57:02,55,7213,17,38,5119.71,8794.04,0.00
2024-12-08 16:57:02,54,7213,16,38,5159.49,8794.67,0.00
2024-12-08 16:57:02,54,7214,16,38,5228.14,8795.00,0.00
2024-12-08 16:57:02,55,7214,17,38,5133.08,8795.02,0.00
2024-12-08 16:57:02,54,7214,16,38,5198.82,8795.02,0.00
2024-12-08 16:57:02,54,7215,16,38,5243.39,8796.00,0.00
2024-12-08 16:57:02,55,7215,17,38,5148.06,8796.02,0.00
2024-12-08 16:57:02,54,7215,17,37,5228.73,8796.02,0.00
2024-12-08 16:57:02,54,7216,17,37,5240.73,8797.00,0.00
2024-12-08 16:57:02,55,7216,17,38,5145.44,8797.02,0.00
2024-12-08 16:57:02,54,7216,16,38,5138.49,8797.72,0.00
2024-12-08 16:57:02,54,7217,16,38,5277.17,8798.00,0.00
2024-12-08 16:57:02,55,7217,17,38,5181.22,8798.02,0.00
2024-12-08 16:57:02,54,7217,17,37,5264.13,8798.02,0.00
2024-12-08 16:57:02,54,7218,17,37,5276.14,8799.00,0.00
2024-12-08 16:57:02,55,7218,18,37,5180.21,8799.02,0.00
2024-12-08 16:57:02,55,7219,18,37,5158.40,8800.00,0.00
2024-12-08 16:57:02,56,7219,19,37,5066.28,8800.02,0.00
2024-12-08 16:57:02,55,7219,19,36,5145.60,8800.02,0.00
2024-12-08 16:57:02,55,7220,19,36,5155.78,8801.00,0.00
2024-12-08 16:57:02,56,7220,19,37,5063.72,8801.02,0.00
2024-12-08 16:57:02,56,7221,19,37,5040.71,8802.00,0.00
2024-12-08 16:57:02,57,7221,19,38,4952.28,8802.02,0.00
2024-12-08 16:57:02,56,7221,19,37,5028.14,8802.02,0.00
2024-12-08 16:57:02,56,7222,19,37,5036.57,8803.00,0.00
2024-12-08 16:57:02,57,7222,19,38,4948.21,8803.02,0.00
2024-12-08 16:57:02,57,7223,19,38,4924.06,8804.00,0.00
2024-12-08 16:57:02,58,7223,20,38,4839.16,8804.02,0.00
2024-12-08 16:57:02,57,7223,20,37,4908.61,8804.02,0.00
2024-12-08 16:57:02,56,7223,19,37,4938.44,8804.66,0.00
2024-12-08 16:57:02,55,7223,18,37,5012.27,8804.75,0.00
2024-12-08 16:57:02,55,7224,18,37,5149.20,8805.00,0.00
2024-12-08 16:57:02,56,7224,18,38,5057.25,8805.02,0.00
2024-12-08 16:57:02,56,7225,18,38,5030.87,8806.00,0.00
2024-12-08 16:57:02,57,7225,18,39,4942.61,8806.02,0.00
2024-12-08 16:57:02,56,7225,18,38,5015.14,8806.02,0.00
2024-12-08 16:57:02,55,7225,17,38,5050.62,8806.65,0.00
2024-12-08 16:57:02,55,7226,17,38,5110.72,8807.00,0.00
2024-12-08 16:57:02,56,7226,17,39,5019.45,8807.02,0.00
2024-12-08 16:57:02,55,7226,16,39,5041.95,8807.27,0.00
2024-12-08 16:57:03,55,7227,16,39,5133.38,8808.00,0.00
2024-12-08 16:57:03,56,7227,17,39,5041.71,8808.02,0.00
2024-12-08 16:57:03,55,7227,17,38,5118.97,8808.02,0.00
2024-12-08 16:57:03,54,7227,16,38,5182.86,8808.24,0.00
2024-12-08 16:57:03,53,7227,15,38,5242.69,8808.66,0.00
2024-12-08 16:57:03,53,7228,15,38,5375.11,8809.00,0.00
2024-12-08 16:57:03,54,7228,15,39,5275.57,8809.02,0.00
2024-12-08 16:57:03,54,7229,15,39,5251.17,8810.00,0.00
2024-12-08 16:57:03,55,7229,16,39,5155.70,8810.02,0.00
2024-12-08 16:57:03,54,7229,16,38,5238.12,8810.02,0.00
2024-12-08 16:57:03,53,7229,15,38,5270.83,8810.70,0.00
2024-12-08 16:57:03,53,7230,15,38,5406.57,8811.00,0.00
2024-12-08 16:57:03,54,7230,15,39,5306.45,8811.02,0.00
2024-12-08 16:57:03,54,7231,15,39,5281.48,8812.00,0.00
2024-12-08 16:57:03,55,7231,15,40,5185.45,8812.02,0.00
2024-12-08 16:57:03,54,7231,15,39,5270.06,8812.02,0.00
2024-12-08 16:57:03,54,7232,15,39,5278.03,8813.00,0.00
2024-12-08 16:57:03,55,7232,16,39,5182.06,8813.02,0.00
2024-12-08 16:57:03,55,7233,16,39,5156.69,8814.00,0.00
2024-12-08 16:57:03,56,7233,17,39,5064.61,8814.02,0.00
2024-12-08 16:57:03,55,7233,17,38,5145.47,8814.02,0.00
2024-12-08 16:57:03,54,7233,16,38,5058.13,8814.65,0.00
2024-12-08 16:57:03,54,7234,16,38,5186.72,8815.00,0.00
2024-12-08 16:57:03,55,7234,16,39,5092.42,8815.02,0.00
2024-12-08 16:57:03,54,7234,16,38,5115.08,8815.15,0.00
2024-12-08 16:57:03,54,7235,16,38,5134.28,8816.00,0.00
2024-12-08 16:57:03,55,7235,16,39,5040.93,8816.02,0.00
2024-12-08 16:57:03,54,7235,16,38,5124.48,8816.02,0.00
2024-12-08 16:57:03,54,7236,16,38,5132.09,8817.00,0.00
2024-12-08 16:57:03,55,7236,16,39,5038.78,8817.02,0.00
2024-12-08 16:57:03,54,7236,15,39,5015.48,8817.78,0.00
2024-12-08 16:57:03,54,7237,15,39,5159.36,8818.00,0.00
2024-12-08 16:57:03,55,7237,15,40,5065.55,8818.02,0.00
2024-12-08 16:57:03,54,7237,15,39,5151.20,8818.02,0.00
2024-12-08 16:57:03,53,7237,14,39,5143.84,8818.57,0.00
2024-12-08 16:57:03,53,7238,14,39,5268.67,8819.00,0.00
2024-12-08 16:57:03,54,7238,15,39,5171.10,8819.02,0.00
2024-12-08 16:57:03,53,7238,14,39,5181.86,8819.60,0.00
2024-12-08 16:57:03,53,7239,14,39,5247.07,8820.00,0.00
2024-12-08 16:57:03,54,7239,14,40,5149.90,8820.02,0.00
2024-12-08 16:57:03,53,7239,14,39,5240.41,8820.02,0.00
2024-12-08 16:57:03,53,7240,14,39,5254.32,8821.00,0.00
2024-12-08 16:57:03,54,7240,14,40,5157.02,8821.02,0.00
2024-12-08 16:57:03,54,7241,14,40,5136.36,8822.00,0.00
2024-12-08 16:57:03,55,7241,15,40,5042.97,8822.02,0.00
2024-12-08 16:57:03,54,7241,15,39,5128.19,8822.02,0.00
2024-12-08 16:57:03,53,7241,14,39,5107.06,8822.62,0.00
2024-12-08 16:57:03,53,7242,14,39,5240.53,8823.00,0.00
2024-12-08 16:57:03,54,7242,15,39,5143.48,8823.02,0.00
2024-12-08 16:57:03,53,7242,14,39,5134.35,8823.74,0.00
2024-12-08 16:57:03,53,7243,14,39,5277.75,8824.00,0.00
2024-12-08 16:57:03,54,7243,15,39,5180.01,8824.02,0.00
2024-12-08 16:57:03,53,7243,15,38,5271.09,8824.02,0.00
2024-12-08 16:57:03,53,7244,15,38,5284.87,8825.00,0.00
2024-12-08 16:57:03,54,7244,15,39,5187.00,8825.02,0.00
2024-12-08 16:57:03,54,7245,15,39,5163.95,8826.00,0.00
2024-12-08 16:57:03,55,7245,16,39,5070.06,8826.02,0.00
2024-12-08 16:57:03,54,7245,16,38,5157.41,8826.02,0.00
2024-12-08 16:57:03,54,7246,16,38,5166.30,8827.00,0.00
2024-12-08 16:57:03,55,7246,16,39,5072.36,8827.02,0.00
2024-12-08 16:57:03,55,7247,16,39,5046.80,8828.00,0.00
2024-12-08 16:57:03,56,7247,17,39,4956.67,8828.02,0.00
2024-12-08 16:57:03,55,7247,17,38,5041.98,8828.02,0.00
2024-12-08 16:57:03,54,7247,16,38,5013.99,8828.94,0.00
2024-12-08 16:57:03,54,7248,16,38,5172.62,8829.00,0.00
2024-12-08 16:57:03,55,7248,16,39,5078.57,8829.02,0.00
2024-12-08 16:57:03,55,7249,16,39,5032.15,8830.00,0.00
2024-12-08 16:57:03,56,7249,16,40,4942.29,8830.02,0.00
2024-12-08 16:57:03,55,7249,16,39,5025.73,8830.02,0.00
2024-12-08 16:57:03,54,7249,15,39,5047.22,8830.74,0.00
2024-12-08 16:57:03,54,7250,15,39,5154.68,8831.00,0.00
2024-12-08 16:57:03,55,7250,15,40,5060.96,8831.02,0.00
2024-12-08 16:57:03,54,7250,14,40,5045.16,8831.19,0.00
2024-12-08 16:57:03,54,7251,14,40,5101.13,8832.00,0.00
2024-12-08 16:57:03,55,7251,14,41,5008.38,8832.02,0.00
2024-12-08 16:57:03,54,7251,14,40,5092.95,8832.02,0.00
2024-12-08 16:57:03,53,7251,13,40,5122.42,8832.11,0.00
2024-12-08 16:57:03,53,7252,13,40,5171.64,8833.00,0.00
2024-12-08 16:57:03,54,7252,14,40,5075.87,8833.02,0.00
2024-12-08 16:57:03,53,7252,13,40,4963.32,8833.83,0.00
2024-12-08 16:57:03,53,7253,13,40,5115.12,8834.00,0.00
2024-12-08 16:57:03,54,7253,14,40,5020.40,8834.02,0.00
2024-12-08 16:57:04,53,7253,14,39,5103.46,8834.02,0.00
2024-12-08 16:57:04,53,7254,14,39,5107.50,8835.00,0.00
2024-12-08 16:57:04,54,7254,15,39,5012.92,8835.02,0.00
2024-12-08 16:57:04,53,7254,14,39,4997.65,8835.43,0.00
2024-12-08 16:57:04,53,7255,14,39,5037.79,8836.00,0.00
2024-12-08 16:57:04,54,7255,14,40,4944.50,8836.02,0.00
2024-12-08 16:57:04,54,7256,14,40,4913.68,8837.00,0.00
2024-12-08 16:57:04,55,7256,15,40,4824.34,8837.02,0.00
2024-12-08 16:57:04,54,7256,15,39,4894.05,8837.07,0.00
2024-12-08 16:57:04,53,7256,14,39,4931.37,8837.10,0.00
2024-12-08 16:57:04,53,7257,14,39,5004.94,8838.00,0.00
2024-12-08 16:57:04,54,7257,14,40,4912.25,8838.02,0.00
2024-12-08 16:57:04,54,7258,14,40,4879.72,8839.00,0.00
2024-12-08 16:57:04,55,7258,15,40,4791.00,8839.02,0.00
2024-12-08 16:57:04,54,7258,15,39,4860.09,8839.07,0.00
2024-12-08 16:57:04,53,7258,14,39,4821.91,8839.93,0.00
2024-12-08 16:57:04,53,7259,14,39,4982.08,8840.00,0.00
2024-12-08 16:57:04,54,7259,15,39,4889.82,8840.02,0.00
2024-12-08 16:57:04,53,7259,15,38,4805.52,8840.72,0.00
2024-12-08 16:57:04,53,7260,15,38,4918.31,8841.00,0.00
2024-12-08 16:57:04,54,7260,15,39,4827.23,8841.02,0.00
2024-12-08 16:57:04,53,7260,15,38,4898.30,8841.08,0.00
2024-12-08 16:57:04,52,7260,14,38,4938.72,8841.67,0.00
2024-12-08 16:57:04,52,7261,14,38,4975.82,8842.00,0.00
2024-12-08 16:57:04,53,7261,14,39,4881.93,8842.02,0.00
2024-12-08 16:57:04,53,7262,14,39,4824.73,8843.00,0.00
2024-12-08 16:57:04,54,7262,14,40,4735.38,8843.02,0.00
2024-12-08 16:57:04,53,7262,14,39,4806.38,8843.08,0.00
2024-12-08 16:57:04,52,7262,13,39,4844.70,8843.67,0.00
2024-12-08 16:57:04,51,7262,12,39,4862.44,8843.96,0.00
2024-12-08 16:57:04,51,7263,12,39,5032.41,8844.00,0.00
2024-12-08 16:57:04,52,7263,12,40,4935.63,8844.02,0.00
2024-12-08 16:57:04,51,7263,12,39,5027.21,8844.06,0.00
2024-12-08 16:57:04,50,7263,12,38,4945.95,8844.80,0.00
2024-12-08 16:57:04,50,7264,12,38,5105.32,8845.00,0.00
2024-12-08 16:57:04,51,7264,12,39,5005.22,8845.02,0.00
2024-12-08 16:57:04,50,7264,12,38,5087.64,8845.06,0.00
2024-12-08 16:57:04,50,7265,12,38,5111.21,8846.00,0.00
2024-12-08 16:57:04,51,7265,12,39,5010.99,8846.02,0.00
2024-12-08 16:57:04,50,7265,11,39,5005.94,8846.72,0.00
2024-12-08 16:57:04,50,7266,11,39,5158.34,8847.00,0.00
2024-12-08 16:57:04,51,7266,11,40,5057.19,8847.02,0.00
2024-12-08 16:57:04,50,7266,11,39,5138.88,8847.06,0.00
2024-12-08 16:57:04,49,7266,10,39,5112.99,8847.67,0.00
2024-12-08 16:57:04,49,7267,10,39,5137.10,8848.00,0.00
2024-12-08 16:57:04,50,7267,11,39,5034.36,8848.02,0.00
2024-12-08 16:57:04,49,7267,10,39,4920.91,8848.82,0.00
2024-12-08 16:57:04,49,7268,10,39,5085.40,8849.00,0.00
2024-12-08 16:57:04,50,7268,10,40,4983.70,8849.02,0.00
2024-12-08 16:57:04,49,7268,10,39,5065.54,8849.06,0.00
2024-12-08 16:57:04,49,7269,10,39,5087.90,8850.00,0.00
2024-12-08 16:57:04,50,7269,10,40,4986.14,8850.02,0.00
2024-12-08 16:57:04,49,7269,9,40,4964.13,8850.51,0.00
2024-12-08 16:57:04,49,7270,9,40,5101.79,8851.00,0.00
2024-12-08 16:57:04,50,7270,10,40,4999.75,8851.02,0.00
2024-12-08 16:57:04,49,7270,10,39,5083.73,8851.06,0.00
2024-12-08 16:57:04,48,7270,9,39,5118.05,8851.44,0.00
2024-12-08 16:57:04,48,7271,9,39,5253.10,8852.00,0.00
2024-12-08 16:57:04,49,7271,9,40,5145.90,8852.02,0.00
2024-12-08 16:57:04,49,7272,9,40,5132.03,8853.00,0.00
2024-12-08 16:57:04,50,7272,10,40,5029.38,8853.02,0.00
2024-12-08 16:57:04,49,7272,10,39,5115.77,8853.06,0.00
2024-12-08 16:57:04,49,7273,10,39,5141.64,8854.00,0.00
2024-12-08 16:57:04,50,7273,11,39,5038.81,8854.02,0.00
2024-12-08 16:57:04,49,7273,10,39,5123.57,8854.04,0.00
2024-12-08 16:57:04,48,7273,9,39,5179.90,8854.19,0.00
2024-12-08 16:57:04,48,7274,9,39,5292.98,8855.00,0.00
2024-12-08 16:57:04,49,7274,9,40,5184.96,8855.02,0.00
2024-12-08 16:57:04,48,7274,9,39,5280.06,8855.04,0.00
2024-12-08 16:57:04,48,7275,9,39,5306.49,8856.00,0.00
2024-12-08 16:57:04,49,7275,9,40,5198.19,8856.02,0.00
2024-12-08 16:57:04,48,7275,8,40,5148.10,8856.60,0.00
2024-12-08 16:57:04,48,7276,8,40,5297.86,8857.00,0.00
2024-12-08 16:57:04,49,7276,8,41,5189.74,8857.02,0.00
2024-12-08 16:57:04,48,7276,8,40,5284.95,8857.04,0.00
2024-12-08 16:57:04,47,7276,7,40,5346.51,8857.04,0.00
2024-12-08 16:57:04,47,7277,7,40,5450.77,8858.00,0.00
2024-12-08 16:57:04,48,7277,8,40,5337.21,8858.02,0.00
2024-12-08 16:57:04,47,7277,8,39,5443.23,8858.02,0.00
2024-12-08 16:57:04,47,7278,8,39,5470.24,8859.00,0.00
2024-12-08 16:57:04,48,7278,9,39,5356.27,8859.02,0.00
2024-12-08 16:57:04,47,7278,8,39,5421.26,8859.13,0.00
2024-12-08 16:57:04,47,7279,8,39,5533.06,8860.00,0.00
2024-12-08 16:57:04,48,7279,8,40,5417.79,8860.02,0.00
2024-12-08 16:57:04,47,7279,8,39,5519.87,8860.02,0.00
2024-12-08 16:57:04,47,7280,8,39,5546.88,8861.00,0.00
2024-12-08 16:57:04,48,7280,9,39,5431.32,8861.02,0.00
2024-12-08 16:57:05,48,7281,9,39,5419.01,8862.00,0.00
2024-12-08 16:57:05,49,7281,9,40,5308.42,8862.02,0.00
2024-12-08 16:57:05,48,7281,9,39,5407.94,8862.02,0.00
2024-12-08 16:57:05,48,7282,9,39,5432.55,8863.00,0.00
2024-12-08 16:57:05,49,7282,9,40,5321.68,8863.02,0.00
2024-12-08 16:57:05,48,7282,8,40,5301.93,8863.83,0.00
2024-12-08 16:57:05,48,7283,8,40,5471.94,8864.00,0.00
2024-12-08 16:57:05,49,7283,8,41,5360.27,8864.02,0.00
2024-12-08 16:57:05,48,7283,8,40,5459.02,8864.02,0.00
2024-12-08 16:57:05,48,7284,8,40,5483.64,8865.00,0.00
2024-12-08 16:57:05,49,7284,8,41,5371.73,8865.02,0.00
2024-12-08 16:57:05,48,7284,7,41,5362.19,8865.79,0.00
2024-12-08 16:57:05,48,7284,7,41,5528.59,8866.00,0.00
2024-12-08 16:57:05,49,7284,8,41,5415.76,8866.02,0.00
2024-12-08 16:57:05,48,7284,8,40,5515.66,8866.02,0.00
2024-12-08 16:57:05,48,7285,8,40,5540.30,8867.00,0.00
2024-12-08 16:57:05,49,7285,8,41,5427.23,8867.02,0.00
2024-12-08 16:57:05,49,7286,8,41,5413.36,8868.00,0.00
2024-12-08 16:57:05,50,7286,8,42,5305.10,8868.02,0.00
2024-12-08 16:57:05,49,7286,8,41,5407.67,8868.02,0.00
2024-12-08 16:57:05,48,7286,7,41,5426.59,8868.83,0.00
2024-12-08 16:57:05,48,7287,7,41,5596.71,8869.00,0.00
2024-12-08 16:57:05,49,7287,7,42,5482.49,8869.02,0.00
2024-12-08 16:57:05,49,7288,7,42,5468.62,8870.00,0.00
2024-12-08 16:57:05,50,7288,8,42,5359.25,8870.02,0.00
2024-12-08 16:57:05,49,7288,8,41,5446.90,8870.02,0.00
2024-12-08 16:57:05,49,7289,8,41,5469.24,8871.00,0.00
2024-12-08 16:57:05,50,7289,8,42,5359.86,8871.02,0.00
2024-12-08 16:57:05,49,7289,7,42,5373.65,8871.67,0.00
2024-12-08 16:57:05,49,7290,7,42,5525.99,8872.00,0.00
2024-12-08 16:57:05,50,7290,8,42,5415.47,8872.02,0.00
2024-12-08 16:57:05,49,7290,8,41,5506.07,8872.02,0.00
2024-12-08 16:57:05,49,7291,8,41,5528.42,8873.00,0.00
2024-12-08 16:57:05,50,7291,9,41,5417.85,8873.02,0.00
2024-12-08 16:57:05,49,7291,8,41,5391.31,8873.88,0.00
2024-12-08 16:57:05,49,7292,8,41,5561.64,8874.00,0.00
2024-12-08 16:57:05,50,7292,8,42,5450.41,8874.02,0.00
2024-12-08 16:57:05,49,7292,8,41,5543.53,8874.02,0.00
2024-12-08 16:57:05,49,7293,8,41,5565.89,8875.00,0.00
2024-12-08 16:57:05,50,7293,8,42,5454.57,8875.02,0.00
2024-12-08 16:57:05,50,7294,8,42,5439.21,8876.00,0.00
2024-12-08 16:57:05,51,7294,9,42,5332.56,8876.02,0.00
2024-12-08 16:57:05,50,7294,9,41,5421.46,8876.02,0.00
2024-12-08 16:57:05,50,7295,9,41,5441.60,8877.00,0.00
2024-12-08 16:57:05,51,7295,9,42,5334.90,8877.02,0.00
2024-12-08 16:57:05,51,7296,9,42,5318.09,8878.00,0.00
2024-12-08 16:57:05,52,7296,10,42,5215.82,8878.02,0.00
2024-12-08 16:57:05,51,7296,10,41,5302.43,8878.02,0.00
2024-12-08 16:57:05,50,7296,9,41,5350.23,8878.66,0.00
2024-12-08 16:57:05,50,7297,9,41,5426.84,8879.00,0.00
2024-12-08 16:57:05,51,7297,10,41,5320.43,8879.02,0.00
2024-12-08 16:57:05,51,7297,10,41,5303.62,8880.00,0.00
2024-12-08 16:57:05,52,7297,10,42,5201.63,8880.02,0.00
2024-12-08 16:57:05,51,7297,10,41,5289.69,8880.02,0.00
2024-12-08 16:57:05,50,7297,9,41,5344.09,8880.28,0.00
2024-12-08 16:57:05,50,7298,9,41,5458.26,8881.00,0.00
2024-12-08 16:57:05,51,7298,10,41,5351.24,8881.02,0.00
2024-12-08 16:57:05,50,7298,9,41,5332.37,8881.48,0.00
2024-12-08 16:57:05,50,7299,9,41,5464.20,8882.00,0.00
2024-12-08 16:57:05,51,7299,9,42,5357.06,8882.02,0.00
2024-12-08 16:57:05,50,7299,9,41,5449.99,8882.02,0.00
2024-12-08 16:57:05,49,7299,8,41,5508.97,8882.61,0.00
2024-12-08 16:57:05,49,7300,8,41,5583.60,8883.00,0.00
2024-12-08 16:57:05,50,7300,8,42,5471.92,8883.02,0.00
2024-12-08 16:57:05,50,7301,8,42,5456.55,8884.00,0.00
2024-12-08 16:57:05,51,7301,8,43,5349.56,8884.02,0.00
2024-12-08 16:57:05,50,7301,8,42,5442.34,8884.02,0.00
2024-12-08 16:57:05,50,7302,8,42,5462.50,8885.00,0.00
2024-12-08 16:57:05,51,7302,8,43,5355.39,8885.02,0.00
2024-12-08 16:57:05,50,7302,7,43,5322.64,8885.90,0.00
2024-12-08 16:57:05,50,7303,7,43,5491.54,8886.00,0.00
2024-12-08 16:57:05,51,7303,8,43,5383.87,8886.02,0.00
2024-12-08 16:57:05,51,7304,8,43,5367.05,8887.00,0.00
2024-12-08 16:57:05,52,7304,8,44,5263.84,8887.02,0.00
2024-12-08 16:57:05,51,7304,8,43,5349.62,8887.04,0.00
2024-12-08 16:57:05,51,7305,8,43,5369.40,8888.00,0.00
2024-12-08 16:57:05,52,7305,8,44,5266.14,8888.02,0.00
2024-12-08 16:57:05,52,7306,8,44,5247.93,8889.00,0.00
2024-12-08 16:57:05,53,7306,9,44,5148.91,8889.02,0.00
2024-12-08 16:57:05,52,7306,9,43,5232.54,8889.04,0.00
2024-12-08 16:57:06,51,7306,8,43,5222.42,8889.96,0.00
2024-12-08 16:57:06,51,7307,8,43,5393.26,8890.00,0.00
2024-12-08 16:57:06,52,7307,8,44,5289.55,8890.02,0.00
2024-12-08 16:57:06,52,7308,8,44,5271.33,8891.00,0.00
2024-12-08 16:57:06,53,7308,9,44,5171.88,8891.02,0.00
2024-12-08 16:57:06,52,7308,9,43,5257.66,8891.04,0.00
2024-12-08 16:57:06,51,7308,8,43,5307.04,8891.65,0.00
2024-12-08 16:57:06,51,7309,8,43,5380.53,8892.00,0.00
2024-12-08 16:57:06,52,7309,8,44,5277.06,8892.02,0.00
2024-12-08 16:57:06,51,7309,8,43,5378.79,8892.02,0.00
2024-12-08 16:57:06,50,7309,7,43,5392.46,8892.66,0.00
2024-12-08 16:57:06,50,7310,7,43,5469.19,8893.00,0.00
2024-12-08 16:57:06,51,7310,7,44,5361.95,8893.02,0.00
2024-12-08 16:57:06,50,7310,7,43,5458.52,8893.02,0.00
2024-12-08 16:57:06,50,7311,7,43,5478.70,8894.00,0.00
2024-12-08 16:57:06,51,7311,8,43,5371.28,8894.02,0.00
2024-12-08 16:57:06,50,7311,7,43,5335.16,8894.92,0.00
2024-12-08 16:57:06,50,7312,7,43,5506.00,8895.00,0.00
2024-12-08 16:57:06,51,7312,8,43,5398.04,8895.02,0.00
2024-12-08 16:57:06,50,7312,8,42,5495.33,8895.02,0.00
2024-12-08 16:57:06,50,7313,8,42,5515.52,8896.00,0.00
2024-12-08 16:57:06,51,7313,9,42,5407.37,8896.02,0.00
2024-12-08 16:57:06,50,7313,8,42,5419.79,8896.68,0.00
2024-12-08 16:57:06,50,7314,8,42,5498.34,8897.00,0.00
2024-12-08 16:57:06,51,7314,9,42,5390.53,8897.02,0.00
2024-12-08 16:57:06,50,7314,9,41,5482.33,8897.02,0.00
2024-12-08 16:57:06,50,7315,9,41,5502.52,8898.00,0.00
2024-12-08 16:57:06,51,7315,9,42,5394.63,8898.02,0.00
2024-12-08 16:57:06,50,7315,8,42,5351.84,8898.96,0.00
2024-12-08 16:57:06,50,7316,8,42,5526.28,8899.00,0.00
2024-12-08 16:57:06,51,7316,9,42,5417.92,8899.02,0.00
2024-12-08 16:57:06,50,7316,9,41,5510.26,8899.02,0.00
2024-12-08 16:57:06,50,7317,9,41,5530.46,8900.00,0.00
2024-12-08 16:57:06,51,7317,10,41,5422.02,8900.02,0.00
2024-12-08 16:57:06,51,7318,10,41,5405.17,8901.00,0.00
2024-12-08 16:57:06,52,7318,11,41,5301.23,8901.02,0.00
2024-12-08 16:57:06,51,7318,11,40,5389.46,8901.02,0.00
2024-12-08 16:57:06,51,7319,11,40,5407.53,8902.00,0.00
2024-12-08 16:57:06,52,7319,11,41,5303.54,8902.02,0.00
2024-12-08 16:57:06,52,7320,11,41,5285.30,8903.00,0.00
2024-12-08 16:57:06,53,7320,11,42,5185.58,8903.02,0.00
2024-12-08 16:57:06,52,7320,11,41,5271.60,8903.02,0.00
2024-12-08 16:57:06,52,7321,11,41,5287.60,8904.00,0.00
2024-12-08 16:57:06,53,7321,11,42,5187.84,8904.02,0.00
2024-12-08 16:57:06,52,7321,10,42,5186.59,8904.08,0.00
2024-12-08 16:57:06,52,7322,10,42,5276.21,8905.00,0.00
2024-12-08 16:57:06,53,7322,11,42,5176.66,8905.02,0.00
2024-12-08 16:57:06,52,7322,11,41,5262.51,8905.02,0.00
2024-12-08 16:57:06,52,7323,11,41,5278.51,8906.00,0.00
2024-12-08 16:57:06,53,7323,11,42,5178.92,8906.02,0.00
2024-12-08 16:57:06,53,7324,11,42,5159.34,8907.00,0.00
2024-12-08 16:57:06,54,7324,11,43,5063.79,8907.02,0.00
2024-12-08 16:57:06,53,7324,11,42,5142.53,8907.02,0.00
2024-12-08 16:57:06,52,7324,10,42,5144.28,8907.87,0.00
2024-12-08 16:57:06,52,7325,10,42,5303.68,8908.00,0.00
2024-12-08 16:57:06,53,7325,11,42,5203.61,8908.02,0.00
2024-12-08 16:57:06,52,7325,10,42,5161.77,8908.58,0.00
2024-12-08 16:57:06,52,7326,10,42,5295.71,8909.00,0.00
2024-12-08 16:57:06,53,7326,10,43,5195.79,8909.02,0.00
2024-12-08 16:57:06,52,7326,10,42,5278.58,8909.02,0.00
2024-12-08 16:57:06,52,7327,10,42,5294.59,8910.00,0.00
2024-12-08 16:57:06,53,7327,10,43,5194.70,8910.02,0.00
2024-12-08 16:57:06,53,7328,10,43,5175.10,8911.00,0.00
2024-12-08 16:57:06,54,7328,11,43,5079.27,8911.02,0.00
2024-12-08 16:57:06,53,7328,11,42,5156.61,8911.02,0.00
2024-12-08 16:57:06,52,7328,10,42,5177.36,8911.77,0.00
2024-12-08 16:57:06,52,7329,10,42,5328.34,8912.00,0.00
2024-12-08 16:57:06,53,7329,10,43,5227.81,8912.02,0.00
2024-12-08 16:57:06,53,7330,10,43,5208.22,8913.00,0.00
2024-12-08 16:57:06,54,7330,11,43,5111.77,8913.02,0.00
2024-12-08 16:57:06,53,7330,11,42,5191.40,8913.02,0.00
2024-12-08 16:57:06,52,7330,10,42,5211.08,8913.77,0.00
2024-12-08 16:57:06,52,7331,10,42,5362.11,8914.00,0.00
2024-12-08 16:57:06,53,7331,10,43,5260.94,8914.02,0.00
2024-12-08 16:57:06,53,7331,10,43,5241.34,8915.00,0.00
2024-12-08 16:57:06,54,7331,10,44,5144.28,8915.02,0.00
2024-12-08 16:57:06,53,7331,10,43,5226.21,8915.02,0.00
2024-12-08 16:57:06,53,7332,10,43,5240.25,8916.00,0.00
2024-12-08 16:57:06,54,7332,11,43,5143.21,8916.02,0.00
2024-12-08 16:57:06,53,7332,10,43,5092.76,8916.96,0.00
2024-12-08 16:57:06,53,7333,10,43,5257.66,8917.00,0.00
2024-12-08 16:57:06,54,7333,10,44,5160.30,8917.02,0.00
2024-12-08 16:57:06,53,7333,10,43,5244.20,8917.02,0.00
2024-12-08 16:57:06,53,7334,10,43,5258.25,8918.00,0.00
2024-12-08 16:57:06,54,7334,11,43,5160.88,8918.02,0.00
2024-12-08 16:57:07,54,7335,11,43,5139.98,8919.00,0.00
2024-12-08 16:57:07,55,7335,11,44,5046.53,8919.02,0.00
2024-12-08 16:57:07,54,7335,11,43,5128.42,8919.02,0.00
2024-12-08 16:57:07,54,7336,11,43,5140.56,8920.00,0.00
2024-12-08 16:57:07,55,7336,12,43,5047.10,8920.02,0.00
2024-12-08 16:57:07,55,7337,12,43,5024.95,8921.00,0.00
2024-12-08 16:57:07,56,7337,12,44,4935.22,8921.02,0.00
2024-12-08 16:57:07,55,7337,12,43,5015.22,8921.02,0.00
2024-12-08 16:57:07,54,7337,11,43,4982.85,8921.67,0.00
2024-12-08 16:57:07,54,7338,11,43,5118.58,8922.00,0.00
2024-12-08 16:57:07,55,7338,12,43,5025.52,8922.02,0.00
2024-12-08 16:57:07,55,7339,12,43,5003.37,8923.00,0.00
2024-12-08 16:57:07,56,7339,13,43,4914.02,8923.02,0.00
2024-12-08 16:57:07,55,7339,13,42,4995.25,8923.02,0.00
2024-12-08 16:57:07,55,7340,13,42,5005.55,8924.00,0.00
2024-12-08 16:57:07,56,7340,14,42,4916.17,8924.02,0.00
2024-12-08 16:57:07,56,7341,14,42,4892.81,8925.00,0.00
2024-12-08 16:57:07,57,7341,14,43,4806.97,8925.02,0.00
2024-12-08 16:57:07,56,7341,14,42,4884.84,8925.02,0.00
2024-12-08 16:57:07,55,7341,13,42,4904.24,8925.73,0.00
2024-12-08 16:57:07,55,7342,13,42,5042.38,8926.00,0.00
2024-12-08 16:57:07,56,7342,13,43,4952.33,8926.02,0.00
2024-12-08 16:57:07,56,7343,13,43,4928.98,8927.00,0.00
2024-12-08 16:57:07,57,7343,14,43,4842.50,8927.02,0.00
2024-12-08 16:57:07,56,7343,14,42,4922.60,8927.02,0.00
2024-12-08 16:57:07,55,7343,13,42,4918.40,8927.85,0.00
2024-12-08 16:57:07,55,7344,13,42,5067.85,8928.00,0.00
2024-12-08 16:57:07,56,7344,13,43,4977.36,8928.02,0.00
2024-12-08 16:57:07,56,7345,13,43,4954.00,8929.00,0.00
2024-12-08 16:57:07,57,7345,13,44,4867.09,8929.02,0.00
2024-12-08 16:57:07,56,7345,13,43,4947.62,8929.02,0.00
2024-12-08 16:57:07,56,7346,13,43,4956.15,8930.00,0.00
2024-12-08 16:57:07,57,7346,13,44,4869.20,8930.02,0.00
2024-12-08 16:57:07,56,7346,12,44,4811.56,8930.96,0.00
2024-12-08 16:57:07,56,7347,12,44,4967.87,8931.00,0.00
2024-12-08 16:57:07,57,7347,13,44,4880.71,8931.02,0.00
2024-12-08 16:57:07,56,7347,13,43,4959.89,8931.02,0.00
2024-12-08 16:57:07,55,7347,12,43,4977.18,8931.45,0.00
2024-12-08 16:57:07,54,7347,11,43,5046.35,8931.70,0.00
2024-12-08 16:57:07,54,7348,11,43,5185.52,8932.00,0.00
2024-12-08 16:57:07,55,7348,12,43,5091.24,8932.02,0.00
2024-12-08 16:57:07,55,7349,12,43,5069.07,8933.00,0.00
2024-12-08 16:57:07,56,7349,13,43,4978.55,8933.02,0.00
2024-12-08 16:57:07,55,7349,13,42,5062.57,8933.02,0.00
2024-12-08 16:57:07,55,7350,13,42,5072.88,8934.00,0.00
2024-12-08 16:57:07,56,7350,14,42,4982.30,8934.02,0.00
2024-12-08 16:57:07,55,7350,13,42,5024.21,8934.20,0.00
2024-12-08 16:57:07,55,7351,13,42,5050.71,8935.00,0.00
2024-12-08 16:57:07,56,7351,13,43,4960.52,8935.02,0.00
2024-12-08 16:57:07,55,7351,13,42,5045.84,8935.02,0.00
2024-12-08 16:57:07,55,7352,13,42,5056.15,8936.00,0.00
2024-12-08 16:57:07,56,7352,13,43,4965.86,8936.02,0.00
2024-12-08 16:57:07,55,7352,12,43,4962.24,8936.69,0.00
2024-12-08 16:57:07,55,7353,12,43,5032.34,8937.00,0.00
2024-12-08 16:57:07,56,7353,12,44,4942.48,8937.02,0.00
2024-12-08 16:57:07,55,7353,12,43,5025.84,8937.02,0.00
2024-12-08 16:57:07,54,7353,11,43,5008.55,8937.94,0.00
2024-12-08 16:57:07,54,7354,11,43,5169.14,8938.00,0.00
2024-12-08 16:57:07,55,7354,12,43,5075.16,8938.02,0.00
2024-12-08 16:57:07,54,7354,11,43,5066.68,8938.44,0.00
2024-12-08 16:57:07,54,7355,11,43,5182.96,8939.00,0.00
2024-12-08 16:57:07,55,7355,11,44,5088.73,8939.02,0.00
2024-12-08 16:57:07,54,7355,11,43,5176.34,8939.02,0.00
2024-12-08 16:57:07,54,7356,11,43,5188.51,8940.00,0.00
2024-12-08 16:57:07,55,7356,12,43,5094.17,8940.02,0.00
2024-12-08 16:57:07,55,7357,12,43,5071.98,8941.00,0.00
2024-12-08 16:57:07,56,7357,13,43,4981.41,8941.02,0.00
2024-12-08 16:57:07,55,7357,13,42,5067.11,8941.02,0.00
2024-12-08 16:57:07,55,7358,13,42,5077.43,8942.00,0.00
2024-12-08 16:57:07,56,7358,13,43,4986.76,8942.02,0.00
2024-12-08 16:57:07,56,7359,13,43,4963.36,8943.00,0.00
2024-12-08 16:57:07,57,7359,13,44,4876.29,8943.02,0.00
2024-12-08 16:57:07,56,7359,13,43,4960.17,8943.02,0.00
2024-12-08 16:57:07,55,7359,12,43,4943.54,8943.93,0.00
2024-12-08 16:57:07,55,7360,12,43,5099.70,8944.00,0.00
2024-12-08 16:57:07,56,7360,13,43,5008.64,8944.02,0.00
2024-12-08 16:57:07,55,7360,12,43,4952.01,8944.64,0.00
2024-12-08 16:57:07,55,7361,12,43,5082.38,8945.00,0.00
2024-12-08 16:57:07,56,7361,13,43,4991.63,8945.02,0.00
2024-12-08 16:57:07,55,7361,13,42,5080.76,8945.02,0.00
2024-12-08 16:57:07,55,7362,13,42,5091.08,8946.00,0.00
2024-12-08 16:57:07,56,7362,13,43,5000.17,8946.02,0.00
2024-12-08 16:57:07,55,7362,12,43,4977.63,8946.80,0.00
2024-12-08 16:57:07,55,7363,12,43,5122.56,8947.00,0.00
2024-12-08 16:57:07,56,7363,12,44,5031.09,8947.02,0.00
2024-12-08 16:57:07,55,7363,12,43,5120.93,8947.02,0.00
2024-12-08 16:57:08,55,7364,12,43,5131.27,8948.00,0.00
2024-12-08 16:57:08,56,7364,12,44,5039.64,8948.02,0.00
2024-12-08 16:57:08,55,7364,12,43,5097.10,8948.02,0.00
2024-12-08 16:57:08,55,7365,12,43,5107.44,8949.00,0.00
2024-12-08 16:57:08,56,7365,12,44,5016.23,8949.02,0.00
2024-12-08 16:57:08,55,7365,12,43,5073.27,8949.02,0.00
2024-12-08 16:57:08,55,7366,12,43,5083.60,8950.00,0.00
2024-12-08 16:57:08,56,7366,12,44,4992.82,8950.02,0.00
2024-12-08 16:57:08,56,7367,12,44,4969.40,8951.00,0.00
2024-12-08 16:57:08,57,7367,13,44,4882.22,8951.02,0.00
2024-12-08 16:57:08,56,7367,13,43,4967.80,8951.02,0.00
2024-12-08 16:57:08,55,7367,12,43,4957.47,8951.56,0.00
2024-12-08 16:57:08,55,7368,12,43,5081.48,8952.00,0.00
2024-12-08 16:57:08,56,7368,12,44,4990.74,8952.02,0.00
2024-12-08 16:57:08,56,7369,12,44,4967.31,8953.00,0.00
2024-12-08 16:57:08,57,7369,13,44,4880.17,8953.02,0.00
2024-12-08 16:57:08,56,7369,13,43,4964.12,8953.02,0.00
2024-12-08 16:57:08,55,7369,12,43,4960.40,8953.85,0.00
2024-12-08 16:57:08,55,7370,12,43,5110.29,8954.00,0.00
2024-12-08 16:57:08,56,7370,12,44,5019.03,8954.02,0.00
2024-12-08 16:57:08,55,7370,11,44,5033.78,8954.06,0.00
2024-12-08 16:57:08,54,7370,10,44,5069.27,8954.69,0.00
2024-12-08 16:57:08,54,7371,10,44,5207.16,8955.00,0.00
2024-12-08 16:57:08,55,7371,10,45,5112.49,8955.02,0.00
2024-12-08 16:57:08,54,7371,10,44,5205.51,8955.02,0.00
2024-12-08 16:57:08,53,7371,9,44,5285.20,8955.23,0.00
2024-12-08 16:57:08,53,7372,9,44,5317.83,8956.00,0.00
2024-12-08 16:57:08,54,7372,10,44,5219.36,8956.02,0.00
2024-12-08 16:57:08,54,7373,10,44,5198.37,8957.00,0.00
2024-12-08 16:57:08,55,7373,10,45,5103.86,8957.02,0.00
2024-12-08 16:57:08,54,7373,10,44,5196.72,8957.02,0.00
2024-12-08 16:57:08,54,7374,10,44,5208.91,8958.00,0.00
2024-12-08 16:57:08,55,7374,11,44,5114.20,8958.02,0.00
2024-12-08 16:57:08,55,7375,11,44,5091.97,8959.00,0.00
2024-12-08 16:57:08,56,7375,11,45,5001.04,8959.02,0.00
2024-12-08 16:57:08,55,7375,11,44,5088.71,8959.02,0.00
2024-12-08 16:57:08,55,7376,11,44,5099.05,8960.00,0.00
2024-12-08 16:57:08,56,7376,12,44,5008.00,8960.02,0.00
2024-12-08 16:57:08,55,7376,11,44,4985.20,8960.47,0.00
2024-12-08 16:57:08,55,7377,11,44,5101.25,8961.00,0.00
2024-12-08 16:57:08,56,7377,11,45,5010.16,8961.02,0.00
2024-12-08 16:57:08,55,7377,11,44,5097.99,8961.02,0.00
2024-12-08 16:57:08,55,7378,11,44,5108.34,8962.00,0.00
2024-12-08 16:57:08,56,7378,12,44,5017.12,8962.02,0.00
2024-12-08 16:57:08,56,7379,12,44,4993.67,8963.00,0.00
2024-12-08 16:57:08,57,7379,13,44,4906.06,8963.02,0.00
2024-12-08 16:57:08,56,7379,13,43,4992.07,8963.02,0.00
2024-12-08 16:57:08,55,7379,12,43,4975.79,8963.93,0.00
2024-12-08 16:57:08,55,7380,12,43,5132.29,8964.00,0.00
2024-12-08 16:57:08,56,7380,13,43,5040.65,8964.02,0.00
2024-12-08 16:57:08,55,7380,13,42,5098.07,8964.02,0.00
2024-12-08 16:57:08,55,7381,13,42,5108.42,8965.00,0.00
2024-12-08 16:57:08,56,7381,13,43,5017.20,8965.02,0.00
2024-12-08 16:57:08,55,7381,13,42,5074.19,8965.02,0.00
2024-12-08 16:57:08,54,7381,12,42,5151.60,8965.19,0.00
2024-12-08 16:57:08,54,7382,12,42,5178.69,8966.00,0.00
2024-12-08 16:57:08,55,7382,13,42,5084.53,8966.02,0.00
2024-12-08 16:57:08,54,7382,12,42,5062.89,8966.80,0.00
2024-12-08 16:57:08,54,7383,12,42,5210.82,8967.00,0.00
2024-12-08 16:57:08,55,7383,12,43,5116.08,8967.02,0.00
2024-12-08 16:57:08,54,7383,12,42,5209.16,8967.02,0.00
2024-12-08 16:57:08,54,7384,12,42,5221.37,8968.00,0.00
2024-12-08 16:57:08,55,7384,13,42,5126.43,8968.02,0.00
2024-12-08 16:57:08,54,7384,13,41,5186.49,8968.02,0.00
2024-12-08 16:57:08,54,7385,13,41,5198.70,8969.00,0.00
2024-12-08 16:57:08,55,7385,13,42,5104.17,8969.02,0.00
2024-12-08 16:57:08,55,7386,13,42,5081.91,8970.00,0.00
2024-12-08 16:57:08,56,7386,14,42,4991.16,8970.02,0.00
2024-12-08 16:57:08,55,7386,14,41,5080.28,8970.02,0.00
2024-12-08 16:57:08,54,7386,13,41,5095.04,8970.78,0.00
2024-12-08 16:57:08,54,7387,13,41,5241.39,8971.00,0.00
2024-12-08 16:57:08,55,7387,13,42,5146.09,8971.02,0.00
2024-12-08 16:57:08,54,7387,12,42,5100.69,8971.93,0.00
2024-12-08 16:57:08,54,7388,12,42,5260.25,8972.00,0.00
2024-12-08 16:57:08,55,7388,13,42,5164.61,8972.02,0.00
2024-12-08 16:57:08,54,7388,13,41,5258.59,8972.02,0.00
2024-12-08 16:57:08,54,7389,13,41,5270.80,8973.00,0.00
2024-12-08 16:57:08,55,7389,14,41,5174.97,8973.02,0.00
2024-12-08 16:57:08,54,7389,14,40,5235.91,8973.02,0.00
2024-12-08 16:57:08,54,7390,14,40,5248.13,8974.00,0.00
2024-12-08 16:57:08,55,7390,14,41,5152.71,8974.02,0.00
2024-12-08 16:57:08,54,7390,13,41,5110.69,8974.91,0.00
2024-12-08 16:57:08,54,7391,13,41,5268.66,8975.00,0.00
2024-12-08 16:57:08,55,7391,13,42,5172.86,8975.02,0.00
2024-12-08 16:57:08,54,7391,13,41,5262.01,8975.02,0.00
2024-12-08 16:57:09,54,7392,13,41,5274.23,8976.00,0.00
2024-12-08 16:57:09,55,7392,13,42,5178.33,8976.02,0.00
2024-12-08 16:57:09,54,7392,12,42,5182.94,8976.37,0.00
2024-12-08 16:57:09,54,7393,12,42,5293.10,8977.00,0.00
2024-12-08 16:57:09,55,7393,12,43,5196.86,8977.02,0.00
2024-12-08 16:57:09,54,7393,12,42,5283.13,8977.02,0.00
2024-12-08 16:57:09,54,7394,12,42,5295.35,8978.00,0.00
2024-12-08 16:57:09,55,7394,12,43,5199.08,8978.02,0.00
2024-12-08 16:57:09,54,7394,11,43,5152.65,8978.61,0.00
2024-12-08 16:57:09,54,7395,11,43,5284.31,8979.00,0.00
2024-12-08 16:57:09,55,7395,11,44,5188.23,8979.02,0.00
2024-12-08 16:57:09,54,7395,11,43,5275.99,8979.02,0.00
2024-12-08 16:57:09,53,7395,10,43,5287.65,8979.49,0.00
2024-12-08 16:57:09,53,7396,10,43,5411.72,8980.00,0.00
2024-12-08 16:57:09,54,7396,11,43,5311.50,8980.02,0.00
2024-12-08 16:57:09,54,7397,11,43,5290.47,8981.00,0.00
2024-12-08 16:57:09,55,7397,12,43,5194.28,8981.02,0.00
2024-12-08 16:57:09,54,7397,12,42,5283.82,8981.02,0.00
2024-12-08 16:57:09,53,7397,11,42,5326.23,8981.66,0.00
2024-12-08 16:57:09,53,7398,11,42,5397.67,8982.00,0.00
2024-12-08 16:57:09,54,7398,11,43,5297.71,8982.02,0.00
2024-12-08 16:57:09,54,7399,11,43,5276.68,8983.00,0.00
2024-12-08 16:57:09,55,7399,12,43,5180.74,8983.02,0.00
2024-12-08 16:57:09,54,7399,12,42,5270.02,8983.02,0.00
2024-12-08 16:57:09,53,7399,11,42,5254.77,8983.96,0.00
2024-12-08 16:57:09,53,7400,11,42,5420.91,8984.00,0.00
2024-12-08 16:57:09,54,7400,11,43,5320.52,8984.02,0.00
2024-12-08 16:57:09,53,7400,10,43,5260.20,8984.68,0.00
2024-12-08 16:57:09,53,7401,10,43,5401.17,8985.00,0.00
2024-12-08 16:57:09,54,7401,10,44,5301.15,8985.02,0.00
2024-12-08 16:57:09,53,7401,10,43,5396.08,8985.02,0.00
2024-12-08 16:57:09,52,7401,9,43,5377.49,8985.65,0.00
2024-12-08 16:57:09,52,7402,9,43,5519.47,8986.00,0.00
2024-12-08 16:57:09,53,7402,10,43,5415.33,8986.02,0.00
2024-12-08 16:57:09,53,7403,10,43,5395.59,8987.00,0.00
2024-12-08 16:57:09,54,7403,11,43,5295.67,8987.02,0.00
2024-12-08 16:57:09,53,7403,11,42,5390.50,8987.02,0.00
2024-12-08 16:57:09,53,7404,11,42,5404.67,8988.00,0.00
2024-12-08 16:57:09,54,7404,11,43,5304.58,8988.02,0.00
2024-12-08 16:57:09,53,7404,10,43,5297.86,8988.15,0.00
2024-12-08 16:57:09,53,7405,10,43,5391.70,8989.00,0.00
2024-12-08 16:57:09,54,7405,10,44,5291.85,8989.02,0.00
2024-12-08 16:57:09,53,7405,10,43,5388.31,8989.02,0.00
2024-12-08 16:57:09,53,7406,10,43,5402.48,8990.00,0.00
2024-12-08 16:57:09,54,7406,11,43,5302.43,8990.02,0.00
2024-12-08 16:57:09,53,7406,10,43,5324.55,8990.30,0.00
2024-12-08 16:57:09,53,7407,10,43,5431.92,8991.00,0.00
2024-12-08 16:57:09,54,7407,11,43,5331.33,8991.02,0.00
2024-12-08 16:57:09,53,7407,11,42,5428.53,8991.02,0.00
2024-12-08 16:57:09,53,7408,11,42,5442.70,8992.00,0.00
2024-12-08 16:57:09,54,7408,12,42,5341.91,8992.02,0.00
2024-12-08 16:57:09,54,7409,12,42,5320.86,8993.00,0.00
2024-12-08 16:57:09,55,7409,12,43,5224.11,8993.02,0.00
2024-12-08 16:57:09,54,7409,12,42,5317.52,8993.02,0.00
2024-12-08 16:57:09,54,7410,12,42,5329.78,8994.00,0.00
2024-12-08 16:57:09,55,7410,13,42,5232.87,8994.02,0.00
2024-12-08 16:57:09,55,7411,13,42,5210.56,8995.00,0.00
2024-12-08 16:57:09,56,7411,14,42,5117.51,8995.02,0.00
2024-12-08 16:57:09,55,7411,14,41,5208.92,8995.02,0.00
2024-12-08 16:57:09,55,7412,14,41,5219.31,8996.00,0.00
2024-12-08 16:57:09,56,7412,14,42,5126.11,8996.02,0.00
2024-12-08 16:57:09,56,7413,14,42,5102.58,8997.00,0.00
2024-12-08 16:57:09,57,7413,15,42,5013.06,8997.02,0.00
2024-12-08 16:57:09,56,7413,15,41,5100.98,8997.02,0.00
2024-12-08 16:57:09,56,7414,15,41,5109.58,8998.00,0.00
2024-12-08 16:57:09,57,7414,16,41,5019.93,8998.02,0.00
2024-12-08 16:57:09,56,7414,15,41,4968.44,8998.59,0.00
2024-12-08 16:57:09,56,7415,15,41,5092.47,8999.00,0.00
2024-12-08 16:57:09,57,7415,16,41,5003.13,8999.02,0.00
2024-12-08 16:57:09,56,7415,16,40,5090.86,8999.02,0.00
2024-12-08 16:57:09,56,7416,16,40,5099.46,9000.00,0.00
2024-12-08 16:57:09,57,7416,16,41,5010.00,9000.02,0.00
2024-12-08 16:57:09,56,7416,15,41,4966.31,9000.55,0.00
2024-12-08 16:57:09,56,7417,15,41,5087.17,9001.00,0.00
2024-12-08 16:57:09,57,7417,16,41,4997.92,9001.02,0.00
2024-12-08 16:57:09,56,7417,16,40,5085.56,9001.02,0.00
2024-12-08 16:57:09,55,7417,15,40,5161.71,9001.18,0.00
2024-12-08 16:57:09,55,7418,15,40,5186.79,9002.00,0.00
2024-12-08 16:57:09,56,7418,16,40,5094.16,9002.02,0.00
2024-12-08 16:57:09,56,7419,16,40,5070.62,9003.00,0.00
2024-12-08 16:57:09,57,7419,16,41,4981.66,9003.02,0.00
2024-12-08 16:57:09,56,7419,16,40,5065.79,9003.02,0.00
2024-12-08 16:57:09,56,7420,16,40,5074.39,9004.00,0.00
2024-12-08 16:57:09,57,7420,17,40,4985.37,9004.02,0.00
2024-12-08 16:57:10,57,7421,17,40,4960.65,9005.00,0.00
2024-12-08 16:57:10,58,7421,17,41,4875.12,9005.02,0.00
2024-12-08 16:57:10,57,7421,17,40,4957.49,9005.02,0.00
2024-12-08 16:57:10,57,7422,17,40,4964.36,9006.00,0.00
2024-12-08 16:57:10,58,7422,18,40,4878.77,9006.02,0.00
2024-12-08 16:57:10,57,7422,17,40,4822.66,9006.95,0.00
2024-12-08 16:57:10,57,7423,17,40,4975.97,9007.00,0.00
2024-12-08 16:57:10,58,7423,18,40,4890.18,9007.02,0.00
2024-12-08 16:57:10,57,7423,18,39,4972.81,9007.02,0.00
2024-12-08 16:57:10,57,7424,18,39,4979.68,9008.00,0.00
2024-12-08 16:57:10,58,7424,19,39,4893.83,9008.02,0.00
2024-12-08 16:57:10,58,7425,19,39,4867.96,9009.00,0.00
2024-12-08 16:57:10,59,7425,19,40,4785.46,9009.02,0.00
2024-12-08 16:57:10,58,7425,19,39,4866.41,9009.02,0.00
2024-12-08 16:57:10,58,7426,19,39,4871.61,9010.00,0.00
2024-12-08 16:57:10,59,7426,19,40,4789.04,9010.02,0.00
2024-12-08 16:57:10,58,7426,19,39,4838.99,9010.02,0.00
2024-12-08 16:57:10,58,7427,19,39,4844.19,9011.00,0.00
2024-12-08 16:57:10,59,7427,20,39,4762.08,9011.02,0.00
2024-12-08 16:57:10,58,7427,19,39,4751.30,9011.69,0.00
2024-12-08 16:57:10,58,7428,19,39,4878.91,9012.00,0.00
2024-12-08 16:57:10,59,7428,20,39,4796.21,9012.02,0.00
2024-12-08 16:57:10,58,7428,20,38,4872.69,9012.02,0.00
2024-12-08 16:57:10,57,7428,19,38,4896.85,9012.69,0.00
2024-12-08 16:57:10,57,7429,19,38,4963.47,9013.00,0.00
2024-12-08 16:57:10,58,7429,20,38,4877.90,9013.02,0.00
2024-12-08 16:57:10,58,7430,20,38,4852.02,9014.00,0.00
2024-12-08 16:57:10,59,7430,20,39,4769.78,9014.02,0.00
2024-12-08 16:57:10,58,7430,20,38,4847.35,9014.02,0.00
2024-12-08 16:57:10,57,7430,19,38,4871.05,9014.69,0.00
2024-12-08 16:57:10,57,7431,19,38,4937.69,9015.00,0.00
2024-12-08 16:57:10,58,7431,19,39,4852.55,9015.02,0.00
2024-12-08 16:57:10,58,7432,19,39,4826.67,9016.00,0.00
2024-12-08 16:57:10,59,7432,19,40,4744.86,9016.02,0.00
2024-12-08 16:57:10,58,7432,19,39,4823.56,9016.02,0.00
2024-12-08 16:57:10,57,7432,18,39,4794.81,9016.97,0.00
2024-12-08 16:57:10,57,7433,18,39,4949.86,9017.00,0.00
2024-12-08 16:57:10,58,7433,18,40,4864.51,9017.02,0.00
2024-12-08 16:57:10,58,7434,18,40,4838.62,9018.00,0.00
2024-12-08 16:57:10,59,7434,18,41,4756.61,9018.02,0.00
2024-12-08 16:57:10,58,7434,18,40,4835.51,9018.02,0.00
2024-12-08 16:57:10,57,7434,17,40,4872.98,9018.32,0.00
2024-12-08 16:57:10,57,7435,17,40,4969.94,9019.00,0.00
2024-12-08 16:57:10,58,7435,17,41,4884.25,9019.02,0.00
2024-12-08 16:57:10,58,7436,17,41,4858.36,9020.00,0.00
2024-12-08 16:57:10,59,7436,18,41,4776.01,9020.02,0.00
2024-12-08 16:57:10,58,7436,18,40,4853.69,9020.02,0.00
2024-12-08 16:57:10,57,7436,17,40,4864.83,9020.75,0.00
2024-12-08 16:57:10,57,7437,17,40,5001.11,9021.00,0.00
2024-12-08 16:57:10,58,7437,18,40,4914.89,9021.02,0.00
2024-12-08 16:57:10,58,7438,18,40,4888.99,9022.00,0.00
2024-12-08 16:57:10,59,7438,18,41,4806.12,9022.02,0.00
2024-12-08 16:57:10,58,7438,18,40,4885.88,9022.02,0.00
2024-12-08 16:57:10,58,7439,18,40,4891.09,9023.00,0.00
2024-12-08 16:57:10,59,7439,18,41,4808.19,9023.02,0.00
2024-12-08 16:57:10,59,7440,18,41,4781.19,9024.00,0.00
2024-12-08 16:57:10,60,7440,18,42,4701.50,9024.02,0.00
2024-12-08 16:57:10,59,7440,18,41,4776.60,9024.02,0.00
2024-12-08 16:57:10,58,7440,17,41,4841.89,9024.19,0.00
2024-12-08 16:57:10,57,7440,16,41,4863.64,9024.47,0.00
2024-12-08 16:57:10,57,7441,16,41,4974.83,9025.00,0.00
2024-12-08 16:57:10,58,7441,17,41,4889.06,9025.02,0.00
2024-12-08 16:57:10,58,7442,17,41,4863.14,9026.00,0.00
2024-12-08 16:57:10,59,7442,18,41,4780.72,9026.02,0.00
2024-12-08 16:57:10,58,7442,18,40,4860.03,9026.02,0.00
2024-12-08 16:57:10,58,7443,18,40,4865.24,9027.00,0.00
2024-12-08 16:57:10,59,7443,18,41,4782.78,9027.02,0.00
2024-12-08 16:57:10,59,7444,18,41,4755.77,9028.00,0.00
2024-12-08 16:57:10,60,7444,18,42,4676.50,9028.02,0.00
2024-12-08 16:57:10,59,7444,18,41,4754.24,9028.02,0.00
2024-12-08 16:57:10,59,7445,18,41,4757.82,9029.00,0.00
2024-12-08 16:57:10,60,7445,18,42,4678.52,9029.02,0.00
2024-12-08 16:57:10,59,7445,18,41,4725.69,9029.02,0.00
2024-12-08 16:57:10,58,7445,17,41,4713.97,9029.53,0.00
2024-12-08 16:57:10,58,7446,17,41,4827.93,9030.00,0.00
2024-12-08 16:57:10,59,7446,17,42,4746.10,9030.02,0.00
2024-12-08 16:57:10,58,7446,17,41,4795.24,9030.02,0.00
2024-12-08 16:57:10,58,7447,17,41,4800.44,9031.00,0.00
2024-12-08 16:57:10,59,7447,18,41,4719.08,9031.02,0.00
2024-12-08 16:57:10,58,7447,17,41,4690.06,9031.47,0.00
2024-12-08 16:57:10,57,7447,16,41,4751.87,9031.69,0.00
2024-12-08 16:57:10,57,7448,16,41,4882.03,9032.00,0.00
2024-12-08 16:57:10,58,7448,17,41,4797.86,9032.02,0.00
2024-12-08 16:57:10,57,7448,17,40,4880.45,9032.02,0.00
2024-12-08 16:57:10,56,7448,16,40,4906.60,9032.68,0.00
2024-12-08 16:57:11,56,7449,16,40,4974.60,9033.00,0.00
2024-12-08 16:57:11,57,7449,16,41,4887.33,9033.02,0.00
2024-12-08 16:57:11,57,7450,16,41,4862.51,9034.00,0.00
2024-12-08 16:57:11,58,7450,17,41,4778.67,9034.02,0.00
2024-12-08 16:57:11,57,7450,17,40,4860.92,9034.02,0.00
2024-12-08 16:57:11,56,7450,16,40,4833.70,9034.96,0.00
2024-12-08 16:57:11,56,7451,16,40,4991.84,9035.00,0.00
2024-12-08 16:57:11,57,7451,17,40,4904.26,9035.02,0.00
2024-12-08 16:57:11,56,7451,17,39,4957.95,9035.02,0.00
2024-12-08 16:57:11,56,7452,17,39,4965.93,9036.00,0.00
2024-12-08 16:57:11,57,7452,18,39,4878.80,9036.02,0.00
2024-12-08 16:57:11,57,7453,18,39,4852.59,9037.00,0.00
2024-12-08 16:57:11,58,7453,19,39,4768.93,9037.02,0.00
2024-12-08 16:57:11,57,7453,19,38,4851.01,9037.02,0.00
2024-12-08 16:57:11,57,7454,19,38,4856.46,9038.00,0.00
2024-12-08 16:57:11,58,7454,20,38,4772.73,9038.02,0.00
2024-12-08 16:57:11,58,7455,20,38,4745.28,9039.00,0.00
2024-12-08 16:57:11,59,7455,21,38,4664.85,9039.02,0.00
2024-12-08 16:57:11,58,7455,21,37,4743.72,9039.02,0.00
2024-12-08 16:57:11,58,7456,21,37,4747.33,9040.00,0.00
2024-12-08 16:57:11,59,7456,22,37,4666.87,9040.02,0.00
2024-12-08 16:57:11,58,7456,21,37,4630.61,9040.50,0.00
2024-12-08 16:57:11,58,7457,21,37,4738.41,9041.00,0.00
2024-12-08 16:57:11,59,7457,22,37,4658.10,9041.02,0.00
2024-12-08 16:57:11,58,7457,22,36,4736.85,9041.02,0.00
2024-12-08 16:57:11,57,7457,21,36,4761.56,9041.67,0.00
2024-12-08 16:57:11,57,7458,21,36,4820.26,9042.00,0.00
2024-12-08 16:57:11,58,7458,22,36,4737.15,9042.02,0.00
2024-12-08 16:57:11,57,7458,21,36,4718.87,9042.44,0.00
2024-12-08 16:57:11,57,7459,21,36,4819.77,9043.00,0.00
2024-12-08 16:57:11,58,7459,22,36,4736.67,9043.02,0.00
2024-12-08 16:57:11,57,7459,22,35,4815.01,9043.02,0.00
2024-12-08 16:57:11,57,7460,22,35,4815.88,9044.00,0.00
2024-12-08 16:57:11,58,7460,22,36,4732.85,9044.02,0.00
2024-12-08 16:57:11,57,7460,21,36,4766.75,9044.21,0.00
2024-12-08 16:57:11,57,7461,21,36,4788.24,9045.00,0.00
2024-12-08 16:57:11,58,7461,22,36,4705.68,9045.02,0.00
2024-12-08 16:57:11,57,7461,22,35,4783.48,9045.02,0.00
2024-12-08 16:57:11,56,7461,21,35,4774.03,9045.86,0.00
2024-12-08 16:57:11,56,7462,21,35,4922.74,9046.00,0.00
2024-12-08 16:57:11,57,7462,22,35,4836.38,9046.02,0.00
2024-12-08 16:57:11,57,7463,22,35,4811.52,9047.00,0.00
2024-12-08 16:57:11,58,7463,23,35,4728.56,9047.02,0.00
2024-12-08 16:57:11,57,7463,23,34,4806.76,9047.02,0.00
2024-12-08 16:57:11,56,7463,22,34,4874.88,9047.21,0.00
2024-12-08 16:57:11,56,7464,22,34,4853.60,9048.00,0.00
2024-12-08 16:57:11,57,7464,23,34,4768.45,9048.02,0.00
2024-12-08 16:57:11,56,7464,23,33,4683.19,9048.36,0.00
2024-12-08 16:57:11,56,7465,23,33,4787.02,9049.00,0.00
2024-12-08 16:57:11,57,7465,24,33,4703.04,9049.02,0.00
2024-12-08 16:57:11,56,7465,24,32,4782.18,9049.02,0.00
2024-12-08 16:57:11,56,7466,24,32,4790.79,9050.00,0.00
2024-12-08 16:57:11,57,7466,24,33,4706.74,9050.02,0.00
2024-12-08 16:57:11,57,7467,24,33,4681.85,9051.00,0.00
2024-12-08 16:57:11,58,7467,25,33,4601.13,9051.02,0.00
2024-12-08 16:57:11,57,7467,25,32,4675.50,9051.02,0.00
2024-12-08 16:57:11,56,7467,24,32,4741.27,9051.21,0.00
2024-12-08 16:57:11,56,7468,24,32,4767.60,9052.00,0.00
2024-12-08 16:57:11,57,7468,24,33,4683.96,9052.02,0.00
2024-12-08 16:57:11,57,7469,24,33,4658.32,9053.00,0.00
2024-12-08 16:57:11,58,7469,25,33,4578.01,9053.02,0.00
2024-12-08 16:57:11,57,7469,25,32,4653.56,9053.02,0.00
2024-12-08 16:57:11,56,7469,24,32,4623.25,9053.95,0.00
2024-12-08 16:57:11,56,7470,24,32,4780.11,9054.00,0.00
2024-12-08 16:57:11,57,7470,24,33,4696.25,9054.02,0.00
2024-12-08 16:57:11,56,7470,23,33,4696.12,9054.32,0.00
2024-12-08 16:57:11,56,7471,23,33,4793.34,9055.00,0.00
2024-12-08 16:57:11,57,7471,24,33,4709.24,9055.02,0.00
2024-12-08 16:57:11,56,7471,24,32,4790.10,9055.02,0.00
2024-12-08 16:57:11,55,7471,23,32,4849.27,9055.24,0.00
2024-12-08 16:57:11,55,7472,23,32,4934.62,9056.00,0.00
2024-12-08 16:57:11,56,7472,23,33,4846.51,9056.02,0.00
2024-12-08 16:57:11,56,7473,23,33,4802.85,9057.00,0.00
2024-12-08 16:57:11,57,7473,23,34,4718.59,9057.02,0.00
2024-12-08 16:57:11,56,7473,23,33,4801.23,9057.02,0.00
2024-12-08 16:57:11,55,7473,22,33,4870.46,9057.20,0.00
2024-12-08 16:57:11,54,7473,21,33,4866.35,9057.81,0.00
2024-12-08 16:57:11,54,7474,21,33,5017.46,9058.00,0.00
2024-12-08 16:57:11,55,7474,22,33,4926.24,9058.02,0.00
2024-12-08 16:57:11,54,7474,22,32,4982.24,9058.02,0.00
2024-12-08 16:57:11,53,7474,21,32,5030.43,9058.47,0.00
2024-12-08 16:57:11,53,7475,21,32,5079.34,9059.00,0.00
2024-12-08 16:57:11,54,7475,22,32,4985.27,9059.02,0.00
2024-12-08 16:57:11,53,7475,22,31,5043.44,9059.02,0.00
2024-12-08 16:57:11,53,7476,22,31,5044.08,9060.00,0.00
2024-12-08 16:57:11,54,7476,22,32,4950.68,9060.02,0.00
2024-12-08 16:57:11,54,7477,22,32,4908.35,9061.00,0.00
2024-12-08 16:57:11,55,7477,23,32,4819.11,9061.02,0.00
2024-12-08 16:57:11,54,7477,23,31,4903.32,9061.04,0.00
2024-12-08 16:57:11,53,7477,22,31,4839.90,9061.68,0.00
2024-12-08 16:57:12,53,7478,22,31,4982.05,9062.00,0.00
2024-12-08 16:57:12,54,7478,23,31,4889.79,9062.02,0.00
2024-12-08 16:57:12,53,7478,22,31,4889.31,9062.43,0.00
2024-12-08 16:57:12,53,7479,22,31,4940.98,9063.00,0.00
2024-12-08 16:57:12,54,7479,23,31,4849.48,9063.02,0.00
2024-12-08 16:57:12,53,7479,23,30,4935.86,9063.04,0.00
2024-12-08 16:57:12,52,7479,22,30,4975.29,9063.65,0.00
2024-12-08 16:57:12,52,7480,22,30,5048.76,9064.00,0.00
2024-12-08 16:57:12,53,7480,23,30,4953.50,9064.02,0.00
2024-12-08 16:57:12,53,7481,23,30,4933.52,9065.00,0.00
2024-12-08 16:57:12,54,7481,24,30,4842.16,9065.02,0.00
2024-12-08 16:57:12,53,7481,24,29,4930.10,9065.04,0.00
2024-12-08 16:57:12,53,7482,24,29,4946.04,9066.00,0.00
2024-12-08 16:57:12,54,7482,24,30,4854.45,9066.02,0.00
2024-12-08 16:57:12,53,7482,23,30,4857.20,9066.32,0.00
2024-12-08 16:57:12,53,7483,23,30,4967.12,9067.00,0.00
2024-12-08 16:57:12,54,7483,24,30,4875.13,9067.02,0.00
2024-12-08 16:57:12,53,7483,24,29,4961.99,9067.04,0.00
2024-12-08 16:57:12,52,7483,23,29,5046.98,9067.14,0.00
2024-12-08 16:57:12,51,7483,22,29,5043.31,9067.94,0.00
2024-12-08 16:57:12,51,7484,22,29,5215.81,9068.00,0.00
2024-12-08 16:57:12,52,7484,22,30,5115.51,9068.02,0.00
2024-12-08 16:57:12,52,7485,22,30,5096.89,9069.00,0.00
2024-12-08 16:57:12,53,7485,23,30,5000.72,9069.02,0.00
2024-12-08 16:57:12,52,7485,23,29,5093.40,9069.04,0.00
2024-12-08 16:57:12,51,7485,22,29,5138.44,9069.65,0.00
2024-12-08 16:57:12,51,7486,22,29,5213.41,9070.00,0.00
2024-12-08 16:57:12,52,7486,23,29,5113.15,9070.02,0.00
2024-12-08 16:57:12,52,7487,23,29,5094.53,9071.00,0.00
2024-12-08 16:57:12,53,7487,24,29,4998.40,9071.02,0.00
2024-12-08 16:57:12,52,7487,24,28,5087.55,9071.04,0.00
2024-12-08 16:57:12,52,7488,24,28,5104.88,9072.00,0.00
2024-12-08 16:57:12,53,7488,25,28,5008.56,9072.02,0.00
2024-12-08 16:57:12,52,7488,24,28,4991.89,9072.42,0.00
2024-12-08 16:57:12,52,7489,24,28,5114.41,9073.00,0.00
2024-12-08 16:57:12,53,7489,25,28,5017.92,9073.02,0.00
2024-12-08 16:57:12,52,7489,25,27,5105.69,9073.04,0.00
2024-12-08 16:57:12,52,7490,25,27,5122.15,9074.00,0.00
2024-12-08 16:57:12,53,7490,25,28,5025.50,9074.02,0.00
2024-12-08 16:57:12,53,7491,25,28,5003.89,9075.00,0.00
2024-12-08 16:57:12,54,7491,25,29,4911.23,9075.02,0.00
2024-12-08 16:57:12,53,7491,25,28,4991.91,9075.04,0.00
2024-12-08 16:57:12,53,7492,25,28,5006.13,9076.00,0.00
2024-12-08 16:57:12,54,7492,26,28,4913.42,9076.02,0.00
2024-12-08 16:57:12,54,7493,26,28,4891.98,9077.00,0.00
2024-12-08 16:57:12,55,7493,27,28,4803.04,9077.02,0.00
2024-12-08 16:57:12,54,7493,27,27,4875.17,9077.04,0.00
2024-12-08 16:57:12,54,7494,27,27,4882.11,9078.00,0.00
2024-12-08 16:57:12,55,7494,27,28,4793.34,9078.02,0.00
2024-12-08 16:57:12,55,7495,27,28,4771.70,9079.00,0.00
2024-12-08 16:57:12,56,7495,28,28,4686.49,9079.02,0.00
2024-12-08 16:57:12,55,7495,28,27,4751.89,9079.04,0.00
2024-12-08 16:57:12,56,7494,29,27,4665.42,9079.09,0.00
2024-12-08 16:57:12,55,7494,28,27,4729.53,9079.67,0.00
2024-12-08 16:57:12,55,7495,28,27,4865.13,9080.00,0.00
2024-12-08 16:57:12,56,7495,29,27,4778.25,9080.02,0.00
2024-12-08 16:57:12,56,7496,29,27,4923.21,9081.00,0.00
2024-12-08 16:57:12,57,7496,30,27,4836.84,9081.02,0.00
2024-12-08 16:57:12,56,7496,29,27,4921.59,9081.02,0.00
2024-12-08 16:57:12,55,7496,29,26,4994.56,9081.02,0.00
2024-12-08 16:57:12,54,7496,28,26,5038.15,9081.56,0.00
2024-12-08 16:57:12,54,7497,28,26,5099.01,9082.00,0.00
2024-12-08 16:57:12,55,7497,28,27,5006.30,9082.02,0.00
2024-12-08 16:57:12,55,7498,28,27,5036.64,9083.00,0.00
2024-12-08 16:57:12,56,7498,28,28,4946.70,9083.02,0.00
2024-12-08 16:57:12,56,7499,28,28,4969.22,9084.00,0.00
2024-12-08 16:57:12,57,7499,28,29,4882.04,9084.02,0.00
2024-12-08 16:57:12,56,7499,27,29,4877.22,9084.64,0.00
2024-12-08 16:57:12,56,7500,27,29,4977.24,9085.00,0.00
2024-12-08 16:57:12,57,7500,27,30,4889.92,9085.02,0.00
2024-12-08 16:57:12,58,7499,28,30,4705.17,9085.79,0.00
2024-12-08 16:57:12,58,7500,28,30,4807.69,9086.00,0.00
2024-12-08 16:57:12,59,7500,28,31,4726.20,9086.02,0.00
2024-12-08 16:57:12,58,7500,28,30,4785.76,9086.02,0.00
2024-12-08 16:57:12,57,7500,27,30,4755.39,9086.82,0.00
2024-12-08 16:57:12,57,7501,27,30,5058.41,9087.00,0.00
2024-12-08 16:57:12,58,7501,28,30,4971.20,9087.02,0.00
2024-12-08 16:57:12,58,7502,28,30,4944.84,9088.00,0.00
2024-12-08 16:57:12,59,7502,29,30,4861.03,9088.02,0.00
2024-12-08 16:57:12,58,7502,29,29,4932.31,9088.02,0.00
2024-12-08 16:57:12,58,7503,29,29,4932.56,9089.00,0.00
2024-12-08 16:57:12,59,7503,30,29,4848.96,9089.02,0.00
2024-12-08 16:57:12,58,7503,29,29,4835.60,9089.66,0.00
2024-12-08 16:57:13,58,7504,29,29,4897.98,9090.00,0.00
2024-12-08 16:57:13,59,7504,29,30,4814.96,9090.02,0.00
2024-12-08 16:57:13,58,7504,29,29,4887.00,9090.02,0.00
2024-12-08 16:57:13,58,7505,29,29,4875.00,9091.00,0.00
2024-12-08 16:57:13,59,7505,29,30,4792.37,9091.02,0.00
2024-12-08 16:57:13,59,7506,29,30,4743.58,9092.00,0.00
2024-12-08 16:57:13,60,7506,29,31,4664.52,9092.02,0.00
2024-12-08 16:57:13,59,7506,29,30,4734.34,9092.02,0.00
2024-12-08 16:57:13,58,7506,28,30,4746.17,9092.38,0.00
2024-12-08 16:57:13,58,7507,28,30,4818.62,9093.00,0.00
2024-12-08 16:57:13,59,7507,29,30,4736.95,9093.02,0.00
2024-12-08 16:57:13,58,7507,28,30,4771.10,9093.17,0.00
2024-12-08 16:57:13,57,7507,27,30,4843.65,9093.21,0.00
2024-12-08 16:57:13,57,7508,27,30,4895.49,9094.00,0.00
2024-12-08 16:57:13,58,7508,28,30,4811.09,9094.02,0.00
2024-12-08 16:57:13,57,7508,28,29,4887.52,9094.02,0.00
2024-12-08 16:57:13,57,7509,28,29,4850.77,9095.00,0.00
2024-12-08 16:57:13,58,7509,28,30,4767.13,9095.02,0.00
2024-12-08 16:57:13,57,7509,27,30,4743.65,9095.84,0.00
2024-12-08 16:57:13,57,7510,27,30,4826.43,9096.00,0.00
2024-12-08 16:57:13,58,7510,27,31,4743.21,9096.02,0.00
2024-12-08 16:57:13,57,7510,27,30,4820.05,9096.02,0.00
2024-12-08 16:57:13,57,7511,27,30,4826.96,9097.00,0.00
2024-12-08 16:57:13,58,7511,27,31,4743.74,9097.02,0.00
2024-12-08 16:57:13,57,7511,26,31,4679.34,9097.97,0.00
2024-12-08 16:57:13,57,7512,26,31,4835.78,9098.00,0.00
2024-12-08 16:57:13,58,7512,26,32,4752.40,9098.02,0.00
2024-12-08 16:57:13,57,7512,26,31,4827.80,9098.02,0.00
2024-12-08 16:57:13,57,7513,26,31,4834.71,9099.00,0.00
2024-12-08 16:57:13,58,7513,27,31,4751.35,9099.02,0.00
2024-12-08 16:57:13,57,7513,27,30,4834.45,9099.02,0.00
2024-12-08 16:57:13,56,7513,27,29,4904.27,9099.02,0.00
2024-12-08 16:57:13,55,7513,26,29,4983.54,9099.13,0.00
2024-12-08 16:57:13,55,7514,26,29,5003.91,9100.00,0.00
2024-12-08 16:57:13,56,7514,27,29,4914.56,9100.02,0.00
2024-12-08 16:57:13,55,7514,27,28,4999.24,9100.02,0.00
2024-12-08 16:57:13,54,7514,26,28,5080.06,9100.13,0.00
2024-12-08 16:57:13,54,7515,26,28,5169.91,9101.00,0.00
2024-12-08 16:57:13,55,7515,27,28,5075.91,9101.02,0.00
2024-12-08 16:57:13,55,7516,27,28,5053.30,9102.00,0.00
2024-12-08 16:57:13,56,7516,27,29,4963.06,9102.02,0.00
2024-12-08 16:57:13,55,7516,27,28,5041.71,9102.02,0.00
2024-12-08 16:57:13,55,7517,27,28,5052.20,9103.00,0.00
2024-12-08 16:57:13,56,7517,27,29,4961.98,9103.02,0.00
2024-12-08 16:57:13,55,7517,26,29,4982.75,9103.22,0.00
2024-12-08 16:57:13,55,7518,26,29,5077.58,9104.00,0.00
2024-12-08 16:57:13,56,7518,26,30,4986.91,9104.02,0.00
2024-12-08 16:57:13,55,7518,26,29,5067.65,9104.02,0.00
2024-12-08 16:57:13,55,7519,26,29,5077.47,9105.00,0.00
2024-12-08 16:57:13,56,7519,27,29,4986.80,9105.02,0.00
2024-12-08 16:57:13,55,7519,26,29,4971.55,9105.36,0.00
2024-12-08 16:57:13,55,7520,26,29,5077.09,9106.00,0.00
2024-12-08 16:57:13,56,7520,26,30,4986.43,9106.02,0.00
2024-12-08 16:57:13,55,7520,26,29,5068.81,9106.02,0.00
2024-12-08 16:57:13,55,7521,26,29,5075.44,9107.00,0.00
2024-12-08 16:57:13,56,7521,26,30,4984.81,9107.02,0.00
2024-12-08 16:57:13,55,7521,25,30,4992.66,9107.04,0.00
2024-12-08 16:57:13,54,7521,24,30,5080.07,9107.09,0.00
2024-12-08 16:57:13,54,7522,24,30,5161.05,9108.00,0.00
2024-12-08 16:57:13,55,7522,24,31,5067.21,9108.02,0.00
2024-12-08 16:57:13,54,7522,24,30,5150.93,9108.02,0.00
2024-12-08 16:57:13,54,7523,24,30,5155.90,9109.00,0.00
2024-12-08 16:57:13,55,7523,25,30,5062.15,9109.02,0.00
2024-12-08 16:57:13,54,7523,24,30,5040.21,9109.74,0.00
2024-12-08 16:57:13,54,7524,24,30,5185.50,9110.00,0.00
2024-12-08 16:57:13,55,7524,25,30,5091.21,9110.02,0.00
2024-12-08 16:57:13,54,7524,25,29,5156.83,9110.06,0.00
2024-12-08 16:57:13,53,7524,24,29,5191.44,9110.66,0.00
2024-12-08 16:57:13,53,7525,24,29,5263.91,9111.00,0.00
2024-12-08 16:57:13,54,7525,24,30,5166.43,9111.02,0.00
2024-12-08 16:57:13,53,7525,23,30,5199.33,9111.34,0.00
2024-12-08 16:57:13,52,7525,22,30,5272.17,9111.64,0.00
2024-12-08 16:57:13,52,7526,22,30,5357.90,9112.00,0.00
2024-12-08 16:57:13,53,7526,22,31,5256.81,9112.02,0.00
2024-12-08 16:57:13,52,7526,22,30,5319.37,9112.08,0.00
2024-12-08 16:57:13,52,7527,22,30,5340.97,9113.00,0.00
2024-12-08 16:57:13,53,7527,23,30,5240.19,9113.02,0.00
2024-12-08 16:57:13,52,7527,22,30,5249.94,9113.29,0.00
2024-12-08 16:57:13,52,7528,22,30,5359.13,9114.00,0.00
2024-12-08 16:57:13,53,7528,22,31,5258.02,9114.02,0.00
2024-12-08 16:57:13,52,7528,22,30,5320.59,9114.08,0.00
2024-12-08 16:57:13,52,7529,22,30,5340.41,9115.00,0.00
2024-12-08 16:57:13,53,7529,22,31,5239.65,9115.02,0.00
2024-12-08 16:57:13,52,7529,21,31,5252.86,9115.27,0.00
2024-12-08 16:57:13,52,7530,21,31,5358.99,9116.00,0.00
2024-12-08 16:57:13,53,7530,22,31,5257.88,9116.02,0.00
2024-12-08 16:57:13,52,7530,22,30,5320.44,9116.08,0.00
2024-12-08 16:57:13,51,7530,21,30,5347.45,9116.39,0.00
2024-12-08 16:57:13,51,7531,21,30,5471.23,9117.00,0.00
2024-12-08 16:57:14,52,7531,22,30,5366.01,9117.02,0.00
2024-12-08 16:57:14,52,7532,22,30,5354.94,9118.00,0.00
2024-12-08 16:57:14,53,7532,23,30,5253.90,9118.02,0.00
2024-12-08 16:57:14,52,7532,23,29,5316.38,9118.08,0.00
2024-12-08 16:57:14,52,7533,23,29,5337.53,9119.00,0.00
2024-12-08 16:57:14,53,7533,24,29,5236.82,9119.02,0.00
2024-12-08 16:57:14,53,7534,24,29,5225.75,9120.00,0.00
2024-12-08 16:57:14,54,7534,25,29,5128.98,9120.02,0.00
2024-12-08 16:57:14,53,7534,25,28,5189.63,9120.08,0.00
2024-12-08 16:57:14,53,7535,25,28,5206.38,9121.00,0.00
2024-12-08 16:57:14,54,7535,26,28,5109.96,9121.02,0.00
2024-12-08 16:57:14,54,7536,26,28,5098.02,9122.00,0.00
2024-12-08 16:57:14,55,7536,27,28,5005.33,9122.02,0.00
2024-12-08 16:57:14,54,7536,27,27,5059.19,9122.09,0.00
2024-12-08 16:57:14,54,7537,27,27,5074.10,9123.00,0.00
2024-12-08 16:57:14,55,7537,28,27,4981.84,9123.02,0.00
2024-12-08 16:57:14,54,7537,27,27,5065.68,9123.11,0.00
2024-12-08 16:57:14,54,7538,27,27,5066.64,9124.00,0.00
2024-12-08 16:57:14,55,7538,28,27,4974.52,9124.02,0.00
2024-12-08 16:57:14,55,7539,28,27,4943.46,9125.00,0.00
2024-12-08 16:57:14,56,7539,28,28,4855.18,9125.02,0.00
2024-12-08 16:57:14,55,7539,28,27,4930.22,9125.13,0.00
2024-12-08 16:57:14,55,7540,28,27,4940.03,9126.00,0.00
2024-12-08 16:57:14,56,7540,29,27,4851.82,9126.02,0.00
2024-12-08 16:57:14,56,7541,29,27,4832.81,9127.00,0.00
2024-12-08 16:57:14,57,7541,30,27,4748.03,9127.02,0.00
2024-12-08 16:57:14,56,7541,29,27,4707.89,9127.63,0.00
2024-12-08 16:57:14,56,7542,29,27,4836.92,9128.00,0.00
2024-12-08 16:57:14,57,7542,29,28,4752.06,9128.02,0.00
2024-12-08 16:57:14,56,7542,29,27,4825.53,9128.13,0.00
2024-12-08 16:57:14,55,7542,28,27,4868.78,9128.53,0.00
2024-12-08 16:57:14,55,7543,28,27,4910.10,9129.00,0.00
2024-12-08 16:57:14,56,7543,29,27,4822.42,9129.02,0.00
2024-12-08 16:57:14,55,7543,28,27,4775.37,9129.67,0.00
2024-12-08 16:57:14,55,7544,28,27,4911.72,9130.00,0.00
2024-12-08 16:57:14,56,7544,28,28,4824.01,9130.02,0.00
2024-12-08 16:57:14,56,7545,28,28,4773.84,9131.00,0.00
2024-12-08 16:57:14,57,7545,29,28,4690.09,9131.02,0.00
2024-12-08 16:57:14,56,7545,29,27,4746.32,9131.14,0.00
2024-12-08 16:57:14,56,7546,29,27,4751.72,9132.00,0.00
2024-12-08 16:57:14,57,7546,30,27,4668.36,9132.02,0.00
2024-12-08 16:57:14,56,7546,29,27,4738.67,9132.02,0.00
2024-12-08 16:57:14,55,7546,28,27,4805.57,9132.11,0.00
2024-12-08 16:57:14,55,7547,28,27,4848.43,9133.00,0.00
2024-12-08 16:57:14,56,7547,28,28,4761.85,9133.02,0.00
2024-12-08 16:57:14,55,7547,28,27,4770.39,9133.49,0.00
2024-12-08 16:57:14,55,7548,28,27,4823.87,9134.00,0.00
2024-12-08 16:57:14,56,7548,28,28,4737.73,9134.02,0.00
2024-12-08 16:57:14,55,7548,28,27,4812.27,9134.11,0.00
2024-12-08 16:57:14,54,7548,27,27,4895.54,9134.17,0.00
2024-12-08 16:57:14,54,7549,27,27,4921.42,9135.00,0.00
2024-12-08 16:57:14,55,7549,27,28,4831.94,9135.02,0.00
2024-12-08 16:57:14,54,7549,26,28,4889.25,9135.11,0.00
2024-12-08 16:57:14,54,7550,26,28,4943.90,9136.00,0.00
2024-12-08 16:57:14,55,7550,26,29,4854.02,9136.02,0.00
2024-12-08 16:57:14,55,7550,26,29,4831.29,9137.00,0.00
2024-12-08 16:57:14,56,7550,26,30,4745.02,9137.02,0.00
2024-12-08 16:57:14,55,7550,26,29,4819.68,9137.11,0.00
2024-12-08 16:57:14,54,7550,25,29,4861.94,9137.57,0.00
2024-12-08 16:57:14,54,7551,25,29,4992.52,9138.00,0.00
2024-12-08 16:57:14,55,7551,25,30,4901.75,9138.02,0.00
2024-12-08 16:57:14,55,7552,25,30,4902.17,9139.00,0.00
2024-12-08 16:57:14,56,7552,25,31,4814.64,9139.02,0.00
2024-12-08 16:57:14,56,7553,25,31,4791.59,9140.00,0.00
2024-12-08 16:57:14,57,7553,25,32,4707.52,9140.02,0.00
2024-12-08 16:57:14,56,7553,25,31,4775.28,9140.14,0.00
2024-12-08 16:57:14,55,7553,24,31,4800.00,9140.73,0.00
2024-12-08 16:57:14,55,7554,24,31,4941.47,9141.00,0.00
2024-12-08 16:57:14,56,7554,25,31,4853.23,9141.02,0.00
2024-12-08 16:57:14,55,7554,24,31,4929.85,9141.13,0.00
2024-12-08 16:57:14,55,7555,24,31,4939.28,9142.00,0.00
2024-12-08 16:57:14,56,7555,24,32,4851.08,9142.02,0.00
2024-12-08 16:57:14,56,7556,24,32,4827.12,9143.00,0.00
2024-12-08 16:57:14,57,7556,25,32,4742.44,9143.02,0.00
2024-12-08 16:57:14,56,7556,24,32,4825.49,9143.02,0.00
2024-12-08 16:57:14,55,7556,24,31,4903.26,9143.11,0.00
2024-12-08 16:57:14,55,7557,24,31,4922.08,9144.00,0.00
2024-12-08 16:57:14,56,7557,25,31,4834.18,9144.02,0.00
2024-12-08 16:57:14,56,7558,25,31,4829.95,9145.00,0.00
2024-12-08 16:57:14,57,7558,25,32,4745.21,9145.02,0.00
2024-12-08 16:57:14,56,7558,25,31,4789.13,9145.11,0.00
2024-12-08 16:57:15,56,7559,25,31,4805.98,9146.00,0.00
2024-12-08 16:57:15,57,7559,26,31,4721.66,9146.02,0.00
2024-12-08 16:57:15,56,7559,25,31,4664.36,9146.93,0.00
2024-12-08 16:57:15,56,7560,25,31,4821.20,9147.00,0.00
2024-12-08 16:57:15,57,7560,26,31,4736.62,9147.02,0.00
2024-12-08 16:57:15,56,7560,25,31,4819.57,9147.02,0.00
2024-12-08 16:57:15,55,7560,25,30,4868.96,9147.09,0.00
2024-12-08 16:57:15,55,7561,25,30,4886.11,9148.00,0.00
2024-12-08 16:57:15,56,7561,25,31,4798.86,9148.02,0.00
2024-12-08 16:57:15,55,7561,24,31,4844.54,9148.11,0.00
2024-12-08 16:57:15,55,7562,24,31,4881.32,9149.00,0.00
2024-12-08 16:57:15,56,7562,24,32,4794.15,9149.02,0.00
2024-12-08 16:57:15,55,7562,24,31,4844.73,9149.09,0.00
2024-12-08 16:57:15,54,7562,23,31,4894.52,9149.44,0.00
2024-12-08 16:57:15,53,7562,22,31,4966.26,9149.66,0.00
2024-12-08 16:57:15,53,7563,22,31,5108.08,9150.00,0.00
2024-12-08 16:57:15,54,7563,22,32,5013.48,9150.02,0.00
2024-12-08 16:57:15,53,7563,21,32,5102.21,9150.08,0.00
2024-12-08 16:57:15,53,7564,21,32,5105.31,9151.00,0.00
2024-12-08 16:57:15,54,7564,21,33,5010.77,9151.02,0.00
2024-12-08 16:57:15,53,7564,21,32,5065.60,9151.08,0.00
2024-12-08 16:57:15,52,7564,20,32,5129.86,9151.42,0.00
2024-12-08 16:57:15,51,7564,19,32,5138.41,9151.92,0.00
2024-12-08 16:57:15,51,7565,19,32,5310.74,9152.00,0.00
2024-12-08 16:57:15,52,7565,20,32,5208.61,9152.02,0.00
2024-12-08 16:57:15,51,7565,19,32,5214.14,9152.67,0.00
2024-12-08 16:57:15,51,7566,19,32,5363.37,9153.00,0.00
2024-12-08 16:57:15,52,7566,20,32,5260.23,9153.02,0.00
2024-12-08 16:57:15,51,7566,20,31,5323.89,9153.08,0.00
2024-12-08 16:57:15,51,7567,20,31,5347.80,9154.00,0.00
2024-12-08 16:57:15,52,7567,21,31,5244.96,9154.02,0.00
2024-12-08 16:57:15,51,7567,20,31,5338.83,9154.02,0.00
2024-12-08 16:57:15,51,7568,20,31,5393.26,9155.00,0.00
2024-12-08 16:57:15,52,7568,20,32,5289.55,9155.02,0.00
2024-12-08 16:57:15,51,7568,20,31,5357.36,9155.06,0.00
2024-12-08 16:57:15,51,7569,20,31,5379.49,9156.00,0.00
2024-12-08 16:57:15,52,7569,21,31,5276.04,9156.02,0.00
2024-12-08 16:57:15,52,7570,21,31,5269.49,9157.00,0.00
2024-12-08 16:57:15,53,7570,22,31,5170.07,9157.02,0.00
2024-12-08 16:57:15,52,7570,22,30,5232.51,9157.06,0.00
2024-12-08 16:57:15,52,7571,22,30,5252.46,9158.00,0.00
2024-12-08 16:57:15,53,7571,22,31,5153.35,9158.02,0.00
2024-12-08 16:57:15,53,7572,22,31,5145.90,9159.00,0.00
2024-12-08 16:57:15,54,7572,22,32,5050.61,9159.02,0.00
2024-12-08 16:57:15,53,7572,22,31,5111.34,9159.06,0.00
2024-12-08 16:57:15,52,7572,21,31,5096.75,9159.89,0.00
2024-12-08 16:57:15,52,7573,21,31,5262.41,9160.00,0.00
2024-12-08 16:57:15,53,7573,22,31,5163.12,9160.02,0.00
2024-12-08 16:57:15,53,7574,22,31,5155.10,9161.00,0.00
2024-12-08 16:57:15,54,7574,22,32,5059.63,9161.02,0.00
2024-12-08 16:57:15,53,7574,21,32,5153.37,9161.02,0.00
2024-12-08 16:57:15,52,7574,21,31,5220.76,9161.04,0.00
2024-12-08 16:57:15,51,7574,20,31,5211.90,9161.51,0.00
2024-12-08 16:57:15,51,7575,20,31,5347.01,9162.00,0.00
2024-12-08 16:57:15,52,7575,21,31,5244.18,9162.02,0.00
2024-12-08 16:57:15,51,7575,20,31,5305.70,9162.08,0.00
2024-12-08 16:57:15,51,7576,20,31,5339.97,9163.00,0.00
2024-12-08 16:57:15,52,7576,21,31,5237.28,9163.02,0.00
2024-12-08 16:57:15,51,7576,21,30,5309.43,9163.04,0.00
2024-12-08 16:57:15,51,7577,21,30,5329.77,9164.00,0.00
2024-12-08 16:57:15,52,7577,22,30,5227.28,9164.02,0.00
2024-12-08 16:57:16,52,7578,22,30,5222.17,9165.00,0.00
2024-12-08 16:57:16,53,7578,23,30,5123.64,9165.02,0.00
2024-12-08 16:57:16,52,7578,22,30,5220.41,9165.02,0.00
2024-12-08 16:57:16,51,7578,22,29,5286.83,9165.04,0.00
2024-12-08 16:57:16,50,7578,21,29,5303.39,9165.62,0.00
2024-12-08 16:57:16,50,7579,21,29,5452.17,9166.00,0.00
2024-12-08 16:57:16,51,7579,21,30,5345.26,9166.02,0.00
2024-12-08 16:57:16,50,7579,20,30,5348.93,9166.22,0.00
2024-12-08 16:57:16,50,7580,20,30,5458.04,9167.00,0.00
2024-12-08 16:57:16,51,7580,21,30,5351.02,9167.02,0.00
2024-12-08 16:57:16,50,7580,21,29,5423.21,9167.04,0.00
2024-12-08 16:57:16,50,7581,21,29,5439.94,9168.00,0.00
2024-12-08 16:57:16,51,7581,22,29,5333.27,9168.02,0.00
2024-12-08 16:57:16,51,7582,22,29,5318.71,9169.00,0.00
2024-12-08 16:57:16,52,7582,23,29,5216.42,9169.02,0.00
2024-12-08 16:57:16,51,7582,23,28,5284.55,9169.04,0.00
2024-12-08 16:57:16,51,7583,23,28,5291.86,9170.00,0.00
2024-12-08 16:57:16,52,7583,24,28,5190.10,9170.02,0.00
2024-12-08 16:57:16,51,7583,23,28,5250.52,9170.08,0.00
2024-12-08 16:57:16,50,7583,22,28,5313.47,9170.18,0.00
2024-12-08 16:57:16,50,7584,22,28,5406.33,9171.00,0.00
2024-12-08 16:57:16,51,7584,22,29,5300.32,9171.02,0.00
2024-12-08 16:57:16,50,7584,22,28,5373.32,9171.04,0.00
2024-12-08 16:57:16,50,7585,22,28,5378.32,9172.00,0.00
2024-12-08 16:57:16,51,7585,22,29,5272.86,9172.02,0.00
2024-12-08 16:57:16,50,7585,21,29,5315.99,9172.14,0.00
2024-12-08 16:57:16,50,7586,21,29,5402.95,9173.00,0.00
2024-12-08 16:57:16,51,7586,22,29,5297.01,9173.02,0.00
2024-12-08 16:57:16,50,7586,22,28,5371.76,9173.04,0.00
2024-12-08 16:57:16,50,7587,22,28,5376.71,9174.00,0.00
2024-12-08 16:57:16,51,7587,22,29,5271.29,9174.02,0.00
2024-12-08 16:57:16,50,7587,22,28,5316.83,9174.26,0.00
2024-12-08 16:57:16,50,7588,22,28,5372.60,9175.00,0.00
2024-12-08 16:57:16,51,7588,23,28,5267.25,9175.02,0.00
2024-12-08 16:57:16,50,7588,23,27,5339.57,9175.04,0.00
2024-12-08 16:57:16,49,7588,22,27,5398.28,9175.59,0.00
2024-12-08 16:57:16,49,7589,22,27,5473.48,9176.00,0.00
2024-12-08 16:57:16,50,7589,22,28,5364.01,9176.02,0.00
2024-12-08 16:57:16,50,7590,22,28,5358.10,9177.00,0.00
2024-12-08 16:57:16,51,7590,22,29,5253.04,9177.02,0.00
2024-12-08 16:57:16,50,7590,22,28,5326.91,9177.04,0.00
2024-12-08 16:57:16,50,7591,22,28,5349.51,9178.00,0.00
2024-12-08 16:57:16,51,7591,23,28,5244.62,9178.02,0.00
2024-12-08 16:57:16,51,7592,23,28,5238.92,9179.00,0.00
2024-12-08 16:57:16,52,7592,23,29,5138.17,9179.02,0.00
2024-12-08 16:57:16,51,7592,23,28,5208.33,9179.04,0.00
2024-12-08 16:57:16,51,7593,23,28,5228.69,9180.00,0.00
2024-12-08 16:57:16,52,7593,23,29,5128.14,9180.02,0.00
2024-12-08 16:57:16,52,7594,23,29,5120.93,9181.00,0.00
2024-12-08 16:57:16,53,7594,24,29,5024.31,9181.02,0.00
2024-12-08 16:57:16,52,7594,24,28,5092.69,9181.04,0.00
2024-12-08 16:57:16,51,7594,23,28,5120.67,9181.35,0.00
2024-12-08 16:57:16,51,7595,23,28,5241.71,9182.00,0.00
2024-12-08 16:57:16,52,7595,24,28,5140.91,9182.02,0.00
2024-12-08 16:57:16,51,7595,23,28,5239.92,9182.04,0.00
2024-12-08 16:57:16,50,7595,22,28,5264.59,9182.50,0.00
2024-12-08 16:57:17,50,7596,22,28,5351.21,9183.00,0.00
2024-12-08 16:57:17,51,7596,22,29,5246.28,9183.02,0.00
2024-12-08 16:57:17,51,7597,22,29,5228.85,9184.00,0.00
2024-12-08 16:57:17,52,7597,22,30,5128.29,9184.02,0.00
2024-12-08 16:57:17,51,7597,21,30,5225.25,9184.06,0.00
2024-12-08 16:57:17,50,7597,21,29,5326.09,9184.06,0.00
2024-12-08 16:57:17,49,7597,20,29,5365.56,9184.33,0.00
2024-12-08 16:57:17,49,7598,20,29,5491.60,9185.00,0.00
2024-12-08 16:57:17,50,7598,20,30,5381.77,9185.02,0.00
2024-12-08 16:57:17,50,7599,20,30,5383.62,9186.00,0.00
2024-12-08 16:57:17,51,7599,21,30,5278.06,9186.02,0.00
2024-12-08 16:57:17,50,7599,20,30,5360.31,9186.06,0.00
2024-12-08 16:57:17,50,7600,20,30,5421.52,9187.00,0.00
2024-12-08 16:57:17,51,7600,20,31,5315.22,9187.02,0.00
2024-12-08 16:57:17,50,7600,20,30,5412.35,9187.08,0.00
2024-12-08 16:57:17,50,7601,20,30,5438.65,9188.00,0.00
2024-12-08 16:57:17,51,7601,20,31,5332.01,9188.02,0.00
2024-12-08 16:57:17,50,7601,19,31,5434.99,9188.06,0.00
2024-12-08 16:57:17,49,7601,18,31,5472.77,9188.45,0.00
2024-12-08 16:57:17,49,7602,18,31,5556.82,9189.00,0.00
2024-12-08 16:57:17,50,7602,18,32,5445.68,9189.02,0.00
2024-12-08 16:57:17,49,7602,17,32,5467.74,9189.47,0.00
2024-12-08 16:57:17,49,7603,17,32,5606.89,9190.00,0.00
2024-12-08 16:57:17,50,7603,17,33,5494.75,9190.02,0.00
2024-12-08 16:57:17,49,7603,17,32,5595.65,9190.06,0.00
2024-12-08 16:57:17,48,7603,16,32,5584.24,9190.60,0.00
2024-12-08 16:57:17,48,7604,16,32,5739.64,9191.00,0.00
2024-12-08 16:57:17,49,7604,16,33,5622.51,9191.02,0.00
2024-12-08 16:57:17,48,7604,15,33,5628.73,9191.33,0.00
2024-12-08 16:57:17,48,7605,15,33,5759.42,9192.00,0.00
2024-12-08 16:57:17,49,7605,16,33,5641.88,9192.02,0.00
2024-12-08 16:57:17,49,7606,16,33,5627.48,9193.00,0.00
2024-12-08 16:57:17,50,7606,17,33,5514.93,9193.02,0.00
2024-12-08 16:57:17,49,7606,17,32,5619.99,9193.06,0.00
2024-12-08 16:57:17,49,7607,17,32,5646.86,9194.00,0.00
2024-12-08 16:57:17,50,7607,17,33,5533.92,9194.02,0.00
2024-12-08 16:57:17,49,7607,16,33,5564.60,9194.49,0.00
2024-12-08 16:57:17,49,7608,16,33,5643.44,9195.00,0.00
2024-12-08 16:57:17,50,7608,16,34,5530.57,9195.02,0.00
2024-12-08 16:57:17,49,7608,16,33,5600.29,9195.06,0.00
2024-12-08 16:57:17,48,7608,15,33,5655.08,9195.60,0.00
2024-12-08 16:57:17,48,7609,15,33,5810.56,9196.00,0.00
2024-12-08 16:57:17,49,7609,16,33,5691.98,9196.02,0.00
2024-12-08 16:57:17,49,7610,16,33,5686.05,9197.00,0.00
2024-12-08 16:57:17,50,7610,16,34,5572.33,9197.02,0.00
2024-12-08 16:57:17,49,7610,16,33,5644.77,9197.06,0.00
2024-12-08 16:57:17,49,7611,16,33,5671.66,9198.00,0.00
2024-12-08 16:57:17,50,7611,17,33,5558.22,9198.02,0.00
2024-12-08 16:57:17,50,7612,17,33,5552.14,9199.00,0.00
2024-12-08 16:57:17,51,7612,18,33,5443.27,9199.02,0.00
2024-12-08 16:57:17,50,7612,17,33,5550.30,9199.02,0.00
2024-12-08 16:57:17,49,7612,17,32,5626.03,9199.04,0.00
2024-12-08 16:57:17,48,7612,16,32,5614.72,9199.96,0.00
2024-12-08 16:57:17,48,7613,16,32,5802.58,9200.00,0.00
2024-12-08 16:57:17,49,7613,16,33,5684.16,9200.02,0.00
2024-12-08 16:57:17,49,7614,16,33,5676.30,9201.00,0.00
2024-12-08 16:57:17,50,7614,16,34,5562.78,9201.02,0.00
2024-12-08 16:57:17,49,7614,16,33,5640.63,9201.04,0.00
2024-12-08 16:57:17,48,7614,15,33,5678.75,9201.33,0.00
2024-12-08 16:57:17,47,7614,14,33,5793.52,9201.40,0.00
2024-12-08 16:57:17,47,7615,14,33,5934.93,9202.00,0.00
2024-12-08 16:57:17,48,7615,14,34,5811.29,9202.02,0.00
2024-12-08 16:57:17,48,7616,14,34,5801.17,9203.00,0.00
2024-12-08 16:57:17,49,7616,15,34,5682.77,9203.02,0.00
2024-12-08 16:57:17,48,7616,15,33,5766.66,9203.04,0.00
2024-12-08 16:57:17,48,7617,15,33,5794.13,9204.00,0.00
2024-12-08 16:57:17,49,7617,15,34,5675.88,9204.02,0.00
2024-12-08 16:57:17,48,7617,14,34,5654.33,9204.35,0.00
2024-12-08 16:57:17,49,7616,14,35,5538.94,9204.39,0.00
2024-12-08 16:57:17,49,7617,14,35,5731.01,9205.00,0.00
2024-12-08 16:57:17,50,7617,14,36,5616.39,9205.02,0.00
2024-12-08 16:57:17,49,7617,14,35,5699.08,9205.04,0.00
2024-12-08 16:57:17,48,7617,13,35,5778.11,9205.46,0.00
2024-12-08 16:57:17,47,7617,12,35,5835.94,9205.85,0.00
2024-12-08 16:57:17,47,7618,12,35,6214.08,9206.00,0.00
2024-12-08 16:57:17,48,7618,12,36,6084.62,9206.02,0.00
2024-12-08 16:57:17,48,7619,12,36,6070.88,9207.00,0.00
2024-12-08 16:57:17,49,7619,12,37,5946.99,9207.02,0.00
2024-12-08 16:57:17,48,7619,12,36,6038.28,9207.04,0.00
2024-12-08 16:57:17,47,7619,11,36,6112.45,9207.60,0.00
2024-12-08 16:57:17,47,7620,11,36,6193.10,9208.00,0.00
2024-12-08 16:57:17,48,7620,12,36,6064.08,9208.02,0.00
2024-12-08 16:57:17,47,7620,11,36,6163.71,9208.02,0.00
2024-12-08 16:57:17,47,7621,11,36,6223.78,9209.00,0.00
2024-12-08 16:57:17,48,7621,11,37,6094.12,9209.02,0.00
2024-12-08 16:57:17,47,7621,11,36,6190.47,9209.02,0.00
2024-12-08 16:57:17,47,7622,11,36,6203.88,9210.00,0.00
2024-12-08 16:57:17,48,7622,11,37,6074.64,9210.02,0.00
2024-12-08 16:57:17,47,7622,10,37,6038.89,9210.85,0.00
2024-12-08 16:57:17,47,7623,10,37,6221.27,9211.00,0.00
2024-12-08 16:57:17,48,7623,11,37,6091.66,9211.02,0.00
2024-12-08 16:57:17,47,7623,11,36,6185.99,9211.02,0.00
2024-12-08 16:57:18,47,7624,11,36,6180.55,9212.00,0.00
2024-12-08 16:57:18,48,7624,11,37,6051.79,9212.02,0.00
2024-12-08 16:57:18,47,7624,11,36,6118.22,9212.15,0.00
2024-12-08 16:57:18,47,7625,11,36,6158.04,9213.00,0.00
2024-12-08 16:57:18,48,7625,12,36,6029.75,9213.02,0.00
2024-12-08 16:57:18,47,7625,12,35,6124.72,9213.02,0.00
2024-12-08 16:57:18,47,7626,12,35,6152.83,9214.00,0.00
2024-12-08 16:57:18,48,7626,12,36,6024.64,9214.02,0.00
2024-12-08 16:57:18,48,7627,12,36,6011.86,9215.00,0.00
2024-12-08 16:57:18,49,7627,13,36,5889.17,9215.02,0.00
2024-12-08 16:57:18,48,7627,13,35,5981.14,9215.02,0.00
2024-12-08 16:57:18,47,7627,12,35,6038.21,9215.68,0.00
2024-12-08 16:57:18,47,7628,12,35,6205.15,9216.00,0.00
2024-12-08 16:57:18,48,7628,13,35,6075.87,9216.02,0.00
2024-12-08 16:57:18,48,7629,13,35,6063.03,9217.00,0.00
2024-12-08 16:57:18,49,7629,13,36,5939.30,9217.02,0.00
2024-12-08 16:57:18,48,7629,13,35,6034.23,9217.02,0.00
2024-12-08 16:57:18,48,7630,13,35,6059.17,9218.00,0.00
2024-12-08 16:57:18,49,7630,14,35,5935.51,9218.02,0.00
2024-12-08 16:57:18,49,7631,14,35,5919.94,9219.00,0.00
2024-12-08 16:57:18,50,7631,15,35,5801.55,9219.02,0.00
2024-12-08 16:57:18,49,7631,15,34,5887.96,9219.02,0.00
2024-12-08 16:57:18,49,7632,15,34,5910.02,9220.00,0.00
2024-12-08 16:57:18,50,7632,15,35,5791.82,9220.02,0.00
2024-12-08 16:57:18,50,7633,15,35,5775.78,9221.00,0.00
2024-12-08 16:57:18,51,7633,16,35,5662.53,9221.02,0.00
2024-12-08 16:57:18,50,7633,16,34,5745.28,9221.04,0.00
2024-12-08 16:57:18,49,7633,15,34,5825.32,9221.16,0.00
2024-12-08 16:57:18,49,7634,15,34,5935.35,9222.00,0.00
2024-12-08 16:57:18,50,7634,16,34,5816.64,9222.02,0.00
2024-12-08 16:57:18,49,7634,15,34,5798.18,9222.47,0.00
2024-12-08 16:57:18,49,7635,15,34,5937.23,9223.00,0.00
2024-12-08 16:57:18,50,7635,16,34,5818.49,9223.02,0.00
2024-12-08 16:57:18,49,7635,16,33,5899.59,9223.04,0.00
2024-12-08 16:57:18,49,7636,16,33,5924.70,9224.00,0.00
2024-12-08 16:57:18,50,7636,17,33,5806.21,9224.02,0.00
2024-12-08 16:57:18,49,7636,16,33,5789.67,9224.84,0.00
2024-12-08 16:57:18,49,7636,16,33,5963.00,9225.00,0.00
2024-12-08 16:57:18,50,7636,16,34,5843.74,9225.02,0.00
2024-12-08 16:57:18,50,7637,16,34,5827.76,9226.00,0.00
2024-12-08 16:57:18,51,7637,17,34,5713.49,9226.02,0.00
2024-12-08 16:57:18,50,7637,17,33,5820.39,9226.08,0.00
2024-12-08 16:57:18,50,7638,17,33,5846.85,9227.00,0.00
2024-12-08 16:57:18,51,7638,17,34,5732.20,9227.02,0.00
2024-12-08 16:57:18,51,7639,17,34,5764.43,9228.00,0.00
2024-12-08 16:57:18,52,7639,17,35,5653.58,9228.02,0.00
2024-12-08 16:57:18,52,7640,17,35,5664.45,9229.00,0.00
2024-12-08 16:57:18,53,7640,18,35,5557.57,9229.02,0.00
2024-12-08 16:57:18,53,7641,18,35,5540.56,9230.00,0.00
2024-12-08 16:57:18,54,7641,18,36,5437.96,9230.02,0.00
2024-12-08 16:57:18,53,7641,17,36,5537.92,9230.04,0.00
2024-12-08 16:57:18,52,7641,17,35,5616.03,9230.06,0.00
2024-12-08 16:57:18,52,7642,17,35,5636.15,9231.00,0.00
2024-12-08 16:57:18,53,7642,18,35,5529.81,9231.02,0.00
2024-12-08 16:57:18,52,7642,17,35,5540.65,9231.65,0.00
2024-12-08 16:57:18,52,7643,17,35,5626.74,9232.00,0.00
2024-12-08 16:57:18,53,7643,18,35,5520.58,9232.02,0.00
2024-12-08 16:57:18,52,7643,18,34,5585.92,9232.06,0.00
2024-12-08 16:57:19,52,7644,18,34,5606.05,9233.00,0.00
2024-12-08 16:57:19,53,7644,19,34,5500.27,9233.02,0.00
2024-12-08 16:57:19,53,7645,19,34,5490.25,9234.00,0.00
2024-12-08 16:57:19,54,7645,20,34,5388.58,9234.02,0.00
2024-12-08 16:57:19,53,7645,20,33,5450.19,9234.06,0.00
2024-12-08 16:57:19,53,7646,20,33,5468.19,9235.00,0.00
2024-12-08 16:57:19,54,7646,21,33,5366.93,9235.02,0.00
2024-12-08 16:57:19,54,7647,21,33,5357.12,9236.00,0.00
2024-12-08 16:57:19,55,7647,22,33,5259.72,9236.02,0.00
2024-12-08 16:57:19,54,7647,22,32,5317.79,9236.06,0.00
2024-12-08 16:57:19,54,7648,22,32,5333.75,9237.00,0.00
2024-12-08 16:57:19,55,7648,23,32,5236.78,9237.02,0.00
2024-12-08 16:57:19,55,7649,23,32,5226.18,9238.00,0.00
2024-12-08 16:57:19,56,7649,23,33,5132.86,9238.02,0.00
2024-12-08 16:57:19,55,7649,23,32,5189.24,9238.06,0.00
2024-12-08 16:57:19,55,7650,23,32,5203.23,9239.00,0.00
2024-12-08 16:57:19,56,7650,24,32,5110.32,9239.02,0.00
2024-12-08 16:57:19,56,7651,24,32,5100.86,9240.00,0.00
2024-12-08 16:57:19,57,7651,24,33,5011.37,9240.02,0.00
2024-12-08 16:57:19,56,7651,24,32,5064.56,9240.05,0.00
2024-12-08 16:57:19,56,7652,24,32,5076.66,9241.00,0.00
2024-12-08 16:57:19,57,7652,25,32,4987.59,9241.02,0.00
2024-12-08 16:57:19,56,7652,24,32,5037.06,9241.07,0.00
2024-12-08 16:57:19,56,7653,24,32,5116.81,9242.00,0.00
2024-12-08 16:57:19,57,7653,24,33,5027.05,9242.02,0.00
2024-12-08 16:57:19,56,7653,24,32,5082.16,9242.05,0.00
2024-12-08 16:57:19,55,7653,23,32,5172.89,9242.06,0.00
2024-12-08 16:57:19,55,7654,23,32,5186.88,9243.00,0.00
2024-12-08 16:57:19,56,7654,24,32,5094.26,9243.02,0.00
2024-12-08 16:57:19,56,7655,24,32,5084.02,9244.00,0.00
2024-12-08 16:57:19,57,7655,24,33,4994.82,9244.02,0.00
2024-12-08 16:57:19,56,7655,24,32,5047.71,9244.05,0.00
2024-12-08 16:57:19,55,7655,23,32,5082.66,9244.65,0.00
2024-12-08 16:57:19,55,7656,23,32,5145.82,9245.00,0.00
2024-12-08 16:57:19,56,7656,23,33,5053.93,9245.02,0.00
2024-12-08 16:57:19,56,7657,23,33,5030.19,9246.00,0.00
2024-12-08 16:57:19,57,7657,23,34,4941.94,9246.02,0.00
2024-12-08 16:57:19,56,7657,23,33,4995.52,9246.05,0.00
2024-12-08 16:57:19,55,7657,22,33,4964.32,9246.82,0.00
2024-12-08 16:57:19,55,7658,22,33,5115.76,9247.00,0.00
2024-12-08 16:57:19,56,7658,23,33,5024.41,9247.02,0.00
2024-12-08 16:57:19,56,7659,23,33,4984.04,9248.00,0.00
2024-12-08 16:57:19,57,7659,24,33,4896.60,9248.02,0.00
2024-12-08 16:57:19,56,7659,24,32,4951.01,9248.05,0.00
2024-12-08 16:57:19,55,7659,23,32,4993.99,9248.56,0.00
2024-12-08 16:57:19,56,7658,23,33,4896.59,9248.68,0.00
2024-12-08 16:57:19,56,7659,23,33,4959.35,9249.00,0.00
2024-12-08 16:57:19,57,7659,24,33,4872.35,9249.02,0.00
2024-12-08 16:57:19,56,7659,23,33,4863.26,9249.61,0.00
2024-12-08 16:57:19,55,7659,23,32,4918.76,9249.67,0.00
2024-12-08 16:57:19,55,7660,23,32,5225.05,9250.00,0.00
2024-12-08 16:57:19,56,7660,23,33,5131.75,9250.02,0.00
2024-12-08 16:57:19,55,7660,23,32,5191.42,9250.06,0.00
2024-12-08 16:57:19,55,7661,23,32,5205.43,9251.00,0.00
2024-12-08 16:57:19,56,7661,24,32,5112.48,9251.02,0.00
2024-12-08 16:57:19,56,7661,24,32,5098.95,9252.00,0.00
2024-12-08 16:57:19,57,7661,24,33,5009.49,9252.02,0.00
2024-12-08 16:57:19,56,7661,24,32,5067.56,9252.05,0.00
2024-12-08 16:57:19,56,7662,24,32,5079.67,9253.00,0.00
2024-12-08 16:57:19,57,7662,24,33,4990.55,9253.02,0.00
2024-12-08 16:57:19,57,7663,24,33,4975.94,9254.00,0.00
2024-12-08 16:57:19,58,7663,25,33,4890.15,9254.02,0.00
2024-12-08 16:57:19,57,7663,25,32,4946.72,9254.05,0.00
2024-12-08 16:57:19,56,7663,24,32,4910.52,9254.96,0.00
2024-12-08 16:57:19,56,7664,24,32,5072.50,9255.00,0.00
2024-12-08 16:57:19,57,7664,25,32,4983.51,9255.02,0.00
2024-12-08 16:57:19,57,7665,25,32,4968.71,9256.00,0.00
2024-12-08 16:57:19,58,7665,25,33,4883.04,9256.02,0.00
2024-12-08 16:57:19,57,7665,25,32,4941.11,9256.05,0.00
2024-12-08 16:57:19,56,7665,24,32,4945.24,9256.48,0.00
2024-12-08 16:57:19,56,7666,24,32,5062.94,9257.00,0.00
2024-12-08 16:57:19,57,7666,24,33,4974.12,9257.02,0.00
2024-12-08 16:57:19,56,7666,23,33,5061.29,9257.02,0.00
2024-12-08 16:57:19,56,7667,23,33,5045.18,9258.00,0.00
2024-12-08 16:57:19,57,7667,24,33,4956.67,9258.02,0.00
2024-12-08 16:57:19,56,7667,24,32,5020.39,9258.04,0.00
2024-12-08 16:57:19,55,7667,23,32,5049.27,9258.58,0.00
2024-12-08 16:57:19,55,7668,23,32,5179.19,9259.00,0.00
2024-12-08 16:57:19,56,7668,23,33,5086.71,9259.02,0.00
2024-12-08 16:57:20,56,7669,23,33,5060.69,9260.00,0.00
2024-12-08 16:57:20,57,7669,24,33,4971.91,9260.02,0.00
2024-12-08 16:57:20,56,7669,24,32,5032.59,9260.05,0.00
2024-12-08 16:57:20,55,7669,23,32,5048.78,9260.31,0.00
2024-12-08 16:57:20,54,7669,22,32,5121.92,9260.52,0.00
2024-12-08 16:57:20,54,7670,22,32,5249.17,9261.00,0.00
2024-12-08 16:57:20,55,7670,23,32,5153.73,9261.02,0.00
2024-12-08 16:57:20,55,7671,23,32,5117.92,9262.00,0.00
2024-12-08 16:57:20,56,7671,23,33,5026.53,9262.02,0.00
2024-12-08 16:57:20,55,7671,23,32,5090.98,9262.06,0.00
2024-12-08 16:57:20,54,7671,23,31,5167.06,9262.15,0.00
2024-12-08 16:57:20,54,7672,23,31,5191.59,9263.00,0.00
2024-12-08 16:57:20,55,7672,24,31,5097.19,9263.02,0.00
2024-12-08 16:57:20,54,7672,23,31,5089.88,9263.33,0.00
2024-12-08 16:57:20,54,7673,23,31,5200.11,9264.00,0.00
2024-12-08 16:57:20,55,7673,24,31,5105.57,9264.02,0.00
2024-12-08 16:57:20,54,7673,24,30,5172.67,9264.06,0.00
2024-12-08 16:57:20,54,7674,24,30,5188.67,9265.00,0.00
2024-12-08 16:57:20,55,7674,25,30,5094.33,9265.02,0.00
2024-12-08 16:57:20,54,7674,24,30,5186.95,9265.02,0.00
2024-12-08 16:57:20,54,7675,24,30,5177.01,9266.00,0.00
2024-12-08 16:57:20,55,7675,24,31,5082.88,9266.02,0.00
2024-12-08 16:57:20,54,7675,24,30,5149.56,9266.04,0.00
2024-12-08 16:57:20,54,7676,24,30,5163.84,9267.00,0.00
2024-12-08 16:57:20,55,7676,24,31,5069.95,9267.02,0.00
2024-12-08 16:57:20,55,7677,24,31,5057.74,9268.00,0.00
2024-12-08 16:57:20,56,7677,24,32,4967.42,9268.02,0.00
2024-12-08 16:57:20,55,7677,24,31,5032.47,9268.04,0.00
2024-12-08 16:57:20,54,7677,23,31,4998.43,9268.96,0.00
2024-12-08 16:57:20,54,7678,23,31,5166.67,9269.00,0.00
2024-12-08 16:57:20,55,7678,24,31,5072.73,9269.02,0.00
2024-12-08 16:57:20,54,7678,23,31,5036.40,9269.48,0.00
2024-12-08 16:57:20,54,7679,23,31,5160.36,9270.00,0.00
2024-12-08 16:57:20,55,7679,24,31,5066.53,9270.02,0.00
2024-12-08 16:57:20,54,7679,24,30,5136.33,9270.04,0.00
2024-12-08 16:57:20,53,7679,23,30,5190.10,9270.49,0.00
2024-12-08 16:57:20,52,7679,22,30,5286.57,9270.52,0.00
2024-12-08 16:57:20,52,7680,22,30,5349.33,9271.00,0.00
2024-12-08 16:57:20,53,7680,22,31,5248.40,9271.02,0.00
2024-12-08 16:57:20,52,7680,21,31,5210.85,9271.44,0.00
2024-12-08 16:57:20,52,7681,21,31,5337.86,9272.00,0.00
2024-12-08 16:57:20,53,7681,22,31,5237.15,9272.02,0.00
2024-12-08 16:57:20,52,7681,22,30,5312.90,9272.04,0.00
2024-12-08 16:57:20,51,7681,21,30,5376.65,9272.24,0.00
2024-12-08 16:57:20,51,7682,21,30,5488.07,9273.00,0.00
2024-12-08 16:57:20,52,7682,21,31,5382.53,9273.02,0.00
2024-12-08 16:57:20,52,7683,21,31,5368.04,9274.00,0.00
2024-12-08 16:57:20,53,7683,21,32,5266.76,9274.02,0.00
2024-12-08 16:57:20,52,7683,21,31,5344.86,9274.04,0.00
2024-12-08 16:57:20,51,7683,20,31,5359.81,9274.77,0.00
2024-12-08 16:57:20,51,7684,20,31,5519.32,9275.00,0.00
2024-12-08 16:57:20,52,7684,21,31,5413.18,9275.02,0.00
2024-12-08 16:57:20,51,7684,20,31,5475.82,9275.08,0.00
2024-12-08 16:57:20,51,7685,20,31,5502.49,9276.00,0.00
2024-12-08 16:57:20,52,7685,20,32,5396.67,9276.02,0.00
2024-12-08 16:57:20,51,7685,20,31,5480.67,9276.04,0.00
2024-12-08 16:57:20,51,7686,20,31,5499.59,9277.00,0.00
2024-12-08 16:57:20,52,7686,20,32,5393.83,9277.02,0.00
2024-12-08 16:57:20,51,7686,19,32,5452.33,9277.14,0.00
2024-12-08 16:57:20,50,7686,18,32,5485.85,9277.76,0.00
2024-12-08 16:57:20,50,7687,18,32,5647.89,9278.00,0.00
2024-12-08 16:57:20,51,7687,18,33,5537.14,9278.02,0.00
2024-12-08 16:57:20,50,7687,18,32,5627.48,9278.04,0.00
2024-12-08 16:57:20,50,7688,18,32,5648.09,9279.00,0.00
2024-12-08 16:57:20,51,7688,18,33,5537.34,9279.02,0.00
2024-12-08 16:57:20,51,7689,18,33,5515.22,9280.00,0.00
2024-12-08 16:57:20,52,7689,19,33,5409.16,9280.02,0.00
2024-12-08 16:57:20,51,7689,19,32,5495.21,9280.04,0.00
2024-12-08 16:57:20,52,7688,20,32,5348.70,9280.48,0.00
2024-12-08 16:57:20,51,7688,19,32,5437.16,9280.92,0.00
2024-12-08 16:57:20,51,7689,19,32,5611.92,9281.00,0.00
2024-12-08 16:57:20,52,7689,19,33,5504.00,9281.02,0.00
2024-12-08 16:57:20,52,7690,19,33,5653.77,9282.00,0.00
2024-12-08 16:57:20,53,7690,20,33,5547.10,9282.02,0.00
2024-12-08 16:57:20,52,7690,20,32,5635.93,9282.04,0.00
2024-12-08 16:57:20,51,7690,19,32,5677.33,9282.69,0.00
2024-12-08 16:57:20,51,7691,19,32,5820.00,9283.00,0.00
2024-12-08 16:57:20,52,7691,20,32,5708.08,9283.02,0.00
2024-12-08 16:57:20,52,7692,20,32,5673.05,9284.00,0.00
2024-12-08 16:57:20,53,7692,20,33,5566.01,9284.02,0.00
2024-12-08 16:57:20,52,7692,20,32,5655.20,9284.04,0.00
2024-12-08 16:57:20,52,7693,20,32,5656.67,9285.00,0.00
2024-12-08 16:57:20,53,7693,20,33,5549.94,9285.02,0.00
2024-12-08 16:57:20,52,7693,19,33,5496.67,9285.62,0.00
2024-12-08 16:57:20,52,7694,19,33,5623.97,9286.00,0.00
2024-12-08 16:57:20,53,7694,20,33,5517.86,9286.02,0.00
2024-12-08 16:57:20,52,7694,20,32,5606.11,9286.04,0.00
2024-12-08 16:57:20,53,7693,20,33,5460.32,9286.45,0.00
2024-12-08 16:57:21,53,7694,20,33,5558.54,9287.00,0.00
2024-12-08 16:57:21,54,7694,21,33,5455.60,9287.02,0.00
2024-12-08 16:57:21,54,7695,21,33,5583.20,9288.00,0.00
2024-12-08 16:57:21,55,7695,22,33,5481.68,9288.02,0.00
2024-12-08 16:57:21,54,7695,22,32,5564.28,9288.04,0.00
2024-12-08 16:57:21,54,7696,22,32,5548.78,9289.00,0.00
2024-12-08 16:57:21,55,7696,23,32,5447.90,9289.02,0.00
2024-12-08 16:57:21,54,7696,22,32,5534.52,9289.06,0.00
2024-12-08 16:57:21,54,7697,22,32,5501.47,9290.00,0.00
2024-12-08 16:57:21,55,7697,22,33,5401.44,9290.02,0.00
2024-12-08 16:57:21,54,7697,22,32,5499.07,9290.04,0.00
2024-12-08 16:57:21,53,7697,22,31,5574.78,9290.04,0.00
2024-12-08 16:57:21,52,7697,21,31,5678.43,9290.08,0.00
2024-12-08 16:57:21,52,7698,21,31,5674.17,9291.00,0.00
2024-12-08 16:57:21,53,7698,21,32,5567.11,9291.02,0.00
2024-12-08 16:57:21,53,7699,21,32,5530.07,9292.00,0.00
2024-12-08 16:57:21,54,7699,21,33,5427.66,9292.02,0.00
2024-12-08 16:57:21,53,7699,21,32,5500.26,9292.04,0.00
2024-12-08 16:57:21,53,7700,21,32,5495.09,9293.00,0.00
2024-12-08 16:57:21,54,7700,21,33,5393.33,9293.02,0.00
2024-12-08 16:57:21,53,7700,20,33,5493.34,9293.02,0.00
2024-12-08 16:57:21,53,7701,20,33,5487.28,9294.00,0.00
2024-12-08 16:57:21,54,7701,20,34,5385.66,9294.02,0.00
2024-12-08 16:57:21,53,7701,20,33,5403.64,9294.49,0.00
2024-12-08 16:57:21,52,7701,20,32,5497.47,9294.50,0.00
2024-12-08 16:57:21,52,7702,20,32,5567.54,9295.00,0.00
2024-12-08 16:57:21,53,7702,20,33,5462.49,9295.02,0.00
2024-12-08 16:57:21,52,7702,20,32,5542.52,9295.02,0.00
2024-12-08 16:57:21,51,7702,19,32,5605.50,9295.51,0.00
2024-12-08 16:57:21,50,7702,18,32,5645.83,9295.70,0.00
2024-12-08 16:57:21,50,7703,18,32,5804.09,9296.00,0.00
2024-12-08 16:57:21,51,7703,18,33,5690.29,9296.02,0.00
2024-12-08 16:57:21,51,7704,18,33,5686.19,9297.00,0.00
2024-12-08 16:57:21,52,7704,18,34,5576.84,9297.02,0.00
2024-12-08 16:57:21,51,7704,17,34,5534.61,9297.86,0.00
2024-12-08 16:57:21,51,7705,17,34,5704.27,9298.00,0.00
2024-12-08 16:57:21,52,7705,17,35,5594.57,9298.02,0.00
2024-12-08 16:57:21,51,7705,16,35,5699.22,9298.06,0.00
2024-12-08 16:57:21,50,7705,16,34,5811.35,9298.06,0.00
2024-12-08 16:57:21,49,7705,15,34,5892.07,9298.23,0.00
2024-12-08 16:57:21,49,7706,15,34,6010.28,9299.00,0.00
2024-12-08 16:57:21,50,7706,16,34,5890.08,9299.02,0.00
2024-12-08 16:57:21,49,7706,15,34,5945.76,9299.02,0.00
2024-12-08 16:57:21,49,7707,15,34,6007.13,9300.00,0.00
2024-12-08 16:57:21,50,7707,15,35,5886.99,9300.02,0.00
2024-12-08 16:57:21,49,7707,15,34,5965.38,9300.04,0.00
2024-12-08 16:57:21,49,7708,15,34,5990.70,9301.00,0.00
2024-12-08 16:57:21,50,7708,16,34,5870.88,9301.02,0.00
2024-12-08 16:57:21,49,7708,15,34,5848.39,9301.45,0.00
2024-12-08 16:57:21,49,7709,15,34,5987.39,9302.00,0.00
2024-12-08 16:57:21,50,7709,15,35,5867.65,9302.02,0.00
2024-12-08 16:57:21,49,7709,15,34,5945.63,9302.04,0.00
2024-12-08 16:57:21,49,7710,15,34,5970.95,9303.00,0.00
2024-12-08 16:57:21,50,7710,15,35,5851.53,9303.02,0.00
2024-12-08 16:57:21,49,7710,14,35,5970.81,9303.02,0.00
2024-12-08 16:57:21,48,7710,13,35,5932.50,9303.60,0.00
2024-12-08 16:57:21,48,7711,13,35,6089.81,9304.00,0.00
2024-12-08 16:57:21,49,7711,13,36,5965.53,9304.02,0.00
2024-12-08 16:57:21,48,7711,13,35,6049.11,9304.02,0.00
2024-12-08 16:57:21,48,7712,13,35,6074.96,9305.00,0.00
2024-12-08 16:57:21,49,7712,14,35,5950.98,9305.02,0.00
2024-12-08 16:57:21,48,7712,13,35,5988.22,9305.52,0.00
2024-12-08 16:57:21,48,7713,13,35,6065.93,9306.00,0.00
2024-12-08 16:57:21,49,7713,14,35,5942.13,9306.02,0.00
2024-12-08 16:57:21,48,7713,14,34,6027.15,9306.02,0.00
2024-12-08 16:57:21,48,7714,14,34,6053.00,9307.00,0.00
2024-12-08 16:57:21,49,7714,14,35,5929.47,9307.02,0.00
2024-12-08 16:57:21,49,7715,14,35,5914.29,9308.00,0.00
2024-12-08 16:57:21,50,7715,15,35,5796.00,9308.02,0.00
2024-12-08 16:57:21,49,7715,15,34,5878.20,9308.02,0.00
2024-12-08 16:57:21,48,7715,14,34,6000.66,9308.02,0.00
2024-12-08 16:57:21,47,7715,13,34,6063.08,9308.62,0.00
2024-12-08 16:57:21,48,7714,14,34,5917.78,9308.75,0.00
2024-12-08 16:57:21,48,7715,14,34,6111.92,9309.00,0.00
2024-12-08 16:57:21,49,7715,14,35,5987.19,9309.02,0.00
2024-12-08 16:57:21,49,7716,14,35,6193.28,9310.00,0.00
2024-12-08 16:57:21,50,7716,14,36,6069.42,9310.02,0.00
2024-12-08 16:57:21,50,7717,14,36,6046.08,9311.00,0.00
2024-12-08 16:57:21,51,7717,14,37,5927.53,9311.02,0.00
2024-12-08 16:57:21,51,7718,14,37,5881.52,9312.00,0.00
2024-12-08 16:57:21,52,7718,14,38,5768.41,9312.02,0.00
2024-12-08 16:57:21,51,7718,14,37,5863.26,9312.04,0.00
2024-12-08 16:57:21,50,7718,13,37,5844.31,9312.94,0.00
2024-12-08 16:57:21,50,7719,13,37,6025.03,9313.00,0.00
2024-12-08 16:57:21,51,7719,14,37,5906.89,9313.02,0.00
2024-12-08 16:57:21,50,7719,14,36,5865.14,9313.64,0.00
2024-12-08 16:57:22,50,7720,14,36,6018.17,9314.00,0.00
2024-12-08 16:57:22,51,7720,15,36,5900.17,9314.02,0.00
2024-12-08 16:57:22,51,7721,15,36,5904.38,9315.00,0.00
2024-12-08 16:57:22,52,7721,15,37,5790.83,9315.02,0.00
2024-12-08 16:57:22,52,7722,15,37,5771.75,9316.00,0.00
2024-12-08 16:57:22,53,7722,15,38,5662.85,9316.02,0.00
2024-12-08 16:57:22,52,7722,15,37,5750.26,9316.04,0.00
2024-12-08 16:57:22,51,7722,14,37,5850.67,9316.16,0.00
2024-12-08 16:57:22,51,7723,14,37,5882.31,9317.00,0.00
2024-12-08 16:57:22,52,7723,15,37,5769.19,9317.02,0.00
2024-12-08 16:57:22,52,7724,15,37,5750.80,9318.00,0.00
2024-12-08 16:57:22,53,7724,16,37,5642.29,9318.02,0.00
2024-12-08 16:57:22,52,7724,16,36,5722.14,9318.04,0.00
2024-12-08 16:57:22,51,7724,15,36,5772.73,9318.65,0.00
2024-12-08 16:57:22,51,7725,15,36,5922.84,9319.00,0.00
2024-12-08 16:57:22,52,7725,15,37,5808.94,9319.02,0.00
2024-12-08 16:57:22,52,7726,15,37,5784.98,9320.00,0.00
2024-12-08 16:57:22,53,7726,16,37,5675.83,9320.02,0.00
2024-12-08 16:57:22,52,7726,16,36,5758.10,9320.04,0.00
2024-12-08 16:57:22,51,7726,15,36,5869.36,9320.04,0.00
2024-12-08 16:57:22,50,7726,14,36,5903.05,9320.40,0.00
2024-12-08 16:57:22,50,7727,14,36,6023.75,9321.00,0.00
2024-12-08 16:57:22,51,7727,14,37,5905.63,9321.02,0.00
2024-12-08 16:57:22,50,7727,13,37,5956.64,9321.04,0.00
2024-12-08 16:57:22,50,7728,13,37,5997.41,9322.00,0.00
2024-12-08 16:57:22,51,7728,13,38,5879.81,9322.02,0.00
2024-12-08 16:57:22,50,7728,13,37,5967.58,9322.04,0.00
2024-12-08 16:57:22,50,7729,13,37,5962.04,9323.00,0.00
2024-12-08 16:57:22,51,7729,14,37,5845.14,9323.02,0.00
2024-12-08 16:57:22,50,7729,13,37,5913.56,9323.02,0.00
2024-12-08 16:57:22,50,7730,13,37,5933.44,9324.00,0.00
2024-12-08 16:57:22,51,7730,13,38,5817.10,9324.02,0.00
2024-12-08 16:57:22,50,7730,13,37,5907.33,9324.02,0.00
2024-12-08 16:57:22,50,7731,13,37,5881.63,9325.00,0.00
2024-12-08 16:57:22,51,7731,13,38,5766.31,9325.02,0.00
2024-12-08 16:57:22,50,7731,13,37,5798.49,9325.44,0.00
2024-12-08 16:57:22,50,7732,13,37,5858.59,9326.00,0.00
2024-12-08 16:57:22,51,7732,13,38,5743.72,9326.02,0.00
2024-12-08 16:57:22,50,7732,13,37,5832.48,9326.02,0.00
2024-12-08 16:57:22,50,7733,13,37,5848.48,9327.00,0.00
2024-12-08 16:57:22,51,7733,13,38,5733.80,9327.02,0.00
2024-12-08 16:57:22,51,7734,13,38,5704.86,9328.00,0.00
2024-12-08 16:57:22,52,7734,14,38,5595.15,9328.02,0.00
2024-12-08 16:57:22,51,7734,14,37,5677.43,9328.02,0.00
2024-12-08 16:57:22,51,7735,14,37,5676.06,9329.00,0.00
2024-12-08 16:57:22,52,7735,14,38,5566.90,9329.02,0.00
2024-12-08 16:57:22,51,7735,13,38,5537.27,9329.47,0.00
2024-12-08 16:57:22,51,7736,13,38,5643.02,9330.00,0.00
2024-12-08 16:57:22,52,7736,13,39,5534.50,9330.02,0.00
2024-12-08 16:57:22,51,7736,13,38,5611.92,9330.02,0.00
2024-12-08 16:57:22,50,7736,12,38,5724.16,9330.02,0.00
2024-12-08 16:57:22,50,7737,12,38,5709.83,9331.00,0.00
2024-12-08 16:57:22,51,7737,13,38,5597.87,9331.02,0.00
2024-12-08 16:57:22,51,7738,13,38,5550.95,9332.00,0.00
2024-12-08 16:57:22,52,7738,14,38,5444.20,9332.02,0.00
2024-12-08 16:57:22,51,7738,14,37,5514.35,9332.02,0.00
2024-12-08 16:57:22,50,7738,14,36,5572.57,9332.56,0.00
2024-12-08 16:57:22,50,7739,14,36,5643.81,9333.00,0.00
2024-12-08 16:57:22,51,7739,15,36,5533.15,9333.02,0.00
2024-12-08 16:57:22,51,7740,15,36,5527.96,9334.00,0.00
2024-12-08 16:57:22,52,7740,15,37,5421.65,9334.02,0.00
2024-12-08 16:57:22,51,7740,15,36,5491.35,9334.02,0.00
2024-12-08 16:57:22,50,7740,14,36,5552.98,9334.52,0.00
2024-12-08 16:57:22,49,7740,13,36,5656.84,9334.61,0.00
2024-12-08 16:57:22,49,7741,13,36,5735.23,9335.00,0.00
2024-12-08 16:57:22,50,7741,14,36,5620.52,9335.02,0.00
2024-12-08 16:57:22,49,7741,13,36,5653.39,9335.23,0.00
2024-12-08 16:57:22,49,7742,13,36,5772.04,9336.00,0.00
2024-12-08 16:57:22,50,7742,14,36,5656.60,9336.02,0.00
2024-12-08 16:57:22,49,7742,14,35,5735.84,9336.02,0.00
2024-12-08 16:57:22,49,7743,14,35,5759.32,9337.00,0.00
2024-12-08 16:57:22,50,7743,14,36,5644.13,9337.02,0.00
2024-12-08 16:57:22,50,7744,14,36,5634.54,9338.00,0.00
2024-12-08 16:57:22,51,7744,14,37,5524.06,9338.02,0.00
2024-12-08 16:57:22,50,7744,14,36,5599.05,9338.02,0.00
2024-12-08 16:57:22,49,7744,13,36,5592.78,9338.92,0.00
2024-12-08 16:57:22,49,7745,13,36,5775.80,9339.00,0.00
2024-12-08 16:57:22,50,7745,14,36,5660.28,9339.02,0.00
2024-12-08 16:57:22,49,7745,13,36,5611.33,9339.61,0.00
2024-12-08 16:57:22,49,7746,13,36,5766.01,9340.00,0.00
2024-12-08 16:57:22,50,7746,13,37,5650.69,9340.02,0.00
2024-12-08 16:57:22,49,7746,13,36,5731.70,9340.02,0.00
2024-12-08 16:57:22,48,7746,12,36,5793.06,9340.63,0.00
2024-12-08 16:57:22,48,7747,12,36,5875.09,9341.00,0.00
2024-12-08 16:57:22,49,7747,13,36,5755.19,9341.02,0.00
2024-12-08 16:57:22,48,7747,12,36,5770.31,9341.58,0.00
2024-12-08 16:57:22,48,7748,12,36,5926.33,9342.00,0.00
2024-12-08 16:57:22,49,7748,13,36,5805.38,9342.02,0.00
2024-12-08 16:57:22,48,7748,13,35,5893.24,9342.02,0.00
2024-12-08 16:57:23,48,7749,13,35,5919.18,9343.00,0.00
2024-12-08 16:57:23,49,7749,13,36,5798.38,9343.02,0.00
2024-12-08 16:57:23,49,7750,13,36,5783.74,9344.00,0.00
2024-12-08 16:57:23,50,7750,13,37,5668.07,9344.02,0.00
2024-12-08 16:57:23,49,7750,13,36,5753.23,9344.02,0.00
2024-12-08 16:57:23,48,7750,12,36,5787.88,9344.77,0.00
2024-12-08 16:57:23,48,7751,12,36,5961.33,9345.00,0.00
2024-12-08 16:57:23,49,7751,13,36,5839.67,9345.02,0.00
2024-12-08 16:57:23,49,7752,13,36,5825.04,9346.00,0.00
2024-12-08 16:57:23,50,7752,13,37,5708.53,9346.02,0.00
2024-12-08 16:57:23,49,7752,13,36,5794.52,9346.02,0.00
2024-12-08 16:57:23,49,7753,13,36,5818.03,9347.00,0.00
2024-12-08 16:57:23,50,7753,14,36,5701.67,9347.02,0.00
2024-12-08 16:57:23,50,7754,14,36,5687.72,9348.00,0.00
2024-12-08 16:57:23,51,7754,15,36,5576.19,9348.02,0.00
2024-12-08 16:57:23,50,7754,15,35,5654.07,9348.04,0.00
2024-12-08 16:57:23,50,7755,15,35,5677.11,9349.00,0.00
2024-12-08 16:57:23,51,7755,15,36,5565.79,9349.02,0.00
2024-12-08 16:57:23,51,7756,15,36,5551.81,9350.00,0.00
2024-12-08 16:57:23,52,7756,15,37,5445.04,9350.02,0.00
2024-12-08 16:57:23,51,7756,15,36,5520.65,9350.04,0.00
2024-12-08 16:57:23,51,7757,15,36,5541.40,9351.00,0.00
2024-12-08 16:57:23,52,7757,16,36,5434.83,9351.02,0.00
2024-12-08 16:57:23,52,7758,16,36,5421.01,9352.00,0.00
2024-12-08 16:57:23,53,7758,17,36,5318.73,9352.02,0.00
2024-12-08 16:57:23,52,7758,17,35,5392.24,9352.04,0.00
2024-12-08 16:57:23,52,7759,17,35,5410.80,9353.00,0.00
2024-12-08 16:57:23,53,7759,18,35,5308.71,9353.02,0.00
2024-12-08 16:57:23,53,7760,18,35,5298.77,9354.00,0.00
2024-12-08 16:57:23,54,7760,19,35,5200.65,9354.02,0.00
2024-12-08 16:57:23,53,7760,19,34,5267.01,9354.04,0.00
2024-12-08 16:57:23,53,7761,19,34,5283.45,9355.00,0.00
2024-12-08 16:57:23,54,7761,19,35,5185.61,9355.02,0.00
2024-12-08 16:57:23,54,7762,19,35,5174.18,9356.00,0.00
2024-12-08 16:57:23,55,7762,19,36,5080.10,9356.02,0.00
2024-12-08 16:57:23,54,7762,19,35,5144.73,9356.04,0.00
2024-12-08 16:57:23,53,7762,18,35,5127.05,9356.53,0.00
2024-12-08 16:57:23,52,7762,17,35,5214.91,9356.64,0.00
2024-12-08 16:57:23,52,7763,17,35,5360.91,9357.00,0.00
2024-12-08 16:57:23,53,7763,18,35,5259.76,9357.02,0.00
2024-12-08 16:57:23,53,7764,18,35,5247.04,9358.00,0.00
2024-12-08 16:57:23,54,7764,18,36,5149.87,9358.02,0.00
2024-12-08 16:57:23,53,7764,18,35,5218.79,9358.04,0.00
2024-12-08 16:57:23,52,7764,17,35,5264.35,9358.60,0.00
2024-12-08 16:57:23,52,7765,17,35,5334.81,9359.00,0.00
2024-12-08 16:57:23,53,7765,18,35,5234.16,9359.02,0.00
2024-12-08 16:57:23,52,7765,17,35,5209.66,9359.79,0.00
2024-12-08 16:57:23,52,7766,17,35,5370.01,9360.00,0.00
2024-12-08 16:57:23,53,7766,18,35,5268.69,9360.02,0.00
2024-12-08 16:57:23,52,7766,18,34,5335.82,9360.06,0.00
2024-12-08 16:57:23,52,7767,18,34,5354.66,9361.00,0.00
2024-12-08 16:57:23,53,7767,19,34,5253.63,9361.02,0.00
2024-12-08 16:57:23,53,7768,19,34,5241.12,9362.00,0.00
2024-12-08 16:57:23,54,7768,19,35,5144.06,9362.02,0.00
2024-12-08 16:57:23,53,7768,19,34,5209.33,9362.06,0.00
2024-12-08 16:57:23,53,7769,19,34,5226.34,9363.00,0.00
2024-12-08 16:57:23,54,7769,19,35,5129.56,9363.02,0.00
2024-12-08 16:57:23,54,7770,19,35,5116.28,9364.00,0.00
2024-12-08 16:57:23,55,7770,20,35,5023.26,9364.02,0.00
2024-12-08 16:57:23,54,7770,20,34,5086.81,9364.06,0.00
2024-12-08 16:57:23,54,7771,20,34,5100.24,9365.00,0.00
2024-12-08 16:57:23,55,7771,20,35,5007.51,9365.02,0.00
2024-12-08 16:57:23,54,7771,19,35,5069.02,9365.02,0.00
2024-12-08 16:57:23,54,7772,19,35,5112.46,9366.00,0.00
2024-12-08 16:57:23,55,7772,19,36,5019.51,9366.02,0.00
2024-12-08 16:57:23,54,7772,19,35,5084.72,9366.04,0.00
2024-12-08 16:57:23,53,7772,18,35,5169.81,9366.10,0.00
2024-12-08 16:57:23,52,7772,17,35,5164.90,9366.52,0.00
2024-12-08 16:57:23,51,7772,16,35,5262.85,9366.55,0.00
2024-12-08 16:57:23,51,7773,16,35,5404.57,9367.00,0.00
2024-12-08 16:57:23,52,7773,17,35,5300.64,9367.02,0.00
2024-12-08 16:57:23,51,7773,17,34,5358.67,9367.04,0.00
2024-12-08 16:57:23,50,7773,16,34,5338.35,9367.60,0.00
2024-12-08 16:57:23,50,7774,16,34,5488.51,9368.00,0.00
2024-12-08 16:57:23,51,7774,16,35,5380.89,9368.02,0.00
2024-12-08 16:57:23,51,7775,16,35,5362.09,9369.00,0.00
2024-12-08 16:57:23,52,7775,17,35,5258.97,9369.02,0.00
2024-12-08 16:57:23,51,7775,17,34,5332.70,9369.04,0.00
2024-12-08 16:57:23,51,7776,17,34,5347.84,9370.00,0.00
2024-12-08 16:57:23,52,7776,18,34,5245.00,9370.02,0.00
2024-12-08 16:57:23,52,7777,18,34,5230.40,9371.00,0.00
2024-12-08 16:57:23,53,7777,19,34,5131.71,9371.02,0.00
2024-12-08 16:57:23,52,7777,19,33,5203.37,9371.04,0.00
2024-12-08 16:57:24,52,7778,19,33,5219.93,9372.00,0.00
2024-12-08 16:57:24,53,7778,19,34,5121.44,9372.02,0.00
2024-12-08 16:57:24,52,7778,18,34,5118.21,9372.64,0.00
2024-12-08 16:57:24,52,7779,18,34,5263.77,9373.00,0.00
2024-12-08 16:57:24,53,7779,19,34,5164.46,9373.02,0.00
2024-12-08 16:57:24,52,7779,19,33,5233.14,9373.06,0.00
2024-12-08 16:57:24,51,7779,18,33,5328.42,9373.12,0.00
2024-12-08 16:57:24,51,7780,18,33,5356.53,9374.00,0.00
2024-12-08 16:57:24,52,7780,18,34,5253.52,9374.02,0.00
2024-12-08 16:57:24,52,7781,18,34,5244.62,9375.00,0.00
2024-12-08 16:57:24,53,7781,18,35,5145.66,9375.02,0.00
2024-12-08 16:57:24,52,7781,18,34,5212.18,9375.06,0.00
2024-12-08 16:57:24,51,7781,17,34,5217.58,9375.43,0.00
2024-12-08 16:57:24,51,7782,17,34,5348.30,9376.00,0.00
2024-12-08 16:57:24,52,7782,17,35,5245.45,9376.02,0.00
2024-12-08 16:57:24,52,7783,17,35,5235.92,9377.00,0.00
2024-12-08 16:57:24,53,7783,18,35,5137.13,9377.02,0.00
2024-12-08 16:57:24,52,7783,18,34,5205.27,9377.06,0.00
2024-12-08 16:57:24,51,7783,17,34,5242.15,9377.63,0.00
2024-12-08 16:57:24,51,7784,17,34,5390.69,9378.00,0.00
2024-12-08 16:57:24,52,7784,18,34,5287.02,9378.02,0.00
2024-12-08 16:57:24,52,7785,18,34,5276.06,9379.00,0.00
2024-12-08 16:57:24,53,7785,19,34,5176.51,9379.02,0.00
2024-12-08 16:57:24,52,7785,19,33,5247.21,9379.06,0.00
2024-12-08 16:57:24,51,7785,18,33,5312.27,9379.45,0.00
2024-12-08 16:57:24,51,7786,18,33,5370.45,9380.00,0.00
2024-12-08 16:57:24,52,7786,18,34,5267.17,9380.02,0.00
2024-12-08 16:57:24,52,7787,18,34,5256.90,9381.00,0.00
2024-12-08 16:57:24,53,7787,18,35,5157.72,9381.02,0.00
2024-12-08 16:57:24,52,7787,18,34,5226.24,9381.06,0.00
2024-12-08 16:57:24,51,7787,17,34,5224.97,9381.82,0.00
2024-12-08 16:57:24,51,7788,17,34,5392.51,9382.00,0.00
2024-12-08 16:57:24,52,7788,17,35,5288.81,9382.02,0.00
2024-12-08 16:57:24,51,7788,16,35,5291.70,9382.61,0.00
2024-12-08 16:57:24,51,7789,16,35,5437.08,9383.00,0.00
2024-12-08 16:57:24,52,7789,16,36,5332.53,9383.02,0.00
2024-12-08 16:57:24,51,7789,16,35,5407.65,9383.06,0.00
2024-12-08 16:57:24,50,7789,15,35,5392.21,9383.60,0.00
2024-12-08 16:57:24,50,7790,15,35,5539.56,9384.00,0.00
2024-12-08 16:57:24,51,7790,16,35,5430.94,9384.02,0.00
2024-12-08 16:57:24,50,7790,15,35,5492.66,9384.12,0.00
2024-12-08 16:57:24,49,7790,14,35,5560.17,9384.57,0.00
2024-12-08 16:57:24,49,7791,14,35,5707.19,9385.00,0.00
2024-12-08 16:57:24,50,7791,15,35,5593.04,9385.02,0.00
2024-12-08 16:57:24,49,7791,15,34,5674.63,9385.06,0.00
2024-12-08 16:57:24,49,7792,15,34,5696.27,9386.00,0.00
2024-12-08 16:57:24,50,7792,15,35,5582.35,9386.02,0.00
2024-12-08 16:57:24,50,7793,15,35,5565.79,9387.00,0.00
2024-12-08 16:57:24,51,7793,15,36,5456.65,9387.02,0.00
2024-12-08 16:57:24,50,7793,15,35,5533.88,9387.06,0.00
2024-12-08 16:57:24,49,7793,14,35,5551.63,9387.45,0.00
2024-12-08 16:57:24,49,7794,14,35,5686.69,9388.00,0.00
2024-12-08 16:57:24,50,7794,15,35,5572.95,9388.02,0.00
2024-12-08 16:57:24,50,7795,15,35,5556.62,9389.00,0.00
2024-12-08 16:57:24,51,7795,15,36,5447.66,9389.02,0.00
2024-12-08 16:57:24,50,7795,15,35,5526.58,9389.06,0.00
2024-12-08 16:57:24,50,7796,15,35,5546.76,9390.00,0.00
2024-12-08 16:57:24,51,7796,16,35,5438.00,9390.02,0.00
2024-12-08 16:57:24,51,7797,16,35,5417.74,9391.00,0.00
2024-12-08 16:57:24,52,7797,16,36,5313.55,9391.02,0.00
2024-12-08 16:57:24,51,7797,16,35,5388.28,9391.06,0.00
2024-12-08 16:57:24,51,7798,16,35,5396.09,9392.00,0.00
2024-12-08 16:57:24,52,7798,16,36,5292.32,9392.02,0.00
2024-12-08 16:57:24,51,7798,15,36,5344.56,9392.16,0.00
2024-12-08 16:57:24,50,7798,14,36,5354.67,9392.48,0.00
2024-12-08 16:57:24,50,7799,14,36,5473.69,9393.00,0.00
2024-12-08 16:57:24,51,7799,15,36,5366.36,9393.02,0.00
2024-12-08 16:57:24,50,7799,15,35,5471.81,9393.02,0.00
2024-12-08 16:57:24,49,7799,15,34,5556.64,9393.04,0.00
2024-12-08 16:57:24,49,7799,15,34,5557.41,9394.00,0.00
2024-12-08 16:57:24,50,7799,15,35,5446.26,9394.02,0.00
2024-12-08 16:57:24,51,7798,16,35,5273.28,9394.37,0.00
2024-12-08 16:57:24,50,7798,15,35,5431.26,9394.50,0.00
2024-12-08 16:57:24,50,7799,15,35,5501.79,9395.00,0.00
2024-12-08 16:57:24,51,7799,16,35,5393.91,9395.02,0.00
2024-12-08 16:57:24,50,7799,16,34,5477.36,9395.04,0.00
2024-12-08 16:57:24,50,7800,16,34,5688.41,9396.00,0.00
2024-12-08 16:57:24,51,7800,17,34,5576.88,9396.02,0.00
2024-12-08 16:57:24,50,7800,16,34,5526.70,9396.94,0.00
2024-12-08 16:57:24,50,7801,16,34,5709.05,9397.00,0.00
2024-12-08 16:57:24,51,7801,16,35,5597.10,9397.02,0.00
2024-12-08 16:57:24,50,7801,16,34,5686.49,9397.04,0.00
2024-12-08 16:57:24,50,7802,16,34,5709.65,9398.00,0.00
2024-12-08 16:57:24,51,7802,17,34,5597.70,9398.02,0.00
2024-12-08 16:57:24,50,7802,16,34,5570.77,9398.46,0.00
2024-12-08 16:57:25,50,7803,16,34,5708.38,9399.00,0.00
2024-12-08 16:57:25,51,7803,17,34,5596.45,9399.02,0.00
2024-12-08 16:57:25,50,7803,17,33,5685.82,9399.04,0.00
2024-12-08 16:57:25,50,7804,17,33,5706.32,9400.00,0.00
2024-12-08 16:57:25,51,7804,18,33,5594.43,9400.02,0.00
2024-12-08 16:57:25,51,7805,18,33,5568.54,9401.00,0.00
2024-12-08 16:57:25,52,7805,18,34,5461.45,9401.02,0.00
2024-12-08 16:57:25,51,7805,18,33,5548.26,9401.04,0.00
2024-12-08 16:57:25,51,7806,18,33,5555.12,9402.00,0.00
2024-12-08 16:57:25,52,7806,19,33,5448.29,9402.02,0.00
2024-12-08 16:57:25,52,7807,19,33,5413.13,9403.00,0.00
2024-12-08 16:57:25,53,7807,19,34,5310.99,9403.02,0.00
2024-12-08 16:57:25,52,7807,19,33,5389.62,9403.04,0.00
2024-12-08 16:57:25,51,7807,18,33,5451.19,9403.51,0.00
2024-12-08 16:57:25,50,7807,17,33,5467.48,9403.88,0.00
2024-12-08 16:57:25,50,7808,17,33,5644.35,9404.00,0.00
2024-12-08 16:57:25,51,7808,17,34,5533.68,9404.02,0.00
2024-12-08 16:57:25,51,7809,17,34,5487.29,9405.00,0.00
2024-12-08 16:57:25,52,7809,18,34,5381.76,9405.02,0.00
2024-12-08 16:57:25,51,7809,18,33,5461.47,9405.04,0.00
2024-12-08 16:57:25,51,7810,18,33,5446.33,9406.00,0.00
2024-12-08 16:57:25,52,7810,18,34,5341.59,9406.02,0.00
2024-12-08 16:57:25,51,7810,17,34,5444.48,9406.02,0.00
2024-12-08 16:57:25,50,7810,17,33,5446.47,9406.66,0.00
2024-12-08 16:57:25,50,7811,17,33,5534.88,9407.00,0.00
2024-12-08 16:57:25,51,7811,17,34,5426.36,9407.02,0.00
2024-12-08 16:57:25,50,7811,17,33,5512.31,9407.02,0.00
2024-12-08 16:57:25,50,7812,17,33,5532.86,9408.00,0.00
2024-12-08 16:57:25,51,7812,18,33,5424.37,9408.02,0.00
2024-12-08 16:57:25,51,7813,18,33,5409.23,9409.00,0.00
2024-12-08 16:57:25,52,7813,19,33,5305.21,9409.02,0.00
2024-12-08 16:57:25,51,7813,19,32,5387.09,9409.02,0.00
2024-12-08 16:57:25,51,7814,19,32,5401.72,9410.00,0.00
2024-12-08 16:57:25,52,7814,20,32,5297.84,9410.02,0.00
2024-12-08 16:57:25,52,7815,20,32,5281.46,9411.00,0.00
2024-12-08 16:57:25,53,7815,21,32,5181.81,9411.02,0.00
2024-12-08 16:57:25,52,7815,21,31,5257.93,9411.02,0.00
2024-12-08 16:57:25,51,7815,21,30,5243.78,9411.27,0.00
2024-12-08 16:57:25,51,7816,21,30,5286.68,9412.00,0.00
2024-12-08 16:57:25,52,7816,21,31,5185.01,9412.02,0.00
2024-12-08 16:57:25,51,7816,20,31,5242.41,9412.10,0.00
2024-12-08 16:57:25,50,7816,19,31,5303.01,9412.56,0.00
2024-12-08 16:57:25,50,7817,19,31,5384.12,9413.00,0.00
2024-12-08 16:57:25,51,7817,19,32,5278.55,9413.02,0.00
2024-12-08 16:57:25,50,7817,19,31,5361.53,9413.02,0.00
2024-12-08 16:57:25,49,7817,18,31,5371.92,9413.73,0.00
2024-12-08 16:57:25,49,7818,18,31,5539.25,9414.00,0.00
2024-12-08 16:57:25,50,7818,18,32,5428.46,9414.02,0.00
2024-12-08 16:57:25,49,7818,17,32,5495.08,9414.08,0.00
2024-12-08 16:57:25,49,7819,17,32,5529.74,9415.00,0.00
2024-12-08 16:57:25,50,7819,18,32,5419.14,9415.02,0.00
2024-12-08 16:57:25,49,7819,18,31,5506.68,9415.02,0.00
2024-12-08 16:57:25,48,7819,17,31,5512.31,9415.48,0.00
2024-12-08 16:57:25,48,7820,17,31,5659.78,9416.00,0.00
2024-12-08 16:57:25,49,7820,17,32,5544.27,9416.02,0.00
2024-12-08 16:57:25,48,7820,16,32,5535.81,9416.73,0.00
2024-12-08 16:57:25,48,7821,16,32,5706.70,9417.00,0.00
2024-12-08 16:57:25,49,7821,16,33,5590.24,9417.02,0.00
2024-12-08 16:57:25,48,7821,16,32,5681.20,9417.02,0.00
2024-12-08 16:57:25,47,7821,15,32,5740.56,9417.62,0.00
2024-12-08 16:57:25,47,7822,15,32,5905.15,9418.00,0.00
2024-12-08 16:57:25,48,7822,16,32,5782.12,9418.02,0.00
2024-12-08 16:57:25,47,7822,15,32,5805.29,9418.64,0.00
2024-12-08 16:57:25,46,7822,14,32,5900.99,9418.74,0.00
2024-12-08 16:57:25,46,7823,14,32,6081.39,9419.00,0.00
2024-12-08 16:57:25,47,7823,14,33,5952.00,9419.02,0.00
2024-12-08 16:57:25,46,7823,14,32,6056.82,9419.02,0.00
2024-12-08 16:57:25,46,7824,14,32,6088.18,9420.00,0.00
2024-12-08 16:57:25,47,7824,14,33,5958.65,9420.02,0.00
2024-12-08 16:57:25,47,7825,14,33,6000.26,9421.00,0.00
2024-12-08 16:57:25,48,7825,14,34,5875.26,9421.02,0.00
2024-12-08 16:57:25,48,7826,14,34,5888.26,9422.00,0.00
2024-12-08 16:57:25,49,7826,14,35,5768.10,9422.02,0.00
2024-12-08 16:57:25,48,7826,13,35,5760.19,9422.31,0.00
2024-12-08 16:57:25,48,7827,13,35,5892.21,9423.00,0.00
2024-12-08 16:57:25,49,7827,13,36,5771.96,9423.02,0.00
2024-12-08 16:57:25,48,7827,13,35,5868.65,9423.02,0.00
2024-12-08 16:57:25,48,7828,13,35,5894.80,9424.00,0.00
2024-12-08 16:57:25,49,7828,13,36,5774.50,9424.02,0.00
2024-12-08 16:57:25,48,7828,12,36,5770.77,9424.90,0.00
2024-12-08 16:57:25,48,7829,12,36,5957.38,9425.00,0.00
2024-12-08 16:57:25,49,7829,13,36,5835.80,9425.02,0.00
2024-12-08 16:57:25,48,7829,13,35,5933.82,9425.02,0.00
2024-12-08 16:57:25,48,7830,13,35,5959.98,9426.00,0.00
2024-12-08 16:57:25,49,7830,13,36,5838.35,9426.02,0.00
2024-12-08 16:57:25,48,7830,12,36,5873.66,9426.25,0.00
2024-12-08 16:57:25,48,7831,12,36,5999.89,9427.00,0.00
2024-12-08 16:57:25,49,7831,12,37,5877.44,9427.02,0.00
2024-12-08 16:57:25,48,7831,12,36,5976.32,9427.02,0.00
2024-12-08 16:57:26,48,7832,12,36,6002.49,9428.00,0.00
2024-12-08 16:57:26,49,7832,13,36,5879.99,9428.02,0.00
2024-12-08 16:57:26,49,7833,13,36,5865.22,9429.00,0.00
2024-12-08 16:57:26,50,7833,13,37,5747.92,9429.02,0.00
2024-12-08 16:57:26,49,7833,13,36,5838.28,9429.02,0.00
2024-12-08 16:57:26,49,7834,13,36,5861.99,9430.00,0.00
2024-12-08 16:57:26,50,7834,14,36,5744.75,9430.02,0.00
2024-12-08 16:57:26,49,7834,13,36,5815.82,9430.08,0.00
2024-12-08 16:57:26,49,7835,13,36,5845.29,9431.00,0.00
2024-12-08 16:57:26,50,7835,14,36,5728.39,9431.02,0.00
2024-12-08 16:57:26,49,7835,14,35,5820.27,9431.02,0.00
2024-12-08 16:57:26,50,7834,15,35,5647.60,9431.66,0.00
2024-12-08 16:57:26,49,7834,14,35,5736.17,9431.96,0.00
2024-12-08 16:57:26,49,7835,14,35,5924.83,9432.00,0.00
2024-12-08 16:57:26,50,7835,15,35,5806.34,9432.02,0.00
2024-12-08 16:57:26,50,7836,15,35,5978.63,9433.00,0.00
2024-12-08 16:57:26,51,7836,15,36,5861.40,9433.02,0.00
2024-12-08 16:57:26,50,7836,15,35,5954.11,9433.02,0.00
2024-12-08 16:57:26,50,7837,15,35,5975.49,9434.00,0.00
2024-12-08 16:57:26,51,7837,16,35,5858.33,9434.02,0.00
2024-12-08 16:57:26,51,7838,16,35,5840.45,9435.00,0.00
2024-12-08 16:57:26,52,7838,16,36,5728.13,9435.02,0.00
2024-12-08 16:57:26,51,7838,16,35,5818.25,9435.02,0.00
2024-12-08 16:57:26,51,7839,16,35,5837.37,9436.00,0.00
2024-12-08 16:57:26,52,7839,17,35,5725.11,9436.02,0.00
2024-12-08 16:57:26,51,7839,16,35,5728.21,9436.04,0.00
2024-12-08 16:57:26,51,7840,16,35,5823.18,9437.00,0.00
2024-12-08 16:57:26,52,7840,17,35,5711.20,9437.02,0.00
2024-12-08 16:57:26,51,7840,17,34,5793.58,9437.02,0.00
2024-12-08 16:57:26,51,7841,17,34,5812.69,9438.00,0.00
2024-12-08 16:57:26,52,7841,17,35,5700.91,9438.02,0.00
2024-12-08 16:57:26,52,7842,17,35,5685.82,9439.00,0.00
2024-12-08 16:57:26,53,7842,18,35,5578.54,9439.02,0.00
2024-12-08 16:57:26,52,7842,18,34,5656.78,9439.02,0.00
2024-12-08 16:57:26,51,7842,17,34,5669.14,9439.43,0.00
2024-12-08 16:57:26,51,7843,17,34,5800.97,9440.00,0.00
2024-12-08 16:57:26,52,7843,18,34,5689.41,9440.02,0.00
2024-12-08 16:57:26,51,7843,17,34,5669.73,9440.43,0.00
2024-12-08 16:57:26,51,7844,17,34,5801.58,9441.00,0.00
2024-12-08 16:57:26,52,7844,17,35,5690.02,9441.02,0.00
2024-12-08 16:57:26,51,7844,17,34,5773.82,9441.02,0.00
2024-12-08 16:57:26,51,7845,17,34,5792.94,9442.00,0.00
2024-12-08 16:57:26,52,7845,17,35,5681.54,9442.02,0.00
2024-12-08 16:57:26,51,7845,16,35,5685.92,9442.69,0.00
2024-12-08 16:57:26,51,7846,16,35,5841.70,9443.00,0.00
2024-12-08 16:57:26,52,7846,17,35,5729.36,9443.02,0.00
2024-12-08 16:57:26,51,7846,17,34,5815.77,9443.02,0.00
2024-12-08 16:57:26,51,7847,17,34,5834.91,9444.00,0.00
2024-12-08 16:57:26,52,7847,17,35,5722.70,9444.02,0.00
2024-12-08 16:57:26,52,7848,17,35,5708.25,9445.00,0.00
2024-12-08 16:57:26,53,7848,18,35,5600.55,9445.02,0.00
2024-12-08 16:57:26,52,7848,18,34,5679.19,9445.02,0.00
2024-12-08 16:57:26,51,7848,17,34,5785.01,9445.08,0.00
2024-12-08 16:57:26,51,7849,17,34,5809.68,9446.00,0.00
2024-12-08 16:57:26,52,7849,18,34,5697.96,9446.02,0.00
2024-12-08 16:57:26,52,7850,18,34,5682.62,9447.00,0.00
2024-12-08 16:57:26,53,7850,19,34,5575.40,9447.02,0.00
2024-12-08 16:57:26,52,7850,19,33,5655.37,9447.02,0.00
2024-12-08 16:57:26,51,7850,18,33,5721.88,9447.22,0.00
2024-12-08 16:57:26,51,7851,18,33,5833.56,9448.00,0.00
2024-12-08 16:57:26,52,7851,18,34,5721.37,9448.02,0.00
2024-12-08 16:57:26,52,7852,18,34,5703.89,9449.00,0.00
2024-12-08 16:57:26,53,7852,18,35,5596.27,9449.02,0.00
2024-12-08 16:57:26,52,7852,18,34,5678.45,9449.02,0.00
2024-12-08 16:57:26,51,7852,17,34,5703.05,9449.77,0.00
2024-12-08 16:57:26,51,7853,17,34,5866.29,9450.00,0.00
2024-12-08 16:57:26,52,7853,17,35,5753.48,9450.02,0.00
2024-12-08 16:57:26,51,7853,16,35,5759.71,9450.67,0.00
2024-12-08 16:57:26,51,7854,16,35,5913.77,9451.00,0.00
2024-12-08 16:57:26,52,7854,17,35,5800.05,9451.02,0.00
2024-12-08 16:57:26,51,7854,17,34,5889.68,9451.02,0.00
2024-12-08 16:57:26,50,7854,16,34,6003.71,9451.06,0.00
2024-12-08 16:57:26,50,7855,16,34,6028.91,9452.00,0.00
2024-12-08 16:57:26,51,7855,16,35,5910.69,9452.02,0.00
2024-12-08 16:57:26,51,7856,16,35,5892.78,9453.00,0.00
2024-12-08 16:57:26,52,7856,16,36,5779.46,9453.02,0.00
2024-12-08 16:57:26,51,7856,16,35,5866.83,9453.02,0.00
2024-12-08 16:57:26,50,7856,15,35,5855.93,9453.60,0.00
2024-12-08 16:57:26,50,7857,15,35,6007.49,9454.00,0.00
2024-12-08 16:57:26,51,7857,15,36,5889.70,9454.02,0.00
2024-12-08 16:57:26,50,7857,14,36,5897.97,9454.34,0.00
2024-12-08 16:57:27,50,7858,14,36,6025.15,9455.00,0.00
2024-12-08 16:57:27,51,7858,14,37,5907.01,9455.02,0.00
2024-12-08 16:57:27,50,7858,14,36,5996.78,9455.02,0.00
2024-12-08 16:57:27,49,7858,13,36,5986.35,9455.61,0.00
2024-12-08 16:57:27,49,7859,13,36,6142.97,9456.00,0.00
2024-12-08 16:57:27,50,7859,13,37,6020.11,9456.02,0.00
2024-12-08 16:57:27,50,7860,13,37,6003.72,9457.00,0.00
2024-12-08 16:57:27,51,7860,13,38,5886.00,9457.02,0.00
2024-12-08 16:57:27,50,7860,13,37,5975.35,9457.02,0.00
2024-12-08 16:57:27,50,7861,13,37,5996.79,9458.00,0.00
2024-12-08 16:57:27,51,7861,13,38,5879.21,9458.02,0.00
2024-12-08 16:57:27,50,7861,12,38,5849.51,9458.52,0.00
2024-12-08 16:57:27,50,7862,12,38,5993.64,9459.00,0.00
2024-12-08 16:57:27,51,7862,12,39,5876.12,9459.02,0.00
2024-12-08 16:57:27,50,7862,12,38,5967.16,9459.02,0.00
2024-12-08 16:57:27,50,7863,12,38,5988.60,9460.00,0.00
2024-12-08 16:57:27,51,7863,13,38,5871.18,9460.02,0.00
2024-12-08 16:57:27,52,7862,13,39,5701.96,9460.27,0.00
2024-12-08 16:57:27,52,7863,13,39,5826.20,9461.00,0.00
2024-12-08 16:57:27,53,7863,13,40,5716.27,9461.02,0.00
2024-12-08 16:57:27,52,7863,13,39,5800.73,9461.02,0.00
2024-12-08 16:57:27,52,7864,13,39,5999.68,9462.00,0.00
2024-12-08 16:57:27,53,7864,14,39,5886.48,9462.02,0.00
2024-12-08 16:57:27,53,7865,14,39,5865.67,9463.00,0.00
2024-12-08 16:57:27,54,7865,15,39,5757.05,9463.02,0.00
2024-12-08 16:57:27,53,7865,15,38,5837.11,9463.04,0.00
2024-12-08 16:57:27,53,7866,15,38,5853.79,9464.00,0.00
2024-12-08 16:57:27,54,7866,16,38,5745.39,9464.02,0.00
2024-12-08 16:57:27,53,7866,15,38,5702.29,9464.55,0.00
2024-12-08 16:57:27,53,7867,15,38,5838.34,9465.00,0.00
2024-12-08 16:57:27,54,7867,15,39,5730.22,9465.02,0.00
2024-12-08 16:57:27,53,7867,15,38,5806.20,9465.04,0.00
2024-12-08 16:57:27,52,7867,14,38,5861.76,9465.62,0.00
2024-12-08 16:57:27,52,7868,14,38,5934.86,9466.00,0.00
2024-12-08 16:57:27,53,7868,15,38,5822.88,9466.02,0.00
2024-12-08 16:57:27,53,7869,15,38,5805.02,9467.00,0.00
2024-12-08 16:57:27,54,7869,16,38,5697.52,9467.02,0.00
2024-12-08 16:57:27,53,7869,16,37,5772.87,9467.04,0.00
2024-12-08 16:57:27,52,7869,15,37,5768.55,9467.92,0.00
2024-12-08 16:57:27,52,7870,15,37,5943.40,9468.00,0.00
2024-12-08 16:57:27,53,7870,16,37,5831.26,9468.02,0.00
2024-12-08 16:57:27,53,7871,16,37,5812.73,9469.00,0.00
2024-12-08 16:57:27,54,7871,17,37,5705.08,9469.02,0.00
2024-12-08 16:57:27,53,7871,17,36,5782.36,9469.04,0.00
2024-12-08 16:57:27,53,7872,17,36,5799.05,9470.00,0.00
2024-12-08 16:57:27,54,7872,17,37,5691.66,9470.02,0.00
2024-12-08 16:57:27,54,7873,17,37,5672.92,9471.00,0.00
2024-12-08 16:57:27,55,7873,17,38,5569.78,9471.02,0.00
2024-12-08 16:57:27,54,7873,17,37,5643.11,9471.04,0.00
2024-12-08 16:57:27,53,7873,16,37,5747.80,9471.06,0.00
2024-12-08 16:57:27,52,7873,15,37,5802.20,9471.64,0.00
2024-12-08 16:57:27,52,7874,15,37,5877.16,9472.00,0.00
2024-12-08 16:57:27,53,7874,15,38,5766.27,9472.02,0.00
2024-12-08 16:57:27,53,7875,15,38,5745.43,9473.00,0.00
2024-12-08 16:57:27,54,7875,15,39,5639.04,9473.02,0.00
2024-12-08 16:57:27,53,7875,15,38,5716.84,9473.04,0.00
2024-12-08 16:57:27,52,7875,14,38,5763.16,9473.33,0.00
2024-12-08 16:57:27,52,7876,14,38,5882.05,9474.00,0.00
2024-12-08 16:57:27,53,7876,15,38,5771.06,9474.02,0.00
2024-12-08 16:57:27,53,7877,15,38,5781.80,9475.00,0.00
2024-12-08 16:57:27,54,7877,15,39,5674.73,9475.02,0.00
2024-12-08 16:57:27,53,7877,14,39,5684.31,9475.49,0.00
2024-12-08 16:57:27,53,7878,14,39,5815.19,9476.00,0.00
2024-12-08 16:57:27,54,7878,15,39,5707.50,9476.02,0.00
2024-12-08 16:57:27,53,7878,15,38,5783.02,9476.06,0.00
2024-12-08 16:57:27,53,7879,15,38,5801.50,9477.00,0.00
2024-12-08 16:57:27,54,7879,15,39,5694.07,9477.02,0.00
2024-12-08 16:57:27,54,7880,15,39,5723.55,9478.00,0.00
2024-12-08 16:57:27,55,7880,16,39,5619.49,9478.02,0.00
2024-12-08 16:57:27,55,7881,16,39,5634.66,9479.00,0.00
2024-12-08 16:57:27,56,7881,16,40,5534.04,9479.02,0.00
2024-12-08 16:57:27,56,7882,16,40,5522.19,9480.00,0.00
2024-12-08 16:57:27,57,7882,16,41,5425.30,9480.02,0.00
2024-12-08 16:57:27,56,7882,16,40,5483.26,9480.05,0.00
2024-12-08 16:57:27,56,7883,16,40,5495.68,9481.00,0.00
2024-12-08 16:57:27,57,7883,16,41,5399.26,9481.02,0.00
2024-12-08 16:57:27,56,7883,15,41,5382.64,9481.75,0.00
2024-12-08 16:57:27,56,7884,15,41,5528.43,9482.00,0.00
2024-12-08 16:57:27,57,7884,16,41,5431.44,9482.02,0.00
2024-12-08 16:57:27,56,7884,16,40,5503.04,9482.05,0.00
2024-12-08 16:57:28,56,7885,16,40,5515.47,9483.00,0.00
2024-12-08 16:57:28,57,7885,16,41,5418.70,9483.02,0.00
2024-12-08 16:57:28,57,7886,16,41,5397.01,9484.00,0.00
2024-12-08 16:57:28,58,7886,17,41,5303.96,9484.02,0.00
2024-12-08 16:57:28,57,7886,17,40,5372.06,9484.05,0.00
2024-12-08 16:57:28,57,7887,17,40,5382.60,9485.00,0.00
2024-12-08 16:57:28,58,7887,18,40,5289.80,9485.02,0.00
2024-12-08 16:57:28,57,7887,17,40,5288.07,9485.67,0.00
2024-12-08 16:57:28,57,7888,17,40,5362.76,9486.00,0.00
2024-12-08 16:57:28,58,7888,18,40,5270.29,9486.02,0.00
2024-12-08 16:57:28,57,7888,18,39,5339.46,9486.05,0.00
2024-12-08 16:57:28,56,7888,17,39,5378.17,9486.64,0.00
2024-12-08 16:57:28,56,7889,17,39,5446.19,9487.00,0.00
2024-12-08 16:57:28,57,7889,18,39,5350.64,9487.02,0.00
2024-12-08 16:57:28,57,7890,18,39,5327.76,9488.00,0.00
2024-12-08 16:57:28,58,7890,18,40,5235.90,9488.02,0.00
2024-12-08 16:57:28,57,7890,18,39,5304.46,9488.05,0.00
2024-12-08 16:57:28,57,7891,18,39,5315.00,9489.00,0.00
2024-12-08 16:57:28,58,7891,18,40,5223.36,9489.02,0.00
2024-12-08 16:57:28,58,7892,18,40,5200.14,9490.00,0.00
2024-12-08 16:57:28,59,7892,19,40,5112.00,9490.02,0.00
2024-12-08 16:57:28,58,7892,19,39,5178.88,9490.05,0.00
2024-12-08 16:57:28,57,7892,18,39,5219.09,9490.30,0.00
2024-12-08 16:57:28,57,7893,18,39,5319.45,9491.00,0.00
2024-12-08 16:57:28,58,7893,19,39,5227.74,9491.02,0.00
2024-12-08 16:57:28,57,7893,18,39,5231.04,9491.60,0.00
2024-12-08 16:57:28,57,7894,18,39,5296.80,9492.00,0.00
2024-12-08 16:57:28,58,7894,18,40,5205.47,9492.02,0.00
2024-12-08 16:57:28,57,7894,18,39,5276.82,9492.05,0.00
2024-12-08 16:57:28,57,7895,18,39,5287.36,9493.00,0.00
2024-12-08 16:57:28,58,7895,19,39,5196.20,9493.02,0.00
2024-12-08 16:57:28,59,7894,19,40,4925.07,9493.98,0.00
2024-12-08 16:57:28,59,7895,19,40,5150.36,9494.00,0.00
2024-12-08 16:57:28,60,7895,19,41,5064.52,9494.02,0.00
2024-12-08 16:57:28,59,7895,18,41,5148.75,9494.02,0.00
2024-12-08 16:57:28,58,7895,18,40,5221.15,9494.03,0.00
2024-12-08 16:57:28,58,7896,18,40,5391.47,9495.00,0.00
2024-12-08 16:57:28,59,7896,18,41,5300.09,9495.02,0.00
2024-12-08 16:57:28,59,7897,18,41,5270.78,9496.00,0.00
2024-12-08 16:57:28,60,7897,18,42,5182.94,9496.02,0.00
2024-12-08 16:57:28,59,7897,18,41,5256.30,9496.03,0.00
2024-12-08 16:57:28,58,7897,17,41,5249.88,9496.85,0.00
2024-12-08 16:57:28,58,7898,17,41,5399.01,9497.00,0.00
2024-12-08 16:57:28,59,7898,17,42,5307.50,9497.02,0.00
2024-12-08 16:57:28,58,7898,16,42,5275.12,9497.81,0.00
2024-12-08 16:57:28,58,7899,16,42,5421.01,9498.00,0.00
2024-12-08 16:57:28,59,7899,16,43,5329.13,9498.02,0.00
2024-12-08 16:57:28,58,7899,16,42,5407.91,9498.03,0.00
2024-12-08 16:57:28,58,7900,16,42,5415.03,9499.00,0.00
2024-12-08 16:57:28,59,7900,16,43,5323.25,9499.02,0.00
2024-12-08 16:57:28,58,7900,15,43,5367.57,9499.16,0.00
2024-12-08 16:57:28,58,7901,15,43,5386.75,9500.00,0.00
2024-12-08 16:57:28,59,7901,16,43,5295.45,9500.02,0.00
2024-12-08 16:57:28,58,7901,16,42,5373.65,9500.03,0.00
2024-12-08 16:57:28,57,7901,15,42,5460.91,9500.11,0.00
2024-12-08 16:57:28,56,7901,14,42,5467.72,9500.82,0.00
2024-12-08 16:57:28,56,7902,14,42,5620.56,9501.00,0.00
2024-12-08 16:57:28,57,7902,15,42,5521.96,9501.02,0.00
2024-12-08 16:57:28,57,7903,15,42,5495.86,9502.00,0.00
2024-12-08 16:57:28,58,7903,15,43,5401.11,9502.02,0.00
2024-12-08 16:57:28,57,7903,15,42,5486.51,9502.04,0.00
2024-12-08 16:57:28,57,7904,15,42,5495.42,9503.00,0.00
2024-12-08 16:57:28,58,7904,15,43,5400.67,9503.02,0.00
2024-12-08 16:57:28,58,7905,15,43,5373.39,9504.00,0.00
2024-12-08 16:57:28,59,7905,15,44,5282.31,9504.02,0.00
2024-12-08 16:57:28,58,7905,15,43,5361.92,9504.03,0.00
2024-12-08 16:57:28,57,7905,14,43,5331.24,9504.67,0.00
2024-12-08 16:57:28,57,7906,14,43,5466.56,9505.00,0.00
2024-12-08 16:57:28,58,7906,15,43,5372.31,9505.02,0.00
2024-12-08 16:57:28,57,7906,14,43,5360.74,9505.69,0.00
2024-12-08 16:57:28,57,7907,14,43,5497.75,9506.00,0.00
2024-12-08 16:57:28,58,7907,15,43,5402.96,9506.02,0.00
2024-12-08 16:57:28,57,7907,15,42,5482.74,9506.04,0.00
2024-12-08 16:57:28,56,7907,14,42,5527.18,9506.59,0.00
2024-12-08 16:57:28,56,7908,14,42,5586.84,9507.00,0.00
2024-12-08 16:57:28,57,7908,14,43,5488.82,9507.02,0.00
2024-12-08 16:57:28,57,7909,14,43,5455.65,9508.00,0.00
2024-12-08 16:57:28,58,7909,14,44,5361.58,9508.02,0.00
2024-12-08 16:57:28,57,7909,14,43,5440.63,9508.04,0.00
2024-12-08 16:57:28,56,7909,13,43,5531.02,9508.11,0.00
2024-12-08 16:57:28,56,7910,13,43,5539.86,9509.00,0.00
2024-12-08 16:57:28,57,7910,14,43,5442.67,9509.02,0.00
2024-12-08 16:57:29,57,7911,14,43,5407.05,9510.00,0.00
2024-12-08 16:57:29,58,7911,15,43,5313.82,9510.02,0.00
2024-12-08 16:57:29,57,7911,15,42,5390.36,9510.04,0.00
2024-12-08 16:57:29,57,7912,15,42,5389.63,9511.00,0.00
2024-12-08 16:57:29,58,7912,16,42,5296.70,9511.02,0.00
2024-12-08 16:57:29,57,7912,15,42,5387.96,9511.02,0.00
2024-12-08 16:57:29,57,7913,15,42,5354.00,9512.00,0.00
2024-12-08 16:57:29,58,7913,16,42,5261.69,9512.02,0.00
2024-12-08 16:57:29,57,7913,16,41,5337.32,9512.02,0.00
2024-12-08 16:57:29,57,7914,16,41,5334.75,9513.00,0.00
2024-12-08 16:57:29,58,7914,16,42,5242.77,9513.02,0.00
2024-12-08 16:57:29,57,7914,15,42,5213.85,9513.79,0.00
2024-12-08 16:57:29,57,7915,15,42,5351.15,9514.00,0.00
2024-12-08 16:57:29,58,7915,15,43,5258.89,9514.02,0.00
2024-12-08 16:57:29,57,7915,15,42,5336.13,9514.02,0.00
2024-12-08 16:57:29,56,7915,14,42,5307.67,9514.61,0.00
2024-12-08 16:57:29,56,7916,14,42,5427.36,9515.00,0.00
2024-12-08 16:57:29,57,7916,15,42,5332.14,9515.02,0.00
2024-12-08 16:57:29,56,7916,14,42,5362.87,9515.23,0.00
2024-12-08 16:57:29,55,7916,13,42,5404.55,9515.76,0.00
2024-12-08 16:57:29,55,7917,13,42,5555.25,9516.00,0.00
2024-12-08 16:57:29,56,7917,14,42,5456.05,9516.02,0.00
2024-12-08 16:57:29,55,7917,14,41,5539.68,9516.02,0.00
2024-12-08 16:57:29,55,7918,14,41,5545.26,9517.00,0.00
2024-12-08 16:57:29,56,7918,15,41,5446.24,9517.02,0.00
2024-12-08 16:57:29,56,7919,15,41,5415.66,9518.00,0.00
2024-12-08 16:57:29,57,7919,16,41,5320.65,9518.02,0.00
2024-12-08 16:57:29,56,7919,16,40,5396.97,9518.02,0.00
2024-12-08 16:57:29,56,7920,16,40,5400.40,9519.00,0.00
2024-12-08 16:57:29,57,7920,16,41,5305.66,9519.02,0.00
2024-12-08 16:57:29,57,7921,16,41,5273.71,9520.00,0.00
2024-12-08 16:57:29,58,7921,16,42,5182.79,9520.02,0.00
2024-12-08 16:57:29,58,7922,16,42,5151.87,9521.00,0.00
2024-12-08 16:57:29,59,7922,17,42,5064.55,9521.02,0.00
2024-12-08 16:57:29,58,7922,17,41,5133.82,9521.03,0.00
2024-12-08 16:57:29,58,7923,17,41,5133.70,9522.00,0.00
2024-12-08 16:57:29,59,7923,18,41,5046.69,9522.02,0.00
2024-12-08 16:57:29,59,7924,18,41,5015.12,9523.00,0.00
2024-12-08 16:57:29,60,7924,18,42,4931.54,9523.02,0.00
2024-12-08 16:57:29,59,7924,18,41,4997.37,9523.03,0.00
2024-12-08 16:57:29,58,7924,17,41,4964.83,9523.91,0.00
2024-12-08 16:57:29,58,7925,17,41,5120.89,9524.00,0.00
2024-12-08 16:57:29,59,7925,17,42,5034.10,9524.02,0.00
2024-12-08 16:57:29,59,7926,17,42,5010.11,9525.00,0.00
2024-12-08 16:57:29,60,7926,17,43,4926.60,9525.02,0.00
2024-12-08 16:57:29,59,7926,17,42,4993.96,9525.03,0.00
2024-12-08 16:57:29,59,7927,17,42,4999.33,9526.00,0.00
2024-12-08 16:57:29,60,7927,17,43,4916.01,9526.02,0.00
2024-12-08 16:57:29,59,7927,16,43,4899.10,9526.68,0.00
2024-12-08 16:57:29,59,7928,16,43,5030.11,9527.00,0.00
2024-12-08 16:57:29,60,7928,16,44,4946.28,9527.02,0.00
2024-12-08 16:57:29,59,7928,16,43,5015.58,9527.03,0.00
2024-12-08 16:57:29,59,7929,16,43,5020.95,9528.00,0.00
2024-12-08 16:57:29,60,7929,17,43,4937.27,9528.02,0.00
2024-12-08 16:57:29,59,7929,16,43,4879.28,9528.92,0.00
2024-12-08 16:57:29,59,7930,16,43,5032.78,9529.00,0.00
2024-12-08 16:57:29,60,7930,17,43,4948.90,9529.02,0.00
2024-12-08 16:57:29,59,7930,17,42,5031.17,9529.02,0.00
2024-12-08 16:57:29,58,7930,17,41,5106.41,9529.02,0.00
2024-12-08 16:57:29,57,7930,16,41,5184.33,9529.14,0.00
2024-12-08 16:57:29,56,7930,15,41,5275.21,9529.14,0.00
2024-12-08 16:57:29,57,7929,16,41,5121.15,9529.82,0.00
2024-12-08 16:57:29,57,7930,16,41,5356.05,9530.00,0.00
2024-12-08 16:57:29,58,7930,17,41,5263.70,9530.02,0.00
2024-12-08 16:57:29,58,7931,17,41,5400.64,9531.00,0.00
2024-12-08 16:57:29,59,7931,18,41,5309.11,9531.02,0.00
2024-12-08 16:57:29,58,7931,18,40,5390.78,9531.02,0.00
2024-12-08 16:57:29,58,7932,18,40,5396.28,9532.00,0.00
2024-12-08 16:57:29,59,7932,18,41,5304.82,9532.02,0.00
2024-12-08 16:57:29,59,7933,18,41,5276.29,9533.00,0.00
2024-12-08 16:57:29,60,7933,18,42,5188.35,9533.02,0.00
2024-12-08 16:57:29,59,7933,18,41,5268.21,9533.02,0.00
2024-12-08 16:57:29,59,7934,18,41,5272.00,9534.00,0.00
2024-12-08 16:57:29,60,7934,19,41,5184.13,9534.02,0.00
2024-12-08 16:57:29,59,7934,18,41,5223.56,9534.17,0.00
2024-12-08 16:57:29,59,7935,18,41,5241.84,9535.00,0.00
2024-12-08 16:57:29,60,7935,18,42,5154.48,9535.02,0.00
2024-12-08 16:57:29,59,7935,18,41,5235.38,9535.02,0.00
2024-12-08 16:57:29,58,7935,17,41,5260.11,9535.69,0.00
2024-12-08 16:57:29,58,7936,17,41,5329.39,9536.00,0.00
2024-12-08 16:57:29,59,7936,17,42,5239.06,9536.02,0.00
2024-12-08 16:57:29,58,7936,16,42,5180.40,9536.60,0.00
2024-12-08 16:57:29,59,7935,17,42,5070.17,9536.86,0.00
2024-12-08 16:57:29,59,7936,17,42,5294.93,9537.00,0.00
2024-12-08 16:57:29,60,7936,17,43,5206.69,9537.02,0.00
2024-12-08 16:57:29,59,7936,17,42,5290.08,9537.02,0.00
2024-12-08 16:57:30,58,7936,16,42,5281.64,9537.52,0.00
2024-12-08 16:57:30,58,7937,16,42,5564.83,9538.00,0.00
2024-12-08 16:57:30,59,7937,16,43,5470.51,9538.02,0.00
2024-12-08 16:57:30,58,7937,15,43,5500.87,9538.16,0.00
2024-12-08 16:57:30,58,7938,15,43,5581.71,9539.00,0.00
2024-12-08 16:57:30,59,7938,16,43,5487.10,9539.02,0.00
2024-12-08 16:57:30,58,7938,16,42,5578.42,9539.02,0.00
2024-12-08 16:57:30,58,7939,16,42,5579.71,9540.00,0.00
2024-12-08 16:57:30,59,7939,17,42,5485.14,9540.02,0.00
2024-12-08 16:57:30,59,7940,17,42,5452.21,9541.00,0.00
2024-12-08 16:57:30,60,7940,18,42,5361.34,9541.02,0.00
2024-12-08 16:57:30,59,7940,18,41,5450.59,9541.02,0.00
2024-12-08 16:57:30,58,7940,17,41,5478.16,9541.66,0.00
2024-12-08 16:57:30,58,7941,17,41,5544.22,9542.00,0.00
2024-12-08 16:57:30,59,7941,17,42,5450.25,9542.02,0.00
2024-12-08 16:57:30,59,7942,17,42,5417.49,9543.00,0.00
2024-12-08 16:57:30,60,7942,18,42,5327.20,9543.02,0.00
2024-12-08 16:57:30,59,7942,18,41,5412.64,9543.02,0.00
2024-12-08 16:57:30,58,7942,17,41,5482.98,9543.19,0.00
2024-12-08 16:57:30,58,7943,17,41,5565.98,9544.00,0.00
2024-12-08 16:57:30,59,7943,18,41,5471.64,9544.02,0.00
2024-12-08 16:57:30,58,7943,17,41,5437.19,9544.48,0.00
2024-12-08 16:57:30,58,7944,17,41,5552.77,9545.00,0.00
2024-12-08 16:57:30,59,7944,17,42,5458.66,9545.02,0.00
2024-12-08 16:57:30,58,7944,17,41,5542.90,9545.02,0.00
2024-12-08 16:57:30,58,7945,17,41,5541.27,9546.00,0.00
2024-12-08 16:57:30,59,7945,18,41,5447.35,9546.02,0.00
2024-12-08 16:57:30,59,7946,18,41,5410.45,9547.00,0.00
2024-12-08 16:57:30,60,7946,19,41,5320.27,9547.02,0.00
2024-12-08 16:57:30,59,7946,19,40,5399.13,9547.03,0.00
2024-12-08 16:57:30,59,7947,19,40,5395.56,9548.00,0.00
2024-12-08 16:57:30,60,7947,19,41,5305.63,9548.02,0.00
2024-12-08 16:57:30,59,7947,18,41,5280.27,9548.42,0.00
2024-12-08 16:57:30,59,7948,18,41,5387.50,9549.00,0.00
2024-12-08 16:57:30,60,7948,18,42,5297.70,9549.02,0.00
2024-12-08 16:57:30,59,7948,18,41,5377.79,9549.03,0.00
2024-12-08 16:57:30,58,7948,17,41,5336.77,9549.66,0.00
2024-12-08 16:57:30,58,7949,17,41,5468.74,9550.00,0.00
2024-12-08 16:57:30,59,7949,18,41,5376.05,9550.02,0.00
2024-12-08 16:57:30,59,7950,18,41,5341.49,9551.00,0.00
2024-12-08 16:57:30,60,7950,18,42,5252.47,9551.02,0.00
2024-12-08 16:57:30,59,7950,18,41,5331.78,9551.03,0.00
2024-12-08 16:57:30,58,7950,18,40,5394.34,9551.31,0.00
2024-12-08 16:57:30,57,7950,17,40,5411.96,9551.44,0.00
2024-12-08 16:57:30,56,7950,16,40,5488.28,9551.64,0.00
2024-12-08 16:57:30,56,7951,16,40,5625.00,9552.00,0.00
2024-12-08 16:57:30,57,7951,16,41,5526.32,9552.02,0.00
2024-12-08 16:57:30,57,7952,16,41,5500.08,9553.00,0.00
2024-12-08 16:57:30,58,7952,16,42,5405.26,9553.02,0.00
2024-12-08 16:57:30,57,7952,16,41,5490.03,9553.04,0.00
2024-12-08 16:57:30,57,7952,16,41,5498.98,9554.00,0.00
2024-12-08 16:57:30,58,7952,17,41,5404.17,9554.02,0.00
2024-12-08 16:57:30,57,7952,16,41,5452.09,9554.16,0.00
2024-12-08 16:57:30,56,7952,15,41,5445.87,9554.95,0.00
2024-12-08 16:57:30,56,7953,15,41,5611.41,9555.00,0.00
2024-12-08 16:57:30,57,7953,16,41,5512.97,9555.02,0.00
2024-12-08 16:57:30,56,7953,16,40,5601.18,9555.04,0.00
2024-12-08 16:57:30,56,7954,16,40,5612.00,9556.00,0.00
2024-12-08 16:57:30,57,7954,17,40,5513.55,9556.02,0.00
2024-12-08 16:57:30,57,7955,17,40,5487.30,9557.00,0.00
2024-12-08 16:57:30,58,7955,18,40,5392.69,9557.02,0.00
2024-12-08 16:57:30,57,7955,18,39,5478.92,9557.04,0.00
2024-12-08 16:57:30,57,7956,18,39,5487.87,9558.00,0.00
2024-12-08 16:57:30,58,7956,18,40,5393.25,9558.02,0.00
2024-12-08 16:57:30,57,7956,18,39,5443.05,9558.12,0.00
2024-12-08 16:57:30,57,7957,18,39,5460.37,9559.00,0.00
2024-12-08 16:57:30,58,7957,18,40,5366.22,9559.02,0.00
2024-12-08 16:57:30,57,7957,18,39,5453.66,9559.04,0.00
2024-12-08 16:57:30,57,7958,18,39,5462.61,9560.00,0.00
2024-12-08 16:57:30,58,7958,18,40,5368.43,9560.02,0.00
2024-12-08 16:57:30,57,7958,18,39,5442.49,9560.02,0.00
2024-12-08 16:57:30,57,7959,18,39,5449.77,9561.00,0.00
2024-12-08 16:57:30,58,7959,19,39,5355.80,9561.02,0.00
2024-12-08 16:57:30,57,7959,18,39,5351.14,9561.69,0.00
2024-12-08 16:57:30,57,7960,18,39,5421.82,9562.00,0.00
2024-12-08 16:57:30,58,7960,18,40,5328.34,9562.02,0.00
2024-12-08 16:57:30,57,7960,18,39,5418.46,9562.02,0.00
2024-12-08 16:57:30,57,7961,18,39,5425.74,9563.00,0.00
2024-12-08 16:57:30,58,7961,18,40,5332.19,9563.02,0.00
2024-12-08 16:57:30,58,7962,18,40,5304.72,9564.00,0.00
2024-12-08 16:57:30,59,7962,19,40,5214.81,9564.02,0.00
2024-12-08 16:57:30,58,7962,19,39,5296.48,9564.02,0.00
2024-12-08 16:57:30,57,7962,18,39,5324.30,9564.69,0.00
2024-12-08 16:57:30,56,7962,17,39,5409.14,9564.73,0.00
2024-12-08 16:57:30,56,7963,17,39,5554.53,9565.00,0.00
2024-12-08 16:57:30,57,7963,18,39,5457.08,9565.02,0.00
2024-12-08 16:57:31,57,7964,18,39,5430.80,9566.00,0.00
2024-12-08 16:57:31,58,7964,19,39,5337.17,9566.02,0.00
2024-12-08 16:57:31,57,7964,19,38,5424.09,9566.02,0.00
2024-12-08 16:57:31,57,7965,19,38,5431.37,9567.00,0.00
2024-12-08 16:57:31,58,7965,20,38,5337.72,9567.02,0.00
2024-12-08 16:57:31,57,7965,19,38,5334.35,9567.69,0.00
2024-12-08 16:57:31,57,7966,19,38,5405.08,9568.00,0.00
2024-12-08 16:57:31,58,7966,19,39,5311.89,9568.02,0.00
2024-12-08 16:57:31,57,7966,19,38,5396.68,9568.02,0.00
2024-12-08 16:57:31,56,7966,18,38,5467.48,9568.20,0.00
2024-12-08 16:57:31,56,7967,18,38,5561.98,9569.00,0.00
2024-12-08 16:57:31,57,7967,19,38,5464.40,9569.02,0.00
2024-12-08 16:57:31,57,7968,19,38,5438.11,9570.00,0.00
2024-12-08 16:57:31,58,7968,20,38,5344.35,9570.02,0.00
2024-12-08 16:57:31,57,7968,20,37,5429.71,9570.02,0.00
2024-12-08 16:57:31,57,7969,20,37,5437.00,9571.00,0.00
2024-12-08 16:57:31,58,7969,20,38,5343.26,9571.02,0.00
2024-12-08 16:57:31,58,7970,20,38,5315.76,9572.00,0.00
2024-12-08 16:57:31,59,7970,21,38,5225.66,9572.02,0.00
2024-12-08 16:57:31,58,7970,21,37,5309.16,9572.02,0.00
2024-12-08 16:57:31,58,7971,21,37,5314.66,9573.00,0.00
2024-12-08 16:57:31,59,7971,21,38,5224.58,9573.02,0.00
2024-12-08 16:57:31,59,7972,21,38,5195.92,9574.00,0.00
2024-12-08 16:57:31,60,7972,22,38,5109.32,9574.02,0.00
2024-12-08 16:57:31,59,7972,22,37,5191.05,9574.02,0.00
2024-12-08 16:57:31,58,7972,21,37,5216.51,9574.67,0.00
2024-12-08 16:57:31,58,7973,21,37,5284.41,9575.00,0.00
2024-12-08 16:57:31,59,7973,22,37,5194.84,9575.02,0.00
2024-12-08 16:57:31,59,7974,22,37,5166.17,9576.00,0.00
2024-12-08 16:57:31,60,7974,23,37,5080.06,9576.02,0.00
2024-12-08 16:57:31,59,7974,23,36,5162.92,9576.02,0.00
2024-12-08 16:57:31,59,7975,23,36,5166.71,9577.00,0.00
2024-12-08 16:57:31,60,7975,23,37,5080.60,9577.02,0.00
2024-12-08 16:57:31,59,7975,22,37,5072.88,9577.66,0.00
2024-12-08 16:57:31,59,7976,22,37,5138.03,9578.00,0.00
2024-12-08 16:57:31,60,7976,22,38,5052.39,9578.02,0.00
2024-12-08 16:57:31,59,7976,22,37,5136.40,9578.02,0.00
2024-12-08 16:57:31,58,7976,21,37,5141.14,9578.78,0.00
2024-12-08 16:57:31,58,7977,21,37,5284.96,9579.00,0.00
2024-12-08 16:57:31,59,7977,22,37,5195.39,9579.02,0.00
2024-12-08 16:57:31,58,7977,22,36,5250.28,9579.02,0.00
2024-12-08 16:57:31,58,7978,22,36,5255.78,9580.00,0.00
2024-12-08 16:57:31,59,7978,23,36,5166.70,9580.02,0.00
2024-12-08 16:57:31,58,7978,22,36,5145.30,9580.47,0.00
2024-12-08 16:57:31,58,7979,22,36,5259.64,9581.00,0.00
2024-12-08 16:57:31,59,7979,23,36,5170.49,9581.02,0.00
2024-12-08 16:57:31,58,7979,23,35,5254.68,9581.02,0.00
2024-12-08 16:57:31,58,7980,23,35,5260.18,9582.00,0.00
2024-12-08 16:57:31,59,7980,23,36,5171.03,9582.02,0.00
2024-12-08 16:57:31,58,7980,22,36,5176.04,9582.33,0.00
2024-12-08 16:57:31,57,7980,21,36,5235.13,9582.67,0.00
2024-12-08 16:57:31,57,7981,21,36,5371.52,9583.00,0.00
2024-12-08 16:57:31,58,7981,22,36,5278.91,9583.02,0.00
2024-12-08 16:57:31,57,7981,22,35,5368.16,9583.02,0.00
2024-12-08 16:57:31,58,7980,22,36,5257.50,9583.24,0.00
2024-12-08 16:57:31,58,7981,22,36,5375.30,9584.00,0.00
2024-12-08 16:57:31,59,7981,23,36,5284.19,9584.02,0.00
2024-12-08 16:57:31,59,7982,23,36,5417.96,9585.00,0.00
2024-12-08 16:57:31,60,7982,23,37,5327.66,9585.02,0.00
2024-12-08 16:57:31,59,7982,23,36,5413.09,9585.02,0.00
2024-12-08 16:57:31,59,7983,23,36,5416.90,9586.00,0.00
2024-12-08 16:57:31,60,7983,23,37,5326.62,9586.02,0.00
2024-12-08 16:57:31,60,7984,23,37,5296.81,9587.00,0.00
2024-12-08 16:57:31,61,7984,24,37,5209.98,9587.02,0.00
2024-12-08 16:57:31,60,7984,24,36,5293.62,9587.02,0.00
2024-12-08 16:57:31,59,7984,23,36,5320.31,9587.66,0.00
2024-12-08 16:57:31,58,7984,22,36,5372.49,9587.86,0.00
2024-12-08 16:57:31,58,7985,22,36,5524.67,9588.00,0.00
2024-12-08 16:57:31,59,7985,23,36,5431.03,9588.02,0.00
2024-12-08 16:57:31,59,7986,23,36,5402.34,9589.00,0.00
2024-12-08 16:57:31,60,7986,24,36,5312.30,9589.02,0.00
2024-12-08 16:57:31,59,7986,24,35,5394.22,9589.02,0.00
2024-12-08 16:57:31,59,7987,24,35,5398.03,9590.00,0.00
2024-12-08 16:57:31,60,7987,25,35,5308.06,9590.02,0.00
2024-12-08 16:57:31,59,7987,24,35,5349.33,9590.19,0.00
2024-12-08 16:57:31,59,7988,24,35,5369.33,9591.00,0.00
2024-12-08 16:57:31,60,7988,25,35,5279.84,9591.02,0.00
2024-12-08 16:57:31,59,7988,25,34,5362.83,9591.02,0.00
2024-12-08 16:57:31,59,7989,25,34,5366.64,9592.00,0.00
2024-12-08 16:57:31,60,7989,25,35,5277.20,9592.02,0.00
2024-12-08 16:57:31,59,7989,24,35,5256.14,9592.17,0.00
2024-12-08 16:57:31,58,7989,23,35,5297.43,9592.67,0.00
2024-12-08 16:57:31,58,7990,23,35,5431.62,9593.00,0.00
2024-12-08 16:57:31,59,7990,23,36,5339.56,9593.02,0.00
2024-12-08 16:57:31,58,7990,23,35,5418.39,9593.03,0.00
2024-12-08 16:57:32,58,7991,23,35,5425.57,9594.00,0.00
2024-12-08 16:57:32,59,7991,23,36,5333.61,9594.02,0.00
2024-12-08 16:57:32,58,7991,22,36,5310.17,9594.76,0.00
2024-12-08 16:57:32,58,7992,22,36,5452.60,9595.00,0.00
2024-12-08 16:57:32,59,7992,22,37,5360.19,9595.02,0.00
2024-12-08 16:57:32,58,7992,22,36,5441.03,9595.03,0.00
2024-12-08 16:57:32,58,7993,22,36,5448.21,9596.00,0.00
2024-12-08 16:57:32,59,7993,23,36,5355.87,9596.02,0.00
2024-12-08 16:57:32,59,7994,23,36,5326.90,9597.00,0.00
2024-12-08 16:57:32,60,7994,24,36,5238.12,9597.02,0.00
2024-12-08 16:57:32,59,7994,24,35,5313.89,9597.03,0.00
2024-12-08 16:57:32,59,7995,24,35,5319.32,9598.00,0.00
2024-12-08 16:57:32,60,7995,24,36,5230.67,9598.02,0.00
2024-12-08 16:57:32,60,7996,24,36,5200.81,9599.00,0.00
2024-12-08 16:57:32,61,7996,24,37,5115.56,9599.02,0.00
2024-12-08 16:57:32,60,7996,24,36,5189.62,9599.03,0.00
2024-12-08 16:57:32,59,7996,23,36,5203.08,9599.73,0.00
2024-12-08 16:57:32,59,7997,23,36,5339.96,9600.00,0.00
2024-12-08 16:57:32,60,7997,24,36,5250.96,9600.02,0.00
2024-12-08 16:57:32,60,7998,24,36,5221.10,9601.00,0.00
2024-12-08 16:57:32,61,7998,25,36,5135.51,9601.02,0.00
2024-12-08 16:57:32,60,7998,25,35,5211.50,9601.03,0.00
2024-12-08 16:57:32,59,7998,24,35,5188.04,9601.93,0.00
2024-12-08 16:57:32,59,7999,24,35,5344.32,9602.00,0.00
2024-12-08 16:57:32,60,7999,24,36,5255.25,9602.02,0.00
2024-12-08 16:57:32,59,7999,23,36,5248.61,9602.68,0.00
2024-12-08 16:57:32,59,8000,23,36,5315.58,9603.00,0.00
2024-12-08 16:57:32,60,8000,24,36,5226.99,9603.02,0.00
2024-12-08 16:57:32,59,8000,24,35,5307.45,9603.03,0.00
2024-12-08 16:57:32,59,8001,24,35,5312.88,9604.00,0.00
2024-12-08 16:57:32,60,8001,25,35,5224.33,9604.02,0.00
2024-12-08 16:57:32,60,8002,25,35,5242.24,9605.00,0.00
2024-12-08 16:57:32,61,8002,26,35,5156.30,9605.02,0.00
2024-12-08 16:57:32,61,8003,26,35,5162.06,9606.00,0.00
2024-12-08 16:57:32,62,8003,26,36,5078.80,9606.02,0.00
2024-12-08 16:57:32,62,8004,26,36,5058.54,9607.00,0.00
2024-12-08 16:57:32,63,8004,27,36,4978.25,9607.02,0.00
2024-12-08 16:57:32,62,8004,27,35,5030.65,9607.03,0.00
2024-12-08 16:57:32,61,8004,26,35,5074.02,9607.12,0.00
2024-12-08 16:57:32,60,8004,25,35,5101.23,9607.70,0.00
2024-12-08 16:57:32,60,8005,25,35,5222.27,9608.00,0.00
2024-12-08 16:57:32,61,8005,26,35,5136.66,9608.02,0.00
2024-12-08 16:57:32,60,8005,25,35,5204.66,9608.02,0.00
2024-12-08 16:57:32,60,8006,25,35,5215.56,9609.00,0.00
2024-12-08 16:57:32,61,8006,26,35,5130.06,9609.02,0.00
2024-12-08 16:57:32,60,8006,26,34,5207.56,9609.03,0.00
2024-12-08 16:57:32,60,8007,26,34,5172.79,9610.00,0.00
2024-12-08 16:57:32,61,8007,26,35,5087.99,9610.02,0.00
2024-12-08 16:57:32,61,8008,26,35,5002.55,9611.00,0.00
2024-12-08 16:57:32,62,8008,27,35,4921.87,9611.02,0.00
2024-12-08 16:57:32,61,8008,27,34,4996.25,9611.03,0.00
2024-12-08 16:57:32,60,8008,26,34,4889.79,9611.97,0.00
2024-12-08 16:57:32,60,8009,26,34,5046.81,9612.00,0.00
2024-12-08 16:57:32,61,8009,27,34,4964.07,9612.02,0.00
2024-12-08 16:57:32,60,8009,26,34,4844.96,9612.90,0.00
2024-12-08 16:57:32,59,8009,25,34,4905.43,9612.92,0.00
2024-12-08 16:57:32,59,8010,25,34,5060.28,9613.00,0.00
2024-12-08 16:57:32,60,8010,26,34,4975.94,9613.02,0.00
2024-12-08 16:57:32,59,8010,26,33,5053.55,9613.03,0.00
2024-12-08 16:57:32,59,8011,26,33,5053.74,9614.00,0.00
2024-12-08 16:57:32,60,8011,26,34,4969.51,9614.02,0.00
2024-12-08 16:57:32,60,8012,26,34,4932.50,9615.00,0.00
2024-12-08 16:57:32,61,8012,26,35,4851.64,9615.02,0.00
2024-12-08 16:57:32,60,8012,26,34,4925.57,9615.03,0.00
2024-12-08 16:57:32,59,8012,25,34,4929.36,9615.49,0.00
2024-12-08 16:57:32,59,8013,25,34,5037.12,9616.00,0.00
2024-12-08 16:57:32,60,8013,25,35,4953.17,9616.02,0.00
2024-12-08 16:57:32,59,8013,24,35,4902.25,9616.56,0.00
2024-12-08 16:57:32,59,8014,24,35,5015.84,9617.00,0.00
2024-12-08 16:57:32,60,8014,25,35,4932.25,9617.02,0.00
2024-12-08 16:57:32,59,8014,25,34,5008.78,9617.03,0.00
2024-12-08 16:57:32,58,8014,24,34,5025.64,9617.45,0.00
2024-12-08 16:57:32,58,8015,24,34,5130.56,9618.00,0.00
2024-12-08 16:57:32,59,8015,24,35,5043.60,9618.02,0.00
2024-12-08 16:57:32,58,8015,24,34,5089.26,9618.03,0.00
2024-12-08 16:57:32,57,8015,23,34,5138.14,9618.32,0.00
2024-12-08 16:57:32,57,8016,23,34,5232.67,9619.00,0.00
2024-12-08 16:57:32,58,8016,24,34,5142.45,9619.02,0.00
2024-12-08 16:57:32,57,8016,23,34,5190.77,9619.04,0.00
2024-12-08 16:57:32,57,8017,23,34,5224.94,9620.00,0.00
2024-12-08 16:57:32,58,8017,24,34,5134.86,9620.02,0.00
2024-12-08 16:57:32,57,8017,24,33,5213.44,9620.04,0.00
2024-12-08 16:57:32,57,8018,24,33,5214.67,9621.00,0.00
2024-12-08 16:57:32,58,8018,25,33,5124.77,9621.02,0.00
2024-12-08 16:57:32,57,8018,24,33,5213.06,9621.02,0.00
2024-12-08 16:57:32,56,8018,23,33,5197.07,9621.71,0.00
2024-12-08 16:57:33,56,8019,23,33,5273.31,9622.00,0.00
2024-12-08 16:57:33,57,8019,23,34,5180.79,9622.02,0.00
2024-12-08 16:57:33,56,8019,23,33,5264.72,9622.04,0.00
2024-12-08 16:57:33,56,8020,23,33,5269.97,9623.00,0.00
2024-12-08 16:57:33,57,8020,24,33,5177.52,9623.02,0.00
2024-12-08 16:57:33,57,8021,24,33,5144.46,9624.00,0.00
2024-12-08 16:57:33,58,8021,24,34,5055.76,9624.02,0.00
2024-12-08 16:57:33,57,8021,24,33,5134.33,9624.04,0.00
2024-12-08 16:57:33,56,8021,23,33,5171.81,9624.48,0.00
2024-12-08 16:57:33,56,8022,23,33,5225.46,9625.00,0.00
2024-12-08 16:57:33,57,8022,24,33,5133.78,9625.02,0.00
2024-12-08 16:57:33,57,8023,24,33,5107.30,9626.00,0.00
2024-12-08 16:57:33,58,8023,25,33,5019.24,9626.02,0.00
2024-12-08 16:57:33,57,8023,25,32,5098.85,9626.04,0.00
2024-12-08 16:57:33,56,8023,24,32,5069.29,9626.96,0.00
2024-12-08 16:57:33,56,8024,24,32,5237.78,9627.00,0.00
2024-12-08 16:57:33,57,8024,24,33,5145.89,9627.02,0.00
2024-12-08 16:57:33,57,8025,24,33,5117.86,9628.00,0.00
2024-12-08 16:57:33,58,8025,24,34,5029.62,9628.02,0.00
2024-12-08 16:57:33,57,8025,24,33,5109.42,9628.04,0.00
2024-12-08 16:57:33,57,8026,24,33,5116.66,9629.00,0.00
2024-12-08 16:57:33,58,8026,25,33,5028.44,9629.02,0.00
2024-12-08 16:57:33,57,8026,24,33,5032.20,9629.07,0.00
2024-12-08 16:57:33,56,8026,23,33,5059.54,9629.68,0.00
2024-12-08 16:57:33,56,8027,23,33,5200.79,9630.00,0.00
2024-12-08 16:57:33,57,8027,24,33,5109.55,9630.02,0.00
2024-12-08 16:57:33,56,8027,24,32,5190.48,9630.05,0.00
2024-12-08 16:57:33,55,8027,23,32,5270.89,9630.20,0.00
2024-12-08 16:57:33,55,8028,23,32,5296.27,9631.00,0.00
2024-12-08 16:57:33,56,8028,24,32,5201.69,9631.02,0.00
2024-12-08 16:57:33,55,8028,23,32,5243.78,9631.20,0.00
2024-12-08 16:57:33,55,8029,23,32,5271.54,9632.00,0.00
2024-12-08 16:57:33,56,8029,24,32,5177.40,9632.02,0.00
2024-12-08 16:57:33,55,8029,24,31,5254.03,9632.07,0.00
2024-12-08 16:57:33,55,8030,24,31,5266.22,9633.00,0.00
2024-12-08 16:57:33,56,8030,24,32,5172.18,9633.02,0.00
2024-12-08 16:57:33,55,8030,23,32,5164.80,9633.65,0.00
2024-12-08 16:57:33,55,8031,23,32,5238.57,9634.00,0.00
2024-12-08 16:57:33,56,8031,24,32,5145.02,9634.02,0.00
2024-12-08 16:57:33,55,8031,24,31,5222.81,9634.07,0.00
2024-12-08 16:57:33,54,8031,23,31,5195.06,9634.96,0.00
2024-12-08 16:57:33,54,8032,23,31,5369.94,9635.00,0.00
2024-12-08 16:57:33,55,8032,23,32,5272.30,9635.02,0.00
2024-12-08 16:57:33,55,8033,23,32,5242.83,9636.00,0.00
2024-12-08 16:57:33,56,8033,23,33,5149.21,9636.02,0.00
2024-12-08 16:57:33,55,8033,23,32,5228.82,9636.07,0.00
2024-12-08 16:57:33,54,8033,22,32,5314.98,9636.19,0.00
2024-12-08 16:57:33,54,8034,22,32,5338.37,9637.00,0.00
2024-12-08 16:57:33,55,8034,23,32,5241.31,9637.02,0.00
2024-12-08 16:57:33,55,8035,23,32,5211.60,9638.00,0.00
2024-12-08 16:57:33,56,8035,24,32,5118.54,9638.02,0.00
2024-12-08 16:57:33,55,8035,24,31,5197.59,9638.07,0.00
2024-12-08 16:57:33,55,8036,24,31,5208.22,9639.00,0.00
2024-12-08 16:57:33,56,8036,25,31,5115.22,9639.02,0.00
2024-12-08 16:57:33,56,8037,25,31,5084.80,9640.00,0.00
2024-12-08 16:57:33,57,8037,25,32,4995.60,9640.02,0.00
2024-12-08 16:57:33,56,8037,25,31,5072.76,9640.07,0.00
2024-12-08 16:57:33,56,8038,25,31,5080.36,9641.00,0.00
2024-12-08 16:57:33,57,8038,26,31,4991.24,9641.02,0.00
2024-12-08 16:57:33,56,8038,25,31,4913.25,9641.68,0.00
2024-12-08 16:57:33,56,8039,25,31,5054.66,9642.00,0.00
2024-12-08 16:57:33,57,8039,25,32,4965.98,9642.02,0.00
2024-12-08 16:57:33,56,8039,25,31,5035.73,9642.09,0.00
2024-12-08 16:57:33,55,8039,25,30,5114.74,9642.18,0.00
2024-12-08 16:57:33,55,8040,25,30,5141.53,9643.00,0.00
2024-12-08 16:57:33,56,8040,26,30,5049.72,9643.02,0.00
2024-12-08 16:57:33,55,8040,25,30,5139.78,9643.02,0.00
2024-12-08 16:57:33,54,8040,24,30,5139.01,9643.63,0.00
2024-12-08 16:57:33,53,8040,23,30,5235.05,9643.64,0.00
2024-12-08 16:57:33,53,8041,23,30,5317.09,9644.00,0.00
2024-12-08 16:57:33,54,8041,24,30,5218.63,9644.02,0.00
2024-12-08 16:57:33,53,8041,24,29,5297.08,9644.08,0.00
2024-12-08 16:57:33,53,8042,24,29,5316.74,9645.00,0.00
2024-12-08 16:57:33,54,8042,24,30,5218.28,9645.02,0.00
2024-12-08 16:57:33,53,8042,23,30,5205.08,9645.68,0.00
2024-12-08 16:57:33,53,8043,23,30,5356.38,9646.00,0.00
2024-12-08 16:57:33,54,8043,23,31,5257.18,9646.02,0.00
2024-12-08 16:57:33,53,8043,23,30,5336.36,9646.08,0.00
2024-12-08 16:57:33,53,8044,23,30,5355.41,9647.00,0.00
2024-12-08 16:57:33,54,8044,24,30,5256.23,9647.02,0.00
2024-12-08 16:57:33,53,8044,23,30,5207.33,9647.57,0.00
2024-12-08 16:57:34,53,8045,23,30,5347.81,9648.00,0.00
2024-12-08 16:57:34,54,8045,23,31,5248.77,9648.02,0.00
2024-12-08 16:57:34,53,8045,23,30,5324.15,9648.08,0.00
2024-12-08 16:57:34,52,8045,22,30,5417.57,9648.15,0.00
2024-12-08 16:57:34,52,8046,22,30,5444.62,9649.00,0.00
2024-12-08 16:57:34,53,8046,22,31,5341.89,9649.02,0.00
2024-12-08 16:57:34,53,8047,22,31,5321.19,9650.00,0.00
2024-12-08 16:57:34,54,8047,22,32,5222.65,9650.02,0.00
2024-12-08 16:57:34,53,8047,22,31,5299.35,9650.08,0.00
2024-12-08 16:57:34,53,8048,22,31,5319.12,9651.00,0.00
2024-12-08 16:57:34,54,8048,23,31,5220.62,9651.02,0.00
2024-12-08 16:57:34,53,8048,22,31,5271.80,9651.13,0.00
2024-12-08 16:57:34,52,8048,21,31,5302.78,9651.42,0.00
2024-12-08 16:57:34,52,8049,21,31,5433.11,9652.00,0.00
2024-12-08 16:57:34,53,8049,21,32,5330.60,9652.02,0.00
2024-12-08 16:57:34,52,8049,21,31,5431.26,9652.02,0.00
2024-12-08 16:57:34,51,8049,21,30,5513.15,9652.06,0.00
2024-12-08 16:57:34,51,8050,21,30,5536.43,9653.00,0.00
2024-12-08 16:57:34,52,8050,21,31,5429.96,9653.02,0.00
2024-12-08 16:57:34,52,8051,21,31,5415.61,9654.00,0.00
2024-12-08 16:57:34,53,8051,22,31,5313.43,9654.02,0.00
2024-12-08 16:57:34,52,8051,22,30,5389.62,9654.06,0.00
2024-12-08 16:57:34,51,8051,21,30,5427.25,9654.35,0.00
2024-12-08 16:57:34,51,8052,21,30,5554.54,9655.00,0.00
2024-12-08 16:57:34,52,8052,22,30,5447.72,9655.02,0.00
2024-12-08 16:57:34,51,8052,21,30,5440.95,9655.08,0.00
2024-12-08 16:57:34,51,8053,21,30,5539.80,9656.00,0.00
2024-12-08 16:57:34,52,8053,21,31,5433.27,9656.02,0.00
2024-12-08 16:57:34,51,8053,21,30,5515.19,9656.06,0.00
2024-12-08 16:57:34,51,8054,21,30,5533.67,9657.00,0.00
2024-12-08 16:57:34,52,8054,21,31,5427.25,9657.02,0.00
2024-12-08 16:57:34,51,8054,20,31,5531.77,9657.02,0.00
2024-12-08 16:57:34,51,8055,20,31,5516.12,9658.00,0.00
2024-12-08 16:57:34,52,8055,21,31,5410.04,9658.02,0.00
2024-12-08 16:57:34,51,8055,21,30,5485.82,9658.04,0.00
2024-12-08 16:57:34,50,8055,20,30,5531.25,9658.60,0.00
2024-12-08 16:57:34,50,8056,20,30,5608.81,9659.00,0.00
2024-12-08 16:57:34,51,8056,21,30,5498.84,9659.02,0.00
2024-12-08 16:57:34,50,8056,20,30,5561.79,9659.10,0.00
2024-12-08 16:57:34,49,8056,19,30,5543.58,9659.92,0.00
2024-12-08 16:57:34,49,8057,19,30,5732.89,9660.00,0.00
2024-12-08 16:57:34,50,8057,19,31,5618.23,9660.02,0.00
2024-12-08 16:57:34,49,8057,19,30,5703.32,9660.04,0.00
2024-12-08 16:57:34,49,8058,19,30,5719.04,9661.00,0.00
2024-12-08 16:57:34,50,8058,19,31,5604.66,9661.02,0.00
2024-12-08 16:57:34,50,8059,19,31,5582.82,9662.00,0.00
2024-12-08 16:57:34,51,8059,19,32,5473.36,9662.02,0.00
2024-12-08 16:57:34,50,8059,19,31,5555.77,9662.04,0.00
2024-12-08 16:57:34,49,8059,18,31,5534.58,9662.96,0.00
2024-12-08 16:57:34,49,8060,18,31,5727.86,9663.00,0.00
2024-12-08 16:57:34,50,8060,19,31,5613.30,9663.02,0.00
2024-12-08 16:57:34,49,8060,18,31,5674.64,9663.14,0.00
2024-12-08 16:57:34,48,8060,17,31,5670.88,9663.56,0.00
2024-12-08 16:57:34,48,8061,17,31,5830.25,9664.00,0.00
2024-12-08 16:57:34,49,8061,18,31,5711.27,9664.02,0.00
2024-12-08 16:57:34,48,8061,18,30,5804.08,9664.04,0.00
2024-12-08 16:57:34,47,8061,18,29,5917.69,9664.13,0.00
2024-12-08 16:57:34,47,8062,18,29,5957.34,9665.00,0.00
2024-12-08 16:57:34,48,8062,19,29,5833.23,9665.02,0.00
2024-12-08 16:57:34,48,8063,19,29,5819.73,9666.00,0.00
2024-12-08 16:57:34,49,8063,19,30,5700.96,9666.02,0.00
2024-12-08 16:57:34,48,8063,18,30,5817.72,9666.02,0.00
2024-12-08 16:57:34,47,8063,18,29,5914.77,9666.02,0.00
2024-12-08 16:57:34,47,8064,18,29,5944.17,9667.00,0.00
2024-12-08 16:57:34,48,8064,19,29,5820.34,9667.02,0.00
2024-12-08 16:57:34,48,8065,19,29,5806.84,9668.00,0.00
2024-12-08 16:57:34,49,8065,19,30,5688.33,9668.02,0.00
2024-12-08 16:57:34,48,8065,19,29,5782.67,9668.02,0.00
2024-12-08 16:57:34,48,8066,19,29,5809.46,9669.00,0.00
2024-12-08 16:57:34,49,8066,19,30,5690.90,9669.02,0.00
2024-12-08 16:57:34,48,8066,18,30,5745.00,9669.02,0.00
2024-12-08 16:57:34,48,8067,18,30,5812.07,9670.00,0.00
2024-12-08 16:57:34,49,8067,19,30,5693.46,9670.02,0.00
2024-12-08 16:57:34,48,8067,19,29,5785.88,9670.02,0.00
2024-12-08 16:57:34,48,8068,19,29,5812.67,9671.00,0.00
2024-12-08 16:57:34,49,8068,19,30,5694.04,9671.02,0.00
2024-12-08 16:57:34,49,8069,19,30,5690.04,9672.00,0.00
2024-12-08 16:57:34,50,8069,20,30,5576.24,9672.02,0.00
2024-12-08 16:57:34,49,8069,20,29,5650.57,9672.04,0.00
2024-12-08 16:57:34,48,8069,19,29,5712.17,9672.63,0.00
2024-12-08 16:57:34,48,8070,19,29,5797.09,9673.00,0.00
2024-12-08 16:57:34,49,8070,19,30,5678.78,9673.02,0.00
2024-12-08 16:57:34,48,8070,18,30,5660.24,9673.42,0.00
2024-12-08 16:57:34,48,8071,18,30,5805.75,9674.00,0.00
2024-12-08 16:57:34,49,8071,19,30,5687.27,9674.02,0.00
2024-12-08 16:57:34,48,8071,19,29,5761.42,9674.04,0.00
2024-12-08 16:57:34,48,8072,19,29,5790.23,9675.00,0.00
2024-12-08 16:57:34,49,8072,19,30,5672.06,9675.02,0.00
2024-12-08 16:57:34,49,8073,19,30,5671.13,9676.00,0.00
2024-12-08 16:57:34,50,8073,19,31,5557.71,9676.02,0.00
2024-12-08 16:57:34,49,8073,19,30,5629.67,9676.04,0.00
2024-12-08 16:57:35,49,8074,19,30,5655.92,9677.00,0.00
2024-12-08 16:57:35,50,8074,20,30,5542.80,9677.02,0.00
2024-12-08 16:57:35,49,8074,19,30,5527.52,9677.39,0.00
2024-12-08 16:57:35,49,8075,19,30,5666.19,9678.00,0.00
2024-12-08 16:57:35,50,8075,19,31,5552.87,9678.02,0.00
2024-12-08 16:57:35,49,8075,19,30,5626.69,9678.04,0.00
2024-12-08 16:57:35,49,8076,19,30,5651.41,9679.00,0.00
2024-12-08 16:57:35,50,8076,20,30,5538.38,9679.02,0.00
2024-12-08 16:57:35,50,8077,20,30,5534.51,9680.00,0.00
2024-12-08 16:57:35,51,8077,20,31,5425.99,9680.02,0.00
2024-12-08 16:57:35,50,8077,20,30,5495.80,9680.04,0.00
2024-12-08 16:57:35,50,8078,20,30,5517.06,9681.00,0.00
2024-12-08 16:57:35,51,8078,21,30,5408.88,9681.02,0.00
2024-12-08 16:57:35,50,8078,20,30,5462.87,9681.08,0.00
2024-12-08 16:57:35,50,8079,20,30,5564.38,9682.00,0.00
2024-12-08 16:57:35,51,8079,20,31,5455.28,9682.02,0.00
2024-12-08 16:57:35,50,8079,20,30,5521.79,9682.04,0.00
2024-12-08 16:57:35,50,8080,20,30,5537.12,9683.00,0.00
2024-12-08 16:57:35,51,8080,20,31,5428.54,9683.02,0.00
2024-12-08 16:57:35,51,8081,20,31,5414.31,9684.00,0.00
2024-12-08 16:57:35,52,8081,21,31,5310.18,9684.02,0.00
2024-12-08 16:57:35,51,8081,21,30,5372.54,9684.04,0.00
2024-12-08 16:57:35,50,8081,20,30,5395.21,9684.22,0.00
2024-12-08 16:57:35,49,8081,19,30,5469.96,9684.59,0.00
2024-12-08 16:57:35,49,8082,19,30,5628.36,9685.00,0.00
2024-12-08 16:57:35,50,8082,20,30,5515.79,9685.02,0.00
2024-12-08 16:57:35,50,8083,20,30,5495.58,9686.00,0.00
2024-12-08 16:57:35,51,8083,21,30,5387.82,9686.02,0.00
2024-12-08 16:57:35,50,8083,21,29,5429.13,9686.06,0.00
2024-12-08 16:57:35,50,8084,21,29,5454.87,9687.00,0.00
2024-12-08 16:57:35,51,8084,21,30,5347.91,9687.02,0.00
2024-12-08 16:57:35,50,8084,21,29,5451.00,9687.04,0.00
2024-12-08 16:57:35,50,8085,21,29,5473.65,9688.00,0.00
2024-12-08 16:57:35,51,8085,22,29,5366.33,9688.02,0.00
2024-12-08 16:57:35,51,8086,22,29,5371.45,9689.00,0.00
2024-12-08 16:57:35,52,8086,23,29,5268.15,9689.02,0.00
2024-12-08 16:57:35,51,8086,22,29,5287.58,9689.45,0.00
2024-12-08 16:57:35,51,8087,22,29,5349.89,9690.00,0.00
2024-12-08 16:57:35,52,8087,23,29,5247.00,9690.02,0.00
2024-12-08 16:57:35,51,8087,22,29,5347.99,9690.04,0.00
2024-12-08 16:57:35,50,8087,22,28,5436.61,9690.08,0.00
2024-12-08 16:57:35,49,8087,21,28,5506.89,9690.49,0.00
2024-12-08 16:57:35,48,8087,20,28,5580.63,9690.60,0.00
2024-12-08 16:57:35,48,8088,20,28,5744.45,9691.00,0.00
2024-12-08 16:57:35,49,8088,21,28,5627.22,9691.02,0.00
2024-12-08 16:57:35,49,8089,21,28,5624.63,9692.00,0.00
2024-12-08 16:57:35,50,8089,21,29,5512.14,9692.02,0.00
2024-12-08 16:57:35,50,8090,21,29,5484.99,9693.00,0.00
2024-12-08 16:57:35,51,8090,22,29,5377.44,9693.02,0.00
2024-12-08 16:57:35,50,8090,22,28,5460.35,9693.10,0.00
2024-12-08 16:57:35,50,8091,22,28,5489.99,9694.00,0.00
2024-12-08 16:57:35,51,8091,22,29,5382.34,9694.02,0.00
2024-12-08 16:57:35,50,8091,21,29,5476.91,9694.04,0.00
2024-12-08 16:57:35,49,8091,20,29,5584.73,9694.06,0.00
2024-12-08 16:57:35,48,8091,19,29,5620.35,9694.19,0.00
2024-12-08 16:57:35,48,8092,19,29,5744.08,9695.00,0.00
2024-12-08 16:57:35,49,8092,19,30,5626.85,9695.02,0.00
2024-12-08 16:57:35,49,8093,19,30,5611.60,9696.00,0.00
2024-12-08 16:57:35,50,8093,20,30,5499.37,9696.02,0.00
2024-12-08 16:57:35,49,8093,20,29,5605.67,9696.06,0.00
2024-12-08 16:57:35,48,8093,19,29,5664.17,9696.63,0.00
2024-12-08 16:57:35,48,8094,19,29,5830.11,9697.00,0.00
2024-12-08 16:57:35,49,8094,20,29,5711.13,9697.02,0.00
2024-12-08 16:57:35,49,8095,20,29,5715.71,9698.00,0.00
2024-12-08 16:57:35,50,8095,20,30,5601.39,9698.02,0.00
2024-12-08 16:57:35,50,8096,20,30,5584.51,9699.00,0.00
2024-12-08 16:57:35,51,8096,20,31,5475.01,9699.02,0.00
2024-12-08 16:57:35,50,8096,20,30,5576.76,9699.06,0.00
2024-12-08 16:57:35,50,8097,20,30,5602.55,9700.00,0.00
2024-12-08 16:57:35,51,8097,20,31,5492.69,9700.02,0.00
2024-12-08 16:57:35,50,8097,19,31,5517.38,9700.48,0.00
2024-12-08 16:57:35,50,8098,19,31,5605.06,9701.00,0.00
2024-12-08 16:57:35,51,8098,20,31,5495.16,9701.02,0.00
2024-12-08 16:57:35,52,8097,20,32,5329.59,9701.25,0.00
2024-12-08 16:57:35,51,8097,19,32,5447.77,9701.82,0.00
2024-12-08 16:57:35,51,8098,19,32,5621.02,9702.00,0.00
2024-12-08 16:57:35,52,8098,19,33,5512.92,9702.02,0.00
2024-12-08 16:57:35,51,8098,19,32,5615.32,9702.06,0.00
2024-12-08 16:57:35,50,8098,18,32,5679.99,9702.48,0.00
2024-12-08 16:57:35,50,8099,18,32,5940.40,9703.00,0.00
2024-12-08 16:57:35,51,8099,19,32,5823.92,9703.02,0.00
2024-12-08 16:57:35,50,8099,18,32,5932.64,9703.06,0.00
2024-12-08 16:57:35,50,8100,18,32,5989.30,9704.00,0.00
2024-12-08 16:57:35,51,8100,18,33,5871.87,9704.02,0.00
2024-12-08 16:57:35,51,8101,18,33,5845.75,9705.00,0.00
2024-12-08 16:57:35,52,8101,18,34,5733.33,9705.02,0.00
2024-12-08 16:57:35,51,8101,18,33,5840.04,9705.06,0.00
2024-12-08 16:57:36,51,8102,18,33,5856.98,9706.00,0.00
2024-12-08 16:57:36,52,8102,19,33,5744.34,9706.02,0.00
2024-12-08 16:57:36,52,8103,19,33,5734.73,9707.00,0.00
2024-12-08 16:57:36,53,8103,19,34,5626.53,9707.02,0.00
2024-12-08 16:57:36,52,8103,18,34,5732.87,9707.02,0.00
2024-12-08 16:57:36,51,8103,18,33,5805.31,9707.04,0.00
2024-12-08 16:57:36,51,8104,18,33,5825.65,9708.00,0.00
2024-12-08 16:57:36,52,8104,18,34,5713.62,9708.02,0.00
2024-12-08 16:57:36,51,8104,17,34,5730.58,9708.26,0.00
2024-12-08 16:57:36,51,8105,17,34,5849.10,9709.00,0.00
2024-12-08 16:57:36,52,8105,17,35,5736.61,9709.02,0.00
2024-12-08 16:57:36,51,8105,17,34,5809.12,9709.04,0.00
2024-12-08 16:57:36,50,8105,16,34,5838.35,9709.76,0.00
2024-12-08 16:57:36,50,8106,16,34,6009.42,9710.00,0.00
2024-12-08 16:57:36,51,8106,16,35,5891.59,9710.02,0.00
2024-12-08 16:57:36,50,8106,16,34,5968.46,9710.04,0.00
2024-12-08 16:57:36,50,8107,16,34,5992.38,9711.00,0.00
2024-12-08 16:57:36,51,8107,17,34,5874.88,9711.02,0.00
2024-12-08 16:57:36,51,8108,17,34,5865.80,9712.00,0.00
2024-12-08 16:57:36,52,8108,18,34,5752.99,9712.02,0.00
2024-12-08 16:57:36,51,8108,18,33,5827.71,9712.04,0.00
2024-12-08 16:57:36,50,8108,17,33,5905.73,9712.42,0.00
2024-12-08 16:57:36,49,8108,16,33,6006.61,9712.47,0.00
2024-12-08 16:57:36,49,8109,16,33,6153.68,9713.00,0.00
2024-12-08 16:57:36,50,8109,17,33,6030.61,9713.02,0.00
2024-12-08 16:57:36,49,8109,16,33,6064.56,9713.23,0.00
2024-12-08 16:57:36,49,8110,16,33,6188.01,9714.00,0.00
2024-12-08 16:57:36,50,8110,16,34,6064.25,9714.02,0.00
2024-12-08 16:57:36,49,8110,16,33,6148.37,9714.04,0.00
2024-12-08 16:57:36,49,8111,16,33,6174.77,9715.00,0.00
2024-12-08 16:57:36,50,8111,16,34,6051.28,9715.02,0.00
2024-12-08 16:57:36,50,8112,16,34,6092.24,9716.00,0.00
2024-12-08 16:57:36,51,8112,16,35,5972.78,9716.02,0.00
2024-12-08 16:57:36,50,8112,15,35,6049.50,9716.06,0.00
2024-12-08 16:57:36,50,8113,15,35,6120.03,9717.00,0.00
2024-12-08 16:57:36,51,8113,15,36,6000.03,9717.02,0.00
2024-12-08 16:57:36,51,8114,15,36,5994.25,9718.00,0.00
2024-12-08 16:57:36,52,8114,16,36,5878.98,9718.02,0.00
2024-12-08 16:57:36,51,8114,15,36,5906.05,9718.39,0.00
2024-12-08 16:57:36,51,8115,15,36,6037.97,9719.00,0.00
2024-12-08 16:57:36,52,8115,16,36,5921.86,9719.02,0.00
2024-12-08 16:57:36,51,8115,16,35,6030.35,9719.04,0.00
2024-12-08 16:57:36,51,8116,16,35,6051.94,9720.00,0.00
2024-12-08 16:57:36,52,8116,16,36,5935.55,9720.02,0.00
2024-12-08 16:57:36,52,8117,16,36,5917.48,9721.00,0.00
2024-12-08 16:57:36,53,8117,17,36,5805.83,9721.02,0.00
2024-12-08 16:57:36,52,8117,17,35,5885.70,9721.04,0.00
2024-12-08 16:57:36,51,8117,16,35,5956.73,9721.47,0.00
2024-12-08 16:57:36,51,8118,16,35,6096.28,9722.00,0.00
2024-12-08 16:57:36,52,8118,17,35,5979.04,9722.02,0.00
2024-12-08 16:57:36,52,8119,17,35,5959.59,9723.00,0.00
2024-12-08 16:57:36,53,8119,18,35,5847.15,9723.02,0.00
2024-12-08 16:57:36,52,8119,18,34,5929.68,9723.04,0.00
2024-12-08 16:57:36,51,8119,17,34,5987.17,9723.63,0.00
2024-12-08 16:57:36,50,8119,16,34,6048.28,9723.92,0.00
2024-12-08 16:57:36,50,8120,16,34,6235.04,9724.00,0.00
2024-12-08 16:57:36,51,8120,16,35,6112.78,9724.02,0.00
2024-12-08 16:57:36,50,8120,15,35,6120.44,9724.34,0.00
2024-12-08 16:57:36,50,8121,15,35,6251.24,9725.00,0.00
2024-12-08 16:57:36,51,8121,15,36,6128.67,9725.02,0.00
2024-12-08 16:57:36,50,8121,15,35,6218.18,9725.04,0.00
2024-12-08 16:57:36,50,8122,15,35,6242.16,9726.00,0.00
2024-12-08 16:57:36,51,8122,15,36,6119.76,9726.02,0.00
2024-12-08 16:57:36,51,8123,15,36,6101.32,9727.00,0.00
2024-12-08 16:57:36,52,8123,15,37,5983.98,9727.02,0.00
2024-12-08 16:57:36,51,8123,15,36,6070.80,9727.04,0.00
2024-12-08 16:57:36,50,8123,14,36,6149.50,9727.22,0.00
2024-12-08 16:57:36,50,8124,14,36,6268.73,9728.00,0.00
2024-12-08 16:57:36,51,8124,14,37,6145.82,9728.02,0.00
2024-12-08 16:57:36,51,8125,14,37,6127.37,9729.00,0.00
2024-12-08 16:57:36,52,8125,14,38,6009.54,9729.02,0.00
2024-12-08 16:57:36,51,8125,14,37,6098.76,9729.04,0.00
2024-12-08 16:57:36,50,8125,13,37,6158.58,9729.28,0.00
2024-12-08 16:57:36,50,8126,13,37,6283.64,9730.00,0.00
2024-12-08 16:57:36,51,8126,13,38,6160.44,9730.02,0.00
2024-12-08 16:57:36,51,8127,13,38,6141.99,9731.00,0.00
2024-12-08 16:57:36,52,8127,14,38,6023.87,9731.02,0.00
2024-12-08 16:57:36,51,8127,14,37,6109.55,9731.04,0.00
2024-12-08 16:57:36,50,8127,13,37,6163.99,9731.68,0.00
2024-12-08 16:57:36,50,8128,13,37,6307.20,9732.00,0.00
2024-12-08 16:57:36,51,8128,13,38,6183.53,9732.02,0.00
2024-12-08 16:57:36,50,8128,12,38,6305.26,9732.02,0.00
2024-12-08 16:57:36,50,8129,12,38,6147.35,9733.00,0.00
2024-12-08 16:57:36,51,8129,13,38,6026.81,9733.02,0.00
2024-12-08 16:57:36,50,8129,13,37,6116.20,9733.02,0.00
2024-12-08 16:57:36,49,8129,12,37,6183.51,9733.25,0.00
2024-12-08 16:57:36,48,8129,11,37,6158.88,9733.73,0.00
2024-12-08 16:57:36,48,8130,11,37,6335.53,9734.00,0.00
2024-12-08 16:57:36,49,8130,11,38,6206.24,9734.02,0.00
2024-12-08 16:57:37,49,8131,11,38,6150.41,9735.00,0.00
2024-12-08 16:57:37,50,8131,12,38,6027.40,9735.02,0.00
2024-12-08 16:57:37,49,8131,12,37,6120.61,9735.02,0.00
2024-12-08 16:57:37,48,8131,12,36,6163.83,9735.65,0.00
2024-12-08 16:57:37,48,8132,12,36,6251.33,9736.00,0.00
2024-12-08 16:57:37,49,8132,13,36,6123.75,9736.02,0.00
2024-12-08 16:57:37,48,8132,12,36,6123.71,9736.38,0.00
2024-12-08 16:57:37,48,8133,12,36,6266.18,9737.00,0.00
2024-12-08 16:57:37,49,8133,12,37,6138.29,9737.02,0.00
2024-12-08 16:57:37,48,8133,12,36,6235.75,9737.02,0.00
2024-12-08 16:57:37,48,8134,12,36,6196.51,9738.00,0.00
2024-12-08 16:57:37,49,8134,12,37,6070.05,9738.02,0.00
2024-12-08 16:57:37,49,8135,12,37,5976.52,9739.00,0.00
2024-12-08 16:57:37,50,8135,12,38,5856.99,9739.02,0.00
2024-12-08 16:57:37,49,8135,12,37,5946.71,9739.02,0.00
2024-12-08 16:57:37,48,8135,11,37,5857.30,9739.96,0.00
2024-12-08 16:57:37,48,8136,11,37,6056.18,9740.00,0.00
2024-12-08 16:57:37,49,8136,11,38,5932.58,9740.02,0.00
2024-12-08 16:57:37,48,8136,10,38,5936.53,9740.25,0.00
2024-12-08 16:57:37,48,8137,10,38,6027.90,9741.00,0.00
2024-12-08 16:57:37,49,8137,10,39,5904.88,9741.02,0.00
2024-12-08 16:57:37,48,8137,10,38,5997.46,9741.02,0.00
2024-12-08 16:57:37,47,8137,9,38,5957.93,9741.66,0.00
2024-12-08 16:57:37,47,8138,9,38,6132.32,9742.00,0.00
2024-12-08 16:57:37,48,8138,10,38,6004.56,9742.02,0.00
2024-12-08 16:57:37,47,8138,9,38,5983.31,9742.49,0.00
2024-12-08 16:57:37,47,8139,9,38,6141.24,9743.00,0.00
2024-12-08 16:57:37,48,8139,9,39,6013.30,9743.02,0.00
2024-12-08 16:57:37,47,8139,9,38,6112.22,9743.02,0.00
2024-12-08 16:57:37,47,8140,9,38,6141.87,9744.00,0.00
2024-12-08 16:57:37,48,8140,9,39,6013.91,9744.02,0.00
2024-12-08 16:57:37,47,8140,8,39,6019.70,9744.36,0.00
2024-12-08 16:57:37,47,8141,8,39,6165.31,9745.00,0.00
2024-12-08 16:57:37,48,8141,9,39,6036.86,9745.02,0.00
2024-12-08 16:57:37,47,8141,9,38,6136.28,9745.02,0.00
2024-12-08 16:57:37,47,8142,9,38,6165.94,9746.00,0.00
2024-12-08 16:57:37,48,8142,9,39,6037.48,9746.02,0.00
2024-12-08 16:57:37,48,8143,9,39,6024.69,9747.00,0.00
2024-12-08 16:57:37,49,8143,10,39,5901.73,9747.02,0.00
2024-12-08 16:57:37,48,8143,10,38,5996.26,9747.02,0.00
2024-12-08 16:57:37,47,8143,9,38,6031.96,9747.40,0.00
2024-12-08 16:57:37,47,8144,9,38,6181.72,9748.00,0.00
2024-12-08 16:57:37,48,8144,10,38,6052.94,9748.02,0.00
2024-12-08 16:57:37,47,8144,9,38,6024.63,9748.89,0.00
2024-12-08 16:57:37,47,8145,9,38,6221.77,9749.00,0.00
2024-12-08 16:57:37,48,8145,9,39,6092.15,9749.02,0.00
2024-12-08 16:57:37,47,8145,9,38,6192.73,9749.02,0.00
2024-12-08 16:57:37,46,8145,8,38,6321.01,9749.07,0.00
2024-12-08 16:57:37,46,8146,8,38,6357.68,9750.00,0.00
2024-12-08 16:57:37,47,8146,8,39,6222.41,9750.02,0.00
2024-12-08 16:57:37,46,8146,7,39,6190.74,9750.70,0.00
2024-12-08 16:57:37,46,8147,7,39,6373.29,9751.00,0.00
2024-12-08 16:57:37,47,8147,7,40,6237.69,9751.02,0.00
2024-12-08 16:57:37,46,8147,7,39,6345.73,9751.02,0.00
2024-12-08 16:57:37,46,8148,7,39,6316.71,9752.00,0.00
2024-12-08 16:57:37,47,8148,7,40,6182.32,9752.02,0.00
2024-12-08 16:57:37,46,8148,7,39,6183.25,9752.50,0.00
2024-12-08 16:57:37,46,8149,7,39,6262.10,9753.00,0.00
2024-12-08 16:57:37,47,8149,8,39,6128.86,9753.02,0.00
2024-12-08 16:57:37,46,8149,8,38,6230.30,9753.02,0.00
2024-12-08 16:57:37,45,8149,7,38,6252.28,9753.89,0.00
2024-12-08 16:57:37,45,8150,7,38,6458.27,9754.00,0.00
2024-12-08 16:57:37,46,8150,7,39,6317.88,9754.02,0.00
2024-12-08 16:57:37,46,8151,7,39,6307.92,9755.00,0.00
2024-12-08 16:57:37,47,8151,8,39,6173.71,9755.02,0.00
2024-12-08 16:57:37,46,8151,8,38,6269.75,9755.02,0.00
2024-12-08 16:57:37,45,8151,7,38,6313.87,9755.40,0.00
2024-12-08 16:57:37,45,8152,7,38,6472.60,9756.00,0.00
2024-12-08 16:57:37,46,8152,7,39,6331.90,9756.02,0.00
2024-12-08 16:57:37,45,8152,7,38,6395.75,9756.36,0.00
2024-12-08 16:57:37,45,8153,7,38,6463.47,9757.00,0.00
2024-12-08 16:57:37,46,8153,8,38,6322.96,9757.02,0.00
2024-12-08 16:57:37,45,8153,8,37,6424.44,9757.02,0.00
2024-12-08 16:57:37,44,8153,7,37,6466.74,9757.82,0.00
2024-12-08 16:57:37,44,8154,7,37,6670.92,9758.00,0.00
2024-12-08 16:57:37,45,8154,8,37,6522.68,9758.02,0.00
2024-12-08 16:57:37,45,8155,8,37,6514.67,9759.00,0.00
2024-12-08 16:57:37,46,8155,8,38,6373.05,9759.02,0.00
2024-12-08 16:57:37,45,8155,8,37,6477.80,9759.02,0.00
2024-12-08 16:57:37,45,8156,8,37,6513.17,9760.00,0.00
2024-12-08 16:57:37,46,8156,8,38,6371.58,9760.02,0.00
2024-12-08 16:57:37,46,8157,8,38,6361.62,9761.00,0.00
2024-12-08 16:57:37,47,8157,8,39,6226.27,9761.02,0.00
2024-12-08 16:57:37,46,8157,8,38,6323.43,9761.02,0.00
2024-12-08 16:57:37,46,8158,8,38,6355.91,9762.00,0.00
2024-12-08 16:57:37,47,8158,8,39,6220.67,9762.02,0.00
2024-12-08 16:57:37,47,8159,8,39,6208.85,9763.00,0.00
2024-12-08 16:57:37,48,8159,8,40,6079.50,9763.02,0.00
2024-12-08 16:57:37,47,8159,8,39,6173.54,9763.02,0.00
2024-12-08 16:57:37,46,8159,7,39,6187.34,9763.91,0.00
2024-12-08 16:57:38,46,8160,7,39,6391.17,9764.00,0.00
2024-12-08 16:57:38,47,8160,8,39,6255.19,9764.02,0.00
2024-12-08 16:57:38,47,8161,8,39,6243.36,9765.00,0.00
2024-12-08 16:57:38,48,8161,9,39,6113.29,9765.02,0.00
2024-12-08 16:57:38,47,8161,9,38,6210.12,9765.02,0.00
2024-12-08 16:57:38,46,8161,8,38,6243.26,9765.83,0.00
2024-12-08 16:57:38,46,8162,8,38,6438.70,9766.00,0.00
2024-12-08 16:57:38,47,8162,9,38,6301.71,9766.02,0.00
2024-12-08 16:57:38,46,8162,8,38,6336.90,9766.26,0.00
2024-12-08 16:57:38,46,8163,8,38,6475.81,9767.00,0.00
2024-12-08 16:57:38,47,8163,9,38,6338.02,9767.02,0.00
2024-12-08 16:57:38,46,8163,9,37,6443.96,9767.02,0.00
2024-12-08 16:57:38,46,8164,9,37,6473.24,9768.00,0.00
2024-12-08 16:57:38,47,8164,9,38,6335.51,9768.02,0.00
2024-12-08 16:57:38,47,8165,9,38,6318.72,9769.00,0.00
2024-12-08 16:57:38,48,8165,10,38,6187.08,9769.02,0.00
2024-12-08 16:57:38,47,8165,10,37,6289.62,9769.02,0.00
2024-12-08 16:57:38,47,8166,10,37,6312.33,9770.00,0.00
2024-12-08 16:57:38,48,8166,11,37,6180.83,9770.02,0.00
2024-12-08 16:57:38,47,8166,10,37,6142.05,9770.92,0.00
2024-12-08 16:57:38,47,8167,10,37,6341.68,9771.00,0.00
2024-12-08 16:57:38,48,8167,10,38,6209.56,9771.02,0.00
2024-12-08 16:57:38,47,8167,10,37,6312.58,9771.02,0.00
2024-12-08 16:57:38,47,8168,10,37,6332.24,9772.00,0.00
2024-12-08 16:57:38,48,8168,11,37,6200.32,9772.02,0.00
2024-12-08 16:57:38,48,8169,11,37,6174.78,9773.00,0.00
2024-12-08 16:57:38,49,8169,12,37,6048.76,9773.02,0.00
2024-12-08 16:57:38,48,8169,12,36,6148.31,9773.02,0.00
2024-12-08 16:57:38,48,8170,12,36,6163.59,9774.00,0.00
2024-12-08 16:57:38,49,8170,12,37,6037.80,9774.02,0.00
2024-12-08 16:57:38,49,8171,12,37,6011.22,9775.00,0.00
2024-12-08 16:57:38,50,8171,13,37,5891.00,9775.02,0.00
2024-12-08 16:57:38,49,8171,13,36,5985.29,9775.02,0.00
2024-12-08 16:57:38,49,8172,13,36,5999.34,9776.00,0.00
2024-12-08 16:57:38,50,8172,13,37,5879.35,9776.02,0.00
2024-12-08 16:57:38,49,8172,12,37,5882.28,9776.67,0.00
2024-12-08 16:57:38,49,8173,12,37,6050.11,9777.00,0.00
2024-12-08 16:57:38,50,8173,13,37,5929.11,9777.02,0.00
2024-12-08 16:57:38,49,8173,12,37,5911.87,9777.78,0.00
2024-12-08 16:57:38,49,8174,12,37,6089.63,9778.00,0.00
2024-12-08 16:57:38,50,8174,12,38,5967.83,9778.02,0.00
2024-12-08 16:57:38,49,8174,12,37,6063.69,9778.04,0.00
2024-12-08 16:57:38,48,8174,12,36,6176.49,9778.17,0.00
2024-12-08 16:57:38,48,8175,12,36,6217.81,9779.00,0.00
2024-12-08 16:57:38,49,8175,12,37,6090.92,9779.02,0.00
2024-12-08 16:57:38,49,8176,12,37,6075.57,9780.00,0.00
2024-12-08 16:57:38,50,8176,12,38,5954.06,9780.02,0.00
2024-12-08 16:57:38,49,8176,12,37,6051.62,9780.04,0.00
2024-12-08 16:57:38,49,8177,12,37,6077.03,9781.00,0.00
2024-12-08 16:57:38,50,8177,13,37,5955.49,9781.02,0.00
2024-12-08 16:57:38,49,8177,12,37,5945.50,9781.43,0.00
2024-12-08 16:57:38,49,8178,12,37,6089.65,9782.00,0.00
2024-12-08 16:57:38,50,8178,13,37,5967.86,9782.02,0.00
2024-12-08 16:57:38,49,8178,13,36,6075.68,9782.02,0.00
2024-12-08 16:57:38,49,8179,13,36,6097.41,9783.00,0.00
2024-12-08 16:57:38,50,8179,13,37,5975.46,9783.02,0.00
2024-12-08 16:57:38,49,8179,13,36,6073.45,9783.02,0.00
2024-12-08 16:57:38,49,8180,13,36,6095.05,9784.00,0.00
2024-12-08 16:57:38,50,8180,14,36,5973.15,9784.02,0.00
2024-12-08 16:57:38,50,8181,14,36,5952.44,9785.00,0.00
2024-12-08 16:57:38,51,8181,15,36,5835.72,9785.02,0.00
2024-12-08 16:57:38,50,8181,15,35,5928.95,9785.02,0.00
2024-12-08 16:57:38,50,8182,15,35,5946.98,9786.00,0.00
2024-12-08 16:57:38,51,8182,15,36,5830.38,9786.02,0.00
2024-12-08 16:57:38,51,8183,15,36,5807.91,9787.00,0.00
2024-12-08 16:57:38,52,8183,16,36,5696.21,9787.02,0.00
2024-12-08 16:57:38,51,8183,16,35,5781.04,9787.02,0.00
2024-12-08 16:57:38,50,8183,15,35,5831.53,9787.60,0.00
2024-12-08 16:57:38,50,8184,15,35,5910.12,9788.00,0.00
2024-12-08 16:57:38,51,8184,15,36,5794.23,9788.02,0.00
2024-12-08 16:57:38,50,8184,14,36,5768.90,9788.44,0.00
2024-12-08 16:57:38,50,8185,14,36,5910.25,9789.00,0.00
2024-12-08 16:57:38,51,8185,14,37,5794.37,9789.02,0.00
2024-12-08 16:57:38,50,8185,14,36,5878.93,9789.02,0.00
2024-12-08 16:57:38,51,8184,15,36,5701.87,9789.59,0.00
2024-12-08 16:57:38,51,8185,15,36,5806.44,9790.00,0.00
2024-12-08 16:57:38,52,8185,16,36,5694.77,9790.02,0.00
2024-12-08 16:57:38,51,8185,15,36,5602.43,9790.61,0.00
2024-12-08 16:57:38,51,8186,15,36,5937.35,9791.00,0.00
2024-12-08 16:57:38,52,8186,15,37,5823.17,9791.02,0.00
2024-12-08 16:57:38,51,8186,15,36,5906.63,9791.02,0.00
2024-12-08 16:57:39,51,8187,15,36,5872.03,9792.00,0.00
2024-12-08 16:57:39,52,8187,16,36,5759.10,9792.02,0.00
2024-12-08 16:57:39,51,8187,15,36,5820.01,9792.08,0.00
2024-12-08 16:57:39,50,8187,14,36,5924.68,9792.12,0.00
2024-12-08 16:57:39,50,8188,14,36,5978.40,9793.00,0.00
2024-12-08 16:57:39,51,8188,14,37,5861.18,9793.02,0.00
2024-12-08 16:57:39,50,8188,14,36,5947.06,9793.02,0.00
2024-12-08 16:57:39,49,8188,13,36,5976.86,9793.49,0.00
2024-12-08 16:57:39,49,8189,13,36,6047.18,9794.00,0.00
2024-12-08 16:57:39,50,8189,13,37,5926.23,9794.02,0.00
2024-12-08 16:57:39,50,8190,13,37,5909.82,9795.00,0.00
2024-12-08 16:57:39,51,8190,14,37,5793.94,9795.02,0.00
2024-12-08 16:57:39,50,8190,14,36,5880.43,9795.02,0.00
2024-12-08 16:57:39,49,8190,13,36,5872.46,9795.96,0.00
2024-12-08 16:57:39,49,8191,13,36,6068.40,9796.00,0.00
2024-12-08 16:57:39,50,8191,13,37,5947.04,9796.02,0.00
2024-12-08 16:57:39,49,8191,12,37,5890.90,9796.59,0.00
2024-12-08 16:57:39,49,8192,12,37,6051.16,9797.00,0.00
2024-12-08 16:57:39,50,8192,12,38,5930.13,9797.02,0.00
2024-12-08 16:57:39,49,8192,12,37,6023.17,9797.02,0.00
2024-12-08 16:57:39,48,8192,11,37,6022.37,9797.54,0.00
2024-12-08 16:57:39,48,8193,11,37,6181.94,9798.00,0.00
2024-12-08 16:57:39,49,8193,11,38,6055.77,9798.02,0.00
2024-12-08 16:57:39,49,8194,11,38,6040.39,9799.00,0.00
2024-12-08 16:57:39,50,8194,11,39,5919.58,9799.02,0.00
2024-12-08 16:57:39,49,8194,11,38,6012.40,9799.02,0.00
2024-12-08 16:57:39,49,8195,11,38,6037.01,9800.00,0.00
2024-12-08 16:57:39,50,8195,11,39,5916.27,9800.02,0.00
2024-12-08 16:57:39,50,8196,11,39,5902.50,9801.00,0.00
2024-12-08 16:57:39,51,8196,12,39,5786.76,9801.02,0.00
2024-12-08 16:57:39,50,8196,12,38,5875.05,9801.02,0.00
2024-12-08 16:57:39,50,8197,12,38,5897.22,9802.00,0.00
2024-12-08 16:57:39,51,8197,13,38,5781.58,9802.02,0.00
2024-12-08 16:57:39,50,8197,12,38,5801.47,9802.60,0.00
2024-12-08 16:57:39,50,8198,12,38,5887.57,9803.00,0.00
2024-12-08 16:57:39,51,8198,13,38,5772.13,9803.02,0.00
2024-12-08 16:57:39,50,8198,13,37,5858.17,9803.02,0.00
2024-12-08 16:57:39,49,8198,12,37,5922.01,9803.59,0.00
2024-12-08 16:57:39,49,8199,12,37,6002.34,9804.00,0.00
2024-12-08 16:57:39,50,8199,13,37,5882.29,9804.02,0.00
2024-12-08 16:57:39,49,8199,12,37,5862.08,9804.41,0.00
2024-12-08 16:57:39,49,8200,12,37,6004.57,9805.00,0.00
2024-12-08 16:57:39,50,8200,12,38,5884.48,9805.02,0.00
2024-12-08 16:57:39,49,8200,12,37,5976.55,9805.02,0.00
2024-12-08 16:57:39,48,8200,11,37,6046.22,9805.58,0.00
2024-12-08 16:57:39,48,8201,11,37,6128.25,9806.00,0.00
2024-12-08 16:57:39,49,8201,12,37,6003.18,9806.02,0.00
2024-12-08 16:57:39,49,8202,12,37,5987.78,9807.00,0.00
2024-12-08 16:57:39,50,8202,12,38,5868.02,9807.02,0.00
2024-12-08 16:57:39,49,8202,12,37,5961.76,9807.02,0.00
2024-12-08 16:57:39,49,8203,12,37,5986.39,9808.00,0.00
2024-12-08 16:57:39,50,8203,13,37,5866.66,9808.02,0.00
2024-12-08 16:57:39,50,8204,13,37,5849.60,9809.00,0.00
2024-12-08 16:57:39,51,8204,13,38,5734.91,9809.02,0.00
2024-12-08 16:57:39,50,8204,13,37,5826.06,9809.02,0.00
2024-12-08 16:57:39,50,8205,13,37,5848.24,9810.00,0.00
2024-12-08 16:57:39,51,8205,14,37,5733.57,9810.02,0.00
2024-12-08 16:57:39,51,8206,14,37,5714.91,9811.00,0.00
2024-12-08 16:57:39,52,8206,15,37,5605.01,9811.02,0.00
2024-12-08 16:57:39,51,8206,15,36,5693.75,9811.02,0.00
2024-12-08 16:57:39,50,8206,14,36,5684.27,9811.54,0.00
2024-12-08 16:57:39,50,8207,14,36,5835.69,9812.00,0.00
2024-12-08 16:57:39,51,8207,15,36,5721.27,9812.02,0.00
2024-12-08 16:57:39,51,8208,15,36,5703.56,9813.00,0.00
2024-12-08 16:57:39,52,8208,16,36,5593.87,9813.02,0.00
2024-12-08 16:57:39,51,8208,16,35,5682.39,9813.02,0.00
2024-12-08 16:57:39,51,8209,16,35,5702.21,9814.00,0.00
2024-12-08 16:57:39,52,8209,17,35,5592.56,9814.02,0.00
2024-12-08 16:57:39,51,8209,16,35,5583.06,9814.37,0.00
2024-12-08 16:57:39,50,8209,15,35,5675.66,9814.56,0.00
2024-12-08 16:57:39,50,8210,15,35,5829.07,9815.00,0.00
2024-12-08 16:57:39,51,8210,16,35,5714.78,9815.02,0.00
2024-12-08 16:57:39,50,8210,16,34,5809.44,9815.02,0.00
2024-12-08 16:57:39,50,8211,16,34,5831.63,9816.00,0.00
2024-12-08 16:57:39,51,8211,17,34,5717.28,9816.02,0.00
2024-12-08 16:57:39,51,8212,17,34,5698.62,9817.00,0.00
2024-12-08 16:57:39,52,8212,18,34,5589.03,9817.02,0.00
2024-12-08 16:57:39,51,8212,18,33,5679.37,9817.02,0.00
2024-12-08 16:57:39,50,8212,17,33,5736.97,9817.58,0.00
2024-12-08 16:57:39,50,8213,17,33,5813.84,9818.00,0.00
2024-12-08 16:57:39,51,8213,18,33,5699.84,9818.02,0.00
2024-12-08 16:57:39,51,8214,18,33,5634.32,9819.00,0.00
2024-12-08 16:57:39,52,8214,19,33,5525.96,9819.02,0.00
2024-12-08 16:57:39,51,8214,19,32,5613.14,9819.02,0.00
2024-12-08 16:57:39,50,8214,18,32,5565.03,9819.80,0.00
2024-12-08 16:57:40,50,8215,18,32,5741.92,9820.00,0.00
2024-12-08 16:57:40,51,8215,19,32,5629.33,9820.02,0.00
2024-12-08 16:57:40,50,8215,18,32,5643.75,9820.48,0.00
2024-12-08 16:57:40,50,8216,18,32,5710.97,9821.00,0.00
2024-12-08 16:57:40,51,8216,18,33,5598.99,9821.02,0.00
2024-12-08 16:57:40,50,8216,18,32,5691.33,9821.02,0.00
2024-12-08 16:57:40,50,8217,18,32,5713.52,9822.00,0.00
2024-12-08 16:57:40,51,8217,18,33,5601.49,9822.02,0.00
2024-12-08 16:57:40,51,8218,18,33,5582.80,9823.00,0.00
2024-12-08 16:57:40,52,8218,18,34,5475.44,9823.02,0.00
2024-12-08 16:57:40,51,8218,18,33,5565.46,9823.02,0.00
2024-12-08 16:57:40,50,8218,17,33,5618.16,9823.62,0.00
2024-12-08 16:57:40,50,8219,17,33,5777.56,9824.00,0.00
2024-12-08 16:57:40,51,8219,18,33,5664.27,9824.02,0.00
2024-12-08 16:57:40,50,8219,17,33,5597.12,9824.64,0.00
2024-12-08 16:57:40,50,8220,17,33,5758.49,9825.00,0.00
2024-12-08 16:57:40,51,8220,18,33,5645.58,9825.02,0.00
2024-12-08 16:57:40,50,8220,18,32,5742.77,9825.02,0.00
2024-12-08 16:57:40,50,8221,18,32,5764.20,9826.00,0.00
2024-12-08 16:57:40,51,8221,18,33,5651.18,9826.02,0.00
2024-12-08 16:57:40,51,8222,18,33,5630.87,9827.00,0.00
2024-12-08 16:57:40,52,8222,19,33,5522.58,9827.02,0.00
2024-12-08 16:57:40,51,8222,19,32,5615.46,9827.02,0.00
2024-12-08 16:57:40,50,8222,18,32,5647.55,9827.70,0.00
2024-12-08 16:57:40,50,8223,18,32,5814.83,9828.00,0.00
2024-12-08 16:57:40,51,8223,18,33,5700.82,9828.02,0.00
2024-12-08 16:57:40,51,8224,18,33,5678.66,9829.00,0.00
2024-12-08 16:57:40,52,8224,19,33,5569.45,9829.02,0.00
2024-12-08 16:57:40,51,8224,19,32,5663.24,9829.02,0.00
2024-12-08 16:57:40,51,8225,19,32,5680.85,9830.00,0.00
2024-12-08 16:57:40,52,8225,20,32,5571.60,9830.02,0.00
2024-12-08 16:57:40,51,8225,19,32,5623.07,9830.16,0.00
2024-12-08 16:57:40,51,8226,19,32,5731.61,9831.00,0.00
2024-12-08 16:57:40,52,8226,20,32,5621.39,9831.02,0.00
2024-12-08 16:57:40,51,8226,20,31,5714.27,9831.02,0.00
2024-12-08 16:57:40,51,8227,20,31,5733.90,9832.00,0.00
2024-12-08 16:57:40,52,8227,20,32,5623.63,9832.02,0.00
2024-12-08 16:57:40,52,8228,20,32,5603.40,9833.00,0.00
2024-12-08 16:57:40,53,8228,20,33,5497.68,9833.02,0.00
2024-12-08 16:57:40,52,8228,20,32,5588.27,9833.02,0.00
2024-12-08 16:57:40,51,8228,19,32,5640.24,9833.61,0.00
2024-12-08 16:57:40,50,8228,18,32,5739.31,9833.68,0.00
2024-12-08 16:57:40,50,8229,18,32,5904.75,9834.00,0.00
2024-12-08 16:57:40,51,8229,19,32,5788.98,9834.02,0.00
2024-12-08 16:57:40,51,8230,19,32,5770.28,9835.00,0.00
2024-12-08 16:57:40,52,8230,19,33,5659.31,9835.02,0.00
2024-12-08 16:57:40,51,8230,19,32,5756.78,9835.02,0.00
2024-12-08 16:57:40,51,8231,19,32,5776.65,9836.00,0.00
2024-12-08 16:57:40,52,8231,20,32,5665.56,9836.02,0.00
2024-12-08 16:57:40,52,8232,20,32,5645.33,9837.00,0.00
2024-12-08 16:57:40,53,8232,21,32,5538.81,9837.02,0.00
2024-12-08 16:57:40,52,8232,21,31,5633.98,9837.02,0.00
2024-12-08 16:57:40,52,8233,21,31,5651.58,9838.00,0.00
2024-12-08 16:57:40,53,8233,21,32,5544.95,9838.02,0.00
2024-12-08 16:57:40,52,8233,20,32,5551.61,9838.64,0.00
2024-12-08 16:57:40,52,8234,20,32,5629.45,9839.00,0.00
2024-12-08 16:57:40,53,8234,20,33,5523.23,9839.02,0.00
2024-12-08 16:57:40,52,8234,20,32,5619.99,9839.02,0.00
2024-12-08 16:57:40,52,8235,20,32,5637.59,9840.00,0.00
2024-12-08 16:57:40,53,8235,21,32,5531.22,9840.02,0.00
2024-12-08 16:57:40,52,8235,20,32,5505.33,9840.46,0.00
2024-12-08 16:57:40,52,8236,20,32,5641.95,9841.00,0.00
2024-12-08 16:57:40,53,8236,21,32,5535.50,9841.02,0.00
2024-12-08 16:57:40,52,8236,21,31,5626.81,9841.02,0.00
2024-12-08 16:57:40,52,8237,21,31,5644.41,9842.00,0.00
2024-12-08 16:57:40,53,8237,22,31,5537.92,9842.02,0.00
2024-12-08 16:57:40,53,8238,22,31,5516.19,9843.00,0.00
2024-12-08 16:57:40,54,8238,23,31,5414.04,9843.02,0.00
2024-12-08 16:57:40,53,8238,23,30,5499.48,9843.02,0.00
2024-12-08 16:57:40,53,8239,23,30,5514.90,9844.00,0.00
2024-12-08 16:57:40,54,8239,24,30,5412.77,9844.02,0.00
2024-12-08 16:57:40,53,8239,23,30,5373.95,9844.49,0.00
2024-12-08 16:57:40,53,8240,23,30,5509.88,9845.00,0.00
2024-12-08 16:57:40,54,8240,23,31,5407.85,9845.02,0.00
2024-12-08 16:57:40,53,8240,23,30,5491.31,9845.02,0.00
2024-12-08 16:57:40,52,8240,22,30,5585.58,9845.12,0.00
2024-12-08 16:57:40,52,8241,22,30,5612.63,9846.00,0.00
2024-12-08 16:57:40,53,8241,23,30,5506.73,9846.02,0.00
2024-12-08 16:57:40,53,8242,23,30,5484.99,9847.00,0.00
2024-12-08 16:57:40,54,8242,24,30,5383.42,9847.02,0.00
2024-12-08 16:57:40,53,8242,24,29,5466.41,9847.02,0.00
2024-12-08 16:57:40,53,8243,24,29,5481.83,9848.00,0.00
2024-12-08 16:57:40,54,8243,24,30,5380.32,9848.02,0.00
2024-12-08 16:57:40,53,8243,23,30,5346.39,9848.45,0.00
2024-12-08 16:57:41,53,8244,23,30,5478.67,9849.00,0.00
2024-12-08 16:57:41,54,8244,23,31,5377.22,9849.02,0.00
2024-12-08 16:57:41,53,8244,23,30,5460.09,9849.02,0.00
2024-12-08 16:57:41,52,8244,22,30,5502.90,9849.64,0.00
2024-12-08 16:57:41,52,8245,22,30,5580.81,9850.00,0.00
2024-12-08 16:57:41,53,8245,22,31,5475.51,9850.02,0.00
2024-12-08 16:57:41,53,8246,22,31,5453.76,9851.00,0.00
2024-12-08 16:57:41,54,8246,22,32,5352.77,9851.02,0.00
2024-12-08 16:57:41,53,8246,22,31,5437.04,9851.02,0.00
2024-12-08 16:57:41,52,8246,21,31,5496.23,9851.27,0.00
2024-12-08 16:57:41,51,8246,20,31,5567.50,9851.63,0.00
2024-12-08 16:57:41,51,8247,20,31,5724.23,9852.00,0.00
2024-12-08 16:57:41,52,8247,21,31,5614.15,9852.02,0.00
2024-12-08 16:57:41,52,8248,21,31,5593.88,9853.00,0.00
2024-12-08 16:57:41,53,8248,21,32,5488.33,9853.02,0.00
2024-12-08 16:57:41,52,8248,21,31,5578.72,9853.02,0.00
2024-12-08 16:57:41,52,8249,21,31,5596.34,9854.00,0.00
2024-12-08 16:57:41,53,8249,22,31,5490.75,9854.02,0.00
2024-12-08 16:57:41,52,8249,21,31,5488.45,9854.35,0.00
2024-12-08 16:57:41,52,8250,21,31,5613.97,9855.00,0.00
2024-12-08 16:57:41,53,8250,22,31,5508.04,9855.02,0.00
2024-12-08 16:57:41,52,8250,22,30,5596.91,9855.02,0.00
2024-12-08 16:57:41,52,8251,22,30,5614.54,9856.00,0.00
2024-12-08 16:57:41,53,8251,22,31,5508.60,9856.02,0.00
2024-12-08 16:57:41,53,8252,22,31,5486.84,9857.00,0.00
2024-12-08 16:57:41,54,8252,23,31,5385.23,9857.02,0.00
2024-12-08 16:57:41,53,8252,23,30,5468.24,9857.02,0.00
2024-12-08 16:57:41,53,8253,23,30,5483.68,9858.00,0.00
2024-12-08 16:57:41,54,8253,23,31,5382.13,9858.02,0.00
2024-12-08 16:57:41,53,8253,22,31,5357.36,9858.42,0.00
2024-12-08 16:57:41,53,8254,22,31,5486.10,9859.00,0.00
2024-12-08 16:57:41,54,8254,23,31,5384.50,9859.02,0.00
2024-12-08 16:57:41,53,8254,23,30,5467.49,9859.02,0.00
2024-12-08 16:57:41,53,8255,23,30,5482.93,9860.00,0.00
2024-12-08 16:57:41,54,8255,23,31,5381.40,9860.02,0.00
2024-12-08 16:57:41,54,8256,23,31,5361.29,9861.00,0.00
2024-12-08 16:57:41,55,8256,23,32,5263.81,9861.02,0.00
2024-12-08 16:57:41,54,8256,23,31,5344.86,9861.02,0.00
2024-12-08 16:57:41,54,8257,23,31,5357.44,9862.00,0.00
2024-12-08 16:57:41,55,8257,24,31,5260.03,9862.02,0.00
2024-12-08 16:57:41,55,8258,24,31,5239.18,9863.00,0.00
2024-12-08 16:57:41,56,8258,25,31,5145.63,9863.02,0.00
2024-12-08 16:57:41,55,8258,25,30,5223.04,9863.02,0.00
2024-12-08 16:57:41,54,8258,24,30,5305.20,9863.15,0.00
2024-12-08 16:57:41,53,8258,23,30,5352.44,9863.64,0.00
2024-12-08 16:57:41,53,8259,23,30,5429.00,9864.00,0.00
2024-12-08 16:57:41,54,8259,23,31,5328.47,9864.02,0.00
2024-12-08 16:57:41,53,8259,22,31,5266.60,9864.93,0.00
2024-12-08 16:57:41,53,8260,22,31,5445.34,9865.00,0.00
2024-12-08 16:57:41,54,8260,23,31,5344.50,9865.02,0.00
2024-12-08 16:57:41,53,8260,23,30,5428.58,9865.02,0.00
2024-12-08 16:57:41,52,8260,22,30,5477.69,9865.25,0.00
2024-12-08 16:57:41,52,8261,22,30,5593.90,9866.00,0.00
2024-12-08 16:57:41,53,8261,23,30,5488.35,9866.02,0.00
2024-12-08 16:57:41,53,8262,23,30,5464.73,9867.00,0.00
2024-12-08 16:57:41,54,8262,23,31,5363.54,9867.02,0.00
2024-12-08 16:57:41,53,8262,23,30,5449.84,9867.02,0.00
2024-12-08 16:57:41,53,8263,23,30,5465.06,9868.00,0.00
2024-12-08 16:57:41,54,8263,24,30,5363.86,9868.02,0.00
2024-12-08 16:57:41,53,8263,23,30,5386.93,9868.21,0.00
2024-12-08 16:57:41,53,8264,23,30,5495.41,9869.00,0.00
2024-12-08 16:57:41,54,8264,23,31,5393.65,9869.02,0.00
2024-12-08 16:57:41,53,8264,23,30,5480.52,9869.02,0.00
2024-12-08 16:57:41,53,8265,23,30,5495.97,9870.00,0.00
2024-12-08 16:57:41,54,8265,24,30,5394.19,9870.02,0.00
2024-12-08 16:57:41,53,8265,23,30,5334.19,9870.59,0.00
2024-12-08 16:57:41,53,8266,23,30,5479.76,9871.00,0.00
2024-12-08 16:57:41,54,8266,24,30,5378.29,9871.02,0.00
2024-12-08 16:57:41,53,8266,24,29,5466.73,9871.02,0.00
2024-12-08 16:57:41,53,8267,24,29,5482.18,9872.00,0.00
2024-12-08 16:57:41,54,8267,25,29,5380.66,9872.02,0.00
2024-12-08 16:57:41,54,8268,25,29,5357.44,9873.00,0.00
2024-12-08 16:57:41,55,8268,25,30,5260.03,9873.02,0.00
2024-12-08 16:57:41,54,8268,25,29,5346.47,9873.02,0.00
2024-12-08 16:57:41,54,8269,25,29,5359.17,9874.00,0.00
2024-12-08 16:57:41,55,8269,26,29,5261.73,9874.02,0.00
2024-12-08 16:57:41,55,8270,26,29,5236.37,9875.00,0.00
2024-12-08 16:57:41,56,8270,27,29,5142.86,9875.02,0.00
2024-12-08 16:57:41,55,8270,27,28,5227.39,9875.02,0.00
2024-12-08 16:57:41,55,8271,27,28,5237.13,9876.00,0.00
2024-12-08 16:57:41,56,8271,28,28,5143.61,9876.02,0.00
2024-12-08 16:57:41,55,8271,27,28,5163.83,9876.18,0.00
2024-12-08 16:57:41,55,8272,27,28,5261.30,9877.00,0.00
2024-12-08 16:57:41,56,8272,28,28,5167.35,9877.02,0.00
2024-12-08 16:57:41,55,8272,28,27,5254.12,9877.02,0.00
2024-12-08 16:57:42,55,8273,28,27,5258.57,9878.00,0.00
2024-12-08 16:57:42,56,8273,29,27,5164.67,9878.02,0.00
2024-12-08 16:57:42,55,8273,28,27,5134.46,9878.40,0.00
2024-12-08 16:57:42,55,8274,28,27,5250.60,9879.00,0.00
2024-12-08 16:57:42,56,8274,29,27,5156.84,9879.02,0.00
2024-12-08 16:57:42,55,8274,29,26,5238.03,9879.02,0.00
2024-12-08 16:57:42,55,8275,29,26,5242.42,9880.00,0.00
2024-12-08 16:57:42,56,8275,30,26,5148.80,9880.02,0.00
2024-12-08 16:57:42,56,8276,30,26,5118.81,9881.00,0.00
2024-12-08 16:57:42,57,8276,31,26,5029.00,9881.02,0.00
2024-12-08 16:57:42,56,8276,31,25,5106.45,9881.02,0.00
2024-12-08 16:57:42,56,8277,31,25,5106.49,9882.00,0.00
2024-12-08 16:57:42,57,8277,32,25,5016.90,9882.02,0.00
2024-12-08 16:57:42,56,8277,31,25,4997.35,9882.36,0.00
2024-12-08 16:57:42,56,8278,31,25,5102.80,9883.00,0.00
2024-12-08 16:57:42,57,8278,31,26,5013.28,9883.02,0.00
2024-12-08 16:57:42,56,8278,31,25,5090.45,9883.02,0.00
2024-12-08 16:57:42,56,8279,31,25,5086.68,9884.00,0.00
2024-12-08 16:57:42,57,8279,32,25,4997.44,9884.02,0.00
2024-12-08 16:57:42,56,8279,31,25,4965.60,9884.70,0.00
2024-12-08 16:57:42,56,8280,31,25,5112.31,9885.00,0.00
2024-12-08 16:57:42,57,8280,31,26,5022.62,9885.02,0.00
2024-12-08 16:57:42,56,8280,31,25,5072.74,9885.05,0.00
2024-12-08 16:57:42,56,8281,31,25,5078.47,9886.00,0.00
2024-12-08 16:57:42,57,8281,32,25,4989.38,9886.02,0.00
2024-12-08 16:57:42,57,8282,32,25,4966.81,9887.00,0.00
2024-12-08 16:57:42,58,8282,32,26,4881.18,9887.02,0.00
2024-12-08 16:57:42,57,8282,31,26,4957.83,9887.04,0.00
2024-12-08 16:57:42,56,8282,31,25,5018.11,9887.04,0.00
2024-12-08 16:57:42,55,8282,30,25,5103.97,9887.07,0.00
2024-12-08 16:57:42,55,8283,30,25,5115.01,9888.00,0.00
2024-12-08 16:57:42,56,8283,31,25,5023.67,9888.02,0.00
2024-12-08 16:57:42,55,8283,30,25,4992.57,9888.65,0.00
2024-12-08 16:57:42,55,8284,30,25,5138.43,9889.00,0.00
2024-12-08 16:57:42,56,8284,30,26,5046.68,9889.02,0.00
2024-12-08 16:57:42,55,8284,30,25,5109.67,9889.04,0.00
2024-12-08 16:57:42,55,8285,30,25,5116.41,9890.00,0.00
2024-12-08 16:57:42,56,8285,31,25,5025.04,9890.02,0.00
2024-12-08 16:57:42,55,8285,30,25,5103.28,9890.02,0.00
2024-12-08 16:57:42,55,8286,30,25,5141.75,9891.00,0.00
2024-12-08 16:57:42,56,8286,30,26,5049.93,9891.02,0.00
2024-12-08 16:57:42,55,8286,30,25,5112.98,9891.02,0.00
2024-12-08 16:57:42,54,8286,29,25,5205.84,9891.04,0.00
2024-12-08 16:57:42,54,8287,29,25,5209.79,9892.00,0.00
2024-12-08 16:57:42,55,8287,29,26,5115.07,9892.02,0.00
2024-12-08 16:57:42,54,8287,28,26,5154.87,9892.11,0.00
2024-12-08 16:57:42,54,8288,28,26,5237.71,9893.00,0.00
2024-12-08 16:57:42,55,8288,28,27,5142.48,9893.02,0.00
2024-12-08 16:57:42,54,8288,28,26,5208.39,9893.02,0.00
2024-12-08 16:57:42,53,8288,27,26,5246.75,9893.49,0.00
2024-12-08 16:57:42,52,8288,26,26,5267.79,9893.58,0.00
2024-12-08 16:57:42,52,8289,26,26,5416.48,9894.00,0.00
2024-12-08 16:57:42,53,8289,26,27,5314.28,9894.02,0.00
2024-12-08 16:57:42,53,8290,26,27,5309.40,9895.00,0.00
2024-12-08 16:57:42,54,8290,26,28,5211.08,9895.02,0.00
2024-12-08 16:57:42,53,8290,26,27,5275.79,9895.02,0.00
2024-12-08 16:57:42,52,8290,25,27,5375.36,9895.04,0.00
2024-12-08 16:57:42,52,8290,25,27,5394.92,9896.00,0.00
2024-12-08 16:57:42,53,8290,25,28,5293.13,9896.02,0.00
2024-12-08 16:57:42,53,8291,25,28,5287.80,9897.00,0.00
2024-12-08 16:57:42,54,8291,26,28,5189.88,9897.02,0.00
2024-12-08 16:57:42,53,8291,26,27,5256.06,9897.02,0.00
2024-12-08 16:57:42,52,8291,25,27,5275.66,9897.31,0.00
2024-12-08 16:57:42,52,8292,25,27,5397.92,9898.00,0.00
2024-12-08 16:57:42,53,8292,26,27,5296.07,9898.02,0.00
2024-12-08 16:57:42,53,8293,26,27,5291.55,9899.00,0.00
2024-12-08 16:57:42,54,8293,27,27,5193.56,9899.02,0.00
2024-12-08 16:57:42,53,8293,27,26,5259.80,9899.02,0.00
2024-12-08 16:57:42,52,8293,26,26,5359.53,9899.02,0.00
2024-12-08 16:57:42,52,8294,26,26,5377.21,9900.00,0.00
2024-12-08 16:57:42,53,8294,26,27,5275.75,9900.02,0.00
2024-12-08 16:57:42,53,8295,26,27,5272.83,9901.00,0.00
2024-12-08 16:57:42,54,8295,26,28,5175.19,9901.02,0.00
2024-12-08 16:57:42,53,8295,26,27,5239.21,9901.02,0.00
2024-12-08 16:57:42,52,8295,25,27,5338.06,9901.04,0.00
2024-12-08 16:57:42,51,8295,24,27,5403.88,9901.43,0.00
2024-12-08 16:57:42,51,8296,24,27,5464.44,9902.00,0.00
2024-12-08 16:57:42,52,8296,25,27,5359.36,9902.02,0.00
2024-12-08 16:57:42,52,8297,25,27,5352.24,9903.00,0.00
2024-12-08 16:57:42,53,8297,25,28,5251.26,9903.02,0.00
2024-12-08 16:57:42,52,8297,25,27,5319.87,9903.02,0.00
2024-12-08 16:57:42,52,8298,25,27,5326.70,9904.00,0.00
2024-12-08 16:57:42,53,8298,26,27,5226.19,9904.02,0.00
2024-12-08 16:57:43,53,8299,26,27,5206.29,9905.00,0.00
2024-12-08 16:57:43,54,8299,26,28,5109.87,9905.02,0.00
2024-12-08 16:57:43,53,8299,25,28,5206.29,9905.02,0.00
2024-12-08 16:57:43,52,8299,25,27,5266.41,9905.02,0.00
2024-12-08 16:57:43,52,8300,25,27,5249.70,9906.00,0.00
2024-12-08 16:57:43,53,8300,25,28,5150.65,9906.02,0.00
2024-12-08 16:57:43,53,8301,25,28,5108.52,9907.00,0.00
2024-12-08 16:57:43,54,8301,26,28,5013.91,9907.02,0.00
2024-12-08 16:57:43,53,8301,25,28,4992.43,9907.59,0.00
2024-12-08 16:57:43,52,8301,25,27,5031.30,9907.71,0.00
2024-12-08 16:57:43,52,8302,25,27,5193.48,9908.00,0.00
2024-12-08 16:57:43,53,8302,25,28,5095.49,9908.02,0.00
2024-12-08 16:57:43,52,8302,24,28,5193.48,9908.02,0.00
2024-12-08 16:57:43,51,8302,24,27,5293.37,9908.02,0.00
2024-12-08 16:57:43,50,8302,23,27,5360.23,9908.40,0.00
2024-12-08 16:57:43,50,8303,23,27,5420.08,9909.00,0.00
2024-12-08 16:57:43,51,8303,24,27,5313.80,9909.02,0.00
2024-12-08 16:57:43,51,8304,24,27,5316.50,9910.00,0.00
2024-12-08 16:57:43,52,8304,24,28,5214.26,9910.02,0.00
2024-12-08 16:57:43,51,8304,24,27,5277.64,9910.02,0.00
2024-12-08 16:57:43,50,8304,23,27,5249.19,9910.80,0.00
2024-12-08 16:57:43,50,8305,23,27,5427.74,9911.00,0.00
2024-12-08 16:57:43,51,8305,24,27,5321.31,9911.02,0.00
2024-12-08 16:57:43,51,8306,24,27,5323.74,9912.00,0.00
2024-12-08 16:57:43,52,8306,24,28,5221.36,9912.02,0.00
2024-12-08 16:57:43,51,8306,24,27,5286.81,9912.02,0.00
2024-12-08 16:57:43,50,8306,23,27,5346.55,9912.48,0.00
2024-12-08 16:57:43,50,8307,23,27,5414.32,9913.00,0.00
2024-12-08 16:57:43,51,8307,23,28,5308.15,9913.02,0.00
2024-12-08 16:57:43,50,8307,22,28,5372.69,9913.04,0.00
2024-12-08 16:57:43,49,8307,21,28,5437.89,9913.23,0.00
2024-12-08 16:57:43,49,8307,21,28,5563.81,9914.00,0.00
2024-12-08 16:57:43,50,8307,21,29,5452.54,9914.02,0.00
2024-12-08 16:57:43,49,8307,21,28,5527.39,9914.02,0.00
2024-12-08 16:57:43,48,8307,20,28,5580.67,9914.25,0.00
2024-12-08 16:57:43,48,8308,20,28,5713.35,9915.00,0.00
2024-12-08 16:57:43,49,8308,21,28,5596.75,9915.02,0.00
2024-12-08 16:57:43,48,8308,20,28,5669.97,9915.04,0.00
2024-12-08 16:57:43,48,8309,20,28,5715.88,9916.00,0.00
2024-12-08 16:57:43,49,8309,21,28,5599.23,9916.02,0.00
2024-12-08 16:57:43,48,8309,21,27,5678.69,9916.02,0.00
2024-12-08 16:57:43,48,8310,21,27,5706.13,9917.00,0.00
2024-12-08 16:57:43,49,8310,21,28,5589.67,9917.02,0.00
2024-12-08 16:57:43,48,8310,20,28,5644.26,9917.04,0.00
2024-12-08 16:57:43,48,8311,20,28,5755.45,9918.00,0.00
2024-12-08 16:57:43,49,8311,20,29,5637.99,9918.02,0.00
2024-12-08 16:57:43,48,8311,20,28,5716.19,9918.02,0.00
2024-12-08 16:57:43,47,8311,19,28,5773.84,9918.62,0.00
2024-12-08 16:57:43,47,8312,19,28,5862.76,9919.00,0.00
2024-12-08 16:57:43,48,8312,19,29,5740.62,9919.02,0.00
2024-12-08 16:57:43,48,8313,19,29,5735.64,9920.00,0.00
2024-12-08 16:57:43,49,8313,19,30,5618.59,9920.02,0.00
2024-12-08 16:57:43,48,8313,19,29,5696.38,9920.02,0.00
2024-12-08 16:57:43,47,8313,18,29,5745.86,9920.21,0.00
2024-12-08 16:57:43,47,8314,18,29,5870.39,9921.00,0.00
2024-12-08 16:57:43,48,8314,19,29,5748.09,9921.02,0.00
2024-12-08 16:57:43,47,8314,18,29,5822.68,9921.06,0.00
2024-12-08 16:57:43,46,8314,17,29,5904.02,9921.17,0.00
2024-12-08 16:57:43,46,8315,17,29,6026.31,9922.00,0.00
2024-12-08 16:57:43,47,8315,17,30,5898.09,9922.02,0.00
2024-12-08 16:57:43,46,8315,17,29,5985.33,9922.02,0.00
2024-12-08 16:57:43,46,8316,17,29,6006.88,9923.00,0.00
2024-12-08 16:57:43,47,8316,18,29,5879.07,9923.02,0.00
2024-12-08 16:57:43,47,8317,18,29,5867.17,9924.00,0.00
2024-12-08 16:57:43,48,8317,18,30,5744.93,9924.02,0.00
2024-12-08 16:57:43,47,8317,18,29,5829.16,9924.02,0.00
2024-12-08 16:57:43,46,8317,17,29,5919.24,9924.35,0.00
2024-12-08 16:57:43,45,8317,16,29,5940.23,9924.96,0.00
2024-12-08 16:57:43,45,8318,16,29,6156.40,9925.00,0.00
2024-12-08 16:57:43,46,8318,16,30,6022.56,9925.02,0.00
2024-12-08 16:57:43,46,8319,16,30,6023.26,9926.00,0.00
2024-12-08 16:57:43,47,8319,16,31,5895.11,9926.02,0.00
2024-12-08 16:57:43,46,8319,16,30,5982.27,9926.02,0.00
2024-12-08 16:57:43,46,8320,16,30,6015.24,9927.00,0.00
2024-12-08 16:57:43,47,8320,17,30,5887.25,9927.02,0.00
2024-12-08 16:57:43,47,8321,17,30,5889.97,9928.00,0.00
2024-12-08 16:57:43,48,8321,18,30,5767.26,9928.02,0.00
2024-12-08 16:57:43,47,8321,18,29,5847.72,9928.02,0.00
2024-12-08 16:57:43,48,8320,19,29,5655.96,9928.77,0.00
2024-12-08 16:57:43,48,8321,19,29,5865.07,9929.00,0.00
2024-12-08 16:57:43,49,8321,20,29,5745.37,9929.02,0.00
2024-12-08 16:57:43,49,8322,20,29,5950.34,9930.00,0.00
2024-12-08 16:57:43,50,8322,21,29,5831.34,9930.02,0.00
2024-12-08 16:57:43,49,8322,21,28,5909.81,9930.02,0.00
2024-12-08 16:57:43,48,8322,20,28,5987.91,9930.44,0.00
2024-12-08 16:57:43,48,8323,20,28,6139.35,9931.00,0.00
2024-12-08 16:57:43,49,8323,21,28,6014.06,9931.02,0.00
2024-12-08 16:57:43,49,8324,21,28,6015.39,9932.00,0.00
2024-12-08 16:57:43,50,8324,21,29,5895.08,9932.02,0.00
2024-12-08 16:57:43,49,8324,20,29,5901.43,9932.59,0.00
2024-12-08 16:57:44,49,8325,20,29,6063.92,9933.00,0.00
2024-12-08 16:57:44,50,8325,20,30,5942.64,9933.02,0.00
2024-12-08 16:57:44,49,8325,20,29,6061.89,9933.02,0.00
2024-12-08 16:57:44,49,8326,20,29,6086.83,9934.00,0.00
2024-12-08 16:57:44,50,8326,21,29,5965.09,9934.02,0.00
2024-12-08 16:57:44,50,8327,21,29,5974.41,9935.00,0.00
2024-12-08 16:57:44,51,8327,21,30,5857.26,9935.02,0.00
2024-12-08 16:57:44,50,8327,20,30,5974.41,9935.02,0.00
2024-12-08 16:57:44,50,8328,20,30,5957.70,9936.00,0.00
2024-12-08 16:57:44,51,8328,21,30,5840.88,9936.02,0.00
2024-12-08 16:57:44,50,8328,21,29,5933.87,9936.10,0.00
2024-12-08 16:57:44,50,8329,21,29,5964.26,9937.00,0.00
2024-12-08 16:57:44,51,8329,21,30,5847.31,9937.02,0.00
2024-12-08 16:57:44,50,8329,20,30,5831.40,9937.72,0.00
2024-12-08 16:57:44,50,8330,20,30,6002.54,9938.00,0.00
2024-12-08 16:57:44,51,8330,20,31,5884.84,9938.02,0.00
2024-12-08 16:57:44,50,8330,19,31,5934.98,9938.12,0.00
2024-12-08 16:57:44,50,8331,19,31,6046.87,9939.00,0.00
2024-12-08 16:57:44,51,8331,19,32,5928.30,9939.02,0.00
2024-12-08 16:57:44,50,8331,18,32,6046.87,9939.02,0.00
2024-12-08 16:57:44,49,8331,18,31,6150.01,9939.08,0.00
2024-12-08 16:57:44,48,8331,17,31,6246.53,9939.40,0.00
2024-12-08 16:57:44,48,8332,17,31,6311.18,9940.00,0.00
2024-12-08 16:57:44,49,8332,17,32,6182.38,9940.02,0.00
2024-12-08 16:57:44,48,8332,16,32,6168.47,9940.42,0.00
2024-12-08 16:57:44,48,8333,16,32,6318.03,9941.00,0.00
2024-12-08 16:57:44,49,8333,17,32,6189.09,9941.02,0.00
2024-12-08 16:57:44,48,8333,16,32,6237.26,9941.02,0.00
2024-12-08 16:57:44,47,8333,15,32,6369.96,9941.02,0.00
2024-12-08 16:57:44,47,8334,15,32,6442.52,9942.00,0.00
2024-12-08 16:57:44,48,8334,16,32,6308.31,9942.02,0.00
2024-12-08 16:57:44,47,8334,16,31,6427.73,9942.04,0.00
2024-12-08 16:57:44,46,8334,15,31,6541.69,9942.28,0.00
2024-12-08 16:57:44,46,8335,15,31,6600.58,9943.00,0.00
2024-12-08 16:57:44,47,8335,16,31,6460.14,9943.02,0.00
2024-12-08 16:57:44,46,8335,15,31,6585.46,9943.04,0.00
2024-12-08 16:57:44,46,8336,15,31,6663.93,9944.00,0.00
2024-12-08 16:57:44,47,8336,16,31,6522.15,9944.02,0.00
2024-12-08 16:57:44,48,8335,17,31,6291.30,9944.60,0.00
2024-12-08 16:57:44,48,8336,17,31,6413.11,9945.00,0.00
2024-12-08 16:57:44,49,8336,17,32,6282.23,9945.02,0.00
2024-12-08 16:57:44,48,8336,17,31,6400.69,9945.04,0.00
2024-12-08 16:57:44,48,8337,17,31,6635.48,9946.00,0.00
2024-12-08 16:57:44,49,8337,18,31,6500.06,9946.02,0.00
2024-12-08 16:57:44,48,8337,17,31,6560.89,9946.02,0.00
2024-12-08 16:57:44,48,8338,17,31,6627.91,9947.00,0.00
2024-12-08 16:57:44,49,8338,18,31,6492.65,9947.02,0.00
2024-12-08 16:57:44,49,8339,18,31,6476.12,9948.00,0.00
2024-12-08 16:57:44,50,8339,18,32,6346.60,9948.02,0.00
2024-12-08 16:57:44,49,8339,18,31,6465.97,9948.02,0.00
2024-12-08 16:57:44,49,8340,18,31,6486.95,9949.00,0.00
2024-12-08 16:57:44,50,8340,19,31,6357.21,9949.02,0.00
2024-12-08 16:57:44,50,8341,19,31,6339.52,9950.00,0.00
2024-12-08 16:57:44,51,8341,19,32,6215.21,9950.02,0.00
2024-12-08 16:57:44,51,8342,19,32,6186.18,9951.00,0.00
2024-12-08 16:57:44,52,8342,20,32,6067.21,9951.02,0.00
2024-12-08 16:57:44,51,8342,20,31,6180.33,9951.02,0.00
2024-12-08 16:57:44,51,8343,20,31,6188.59,9952.00,0.00
2024-12-08 16:57:44,52,8343,21,31,6069.58,9952.02,0.00
2024-12-08 16:57:44,52,8344,21,31,6047.96,9953.00,0.00
2024-12-08 16:57:44,53,8344,22,31,5933.84,9953.02,0.00
2024-12-08 16:57:44,52,8344,21,31,5963.09,9953.48,0.00
2024-12-08 16:57:44,52,8345,21,31,6017.02,9954.00,0.00
2024-12-08 16:57:44,53,8345,21,32,5903.49,9954.02,0.00
2024-12-08 16:57:44,52,8345,21,31,6015.10,9954.02,0.00
2024-12-08 16:57:44,52,8346,21,31,6026.47,9955.00,0.00
2024-12-08 16:57:44,53,8346,22,31,5912.77,9955.02,0.00
2024-12-08 16:57:44,53,8347,22,31,5896.79,9956.00,0.00
2024-12-08 16:57:44,54,8347,23,31,5787.59,9956.02,0.00
2024-12-08 16:57:44,53,8347,23,30,5859.22,9956.02,0.00
2024-12-08 16:57:44,53,8348,23,30,5874.49,9957.00,0.00
2024-12-08 16:57:44,54,8348,23,31,5765.70,9957.02,0.00
2024-12-08 16:57:44,54,8349,23,31,5751.72,9958.00,0.00
2024-12-08 16:57:44,55,8349,23,32,5647.14,9958.02,0.00
2024-12-08 16:57:44,54,8349,23,31,5716.68,9958.02,0.00
2024-12-08 16:57:44,53,8349,22,31,5771.34,9958.55,0.00
2024-12-08 16:57:44,53,8350,22,31,5839.28,9959.00,0.00
2024-12-08 16:57:44,54,8350,22,32,5731.15,9959.02,0.00
2024-12-08 16:57:44,55,8349,23,32,5462.22,9959.75,0.00
2024-12-08 16:57:45,55,8350,23,32,5643.48,9960.00,0.00
2024-12-08 16:57:45,56,8350,23,33,5542.70,9960.02,0.00
2024-12-08 16:57:45,55,8350,23,32,5603.64,9960.04,0.00
2024-12-08 16:57:45,55,8351,23,32,5797.99,9961.00,0.00
2024-12-08 16:57:45,56,8351,24,32,5694.45,9961.02,0.00
2024-12-08 16:57:45,56,8352,24,32,5681.64,9962.00,0.00
2024-12-08 16:57:45,57,8352,24,33,5581.96,9962.02,0.00
2024-12-08 16:57:45,56,8352,24,32,5644.28,9962.04,0.00
2024-12-08 16:57:45,56,8353,24,32,5655.52,9963.00,0.00
2024-12-08 16:57:45,57,8353,25,32,5556.30,9963.02,0.00
2024-12-08 16:57:45,56,8353,24,32,5581.57,9963.39,0.00
2024-12-08 16:57:45,56,8354,24,32,5644.15,9964.00,0.00
2024-12-08 16:57:45,57,8354,25,32,5545.13,9964.02,0.00
2024-12-08 16:57:45,56,8354,25,31,5606.78,9964.04,0.00
2024-12-08 16:57:45,56,8355,25,31,5618.02,9965.00,0.00
2024-12-08 16:57:45,57,8355,25,32,5519.46,9965.02,0.00
2024-12-08 16:57:45,56,8355,24,32,5617.17,9965.02,0.00
2024-12-08 16:57:45,56,8356,24,32,5607.10,9966.00,0.00
2024-12-08 16:57:45,57,8356,24,33,5508.73,9966.02,0.00
2024-12-08 16:57:45,56,8356,24,32,5571.51,9966.02,0.00
2024-12-08 16:57:45,55,8356,23,32,5585.94,9966.31,0.00
2024-12-08 16:57:45,55,8357,23,32,5698.71,9967.00,0.00
2024-12-08 16:57:45,56,8357,24,32,5596.94,9967.02,0.00
2024-12-08 16:57:45,56,8358,24,32,5584.64,9968.00,0.00
2024-12-08 16:57:45,57,8358,25,32,5486.66,9968.02,0.00
2024-12-08 16:57:45,56,8358,25,31,5550.82,9968.02,0.00
2024-12-08 16:57:45,56,8359,25,31,5560.27,9969.00,0.00
2024-12-08 16:57:45,57,8359,26,31,5462.73,9969.02,0.00
2024-12-08 16:57:45,56,8359,25,31,5475.39,9969.50,0.00
2024-12-08 16:57:45,55,8359,24,31,5504.48,9969.64,0.00
2024-12-08 16:57:45,55,8360,24,31,5649.74,9970.00,0.00
2024-12-08 16:57:45,56,8360,25,31,5548.86,9970.02,0.00
2024-12-08 16:57:45,55,8360,25,30,5615.30,9970.02,0.00
2024-12-08 16:57:45,55,8361,25,30,5626.74,9971.00,0.00
2024-12-08 16:57:45,56,8361,25,31,5526.26,9971.02,0.00
2024-12-08 16:57:45,56,8362,25,31,5514.98,9972.00,0.00
2024-12-08 16:57:45,57,8362,25,32,5418.23,9972.02,0.00
2024-12-08 16:57:45,56,8362,25,31,5481.15,9972.02,0.00
2024-12-08 16:57:45,56,8363,25,31,5490.61,9973.00,0.00
2024-12-08 16:57:45,57,8363,26,31,5394.28,9973.02,0.00
2024-12-08 16:57:45,57,8364,26,31,5383.52,9974.00,0.00
2024-12-08 16:57:45,58,8364,26,32,5290.70,9974.02,0.00
2024-12-08 16:57:45,57,8364,26,31,5350.28,9974.02,0.00
2024-12-08 16:57:45,56,8364,25,31,5401.34,9974.46,0.00
2024-12-08 16:57:45,56,8365,25,31,5455.11,9975.00,0.00
2024-12-08 16:57:45,57,8365,26,31,5359.41,9975.02,0.00
2024-12-08 16:57:45,57,8366,26,31,5347.69,9976.00,0.00
2024-12-08 16:57:45,58,8366,26,32,5255.48,9976.02,0.00
2024-12-08 16:57:45,57,8366,26,31,5316.18,9976.02,0.00
2024-12-08 16:57:45,57,8367,26,31,5323.72,9977.00,0.00
2024-12-08 16:57:45,58,8367,26,32,5231.93,9977.02,0.00
2024-12-08 16:57:45,57,8367,25,32,5285.22,9977.05,0.00
2024-12-08 16:57:45,56,8367,24,32,5319.68,9977.57,0.00
2024-12-08 16:57:45,56,8368,24,32,5455.37,9978.00,0.00
2024-12-08 16:57:45,57,8368,24,33,5359.66,9978.02,0.00
2024-12-08 16:57:45,56,8368,24,32,5425.08,9978.02,0.00
2024-12-08 16:57:45,55,8368,23,32,5464.11,9978.55,0.00
2024-12-08 16:57:45,55,8369,23,32,5600.48,9979.00,0.00
2024-12-08 16:57:45,56,8369,24,32,5500.48,9979.02,0.00
2024-12-08 16:57:45,56,8370,24,32,5488.38,9980.00,0.00
2024-12-08 16:57:45,57,8370,25,32,5392.10,9980.02,0.00
2024-12-08 16:57:45,56,8370,25,31,5454.53,9980.04,0.00
2024-12-08 16:57:45,56,8371,25,31,5465.77,9981.00,0.00
2024-12-08 16:57:45,57,8371,26,31,5369.88,9981.02,0.00
2024-12-08 16:57:45,56,8371,25,31,5342.96,9981.43,0.00
2024-12-08 16:57:45,56,8372,25,31,5464.53,9982.00,0.00
2024-12-08 16:57:45,57,8372,26,31,5368.66,9982.02,0.00
2024-12-08 16:57:45,56,8372,26,30,5432.45,9982.04,0.00
2024-12-08 16:57:45,55,8372,25,30,5482.11,9982.53,0.00
2024-12-08 16:57:45,55,8373,25,30,5544.15,9983.00,0.00
2024-12-08 16:57:45,56,8373,25,31,5445.15,9983.02,0.00
2024-12-08 16:57:45,56,8374,25,31,5431.21,9984.00,0.00
2024-12-08 16:57:45,57,8374,26,31,5335.93,9984.02,0.00
2024-12-08 16:57:45,56,8374,26,30,5400.91,9984.04,0.00
2024-12-08 16:57:45,55,8374,25,30,5380.59,9984.85,0.00
2024-12-08 16:57:45,55,8375,25,30,5547.72,9985.00,0.00
2024-12-08 16:57:45,56,8375,25,31,5448.65,9985.02,0.00
2024-12-08 16:57:45,56,8376,25,31,5427.71,9986.00,0.00
2024-12-08 16:57:45,57,8376,25,32,5332.49,9986.02,0.00
2024-12-08 16:57:45,56,8376,25,31,5399.18,9986.04,0.00
2024-12-08 16:57:45,56,8377,25,31,5401.07,9987.00,0.00
2024-12-08 16:57:45,57,8377,25,32,5306.31,9987.02,0.00
2024-12-08 16:57:45,56,8377,25,31,5343.41,9987.18,0.00
2024-12-08 16:57:46,55,8377,24,31,5363.95,9987.73,0.00
2024-12-08 16:57:46,55,8378,24,31,5518.51,9988.00,0.00
2024-12-08 16:57:46,56,8378,25,31,5419.96,9988.02,0.00
2024-12-08 16:57:46,55,8378,25,30,5489.45,9988.04,0.00
2024-12-08 16:57:46,54,8378,24,30,5580.44,9988.13,0.00
2024-12-08 16:57:46,53,8378,23,30,5560.59,9988.94,0.00
2024-12-08 16:57:46,53,8379,23,30,5743.44,9989.00,0.00
2024-12-08 16:57:46,54,8379,23,31,5637.08,9989.02,0.00
2024-12-08 16:57:46,54,8380,23,31,5623.18,9990.00,0.00
2024-12-08 16:57:46,55,8380,23,32,5520.94,9990.02,0.00
2024-12-08 16:57:46,54,8380,23,31,5593.58,9990.04,0.00
2024-12-08 16:57:46,54,8381,23,31,5608.94,9991.00,0.00
2024-12-08 16:57:46,55,8381,24,31,5506.96,9991.02,0.00
2024-12-08 16:57:46,55,8382,24,31,5516.96,9992.00,0.00
2024-12-08 16:57:46,56,8382,24,32,5418.44,9992.02,0.00
2024-12-08 16:57:46,56,8383,24,32,5401.24,9993.00,0.00
2024-12-08 16:57:46,57,8383,25,32,5306.48,9993.02,0.00
2024-12-08 16:57:46,56,8383,25,31,5378.04,9993.04,0.00
2024-12-08 16:57:46,55,8383,24,31,5433.64,9993.26,0.00
2024-12-08 16:57:46,55,8384,24,31,5541.32,9994.00,0.00
2024-12-08 16:57:46,56,8384,24,32,5442.37,9994.02,0.00
2024-12-08 16:57:46,56,8385,24,32,5425.75,9995.00,0.00
2024-12-08 16:57:46,57,8385,25,32,5330.56,9995.02,0.00
2024-12-08 16:57:46,56,8385,25,31,5402.55,9995.04,0.00
2024-12-08 16:57:46,56,8386,25,31,5413.80,9996.00,0.00
2024-12-08 16:57:46,57,8386,26,31,5318.82,9996.02,0.00
2024-12-08 16:57:46,56,8386,25,31,5412.18,9996.02,0.00
2024-12-08 16:57:46,56,8387,25,31,5402.18,9997.00,0.00
2024-12-08 16:57:46,57,8387,26,31,5307.41,9997.02,0.00
2024-12-08 16:57:46,56,8387,26,30,5370.05,9997.05,0.00
2024-12-08 16:57:46,55,8387,25,30,5419.65,9997.53,0.00
2024-12-08 16:57:46,55,8388,25,30,5481.78,9998.00,0.00
2024-12-08 16:57:46,56,8388,25,31,5383.90,9998.02,0.00
2024-12-08 16:57:46,55,8388,24,31,5383.71,9998.31,0.00
2024-12-08 16:57:46,55,8389,24,31,5496.88,9999.00,0.00
2024-12-08 16:57:46,56,8389,25,31,5398.72,9999.02,0.00
2024-12-08 16:57:46,55,8389,24,31,5493.31,9999.04,0.00
2024-12-08 16:57:46,54,8389,24,30,5563.56,9999.04,0.00
2024-12-08 16:57:46,53,8389,23,30,5591.32,9999.38,0.00
2024-12-08 16:57:46,53,8390,23,30,5718.16,10000.00,0.00
2024-12-08 16:57:46,54,8390,23,31,5612.26,10000.02,0.00
2024-12-08 16:57:46,53,8390,22,31,5576.71,10000.79,0.00
2024-12-08 16:57:46,53,8391,22,31,5744.81,10001.00,0.00
2024-12-08 16:57:46,54,8391,22,32,5638.43,10001.02,0.00
2024-12-08 16:57:46,53,8391,22,31,5708.97,10001.06,0.00
2024-12-08 16:57:46,52,8391,21,31,5766.87,10001.54,0.00
2024-12-08 16:57:46,52,8392,21,31,5913.40,10002.00,0.00
2024-12-08 16:57:46,53,8392,21,32,5801.82,10002.02,0.00
2024-12-08 16:57:46,52,8392,20,32,5865.34,10002.12,0.00
2024-12-08 16:57:46,52,8393,20,32,5903.14,10003.00,0.00
2024-12-08 16:57:46,53,8393,20,33,5791.76,10003.02,0.00
2024-12-08 16:57:46,52,8393,20,32,5868.53,10003.06,0.00
2024-12-08 16:57:46,51,8393,19,32,5863.72,10003.88,0.00
2024-12-08 16:57:46,51,8394,19,32,6048.20,10004.00,0.00
2024-12-08 16:57:46,52,8394,20,32,5931.89,10004.02,0.00
2024-12-08 16:57:46,51,8394,19,32,6001.15,10004.10,0.00
2024-12-08 16:57:46,51,8395,19,32,6036.25,10005.00,0.00
2024-12-08 16:57:46,52,8395,20,32,5920.17,10005.02,0.00
2024-12-08 16:57:46,51,8395,20,31,6002.91,10005.06,0.00
2024-12-08 16:57:46,50,8395,19,31,6033.69,10005.40,0.00
2024-12-08 16:57:46,50,8396,19,31,6172.91,10006.00,0.00
2024-12-08 16:57:46,51,8396,20,31,6051.87,10006.02,0.00
2024-12-08 16:57:46,51,8397,20,31,6033.76,10007.00,0.00
2024-12-08 16:57:46,52,8397,21,31,5917.72,10007.02,0.00
2024-12-08 16:57:46,51,8397,21,30,6002.37,10007.06,0.00
2024-12-08 16:57:46,51,8398,21,30,6021.92,10008.00,0.00
2024-12-08 16:57:46,52,8398,22,30,5906.11,10008.02,0.00
2024-12-08 16:57:46,51,8398,21,30,5976.80,10008.08,0.00
2024-12-08 16:57:46,50,8398,20,30,6024.40,10008.36,0.00
2024-12-08 16:57:46,50,8399,20,30,6154.94,10009.00,0.00
2024-12-08 16:57:46,51,8399,21,30,6034.26,10009.02,0.00
2024-12-08 16:57:46,50,8399,21,29,6116.92,10009.06,0.00
2024-12-08 16:57:46,50,8400,21,29,6135.94,10010.00,0.00
2024-12-08 16:57:46,51,8400,21,30,6015.63,10010.02,0.00
2024-12-08 16:57:46,51,8401,21,30,5995.12,10011.00,0.00
2024-12-08 16:57:46,52,8401,22,30,5879.83,10011.02,0.00
2024-12-08 16:57:46,51,8401,22,29,5955.87,10011.06,0.00
2024-12-08 16:57:46,50,8401,21,29,6019.30,10011.26,0.00
2024-12-08 16:57:46,50,8402,21,29,6078.61,10012.00,0.00
2024-12-08 16:57:46,51,8402,21,30,5959.42,10012.02,0.00
2024-12-08 16:57:47,51,8403,21,30,5881.27,10013.00,0.00
2024-12-08 16:57:47,52,8403,22,30,5768.17,10013.02,0.00
2024-12-08 16:57:47,51,8403,22,29,5842.01,10013.06,0.00
2024-12-08 16:57:47,50,8403,21,29,5857.56,10013.42,0.00
2024-12-08 16:57:47,49,8403,21,28,5892.32,10013.65,0.00
2024-12-08 16:57:47,49,8404,21,28,6062.22,10014.00,0.00
2024-12-08 16:57:47,50,8404,21,29,5940.98,10014.02,0.00
2024-12-08 16:57:47,50,8405,21,29,5925.08,10015.00,0.00
2024-12-08 16:57:47,51,8405,22,29,5808.90,10015.02,0.00
2024-12-08 16:57:47,50,8405,22,28,5879.02,10015.08,0.00
2024-12-08 16:57:47,50,8406,22,28,5894.81,10016.00,0.00
2024-12-08 16:57:47,51,8406,23,28,5779.23,10016.02,0.00
2024-12-08 16:57:47,50,8406,22,28,5888.88,10016.06,0.00
2024-12-08 16:57:47,50,8407,22,28,5880.68,10017.00,0.00
2024-12-08 16:57:47,51,8407,22,29,5765.38,10017.02,0.00
2024-12-08 16:57:47,50,8407,22,28,5834.61,10017.06,0.00
2024-12-08 16:57:47,50,8408,22,28,5847.14,10018.00,0.00
2024-12-08 16:57:47,51,8408,23,28,5732.49,10018.02,0.00
2024-12-08 16:57:47,51,8409,23,28,5715.59,10019.00,0.00
2024-12-08 16:57:47,52,8409,24,28,5605.67,10019.02,0.00
2024-12-08 16:57:47,51,8409,24,27,5672.37,10019.06,0.00
2024-12-08 16:57:47,50,8409,23,27,5721.68,10019.54,0.00
2024-12-08 16:57:47,50,8410,23,27,5796.16,10020.00,0.00
2024-12-08 16:57:47,51,8410,24,27,5682.51,10020.02,0.00
2024-12-08 16:57:47,50,8410,23,27,5760.08,10020.04,0.00
2024-12-08 16:57:47,49,8410,22,27,5801.75,10020.33,0.00
2024-12-08 16:57:47,49,8411,22,27,5928.09,10021.00,0.00
2024-12-08 16:57:47,50,8411,23,27,5809.53,10021.02,0.00
2024-12-08 16:57:47,49,8411,23,26,5887.19,10021.04,0.00
2024-12-08 16:57:47,48,8411,22,26,5997.34,10021.10,0.00
2024-12-08 16:57:47,47,8411,21,26,6104.00,10021.30,0.00
2024-12-08 16:57:47,47,8412,21,26,6247.36,10022.00,0.00
2024-12-08 16:57:47,48,8412,21,27,6117.21,10022.02,0.00
2024-12-08 16:57:47,48,8413,21,27,6109.91,10023.00,0.00
2024-12-08 16:57:47,49,8413,21,28,5985.22,10023.02,0.00
2024-12-08 16:57:47,48,8413,21,27,6068.16,10023.06,0.00
2024-12-08 16:57:47,48,8414,21,27,6100.08,10024.00,0.00
2024-12-08 16:57:47,49,8414,21,28,5975.59,10024.02,0.00
2024-12-08 16:57:47,48,8414,20,28,6012.80,10024.46,0.00
2024-12-08 16:57:47,48,8415,20,28,6094.62,10025.00,0.00
2024-12-08 16:57:47,49,8415,20,29,5970.24,10025.02,0.00
2024-12-08 16:57:47,48,8415,20,28,6052.86,10025.06,0.00
2024-12-08 16:57:47,49,8414,20,29,5890.67,10025.49,0.00
2024-12-08 16:57:47,49,8415,20,29,6013.80,10026.00,0.00
2024-12-08 16:57:47,50,8415,21,29,5893.53,10026.02,0.00
2024-12-08 16:57:47,50,8416,21,29,6090.29,10027.00,0.00
2024-12-08 16:57:47,51,8416,21,30,5970.87,10027.02,0.00
2024-12-08 16:57:47,50,8416,21,29,6048.18,10027.06,0.00
2024-12-08 16:57:47,49,8416,20,29,6057.84,10027.82,0.00
2024-12-08 16:57:47,49,8417,20,29,6244.21,10028.00,0.00
2024-12-08 16:57:47,50,8417,20,30,6119.33,10028.02,0.00
2024-12-08 16:57:47,49,8417,19,30,6242.17,10028.02,0.00
2024-12-08 16:57:47,49,8418,19,30,6235.72,10029.00,0.00
2024-12-08 16:57:47,50,8418,20,30,6111.00,10029.02,0.00
2024-12-08 16:57:47,49,8418,20,29,6196.84,10029.04,0.00
2024-12-08 16:57:47,49,8419,20,29,6223.15,10030.00,0.00
2024-12-08 16:57:47,50,8419,21,29,6098.69,10030.02,0.00
2024-12-08 16:57:47,50,8420,21,29,6086.94,10031.00,0.00
2024-12-08 16:57:47,51,8420,21,30,5967.59,10031.02,0.00
2024-12-08 16:57:47,50,8420,21,29,6042.81,10031.04,0.00
2024-12-08 16:57:47,50,8421,21,29,6051.14,10032.00,0.00
2024-12-08 16:57:47,51,8421,22,29,5932.49,10032.02,0.00
2024-12-08 16:57:47,50,8421,21,29,5927.68,10032.56,0.00
2024-12-08 16:57:47,50,8422,21,29,6084.52,10033.00,0.00
2024-12-08 16:57:47,51,8422,21,30,5965.21,10033.02,0.00
2024-12-08 16:57:47,50,8422,21,29,6042.38,10033.04,0.00
2024-12-08 16:57:47,50,8423,21,29,6026.47,10034.00,0.00
2024-12-08 16:57:47,51,8423,21,30,5908.31,10034.02,0.00
2024-12-08 16:57:47,50,8423,20,30,5810.23,10034.86,0.00
2024-12-08 16:57:48,50,8424,20,30,5996.98,10035.00,0.00
2024-12-08 16:57:48,51,8424,21,30,5879.40,10035.02,0.00
2024-12-08 16:57:48,50,8424,21,29,5954.84,10035.04,0.00
2024-12-08 16:57:48,49,8424,20,29,6007.89,10035.33,0.00
2024-12-08 16:57:48,48,8424,19,29,6048.39,10035.42,0.00
2024-12-08 16:57:48,48,8425,19,29,6189.34,10036.00,0.00
2024-12-08 16:57:48,49,8425,19,30,6063.03,10036.02,0.00
2024-12-08 16:57:48,49,8426,19,30,6024.08,10037.00,0.00
2024-12-08 16:57:48,50,8426,19,31,5903.60,10037.02,0.00
2024-12-08 16:57:48,49,8426,19,30,5981.07,10037.04,0.00
2024-12-08 16:57:48,49,8427,19,30,5963.87,10038.00,0.00
2024-12-08 16:57:48,50,8427,20,30,5844.59,10038.02,0.00
2024-12-08 16:57:48,49,8427,19,30,5803.18,10038.57,0.00
2024-12-08 16:57:48,49,8428,19,30,5965.35,10039.00,0.00
2024-12-08 16:57:48,50,8428,19,31,5846.05,10039.02,0.00
2024-12-08 16:57:48,49,8428,19,30,5924.38,10039.04,0.00
2024-12-08 16:57:48,48,8428,19,29,6010.96,10039.13,0.00
2024-12-08 16:57:48,47,8428,18,29,6091.09,10039.51,0.00
2024-12-08 16:57:48,47,8429,18,29,6170.49,10040.00,0.00
2024-12-08 16:57:48,48,8429,18,30,6041.94,10040.02,0.00
2024-12-08 16:57:48,47,8429,17,30,6123.50,10040.06,0.00
2024-12-08 16:57:48,46,8429,16,30,6167.35,10040.35,0.00
2024-12-08 16:57:48,46,8430,16,30,6318.51,10041.00,0.00
2024-12-08 16:57:48,47,8430,17,30,6184.08,10041.02,0.00
2024-12-08 16:57:48,46,8430,17,29,6277.04,10041.04,0.00
2024-12-08 16:57:48,46,8431,17,29,6304.77,10042.00,0.00
2024-12-08 16:57:48,47,8431,17,30,6170.63,10042.02,0.00
2024-12-08 16:57:48,47,8432,17,30,6153.41,10043.00,0.00
2024-12-08 16:57:48,48,8432,17,31,6025.21,10043.02,0.00
2024-12-08 16:57:48,47,8432,17,30,6106.40,10043.04,0.00
2024-12-08 16:57:48,46,8432,16,30,6077.51,10043.91,0.00
2024-12-08 16:57:48,46,8433,16,30,6287.19,10044.00,0.00
2024-12-08 16:57:48,47,8433,16,31,6153.42,10044.02,0.00
2024-12-08 16:57:48,46,8433,15,31,6156.59,10044.30,0.00
2024-12-08 16:57:48,46,8434,15,31,6271.64,10045.00,0.00
2024-12-08 16:57:48,47,8434,16,31,6138.20,10045.02,0.00
2024-12-08 16:57:48,46,8434,16,30,6223.60,10045.04,0.00
2024-12-08 16:57:48,45,8434,15,30,6222.36,10045.42,0.00
2024-12-08 16:57:48,45,8435,15,30,6341.92,10046.00,0.00
2024-12-08 16:57:48,46,8435,16,30,6204.05,10046.02,0.00
2024-12-08 16:57:48,45,8435,15,30,6155.84,10046.49,0.00
2024-12-08 16:57:48,44,8435,15,29,6227.27,10046.61,0.00
2024-12-08 16:57:48,44,8436,15,29,6412.38,10047.00,0.00
2024-12-08 16:57:48,45,8436,15,30,6269.89,10047.02,0.00
2024-12-08 16:57:48,44,8436,15,29,6362.15,10047.05,0.00
2024-12-08 16:57:48,44,8437,15,29,6375.08,10048.00,0.00
2024-12-08 16:57:48,45,8437,15,30,6233.41,10048.02,0.00
2024-12-08 16:57:48,44,8437,14,30,6347.67,10048.02,0.00
2024-12-08 16:57:48,45,8436,14,31,6149.92,10048.18,0.00
2024-12-08 16:57:48,45,8437,14,31,6425.21,10049.00,0.00
2024-12-08 16:57:48,46,8437,14,32,6285.53,10049.02,0.00
2024-12-08 16:57:48,45,8437,14,31,6381.88,10049.02,0.00
2024-12-08 16:57:48,45,8438,14,31,6578.70,10050.00,0.00
2024-12-08 16:57:48,46,8438,15,31,6435.69,10050.02,0.00
2024-12-08 16:57:48,45,8438,14,31,6415.22,10050.62,0.00
2024-12-08 16:57:48,45,8439,14,31,6569.29,10051.00,0.00
2024-12-08 16:57:48,46,8439,14,32,6426.48,10051.02,0.00
2024-12-08 16:57:48,45,8439,14,31,6524.62,10051.02,0.00
2024-12-08 16:57:48,45,8440,14,31,6453.37,10052.00,0.00
2024-12-08 16:57:48,46,8440,14,32,6313.08,10052.02,0.00
2024-12-08 16:57:48,46,8441,14,32,6182.79,10053.00,0.00
2024-12-08 16:57:48,47,8441,15,32,6051.24,10053.02,0.00
2024-12-08 16:57:48,46,8441,15,31,6136.90,10053.04,0.00
2024-12-08 16:57:48,45,8441,14,31,6258.95,10053.04,0.00
2024-12-08 16:57:48,44,8441,13,31,6330.37,10053.50,0.00
2024-12-08 16:57:48,43,8441,13,30,6383.57,10053.91,0.00
2024-12-08 16:57:48,43,8442,13,30,6608.09,10054.00,0.00
2024-12-08 16:57:48,44,8442,13,31,6457.91,10054.02,0.00
2024-12-08 16:57:48,44,8443,13,31,6441.11,10055.00,0.00
2024-12-08 16:57:48,45,8443,13,32,6297.97,10055.02,0.00
2024-12-08 16:57:48,45,8444,13,32,6261.65,10056.00,0.00
2024-12-08 16:57:48,46,8444,13,33,6125.53,10056.02,0.00
2024-12-08 16:57:48,45,8444,13,32,6231.89,10056.04,0.00
2024-12-08 16:57:48,44,8444,13,31,6362.10,10056.05,0.00
2024-12-08 16:57:48,43,8444,12,31,6360.76,10056.95,0.00
2024-12-08 16:57:48,43,8445,12,31,6589.99,10057.00,0.00
2024-12-08 16:57:48,44,8445,13,31,6440.22,10057.02,0.00
2024-12-08 16:57:48,43,8445,12,31,6588.50,10057.02,0.00
2024-12-08 16:57:48,42,8445,11,31,6573.19,10057.45,0.00
2024-12-08 16:57:48,42,8446,11,31,6758.01,10058.00,0.00
2024-12-08 16:57:48,43,8446,12,31,6600.85,10058.02,0.00
2024-12-08 16:57:48,43,8447,12,31,6596.83,10059.00,0.00
2024-12-08 16:57:48,44,8447,13,31,6446.90,10059.02,0.00
2024-12-08 16:57:48,43,8447,13,30,6589.81,10059.02,0.00
2024-12-08 16:57:48,43,8448,13,30,6632.58,10060.00,0.00
2024-12-08 16:57:48,44,8448,14,30,6481.84,10060.02,0.00
2024-12-08 16:57:48,43,8448,13,30,6562.41,10060.07,0.00
2024-12-08 16:57:48,43,8449,13,30,6703.43,10061.00,0.00
2024-12-08 16:57:48,44,8449,13,31,6551.08,10061.02,0.00
2024-12-08 16:57:48,44,8450,13,31,6544.87,10062.00,0.00
2024-12-08 16:57:48,45,8450,13,32,6399.43,10062.02,0.00
2024-12-08 16:57:48,44,8450,13,31,6542.58,10062.02,0.00
2024-12-08 16:57:49,44,8451,13,31,6582.11,10063.00,0.00
2024-12-08 16:57:49,45,8451,13,32,6435.84,10063.02,0.00
2024-12-08 16:57:49,45,8452,13,32,6430.16,10064.00,0.00
2024-12-08 16:57:49,46,8452,14,32,6290.37,10064.02,0.00
2024-12-08 16:57:49,45,8452,14,31,6385.43,10064.02,0.00
2024-12-08 16:57:49,45,8453,14,31,6421.85,10065.00,0.00
2024-12-08 16:57:49,46,8453,15,31,6282.25,10065.02,0.00
2024-12-08 16:57:49,46,8454,15,31,6288.28,10066.00,0.00
2024-12-08 16:57:49,47,8454,15,32,6154.49,10066.02,0.00
2024-12-08 16:57:49,47,8455,15,32,5990.54,10067.00,0.00
2024-12-08 16:57:49,48,8455,16,32,5865.73,10067.02,0.00
2024-12-08 16:57:49,47,8455,16,31,5979.83,10067.04,0.00
2024-12-08 16:57:49,46,8455,15,31,6057.23,10067.57,0.00
2024-12-08 16:57:49,45,8455,15,30,6133.42,10067.76,0.00
2024-12-08 16:57:49,45,8456,15,30,6243.21,10068.00,0.00
2024-12-08 16:57:49,46,8456,15,31,6107.49,10068.02,0.00
2024-12-08 16:57:49,45,8456,14,31,6215.31,10068.04,0.00
2024-12-08 16:57:49,45,8457,14,31,6140.81,10069.00,0.00
2024-12-08 16:57:49,46,8457,15,31,6007.32,10069.02,0.00
2024-12-08 16:57:49,45,8457,14,31,6140.81,10069.02,0.00
2024-12-08 16:57:49,44,8457,14,30,6156.14,10069.59,0.00
2024-12-08 16:57:49,44,8458,14,30,6252.55,10070.00,0.00
2024-12-08 16:57:49,45,8458,14,31,6113.61,10070.02,0.00
2024-12-08 16:57:49,44,8458,14,30,6245.69,10070.02,0.00
2024-12-08 16:57:49,44,8459,14,30,6285.22,10071.00,0.00
2024-12-08 16:57:49,45,8459,14,31,6145.54,10071.02,0.00
2024-12-08 16:57:49,44,8459,13,31,6152.61,10071.32,0.00
2024-12-08 16:57:49,44,8460,13,31,6313.31,10072.00,0.00
2024-12-08 16:57:49,45,8460,13,32,6173.01,10072.02,0.00
2024-12-08 16:57:49,45,8461,13,32,6164.67,10073.00,0.00
2024-12-08 16:57:49,46,8461,14,32,6030.66,10073.02,0.00
2024-12-08 16:57:49,45,8461,14,31,6160.20,10073.02,0.00
2024-12-08 16:57:49,44,8461,13,31,6197.38,10073.39,0.00
2024-12-08 16:57:49,44,8462,13,31,6364.93,10074.00,0.00
2024-12-08 16:57:49,45,8462,14,31,6223.49,10074.02,0.00
2024-12-08 16:57:49,45,8463,14,31,6228.23,10075.00,0.00
2024-12-08 16:57:49,46,8463,15,31,6092.83,10075.02,0.00
2024-12-08 16:57:49,46,8464,15,31,6082.48,10076.00,0.00
2024-12-08 16:57:49,47,8464,16,31,5953.07,10076.02,0.00
2024-12-08 16:57:49,46,8464,16,30,6078.10,10076.02,0.00
2024-12-08 16:57:49,46,8465,16,30,6111.57,10077.00,0.00
2024-12-08 16:57:49,47,8465,16,31,5981.53,10077.02,0.00
2024-12-08 16:57:49,47,8466,16,31,5989.85,10078.00,0.00
2024-12-08 16:57:49,48,8466,17,31,5865.06,10078.02,0.00
2024-12-08 16:57:49,47,8466,16,31,5896.58,10078.47,0.00
2024-12-08 16:57:49,47,8467,16,31,6057.78,10079.00,0.00
2024-12-08 16:57:49,48,8467,17,31,5931.57,10079.02,0.00
2024-12-08 16:57:49,47,8467,17,30,6044.92,10079.06,0.00
2024-12-08 16:57:49,47,8468,17,30,6079.82,10080.00,0.00
2024-12-08 16:57:49,48,8468,18,30,5953.16,10080.02,0.00
2024-12-08 16:57:49,47,8468,17,30,5909.48,10080.60,0.00
2024-12-08 16:57:49,47,8469,17,30,6083.50,10081.00,0.00
2024-12-08 16:57:49,48,8469,18,30,5956.76,10081.02,0.00
2024-12-08 16:57:49,48,8470,18,30,5942.64,10082.00,0.00
2024-12-08 16:57:49,49,8470,18,31,5821.36,10082.02,0.00
2024-12-08 16:57:49,48,8470,18,30,5934.24,10082.06,0.00
2024-12-08 16:57:49,48,8471,18,30,5963.82,10083.00,0.00
2024-12-08 16:57:49,49,8471,19,30,5842.11,10083.02,0.00
2024-12-08 16:57:49,49,8472,19,30,5835.46,10084.00,0.00
2024-12-08 16:57:49,50,8472,19,31,5718.75,10084.02,0.00
2024-12-08 16:57:49,49,8472,19,30,5788.13,10084.06,0.00
2024-12-08 16:57:49,49,8473,19,30,5806.58,10085.00,0.00
2024-12-08 16:57:49,50,8473,20,30,5690.45,10085.02,0.00
2024-12-08 16:57:49,49,8473,19,30,5804.85,10085.02,0.00
2024-12-08 16:57:49,48,8473,18,30,5823.15,10085.60,0.00
2024-12-08 16:57:49,47,8473,17,30,5858.45,10085.87,0.00
2024-12-08 16:57:49,47,8474,17,30,6060.24,10086.00,0.00
2024-12-08 16:57:49,48,8474,17,31,5933.99,10086.02,0.00
2024-12-08 16:57:49,47,8474,17,30,6015.19,10086.04,0.00
2024-12-08 16:57:49,47,8475,17,30,6026.15,10087.00,0.00
2024-12-08 16:57:49,48,8475,17,31,5900.61,10087.02,0.00
2024-12-08 16:57:49,47,8475,16,31,5937.45,10087.47,0.00
2024-12-08 16:57:49,47,8476,16,31,5999.27,10088.00,0.00
2024-12-08 16:57:49,48,8476,17,31,5874.28,10088.02,0.00
2024-12-08 16:57:49,47,8476,17,30,5949.92,10088.06,0.00
2024-12-08 16:57:49,46,8476,16,30,5983.49,10088.74,0.00
2024-12-08 16:57:50,46,8477,16,30,6146.27,10089.00,0.00
2024-12-08 16:57:50,47,8477,16,31,6015.50,10089.02,0.00
2024-12-08 16:57:50,47,8478,16,31,5985.35,10090.00,0.00
2024-12-08 16:57:50,48,8478,16,32,5860.65,10090.02,0.00
2024-12-08 16:57:50,47,8478,15,32,5803.74,10090.53,0.00
2024-12-08 16:57:50,47,8479,15,32,5942.74,10091.00,0.00
2024-12-08 16:57:50,48,8479,15,33,5818.93,10091.02,0.00
2024-12-08 16:57:50,47,8479,15,32,5936.31,10091.06,0.00
2024-12-08 16:57:50,46,8479,14,32,5989.17,10091.72,0.00
2024-12-08 16:57:50,46,8480,14,32,6092.50,10092.00,0.00
2024-12-08 16:57:50,47,8480,15,32,5962.87,10092.02,0.00
2024-12-08 16:57:50,46,8480,14,32,5952.27,10092.41,0.00
2024-12-08 16:57:50,46,8481,14,32,6112.84,10093.00,0.00
2024-12-08 16:57:50,47,8481,14,33,5982.78,10093.02,0.00
2024-12-08 16:57:50,46,8481,14,32,6062.39,10093.07,0.00
2024-12-08 16:57:50,46,8482,14,32,6100.28,10094.00,0.00
2024-12-08 16:57:50,47,8482,14,33,5970.49,10094.02,0.00
2024-12-08 16:57:50,47,8483,14,33,5970.39,10095.00,0.00
2024-12-08 16:57:50,48,8483,15,33,5846.00,10095.02,0.00
2024-12-08 16:57:50,47,8483,15,32,5923.15,10095.06,0.00
2024-12-08 16:57:50,46,8483,14,32,6004.58,10095.52,0.00
2024-12-08 16:57:50,46,8484,14,32,6176.12,10096.00,0.00
2024-12-08 16:57:50,47,8484,15,32,6044.71,10096.02,0.00
2024-12-08 16:57:50,47,8485,15,32,6044.27,10097.00,0.00
2024-12-08 16:57:50,48,8485,16,32,5918.35,10097.02,0.00
2024-12-08 16:57:50,47,8485,16,31,5996.51,10097.06,0.00
2024-12-08 16:57:50,47,8486,16,31,6031.46,10098.00,0.00
2024-12-08 16:57:50,48,8486,16,32,5905.81,10098.02,0.00
2024-12-08 16:57:50,47,8486,15,32,5930.51,10098.55,0.00
2024-12-08 16:57:50,47,8487,15,32,6100.58,10099.00,0.00
2024-12-08 16:57:50,48,8487,15,33,5973.48,10099.02,0.00
2024-12-08 16:57:50,47,8487,15,32,6053.26,10099.06,0.00
2024-12-08 16:57:50,47,8488,15,32,6088.23,10100.00,0.00
2024-12-08 16:57:50,48,8488,16,32,5961.39,10100.02,0.00
2024-12-08 16:57:50,47,8488,15,32,6047.10,10100.02,0.00
2024-12-08 16:57:50,47,8489,15,32,6120.77,10101.00,0.00
2024-12-08 16:57:50,48,8489,16,32,5993.26,10101.02,0.00
2024-12-08 16:57:50,47,8489,16,31,6077.80,10101.04,0.00
2024-12-08 16:57:50,47,8490,16,31,6106.80,10102.00,0.00
2024-12-08 16:57:50,48,8490,17,31,5979.58,10102.02,0.00
2024-12-08 16:57:50,47,8490,16,31,6008.21,10102.57,0.00
2024-12-08 16:57:50,47,8491,16,31,6104.09,10103.00,0.00
2024-12-08 16:57:50,48,8491,17,31,5976.93,10103.02,0.00
2024-12-08 16:57:50,47,8491,17,30,6063.26,10103.04,0.00
2024-12-08 16:57:50,47,8492,17,30,6095.06,10104.00,0.00
2024-12-08 16:57:50,48,8492,17,31,5968.08,10104.02,0.00
2024-12-08 16:57:50,47,8492,16,31,5940.75,10104.85,0.00
2024-12-08 16:57:50,47,8493,16,31,6140.49,10105.00,0.00
2024-12-08 16:57:50,48,8493,16,32,6012.56,10105.02,0.00
2024-12-08 16:57:50,47,8493,16,31,6099.64,10105.04,0.00
2024-12-08 16:57:50,47,8494,16,31,6132.50,10106.00,0.00
2024-12-08 16:57:50,48,8494,16,32,6004.73,10106.02,0.00
2024-12-08 16:57:50,48,8495,16,32,5997.56,10107.00,0.00
2024-12-08 16:57:50,49,8495,17,32,5875.16,10107.02,0.00
2024-12-08 16:57:50,48,8495,17,31,5959.66,10107.04,0.00
2024-12-08 16:57:50,47,8495,16,31,6084.32,10107.06,0.00
2024-12-08 16:57:50,46,8495,15,31,6089.00,10107.91,0.00
2024-12-08 16:57:50,46,8496,15,31,6300.01,10108.00,0.00
2024-12-08 16:57:50,47,8496,16,31,6165.97,10108.02,0.00
2024-12-08 16:57:50,46,8496,15,31,6137.62,10108.48,0.00
2024-12-08 16:57:50,46,8497,15,31,6303.45,10109.00,0.00
2024-12-08 16:57:50,47,8497,15,32,6169.34,10109.02,0.00
2024-12-08 16:57:50,46,8497,15,31,6266.10,10109.04,0.00
2024-12-08 16:57:50,46,8498,15,31,6298.98,10110.00,0.00
2024-12-08 16:57:50,47,8498,15,32,6164.96,10110.02,0.00
2024-12-08 16:57:50,47,8499,15,32,6150.97,10111.00,0.00
2024-12-08 16:57:50,48,8499,15,33,6022.83,10111.02,0.00
2024-12-08 16:57:50,47,8499,15,32,6112.25,10111.04,0.00
2024-12-08 16:57:50,46,8499,14,32,6102.13,10111.96,0.00
2024-12-08 16:57:50,46,8500,14,32,6317.58,10112.00,0.00
2024-12-08 16:57:50,47,8500,14,33,6183.16,10112.02,0.00
2024-12-08 16:57:50,47,8501,14,33,6163.12,10113.00,0.00
2024-12-08 16:57:50,48,8501,15,33,6034.72,10113.02,0.00
2024-12-08 16:57:50,47,8501,15,32,6124.39,10113.04,0.00
2024-12-08 16:57:50,47,8502,15,32,6140.05,10114.00,0.00
2024-12-08 16:57:50,48,8502,15,33,6012.13,10114.02,0.00
2024-12-08 16:57:50,48,8503,15,33,5981.46,10115.00,0.00
2024-12-08 16:57:50,49,8503,16,33,5859.39,10115.02,0.00
2024-12-08 16:57:50,48,8503,16,32,5943.53,10115.04,0.00
2024-12-08 16:57:50,47,8503,15,32,5975.60,10115.36,0.00
2024-12-08 16:57:50,47,8504,15,32,6092.06,10116.00,0.00
2024-12-08 16:57:50,48,8504,15,33,5965.15,10116.02,0.00
2024-12-08 16:57:50,48,8505,15,33,5916.38,10117.00,0.00
2024-12-08 16:57:50,49,8505,15,34,5795.64,10117.02,0.00
2024-12-08 16:57:51,48,8505,15,33,5880.55,10117.04,0.00
2024-12-08 16:57:51,47,8505,14,33,5917.09,10117.70,0.00
2024-12-08 16:57:51,47,8506,14,33,6016.34,10118.00,0.00
2024-12-08 16:57:51,48,8506,15,33,5891.00,10118.02,0.00
2024-12-08 16:57:51,47,8506,14,33,5831.34,10118.96,0.00
2024-12-08 16:57:51,47,8507,14,33,6042.35,10119.00,0.00
2024-12-08 16:57:51,48,8507,14,34,5916.47,10119.02,0.00
2024-12-08 16:57:51,47,8507,14,33,6005.75,10119.04,0.00
2024-12-08 16:57:51,47,8508,14,33,6038.64,10120.00,0.00
2024-12-08 16:57:51,48,8508,14,34,5912.84,10120.02,0.00
2024-12-08 16:57:51,47,8508,13,34,5873.08,10120.53,0.00
2024-12-08 16:57:51,47,8509,13,34,6041.39,10121.00,0.00
2024-12-08 16:57:51,48,8509,13,35,5915.53,10121.02,0.00
2024-12-08 16:57:51,47,8509,13,34,6004.79,10121.04,0.00
2024-12-08 16:57:51,47,8510,13,34,6037.66,10122.00,0.00
2024-12-08 16:57:51,48,8510,14,34,5911.87,10122.02,0.00
2024-12-08 16:57:51,48,8511,14,34,5911.05,10123.00,0.00
2024-12-08 16:57:51,49,8511,15,34,5790.41,10123.02,0.00
2024-12-08 16:57:51,48,8511,15,33,5866.77,10123.06,0.00
2024-12-08 16:57:51,48,8512,15,33,5894.05,10124.00,0.00
2024-12-08 16:57:51,49,8512,16,33,5773.76,10124.02,0.00
2024-12-08 16:57:51,49,8513,16,33,5766.28,10125.00,0.00
2024-12-08 16:57:51,50,8513,16,34,5650.96,10125.02,0.00
2024-12-08 16:57:51,49,8513,16,33,5764.22,10125.02,0.00
2024-12-08 16:57:51,48,8513,16,32,5844.23,10125.04,0.00
2024-12-08 16:57:51,47,8513,15,32,5901.70,10125.60,0.00
2024-12-08 16:57:51,47,8514,15,32,5990.34,10126.00,0.00
2024-12-08 16:57:51,48,8514,15,33,5865.54,10126.02,0.00
2024-12-08 16:57:51,48,8515,15,33,5853.19,10127.00,0.00
2024-12-08 16:57:51,49,8515,15,34,5733.74,10127.02,0.00
2024-12-08 16:57:51,48,8515,15,33,5815.23,10127.04,0.00
2024-12-08 16:57:51,47,8515,14,33,5842.83,10127.64,0.00
2024-12-08 16:57:51,47,8516,14,33,6021.96,10128.00,0.00
2024-12-08 16:57:51,48,8516,15,33,5896.50,10128.02,0.00
2024-12-08 16:57:51,47,8516,14,33,5974.56,10128.06,0.00
2024-12-08 16:57:51,47,8517,14,33,6091.29,10129.00,0.00
2024-12-08 16:57:51,48,8517,14,34,5964.39,10129.02,0.00
2024-12-08 16:57:51,47,8517,14,33,6050.35,10129.04,0.00
2024-12-08 16:57:51,47,8518,14,33,6080.82,10130.00,0.00
2024-12-08 16:57:51,48,8518,14,34,5954.13,10130.02,0.00
2024-12-08 16:57:51,48,8519,14,34,5949.54,10131.00,0.00
2024-12-08 16:57:51,49,8519,14,35,5828.12,10131.02,0.00
2024-12-08 16:57:51,48,8519,14,34,5909.45,10131.04,0.00
2024-12-08 16:57:51,47,8519,13,34,5892.12,10131.96,0.00
2024-12-08 16:57:51,47,8520,13,34,6103.41,10132.00,0.00
2024-12-08 16:57:51,48,8520,14,34,5976.25,10132.02,0.00
2024-12-08 16:57:51,48,8521,14,34,5974.04,10133.00,0.00
2024-12-08 16:57:51,49,8521,15,34,5852.12,10133.02,0.00
2024-12-08 16:57:51,48,8521,15,33,5933.94,10133.04,0.00
2024-12-08 16:57:51,48,8522,15,33,5964.08,10134.00,0.00
2024-12-08 16:57:51,49,8522,16,33,5842.36,10134.02,0.00
2024-12-08 16:57:51,49,8523,16,33,5838.94,10135.00,0.00
2024-12-08 16:57:51,50,8523,17,33,5722.16,10135.02,0.00
2024-12-08 16:57:51,49,8523,17,32,5801.72,10135.04,0.00
2024-12-08 16:57:51,49,8524,17,32,5829.18,10136.00,0.00
2024-12-08 16:57:51,50,8524,17,33,5712.59,10136.02,0.00
2024-12-08 16:57:51,49,8524,16,33,5783.68,10136.06,0.00
2024-12-08 16:57:51,49,8525,16,33,5826.10,10137.00,0.00
2024-12-08 16:57:51,50,8525,16,34,5709.58,10137.02,0.00
2024-12-08 16:57:51,49,8525,16,33,5790.94,10137.04,0.00
2024-12-08 16:57:51,48,8525,15,33,5839.39,10137.56,0.00
2024-12-08 16:57:51,48,8526,15,33,6006.56,10138.00,0.00
2024-12-08 16:57:51,49,8526,15,34,5883.98,10138.02,0.00
2024-12-08 16:57:51,48,8526,14,34,5936.89,10138.13,0.00
2024-12-08 16:57:51,47,8526,13,34,6011.72,10138.62,0.00
2024-12-08 16:57:51,48,8525,14,34,5869.69,10138.81,0.00
2024-12-08 16:57:51,48,8526,14,34,6083.19,10139.00,0.00
2024-12-08 16:57:51,49,8526,15,34,5959.05,10139.02,0.00
2024-12-08 16:57:51,48,8526,14,34,6038.84,10139.02,0.00
2024-12-08 16:57:51,47,8526,14,33,6126.34,10139.02,0.00
2024-12-08 16:57:51,47,8527,14,33,6459.19,10140.00,0.00
2024-12-08 16:57:51,48,8527,15,33,6324.62,10140.02,0.00
2024-12-08 16:57:51,48,8528,15,33,6322.47,10141.00,0.00
2024-12-08 16:57:51,49,8528,15,34,6193.44,10141.02,0.00
2024-12-08 16:57:51,50,8527,16,34,5938.28,10141.96,0.00
2024-12-08 16:57:51,50,8528,16,34,6060.03,10142.00,0.00
2024-12-08 16:57:51,51,8528,17,34,5941.20,10142.02,0.00
2024-12-08 16:57:51,50,8528,17,33,6058.00,10142.02,0.00
2024-12-08 16:57:51,50,8529,17,33,6283.77,10143.00,0.00
2024-12-08 16:57:51,51,8529,17,34,6160.56,10143.02,0.00
2024-12-08 16:57:51,50,8529,16,34,6281.74,10143.02,0.00
2024-12-08 16:57:51,50,8530,16,34,6345.25,10144.00,0.00
2024-12-08 16:57:51,51,8530,17,34,6220.84,10144.02,0.00
2024-12-08 16:57:51,50,8530,17,33,6302.65,10144.02,0.00
2024-12-08 16:57:51,49,8530,16,33,6378.20,10144.18,0.00
2024-12-08 16:57:52,49,8531,16,33,6502.98,10145.00,0.00
2024-12-08 16:57:52,50,8531,17,33,6372.92,10145.02,0.00
2024-12-08 16:57:52,49,8531,16,33,6437.09,10145.25,0.00
2024-12-08 16:57:52,49,8532,16,33,6495.53,10146.00,0.00
2024-12-08 16:57:52,50,8532,17,33,6365.62,10146.02,0.00
2024-12-08 16:57:52,49,8532,17,32,6452.04,10146.02,0.00
2024-12-08 16:57:52,49,8533,17,32,6477.53,10147.00,0.00
2024-12-08 16:57:52,50,8533,17,33,6347.98,10147.02,0.00
2024-12-08 16:57:52,50,8534,17,33,6337.07,10148.00,0.00
2024-12-08 16:57:52,51,8534,18,33,6212.81,10148.02,0.00
2024-12-08 16:57:52,50,8534,18,32,6296.48,10148.02,0.00
2024-12-08 16:57:52,49,8534,17,32,6416.04,10148.02,0.00
2024-12-08 16:57:52,49,8535,17,32,6524.37,10149.00,0.00
2024-12-08 16:57:52,50,8535,18,32,6393.89,10149.02,0.00
2024-12-08 16:57:52,49,8535,17,32,6377.81,10149.82,0.00
2024-12-08 16:57:52,49,8536,17,32,6566.45,10150.00,0.00
2024-12-08 16:57:52,50,8536,18,32,6435.12,10150.02,0.00
2024-12-08 16:57:52,49,8536,18,31,6525.02,10150.02,0.00
2024-12-08 16:57:52,49,8537,18,31,6550.52,10151.00,0.00
2024-12-08 16:57:52,50,8537,19,31,6419.51,10151.02,0.00
2024-12-08 16:57:52,50,8538,19,31,6405.26,10152.00,0.00
2024-12-08 16:57:52,51,8538,19,32,6279.66,10152.02,0.00
2024-12-08 16:57:52,50,8538,19,31,6366.68,10152.02,0.00
2024-12-08 16:57:52,50,8539,19,31,6389.64,10153.00,0.00
2024-12-08 16:57:52,51,8539,19,32,6264.35,10153.02,0.00
2024-12-08 16:57:52,51,8540,19,32,6248.28,10154.00,0.00
2024-12-08 16:57:52,52,8540,19,33,6128.12,10154.02,0.00
2024-12-08 16:57:52,51,8540,19,32,6212.44,10154.02,0.00
2024-12-08 16:57:52,50,8540,18,32,6201.36,10154.96,0.00
2024-12-08 16:57:52,50,8541,18,32,6400.41,10155.00,0.00
2024-12-08 16:57:52,51,8541,19,32,6274.91,10155.02,0.00
2024-12-08 16:57:52,51,8542,19,32,6255.48,10156.00,0.00
2024-12-08 16:57:52,52,8542,19,33,6135.18,10156.02,0.00
2024-12-08 16:57:52,51,8542,19,32,6219.64,10156.02,0.00
2024-12-08 16:57:52,50,8542,18,32,6340.40,10156.04,0.00
2024-12-08 16:57:52,50,8543,18,32,6357.92,10157.00,0.00
2024-12-08 16:57:52,51,8543,18,33,6233.25,10157.02,0.00
2024-12-08 16:57:52,50,8543,17,33,6246.20,10157.56,0.00
2024-12-08 16:57:52,50,8544,17,33,6404.99,10158.00,0.00
2024-12-08 16:57:52,51,8544,17,34,6279.40,10158.02,0.00
2024-12-08 16:57:52,50,8544,17,33,6360.30,10158.04,0.00
2024-12-08 16:57:52,49,8544,16,33,6409.41,10158.33,0.00
2024-12-08 16:57:52,49,8545,16,33,6538.54,10159.00,0.00
2024-12-08 16:57:52,50,8545,17,33,6407.77,10159.02,0.00
2024-12-08 16:57:52,49,8545,16,33,6398.59,10159.33,0.00
2024-12-08 16:57:52,49,8546,16,33,6526.08,10160.00,0.00
2024-12-08 16:57:52,50,8546,17,33,6395.56,10160.02,0.00
2024-12-08 16:57:52,49,8546,17,32,6482.54,10160.04,0.00
2024-12-08 16:57:52,49,8547,17,32,6496.94,10161.00,0.00
2024-12-08 16:57:52,50,8547,18,32,6367.00,10161.02,0.00
2024-12-08 16:57:52,50,8548,18,32,6340.11,10162.00,0.00
2024-12-08 16:57:52,51,8548,19,32,6215.80,10162.02,0.00
2024-12-08 16:57:52,51,8549,19,32,6177.49,10163.00,0.00
2024-12-08 16:57:52,52,8549,19,33,6058.69,10163.02,0.00
2024-12-08 16:57:52,51,8549,19,32,6171.52,10163.04,0.00
2024-12-08 16:57:52,51,8550,19,32,6168.96,10164.00,0.00
2024-12-08 16:57:52,52,8550,20,32,6050.33,10164.02,0.00
2024-12-08 16:57:52,51,8550,19,32,6062.69,10164.43,0.00
2024-12-08 16:57:52,51,8551,19,32,6135.08,10165.00,0.00
2024-12-08 16:57:52,52,8551,20,32,6017.10,10165.02,0.00
2024-12-08 16:57:52,51,8551,20,31,6091.24,10165.04,0.00
2024-12-08 16:57:52,51,8552,20,31,6113.76,10166.00,0.00
2024-12-08 16:57:52,52,8552,21,31,5996.18,10166.02,0.00
2024-12-08 16:57:52,52,8553,21,31,5983.66,10167.00,0.00
2024-12-08 16:57:52,53,8553,21,32,5870.76,10167.02,0.00
2024-12-08 16:57:52,52,8553,21,31,5942.60,10167.04,0.00
2024-12-08 16:57:52,52,8554,21,31,5962.74,10168.00,0.00
2024-12-08 16:57:52,53,8554,22,31,5850.23,10168.02,0.00
2024-12-08 16:57:52,52,8554,21,31,5868.97,10168.23,0.00
2024-12-08 16:57:52,52,8555,21,31,5986.79,10169.00,0.00
2024-12-08 16:57:52,53,8555,22,31,5873.83,10169.02,0.00
2024-12-08 16:57:52,52,8555,22,30,5943.77,10169.04,0.00
2024-12-08 16:57:52,52,8556,22,30,5963.91,10170.00,0.00
2024-12-08 16:57:52,53,8556,23,30,5851.38,10170.02,0.00
2024-12-08 16:57:52,53,8557,23,30,5840.53,10171.00,0.00
2024-12-08 16:57:52,54,8557,23,31,5732.37,10171.02,0.00
2024-12-08 16:57:52,53,8557,23,30,5800.23,10171.04,0.00
2024-12-08 16:57:53,53,8558,23,30,5818.07,10172.00,0.00
2024-12-08 16:57:53,54,8558,24,30,5710.33,10172.02,0.00
2024-12-08 16:57:53,54,8559,24,30,5697.88,10173.00,0.00
2024-12-08 16:57:53,55,8559,24,31,5594.28,10173.02,0.00
2024-12-08 16:57:53,54,8559,24,30,5660.21,10173.04,0.00
2024-12-08 16:57:53,54,8560,24,30,5675.83,10174.00,0.00
2024-12-08 16:57:53,55,8560,25,30,5572.63,10174.02,0.00
2024-12-08 16:57:53,54,8560,24,30,5581.35,10174.57,0.00
2024-12-08 16:57:53,54,8561,24,30,5663.96,10175.00,0.00
2024-12-08 16:57:53,55,8561,25,30,5560.98,10175.02,0.00
2024-12-08 16:57:53,54,8561,25,29,5628.17,10175.04,0.00
2024-12-08 16:57:53,54,8562,25,29,5643.79,10176.00,0.00
2024-12-08 16:57:53,55,8562,25,30,5541.18,10176.02,0.00
2024-12-08 16:57:53,54,8562,24,30,5495.06,10176.50,0.00
2024-12-08 16:57:53,54,8563,24,30,5632.95,10177.00,0.00
2024-12-08 16:57:53,55,8563,24,31,5530.53,10177.02,0.00
2024-12-08 16:57:53,56,8562,24,32,5431.77,10177.05,0.00
2024-12-08 16:57:53,55,8562,24,31,5648.98,10177.05,0.00
2024-12-08 16:57:53,54,8562,23,31,5655.79,10177.48,0.00
2024-12-08 16:57:53,54,8563,23,31,5791.83,10178.00,0.00
2024-12-08 16:57:53,55,8563,23,32,5686.52,10178.02,0.00
2024-12-08 16:57:53,54,8563,22,32,5650.76,10178.44,0.00
2024-12-08 16:57:53,54,8564,22,32,5971.55,10179.00,0.00
2024-12-08 16:57:53,55,8564,22,33,5862.98,10179.02,0.00
2024-12-08 16:57:53,54,8564,22,32,5935.76,10179.04,0.00
2024-12-08 16:57:53,53,8564,21,32,5939.13,10179.47,0.00
2024-12-08 16:57:53,53,8565,21,32,6077.77,10180.00,0.00
2024-12-08 16:57:53,54,8565,22,32,5965.22,10180.02,0.00
2024-12-08 16:57:53,54,8566,22,32,5947.43,10181.00,0.00
2024-12-08 16:57:53,55,8566,22,33,5839.29,10181.02,0.00
2024-12-08 16:57:53,54,8566,22,32,5913.51,10181.04,0.00
2024-12-08 16:57:53,53,8566,21,32,5918.00,10181.79,0.00
2024-12-08 16:57:53,53,8567,21,32,6089.15,10182.00,0.00
2024-12-08 16:57:53,54,8567,21,33,5976.39,10182.02,0.00
2024-12-08 16:57:53,54,8567,21,33,5955.92,10183.00,0.00
2024-12-08 16:57:53,55,8567,21,34,5847.63,10183.02,0.00
2024-12-08 16:57:53,54,8567,21,33,5922.00,10183.04,0.00
2024-12-08 16:57:53,53,8567,20,33,5922.25,10183.75,0.00
2024-12-08 16:57:53,53,8568,20,33,6089.62,10184.00,0.00
2024-12-08 16:57:53,54,8568,20,34,5976.85,10184.02,0.00
2024-12-08 16:57:53,53,8568,19,34,5993.24,10184.58,0.00
2024-12-08 16:57:53,53,8569,19,34,6070.44,10185.00,0.00
2024-12-08 16:57:53,54,8569,20,34,5958.03,10185.02,0.00
2024-12-08 16:57:53,53,8569,20,33,6037.21,10185.04,0.00
2024-12-08 16:57:53,53,8570,20,33,6051.47,10186.00,0.00
2024-12-08 16:57:53,54,8570,21,33,5939.40,10186.02,0.00
2024-12-08 16:57:53,53,8570,20,33,5882.29,10186.91,0.00
2024-12-08 16:57:53,53,8571,20,33,6064.96,10187.00,0.00
2024-12-08 16:57:53,54,8571,21,33,5952.65,10187.02,0.00
2024-12-08 16:57:53,53,8571,21,32,6032.38,10187.04,0.00
2024-12-08 16:57:53,53,8572,21,32,6046.52,10188.00,0.00
2024-12-08 16:57:53,54,8572,22,32,5934.55,10188.02,0.00
2024-12-08 16:57:53,53,8572,21,32,5941.99,10188.60,0.00
2024-12-08 16:57:53,53,8573,21,32,6024.49,10189.00,0.00
2024-12-08 16:57:53,54,8573,21,33,5912.93,10189.02,0.00
2024-12-08 16:57:53,53,8573,21,32,5989.87,10189.04,0.00
2024-12-08 16:57:53,53,8574,21,32,6007.75,10190.00,0.00
2024-12-08 16:57:53,54,8574,22,32,5896.49,10190.02,0.00
2024-12-08 16:57:53,54,8575,22,32,5880.26,10191.00,0.00
2024-12-08 16:57:53,55,8575,23,32,5773.34,10191.02,0.00
2024-12-08 16:57:53,54,8575,23,31,5848.19,10191.04,0.00
2024-12-08 16:57:53,54,8576,23,31,5863.85,10192.00,0.00
2024-12-08 16:57:53,55,8576,24,31,5757.23,10192.02,0.00
2024-12-08 16:57:53,55,8577,24,31,5755.59,10193.00,0.00
2024-12-08 16:57:53,56,8577,25,31,5652.81,10193.02,0.00
2024-12-08 16:57:53,55,8577,24,31,5709.29,10193.11,0.00
2024-12-08 16:57:53,55,8578,24,31,5730.20,10194.00,0.00
2024-12-08 16:57:53,56,8578,24,32,5627.88,10194.02,0.00
2024-12-08 16:57:53,55,8578,24,31,5719.10,10194.04,0.00
2024-12-08 16:57:53,55,8579,24,31,5732.62,10195.00,0.00
2024-12-08 16:57:53,56,8579,25,31,5630.25,10195.02,0.00
2024-12-08 16:57:53,56,8580,25,31,5612.56,10196.00,0.00
2024-12-08 16:57:53,57,8580,26,31,5514.09,10196.02,0.00
2024-12-08 16:57:53,57,8581,26,31,5538.86,10197.00,0.00
2024-12-08 16:57:53,58,8581,27,31,5443.36,10197.02,0.00
2024-12-08 16:57:53,58,8582,27,31,5454.77,10198.00,0.00
2024-12-08 16:57:53,59,8582,27,32,5362.31,10198.02,0.00
2024-12-08 16:57:53,59,8583,27,32,5347.89,10199.00,0.00
2024-12-08 16:57:53,60,8583,27,33,5258.76,10199.02,0.00
2024-12-08 16:57:54,59,8583,27,32,5319.05,10199.02,0.00
2024-12-08 16:57:54,59,8584,27,32,5323.03,10200.00,0.00
2024-12-08 16:57:54,60,8584,27,33,5234.32,10200.02,0.00
2024-12-08 16:57:54,59,8584,27,32,5305.74,10200.02,0.00
2024-12-08 16:57:54,59,8585,27,32,5309.72,10201.00,0.00
2024-12-08 16:57:54,60,8585,27,33,5221.23,10201.02,0.00
2024-12-08 16:57:54,59,8585,26,33,5230.29,10201.24,0.00
2024-12-08 16:57:54,59,8586,26,33,5325.84,10202.00,0.00
2024-12-08 16:57:54,60,8586,26,34,5237.08,10202.02,0.00
2024-12-08 16:57:54,59,8586,26,33,5310.28,10202.02,0.00
2024-12-08 16:57:54,58,8586,25,33,5399.91,10202.03,0.00
2024-12-08 16:57:54,58,8587,25,33,5407.47,10203.00,0.00
2024-12-08 16:57:54,59,8587,25,34,5315.82,10203.02,0.00
2024-12-08 16:57:54,58,8587,24,34,5280.30,10203.88,0.00
2024-12-08 16:57:54,58,8588,24,34,5444.00,10204.00,0.00
2024-12-08 16:57:54,59,8588,24,35,5351.73,10204.02,0.00
2024-12-08 16:57:54,58,8588,24,34,5429.93,10204.02,0.00
2024-12-08 16:57:54,57,8588,23,34,5427.99,10204.88,0.00
2024-12-08 16:57:54,57,8589,23,34,5594.60,10205.00,0.00
2024-12-08 16:57:54,58,8589,24,34,5498.14,10205.02,0.00
2024-12-08 16:57:54,57,8589,23,34,5462.27,10205.47,0.00
2024-12-08 16:57:54,57,8590,23,34,5587.81,10206.00,0.00
2024-12-08 16:57:54,58,8590,24,34,5491.47,10206.02,0.00
2024-12-08 16:57:54,57,8590,24,33,5568.11,10206.02,0.00
2024-12-08 16:57:54,57,8591,24,33,5573.55,10207.00,0.00
2024-12-08 16:57:54,58,8591,25,33,5477.45,10207.02,0.00
2024-12-08 16:57:54,57,8591,24,33,5476.95,10207.33,0.00
2024-12-08 16:57:54,57,8592,24,33,5585.59,10208.00,0.00
2024-12-08 16:57:54,58,8592,24,34,5489.29,10208.02,0.00
2024-12-08 16:57:54,57,8592,24,33,5567.68,10208.02,0.00
2024-12-08 16:57:54,56,8592,23,33,5657.79,10208.11,0.00
2024-12-08 16:57:54,56,8593,23,33,5673.43,10209.00,0.00
2024-12-08 16:57:54,57,8593,23,34,5573.89,10209.02,0.00
2024-12-08 16:57:54,56,8593,22,34,5576.81,10209.05,0.00
2024-12-08 16:57:54,56,8594,22,34,5660.17,10210.00,0.00
2024-12-08 16:57:54,57,8594,23,34,5560.86,10210.02,0.00
2024-12-08 16:57:54,56,8594,23,33,5643.76,10210.02,0.00
2024-12-08 16:57:54,55,8594,22,33,5720.43,10210.16,0.00
2024-12-08 16:57:54,55,8595,22,33,5816.76,10211.00,0.00
2024-12-08 16:57:54,56,8595,23,33,5712.89,10211.02,0.00
2024-12-08 16:57:54,55,8595,22,33,5652.76,10211.58,0.00
2024-12-08 16:57:54,55,8596,22,33,5793.13,10212.00,0.00
2024-12-08 16:57:54,56,8596,23,33,5689.68,10212.02,0.00
2024-12-08 16:57:54,55,8596,23,32,5772.71,10212.04,0.00
2024-12-08 16:57:54,54,8596,22,32,5812.08,10212.59,0.00
2024-12-08 16:57:54,53,8596,21,32,5912.16,10212.68,0.00
2024-12-08 16:57:54,53,8597,21,32,5992.22,10213.00,0.00
2024-12-08 16:57:54,54,8597,21,33,5881.25,10213.02,0.00
2024-12-08 16:57:54,54,8598,21,33,5838.69,10214.00,0.00
2024-12-08 16:57:54,55,8598,22,33,5732.54,10214.02,0.00
2024-12-08 16:57:54,54,8598,21,33,5837.17,10214.02,0.00
2024-12-08 16:57:54,53,8598,21,32,5926.11,10214.04,0.00
2024-12-08 16:57:54,52,8598,20,32,6001.31,10214.35,0.00
2024-12-08 16:57:54,52,8599,20,32,6048.80,10215.00,0.00
2024-12-08 16:57:54,53,8599,20,33,5934.67,10215.02,0.00
2024-12-08 16:57:54,52,8599,19,33,5962.43,10215.25,0.00
2024-12-08 16:57:54,52,8600,19,33,6079.14,10216.00,0.00
2024-12-08 16:57:54,53,8600,19,34,5964.43,10216.02,0.00
2024-12-08 16:57:54,52,8600,19,33,6053.60,10216.04,0.00
2024-12-08 16:57:54,52,8601,19,33,6069.76,10217.00,0.00
2024-12-08 16:57:54,53,8601,20,33,5955.24,10217.02,0.00
2024-12-08 16:57:54,53,8602,20,33,5934.33,10218.00,0.00
2024-12-08 16:57:54,54,8602,21,33,5824.44,10218.02,0.00
2024-12-08 16:57:54,53,8602,21,32,5903.49,10218.04,0.00
2024-12-08 16:57:54,53,8603,21,32,5914.25,10219.00,0.00
2024-12-08 16:57:54,54,8603,21,33,5804.72,10219.02,0.00
2024-12-08 16:57:54,54,8604,21,33,5779.81,10220.00,0.00
2024-12-08 16:57:54,55,8604,21,34,5674.72,10220.02,0.00
2024-12-08 16:57:54,54,8604,21,33,5751.43,10220.04,0.00
2024-12-08 16:57:54,53,8604,20,33,5849.94,10220.11,0.00
2024-12-08 16:57:54,53,8605,20,33,5871.23,10221.00,0.00
2024-12-08 16:57:54,54,8605,21,33,5762.50,10221.02,0.00
2024-12-08 16:57:54,53,8605,20,33,5687.72,10221.96,0.00
2024-12-08 16:57:54,53,8606,20,33,5876.75,10222.00,0.00
2024-12-08 16:57:54,54,8606,21,33,5767.92,10222.02,0.00
2024-12-08 16:57:54,53,8606,21,32,5849.75,10222.04,0.00
2024-12-08 16:57:54,53,8607,21,32,5860.66,10223.00,0.00
2024-12-08 16:57:54,54,8607,22,32,5752.13,10223.02,0.00
2024-12-08 16:57:54,54,8608,22,32,5720.87,10224.00,0.00
2024-12-08 16:57:54,55,8608,23,32,5616.85,10224.02,0.00
2024-12-08 16:57:54,54,8608,23,31,5703.16,10224.04,0.00
2024-12-08 16:57:54,54,8609,23,31,5711.50,10225.00,0.00
2024-12-08 16:57:54,55,8609,24,31,5607.65,10225.02,0.00
2024-12-08 16:57:54,54,8609,23,31,5646.65,10225.11,0.00
2024-12-08 16:57:55,54,8610,23,31,5741.17,10226.00,0.00
2024-12-08 16:57:55,55,8610,23,32,5636.79,10226.02,0.00
2024-12-08 16:57:55,56,8609,24,32,5536.13,10226.05,0.00
2024-12-08 16:57:55,55,8609,24,31,5770.68,10226.05,0.00
2024-12-08 16:57:55,54,8609,23,31,5875.48,10226.07,0.00
2024-12-08 16:57:55,54,8610,23,31,5891.98,10227.00,0.00
2024-12-08 16:57:55,55,8610,23,32,5784.85,10227.02,0.00
2024-12-08 16:57:55,55,8611,23,32,5946.75,10228.00,0.00
2024-12-08 16:57:55,56,8611,23,33,5840.56,10228.02,0.00
2024-12-08 16:57:55,55,8611,23,32,5924.46,10228.04,0.00
2024-12-08 16:57:55,54,8611,22,32,5948.98,10228.39,0.00
2024-12-08 16:57:55,54,8612,22,32,6070.99,10229.00,0.00
2024-12-08 16:57:55,55,8612,23,32,5960.61,10229.02,0.00
2024-12-08 16:57:55,54,8612,22,32,6027.45,10229.07,0.00
2024-12-08 16:57:55,54,8613,22,32,6043.66,10230.00,0.00
2024-12-08 16:57:55,55,8613,22,33,5933.77,10230.02,0.00
2024-12-08 16:57:55,54,8613,22,32,6015.26,10230.04,0.00
2024-12-08 16:57:55,54,8614,22,32,5973.24,10231.00,0.00
2024-12-08 16:57:55,55,8614,23,32,5864.63,10231.02,0.00
2024-12-08 16:57:55,54,8614,22,32,5878.65,10231.57,0.00
2024-12-08 16:57:55,53,8614,21,32,5984.43,10231.62,0.00
2024-12-08 16:57:55,53,8615,21,32,5990.86,10232.00,0.00
2024-12-08 16:57:55,54,8615,22,32,5879.92,10232.02,0.00
2024-12-08 16:57:55,53,8615,22,31,5958.06,10232.04,0.00
2024-12-08 16:57:55,53,8616,22,31,5891.59,10233.00,0.00
2024-12-08 16:57:55,54,8616,23,31,5782.49,10233.02,0.00
2024-12-08 16:57:55,53,8616,22,31,5664.94,10233.89,0.00
2024-12-08 16:57:55,53,8617,22,31,5846.53,10234.00,0.00
2024-12-08 16:57:55,54,8617,22,32,5738.26,10234.02,0.00
2024-12-08 16:57:55,53,8617,22,31,5809.86,10234.04,0.00
2024-12-08 16:57:55,52,8617,21,31,5856.95,10234.65,0.00
2024-12-08 16:57:55,52,8618,21,31,5913.42,10235.00,0.00
2024-12-08 16:57:55,53,8618,21,32,5801.85,10235.02,0.00
2024-12-08 16:57:55,52,8618,20,32,5762.11,10235.52,0.00
2024-12-08 16:57:55,52,8619,20,32,5883.02,10236.00,0.00
2024-12-08 16:57:55,53,8619,21,32,5772.02,10236.02,0.00
2024-12-08 16:57:55,52,8619,21,31,5845.63,10236.04,0.00
2024-12-08 16:57:55,51,8619,20,31,5904.19,10236.59,0.00
2024-12-08 16:57:55,50,8619,19,31,5896.64,10236.78,0.00
2024-12-08 16:57:55,50,8620,19,31,6079.01,10237.00,0.00
2024-12-08 16:57:55,51,8620,19,32,5959.81,10237.02,0.00
2024-12-08 16:57:55,50,8620,18,32,5956.54,10237.72,0.00
2024-12-08 16:57:55,50,8621,18,32,6132.84,10238.00,0.00
2024-12-08 16:57:55,51,8621,18,33,6012.59,10238.02,0.00
2024-12-08 16:57:55,50,8621,18,32,6089.87,10238.06,0.00
2024-12-08 16:57:55,50,8622,18,32,6117.06,10239.00,0.00
2024-12-08 16:57:55,51,8622,19,32,5997.11,10239.02,0.00
2024-12-08 16:57:55,51,8623,19,32,5986.75,10240.00,0.00
2024-12-08 16:57:55,52,8623,19,33,5871.62,10240.02,0.00
2024-12-08 16:57:55,51,8623,19,32,5946.61,10240.06,0.00
2024-12-08 16:57:55,50,8623,18,32,6025.54,10240.32,0.00
2024-12-08 16:57:55,50,8624,18,32,6161.19,10241.00,0.00
2024-12-08 16:57:55,51,8624,18,33,6040.38,10241.02,0.00
2024-12-08 16:57:55,51,8625,18,33,6027.28,10242.00,0.00
2024-12-08 16:57:55,52,8625,18,34,5911.37,10242.02,0.00
2024-12-08 16:57:55,51,8625,18,33,5991.15,10242.06,0.00
2024-12-08 16:57:55,51,8626,18,33,6015.82,10243.00,0.00
2024-12-08 16:57:55,52,8626,19,33,5900.13,10243.02,0.00
2024-12-08 16:57:55,51,8626,18,33,5903.30,10243.65,0.00
2024-12-08 16:57:55,51,8627,18,33,6068.26,10244.00,0.00
2024-12-08 16:57:55,52,8627,18,34,5951.56,10244.02,0.00
2024-12-08 16:57:55,51,8627,18,33,6034.14,10244.06,0.00
2024-12-08 16:57:55,51,8628,18,33,6058.81,10245.00,0.00
2024-12-08 16:57:55,52,8628,19,33,5942.29,10245.02,0.00
2024-12-08 16:57:55,52,8629,19,33,5926.75,10246.00,0.00
2024-12-08 16:57:55,53,8629,19,34,5814.93,10246.02,0.00
2024-12-08 16:57:55,52,8629,19,33,5895.25,10246.06,0.00
2024-12-08 16:57:55,52,8630,19,33,5917.48,10247.00,0.00
2024-12-08 16:57:55,53,8630,20,33,5805.83,10247.02,0.00
2024-12-08 16:57:55,53,8631,20,33,5790.56,10248.00,0.00
2024-12-08 16:57:55,54,8631,21,33,5683.33,10248.02,0.00
2024-12-08 16:57:55,53,8631,21,32,5759.64,10248.06,0.00
2024-12-08 16:57:55,53,8632,21,32,5779.52,10249.00,0.00
2024-12-08 16:57:55,54,8632,21,33,5672.49,10249.02,0.00
2024-12-08 16:57:55,53,8632,20,33,5655.92,10249.42,0.00
2024-12-08 16:57:55,53,8633,20,33,5789.76,10250.00,0.00
2024-12-08 16:57:55,54,8633,20,34,5682.54,10250.02,0.00
2024-12-08 16:57:55,53,8633,20,33,5760.77,10250.06,0.00
2024-12-08 16:57:55,52,8633,19,33,5820.76,10250.54,0.00
2024-12-08 16:57:55,52,8634,19,33,5892.06,10251.00,0.00
2024-12-08 16:57:55,53,8634,19,34,5780.89,10251.02,0.00
2024-12-08 16:57:55,52,8634,18,34,5838.88,10251.15,0.00
2024-12-08 16:57:55,51,8634,17,34,5861.43,10251.45,0.00
2024-12-08 16:57:56,51,8635,17,34,6006.55,10252.00,0.00
2024-12-08 16:57:56,52,8635,17,35,5891.04,10252.02,0.00
2024-12-08 16:57:56,51,8635,17,34,5978.42,10252.06,0.00
2024-12-08 16:57:56,50,8635,16,34,6024.19,10252.08,0.00
2024-12-08 16:57:56,50,8636,16,34,6135.48,10253.00,0.00
2024-12-08 16:57:56,51,8636,17,34,6015.18,10253.02,0.00
2024-12-08 16:57:56,51,8637,17,34,5996.51,10254.00,0.00
2024-12-08 16:57:56,52,8637,18,34,5881.20,10254.02,0.00
2024-12-08 16:57:56,51,8637,18,33,5970.39,10254.06,0.00
2024-12-08 16:57:56,50,8637,17,33,6084.83,10254.10,0.00
2024-12-08 16:57:56,50,8638,17,33,6116.17,10255.00,0.00
2024-12-08 16:57:56,51,8638,17,34,5996.24,10255.02,0.00
2024-12-08 16:57:56,50,8638,16,34,6110.68,10255.06,0.00
2024-12-08 16:57:56,50,8639,16,34,6178.95,10256.00,0.00
2024-12-08 16:57:56,51,8639,16,35,6057.79,10256.02,0.00
2024-12-08 16:57:56,50,8639,16,34,6146.15,10256.06,0.00
2024-12-08 16:57:56,50,8640,16,34,6173.40,10257.00,0.00
2024-12-08 16:57:56,51,8640,17,34,6052.35,10257.02,0.00
2024-12-08 16:57:56,50,8640,16,34,6073.17,10257.60,0.00
2024-12-08 16:57:56,50,8641,16,34,6165.32,10258.00,0.00
2024-12-08 16:57:56,51,8641,17,34,6044.44,10258.02,0.00
2024-12-08 16:57:56,50,8641,17,33,6126.36,10258.06,0.00
2024-12-08 16:57:56,50,8642,17,33,6153.17,10259.00,0.00
2024-12-08 16:57:56,51,8642,18,33,6032.52,10259.02,0.00
2024-12-08 16:57:56,51,8643,18,33,6024.17,10260.00,0.00
2024-12-08 16:57:56,52,8643,18,34,5908.32,10260.02,0.00
2024-12-08 16:57:56,51,8643,18,33,5977.92,10260.08,0.00
2024-12-08 16:57:56,50,8643,17,33,6011.85,10260.68,0.00
2024-12-08 16:57:56,50,8644,17,33,6184.46,10261.00,0.00
2024-12-08 16:57:56,51,8644,18,33,6063.19,10261.02,0.00
2024-12-08 16:57:56,51,8645,18,33,6052.14,10262.00,0.00
2024-12-08 16:57:56,52,8645,19,33,5935.75,10262.02,0.00
2024-12-08 16:57:56,51,8645,19,32,6007.89,10262.08,0.00
2024-12-08 16:57:56,51,8646,19,32,6031.85,10263.00,0.00
2024-12-08 16:57:56,52,8646,20,32,5915.86,10263.02,0.00
2024-12-08 16:57:56,52,8647,20,32,5892.71,10264.00,0.00
2024-12-08 16:57:56,53,8647,21,32,5781.53,10264.02,0.00
2024-12-08 16:57:56,52,8647,21,31,5887.71,10264.06,0.00
2024-12-08 16:57:56,52,8648,21,31,5906.51,10265.00,0.00
2024-12-08 16:57:56,53,8648,22,31,5795.06,10265.02,0.00
2024-12-08 16:57:56,53,8649,22,31,5777.06,10266.00,0.00
2024-12-08 16:57:56,54,8649,22,32,5670.08,10266.02,0.00
2024-12-08 16:57:56,53,8649,22,31,5742.21,10266.06,0.00
2024-12-08 16:57:56,52,8649,21,31,5844.76,10266.12,0.00
2024-12-08 16:57:56,52,8650,21,31,5865.16,10267.00,0.00
2024-12-08 16:57:56,53,8650,21,32,5754.50,10267.02,0.00
2024-12-08 16:57:56,53,8651,21,32,5732.38,10268.00,0.00
2024-12-08 16:57:56,54,8651,22,32,5626.23,10268.02,0.00
2024-12-08 16:57:56,53,8651,22,31,5699.46,10268.06,0.00
2024-12-08 16:57:56,52,8651,21,31,5744.60,10268.62,0.00
2024-12-08 16:57:56,51,8651,20,31,5777.66,10268.96,0.00
2024-12-08 16:57:56,51,8652,20,31,5975.00,10269.00,0.00
2024-12-08 16:57:56,52,8652,21,31,5860.10,10269.02,0.00
2024-12-08 16:57:56,52,8653,21,31,5841.85,10270.00,0.00
2024-12-08 16:57:56,53,8653,21,32,5731.63,10270.02,0.00
2024-12-08 16:57:56,52,8653,21,31,5810.27,10270.06,0.00
2024-12-08 16:57:56,52,8654,21,31,5832.55,10271.00,0.00
2024-12-08 16:57:56,53,8654,22,31,5722.50,10271.02,0.00
2024-12-08 16:57:56,52,8654,21,31,5672.81,10271.88,0.00
2024-12-08 16:57:56,52,8655,21,31,5858.58,10272.00,0.00
2024-12-08 16:57:56,53,8655,22,31,5748.04,10272.02,0.00
2024-12-08 16:57:56,52,8655,22,30,5828.96,10272.06,0.00
2024-12-08 16:57:56,52,8656,22,30,5851.25,10273.00,0.00
2024-12-08 16:57:56,53,8656,22,31,5740.85,10273.02,0.00
2024-12-08 16:57:56,53,8657,22,31,5727.80,10274.00,0.00
2024-12-08 16:57:56,54,8657,22,32,5621.73,10274.02,0.00
2024-12-08 16:57:56,53,8657,22,31,5694.85,10274.06,0.00
2024-12-08 16:57:56,52,8657,21,31,5731.40,10274.31,0.00
2024-12-08 16:57:56,52,8658,21,31,5858.32,10275.00,0.00
2024-12-08 16:57:56,53,8658,22,31,5747.78,10275.02,0.00
2024-12-08 16:57:56,52,8658,21,31,5854.38,10275.04,0.00
2024-12-08 16:57:56,52,8659,21,31,5844.59,10276.00,0.00
2024-12-08 16:57:56,53,8659,22,31,5734.31,10276.02,0.00
2024-12-08 16:57:56,52,8659,22,30,5814.96,10276.04,0.00
2024-12-08 16:57:56,52,8660,22,30,5835.28,10277.00,0.00
2024-12-08 16:57:56,53,8660,22,31,5725.18,10277.02,0.00
2024-12-08 16:57:56,53,8661,22,31,5713.87,10278.00,0.00
2024-12-08 16:57:56,54,8661,22,32,5608.05,10278.02,0.00
2024-12-08 16:57:56,53,8661,22,31,5680.91,10278.04,0.00
2024-12-08 16:57:56,52,8661,21,31,5703.55,10278.35,0.00
2024-12-08 16:57:56,52,8662,21,31,5834.44,10279.00,0.00
2024-12-08 16:57:56,53,8662,21,32,5724.35,10279.02,0.00
2024-12-08 16:57:56,52,8662,20,32,5747.53,10279.23,0.00
2024-12-08 16:57:56,52,8663,20,32,5866.63,10280.00,0.00
2024-12-08 16:57:57,53,8663,20,33,5755.94,10280.02,0.00
2024-12-08 16:57:57,52,8663,20,32,5833.04,10280.04,0.00
2024-12-08 16:57:57,52,8664,20,32,5853.36,10281.00,0.00
2024-12-08 16:57:57,53,8664,20,33,5742.92,10281.02,0.00
2024-12-08 16:57:57,52,8664,19,33,5796.41,10281.10,0.00
2024-12-08 16:57:57,52,8665,19,33,5901.75,10282.00,0.00
2024-12-08 16:57:57,53,8665,20,33,5790.39,10282.02,0.00
2024-12-08 16:57:57,52,8665,20,32,5870.12,10282.04,0.00
2024-12-08 16:57:57,51,8665,19,32,5904.71,10282.35,0.00
2024-12-08 16:57:57,51,8666,19,32,6040.23,10283.00,0.00
2024-12-08 16:57:57,52,8666,19,33,5924.07,10283.02,0.00
2024-12-08 16:57:57,52,8667,19,33,5912.70,10284.00,0.00
2024-12-08 16:57:57,53,8667,20,33,5801.14,10284.02,0.00
2024-12-08 16:57:57,52,8667,20,32,5879.09,10284.04,0.00
2024-12-08 16:57:57,51,8667,19,32,5877.70,10284.47,0.00
2024-12-08 16:57:57,51,8668,19,32,6025.27,10285.00,0.00
2024-12-08 16:57:57,52,8668,20,32,5909.40,10285.02,0.00
2024-12-08 16:57:57,51,8668,19,32,5929.04,10285.55,0.00
2024-12-08 16:57:57,51,8669,19,32,6013.69,10286.00,0.00
2024-12-08 16:57:57,52,8669,19,33,5898.04,10286.02,0.00
2024-12-08 16:57:57,51,8669,19,32,5981.43,10286.04,0.00
2024-12-08 16:57:57,51,8670,19,32,6001.98,10287.00,0.00
2024-12-08 16:57:57,52,8670,20,32,5886.56,10287.02,0.00
2024-12-08 16:57:57,51,8670,19,32,5814.52,10287.96,0.00
2024-12-08 16:57:57,51,8671,19,32,6012.23,10288.00,0.00
2024-12-08 16:57:57,52,8671,19,33,5896.61,10288.02,0.00
2024-12-08 16:57:57,51,8671,19,32,5981.92,10288.04,0.00
2024-12-08 16:57:57,50,8671,18,32,6047.62,10288.56,0.00
2024-12-08 16:57:57,50,8672,18,32,6118.74,10289.00,0.00
2024-12-08 16:57:57,51,8672,18,33,5998.76,10289.02,0.00
2024-12-08 16:57:57,51,8673,18,33,5980.65,10290.00,0.00
2024-12-08 16:57:57,52,8673,19,33,5865.63,10290.02,0.00
2024-12-08 16:57:57,51,8673,18,33,5975.66,10290.02,0.00
2024-12-08 16:57:57,50,8673,18,32,6058.13,10290.02,0.00
2024-12-08 16:57:57,49,8673,17,32,6179.67,10290.04,0.00
2024-12-08 16:57:57,49,8674,17,32,6277.27,10291.00,0.00
2024-12-08 16:57:57,50,8674,17,33,6151.72,10291.02,0.00
2024-12-08 16:57:57,50,8675,17,33,6123.45,10292.00,0.00
2024-12-08 16:57:57,51,8675,18,33,6003.39,10292.02,0.00
2024-12-08 16:57:57,50,8675,18,32,6088.46,10292.02,0.00
2024-12-08 16:57:57,50,8676,18,32,6088.55,10293.00,0.00
2024-12-08 16:57:57,51,8676,18,33,5969.16,10293.02,0.00
2024-12-08 16:57:57,51,8677,18,33,5928.93,10294.00,0.00
2024-12-08 16:57:57,52,8677,18,34,5814.91,10294.02,0.00
2024-12-08 16:57:57,51,8677,18,33,5894.62,10294.02,0.00
2024-12-08 16:57:57,50,8677,17,33,6012.51,10294.02,0.00
2024-12-08 16:57:57,50,8678,17,33,5996.28,10295.00,0.00
2024-12-08 16:57:57,51,8678,18,33,5878.71,10295.02,0.00
2024-12-08 16:57:57,50,8678,17,33,5887.28,10295.30,0.00
2024-12-08 16:57:57,50,8679,17,33,5973.62,10296.00,0.00
2024-12-08 16:57:57,51,8679,18,33,5856.49,10296.02,0.00
2024-12-08 16:57:57,50,8679,18,32,5934.50,10296.02,0.00
2024-12-08 16:57:57,49,8679,18,31,5949.32,10296.69,0.00
2024-12-08 16:57:57,49,8680,18,31,6044.11,10297.00,0.00
2024-12-08 16:57:57,50,8680,19,31,5923.23,10297.02,0.00
2024-12-08 16:57:57,50,8681,19,31,5911.38,10298.00,0.00
2024-12-08 16:57:57,51,8681,20,31,5795.47,10298.02,0.00
2024-12-08 16:57:57,50,8681,20,30,5874.31,10298.02,0.00
2024-12-08 16:57:57,50,8682,20,30,5891.30,10299.00,0.00
2024-12-08 16:57:57,51,8682,21,30,5775.79,10299.02,0.00
2024-12-08 16:57:57,51,8683,21,30,5767.60,10300.00,0.00
2024-12-08 16:57:57,52,8683,22,30,5656.69,10300.02,0.00
2024-12-08 16:57:57,51,8683,22,29,5731.25,10300.02,0.00
2024-12-08 16:57:57,50,8683,21,29,5694.62,10300.96,0.00
2024-12-08 16:57:57,50,8684,21,29,5896.54,10301.00,0.00
2024-12-08 16:57:57,51,8684,21,30,5780.92,10301.02,0.00
2024-12-08 16:57:57,51,8685,21,30,5768.47,10302.00,0.00
2024-12-08 16:57:57,52,8685,21,31,5657.54,10302.02,0.00
2024-12-08 16:57:57,51,8685,21,30,5734.13,10302.02,0.00
2024-12-08 16:57:57,50,8685,20,30,5754.79,10302.32,0.00
2024-12-08 16:57:57,50,8686,20,30,5891.24,10303.00,0.00
2024-12-08 16:57:57,51,8686,20,31,5775.72,10303.02,0.00
2024-12-08 16:57:57,51,8687,20,31,5761.62,10304.00,0.00
2024-12-08 16:57:57,52,8687,21,31,5650.82,10304.02,0.00
2024-12-08 16:57:57,51,8687,21,30,5727.27,10304.02,0.00
2024-12-08 16:57:57,50,8687,20,30,5740.97,10304.70,0.00
2024-12-08 16:57:57,50,8688,20,30,5916.37,10305.00,0.00
2024-12-08 16:57:57,51,8688,21,30,5800.37,10305.02,0.00
2024-12-08 16:57:57,50,8688,20,30,5822.16,10305.24,0.00
2024-12-08 16:57:57,50,8689,20,30,5950.45,10306.00,0.00
2024-12-08 16:57:57,51,8689,20,31,5833.77,10306.02,0.00
2024-12-08 16:57:57,50,8689,20,30,5917.47,10306.02,0.00
2024-12-08 16:57:57,50,8690,20,30,5940.72,10307.00,0.00
2024-12-08 16:57:57,51,8690,20,31,5824.23,10307.02,0.00
2024-12-08 16:57:57,50,8690,20,30,5905.22,10307.02,0.00
2024-12-08 16:57:58,50,8691,20,30,5927.40,10308.00,0.00
2024-12-08 16:57:58,51,8691,20,31,5811.18,10308.02,0.00
2024-12-08 16:57:58,50,8691,20,30,5896.54,10308.02,0.00
2024-12-08 16:57:58,50,8692,20,30,5916.71,10309.00,0.00
2024-12-08 16:57:58,51,8692,20,31,5800.69,10309.02,0.00
2024-12-08 16:57:58,51,8693,20,31,5791.85,10310.00,0.00
2024-12-08 16:57:58,52,8693,20,32,5680.47,10310.02,0.00
2024-12-08 16:57:58,51,8693,20,31,5757.48,10310.02,0.00
2024-12-08 16:57:58,51,8694,20,31,5770.99,10311.00,0.00
2024-12-08 16:57:58,52,8694,20,32,5660.01,10311.02,0.00
2024-12-08 16:57:58,51,8694,19,32,5765.39,10311.02,0.00
2024-12-08 16:57:58,51,8695,19,32,5817.54,10312.00,0.00
2024-12-08 16:57:58,52,8695,19,33,5705.67,10312.02,0.00
2024-12-08 16:57:58,51,8695,19,32,5781.15,10312.02,0.00
2024-12-08 16:57:58,51,8696,19,32,5793.73,10313.00,0.00
2024-12-08 16:57:58,52,8696,19,33,5682.31,10313.02,0.00
2024-12-08 16:57:58,51,8696,18,33,5659.20,10313.76,0.00
2024-12-08 16:57:58,51,8697,18,33,5837.26,10314.00,0.00
2024-12-08 16:57:58,52,8697,19,33,5725.00,10314.02,0.00
2024-12-08 16:57:58,51,8697,19,32,5802.88,10314.02,0.00
2024-12-08 16:57:58,50,8697,18,32,5860.71,10314.58,0.00
2024-12-08 16:57:58,50,8698,18,32,5941.47,10315.00,0.00
2024-12-08 16:57:58,51,8698,18,33,5824.97,10315.02,0.00
2024-12-08 16:57:58,51,8699,18,33,5819.03,10316.00,0.00
2024-12-08 16:57:58,52,8699,19,33,5707.13,10316.02,0.00
2024-12-08 16:57:58,51,8699,19,32,5786.67,10316.02,0.00
2024-12-08 16:57:58,50,8699,18,32,5824.54,10316.64,0.00
2024-12-08 16:57:58,50,8700,18,32,5994.01,10317.00,0.00
2024-12-08 16:57:58,51,8700,19,32,5876.48,10317.02,0.00
2024-12-08 16:57:58,50,8700,18,32,5892.46,10317.58,0.00
2024-12-08 16:57:58,50,8701,18,32,5985.97,10318.00,0.00
2024-12-08 16:57:58,51,8701,18,33,5868.60,10318.02,0.00
2024-12-08 16:57:58,50,8701,18,32,5955.02,10318.02,0.00
2024-12-08 16:57:58,50,8702,18,32,5978.30,10319.00,0.00
2024-12-08 16:57:58,51,8702,18,33,5861.07,10319.02,0.00
2024-12-08 16:57:58,51,8703,18,33,5854.19,10320.00,0.00
2024-12-08 16:57:58,52,8703,19,33,5741.61,10320.02,0.00
2024-12-08 16:57:58,51,8703,19,32,5821.82,10320.02,0.00
2024-12-08 16:57:58,50,8703,18,32,5791.59,10320.96,0.00
2024-12-08 16:57:58,50,8704,18,32,5993.90,10321.00,0.00
2024-12-08 16:57:58,51,8704,19,32,5876.37,10321.02,0.00
2024-12-08 16:57:58,51,8705,19,32,5868.80,10322.00,0.00
2024-12-08 16:57:58,52,8705,19,33,5755.94,10322.02,0.00
2024-12-08 16:57:58,51,8705,19,32,5838.44,10322.02,0.00
2024-12-08 16:57:58,51,8706,19,32,5859.25,10323.00,0.00
2024-12-08 16:57:58,52,8706,19,33,5746.57,10323.02,0.00
2024-12-08 16:57:58,51,8706,18,33,5857.70,10323.02,0.00
2024-12-08 16:57:58,51,8707,18,33,5854.78,10324.00,0.00
2024-12-08 16:57:58,52,8707,18,34,5742.19,10324.02,0.00
2024-12-08 16:57:58,51,8707,18,33,5820.36,10324.02,0.00
2024-12-08 16:57:58,51,8708,18,33,5841.17,10325.00,0.00
2024-12-08 16:57:58,52,8708,18,34,5728.84,10325.02,0.00
2024-12-08 16:57:58,51,8708,17,34,5786.53,10325.08,0.00
2024-12-08 16:57:58,51,8709,17,34,5894.38,10326.00,0.00
2024-12-08 16:57:58,52,8709,18,34,5781.03,10326.02,0.00
2024-12-08 16:57:58,51,8709,18,33,5849.84,10326.04,0.00
2024-12-08 16:57:58,50,8709,17,33,5948.27,10326.10,0.00
2024-12-08 16:57:58,49,8709,16,33,6017.25,10326.61,0.00
2024-12-08 16:57:58,49,8710,16,33,6188.25,10327.00,0.00
2024-12-08 16:57:58,50,8710,17,33,6064.49,10327.02,0.00
2024-12-08 16:57:58,50,8711,17,33,6062.06,10328.00,0.00
2024-12-08 16:57:58,51,8711,18,33,5943.20,10328.02,0.00
2024-12-08 16:57:58,50,8711,18,32,6018.68,10328.04,0.00
2024-12-08 16:57:58,49,8711,17,32,6129.74,10328.14,0.00
2024-12-08 16:57:58,49,8712,17,32,6168.24,10329.00,0.00
2024-12-08 16:57:58,50,8712,18,32,6044.88,10329.02,0.00
2024-12-08 16:57:58,49,8712,17,32,6164.03,10329.04,0.00
2024-12-08 16:57:58,49,8713,17,32,6234.19,10330.00,0.00
2024-12-08 16:57:58,50,8713,18,32,6109.51,10330.02,0.00
2024-12-08 16:57:58,49,8713,18,31,6187.81,10330.04,0.00
2024-12-08 16:57:58,49,8714,18,31,6215.82,10331.00,0.00
2024-12-08 16:57:58,50,8714,19,31,6091.50,10331.02,0.00
2024-12-08 16:57:58,50,8715,19,31,6089.43,10332.00,0.00
2024-12-08 16:57:58,51,8715,19,32,5970.03,10332.02,0.00
2024-12-08 16:57:58,50,8715,18,32,5997.72,10332.50,0.00
2024-12-08 16:57:58,50,8716,18,32,6070.40,10333.00,0.00
2024-12-08 16:57:58,51,8716,18,33,5951.37,10333.02,0.00
2024-12-08 16:57:58,50,8716,18,32,6064.21,10333.06,0.00
2024-12-08 16:57:58,50,8717,18,32,6091.66,10334.00,0.00
2024-12-08 16:57:58,51,8717,19,32,5972.21,10334.02,0.00
2024-12-08 16:57:58,50,8717,18,32,5915.68,10334.96,0.00
2024-12-08 16:57:58,50,8718,18,32,6118.27,10335.00,0.00
2024-12-08 16:57:58,51,8718,19,32,5998.30,10335.02,0.00
2024-12-08 16:57:58,50,8718,18,32,6115.00,10335.02,0.00
2024-12-08 16:57:59,49,8718,18,31,6195.51,10335.04,0.00
2024-12-08 16:57:59,49,8719,18,31,6223.52,10336.00,0.00
2024-12-08 16:57:59,50,8719,19,31,6099.05,10336.02,0.00
2024-12-08 16:57:59,50,8720,19,31,6094.51,10337.00,0.00
2024-12-08 16:57:59,51,8720,19,32,5975.01,10337.02,0.00
2024-12-08 16:57:59,50,8720,19,31,6046.97,10337.06,0.00
2024-12-08 16:57:59,50,8721,19,31,6072.23,10338.00,0.00
2024-12-08 16:57:59,51,8721,20,31,5953.17,10338.02,0.00
2024-12-08 16:57:59,51,8722,20,31,5940.87,10339.00,0.00
2024-12-08 16:57:59,52,8722,20,32,5826.62,10339.02,0.00
2024-12-08 16:57:59,51,8722,20,31,5896.28,10339.06,0.00
2024-12-08 16:57:59,51,8723,20,31,5909.31,10340.00,0.00
2024-12-08 16:57:59,52,8723,20,32,5795.67,10340.02,0.00
2024-12-08 16:57:59,52,8724,20,32,5777.04,10341.00,0.00
2024-12-08 16:57:59,53,8724,20,33,5668.04,10341.02,0.00
2024-12-08 16:57:59,52,8724,20,32,5733.31,10341.06,0.00
2024-12-08 16:57:59,52,8725,20,32,5739.99,10342.00,0.00
2024-12-08 16:57:59,53,8725,21,32,5631.69,10342.02,0.00
2024-12-08 16:57:59,53,8726,21,32,5613.65,10343.00,0.00
2024-12-08 16:57:59,54,8726,21,33,5509.70,10343.02,0.00
2024-12-08 16:57:59,53,8726,21,32,5572.69,10343.06,0.00
2024-12-08 16:57:59,52,8726,20,32,5611.95,10343.60,0.00
2024-12-08 16:57:59,52,8727,20,32,5677.11,10344.00,0.00
2024-12-08 16:57:59,53,8727,21,32,5569.99,10344.02,0.00
2024-12-08 16:57:59,52,8727,20,32,5613.92,10344.10,0.00
2024-12-08 16:57:59,52,8728,20,32,5709.42,10345.00,0.00
2024-12-08 16:57:59,53,8728,21,32,5601.70,10345.02,0.00
2024-12-08 16:57:59,52,8728,21,31,5665.67,10345.08,0.00
2024-12-08 16:57:59,52,8729,21,31,5680.65,10346.00,0.00
2024-12-08 16:57:59,53,8729,22,31,5573.47,10346.02,0.00
2024-12-08 16:57:59,53,8730,22,31,5561.65,10347.00,0.00
2024-12-08 16:57:59,54,8730,23,31,5458.66,10347.02,0.00
2024-12-08 16:57:59,53,8730,23,30,5516.76,10347.08,0.00
2024-12-08 16:57:59,53,8731,23,30,5528.46,10348.00,0.00
2024-12-08 16:57:59,54,8731,23,31,5426.08,10348.02,0.00
2024-12-08 16:57:59,54,8732,23,31,5402.20,10349.00,0.00
2024-12-08 16:57:59,55,8732,23,32,5303.98,10349.02,0.00
2024-12-08 16:57:59,54,8732,22,32,5397.39,10349.06,0.00
2024-12-08 16:57:59,53,8732,22,31,5481.16,10349.06,0.00
2024-12-08 16:57:59,52,8732,21,31,5546.51,10349.44,0.00
2024-12-08 16:57:59,51,8732,20,31,5649.79,10349.49,0.00
2024-12-08 16:57:59,50,8732,19,31,5686.46,10349.88,0.00
2024-12-08 16:57:59,50,8733,19,31,5881.12,10350.00,0.00
2024-12-08 16:57:59,51,8733,19,32,5765.80,10350.02,0.00
2024-12-08 16:57:59,51,8734,19,32,5765.72,10351.00,0.00
2024-12-08 16:57:59,52,8734,20,32,5654.84,10351.02,0.00
2024-12-08 16:57:59,51,8734,20,31,5717.03,10351.08,0.00
2024-12-08 16:57:59,51,8735,20,31,5743.95,10352.00,0.00
2024-12-08 16:57:59,52,8735,21,31,5633.49,10352.02,0.00
2024-12-08 16:57:59,51,8735,20,31,5604.86,10352.71,0.00
2024-12-08 16:57:59,51,8736,20,31,5777.62,10353.00,0.00
2024-12-08 16:57:59,52,8736,20,32,5666.52,10353.02,0.00
2024-12-08 16:57:59,51,8736,20,31,5728.92,10353.08,0.00
2024-12-08 16:57:59,51,8737,20,31,5755.78,10354.00,0.00
2024-12-08 16:57:59,52,8737,20,32,5645.09,10354.02,0.00
2024-12-08 16:57:59,52,8738,20,32,5642.13,10355.00,0.00
2024-12-08 16:57:59,53,8738,21,32,5535.67,10355.02,0.00
2024-12-08 16:57:59,52,8738,21,31,5596.34,10355.08,0.00
2024-12-08 16:57:59,51,8738,20,31,5555.50,10355.96,0.00
2024-12-08 16:57:59,51,8739,20,31,5754.51,10356.00,0.00
2024-12-08 16:57:59,52,8739,21,31,5643.85,10356.02,0.00
2024-12-08 16:57:59,52,8740,21,31,5648.36,10357.00,0.00
2024-12-08 16:57:59,53,8740,22,31,5541.79,10357.02,0.00
2024-12-08 16:57:59,52,8740,21,31,5556.27,10357.52,0.00
2024-12-08 16:57:59,51,8740,20,31,5664.12,10357.53,0.00
2024-12-08 16:57:59,50,8740,19,31,5736.57,10357.64,0.00
2024-12-08 16:57:59,50,8741,19,31,5906.72,10358.00,0.00
2024-12-08 16:57:59,51,8741,19,32,5790.90,10358.02,0.00
2024-12-08 16:57:59,50,8741,18,32,5896.38,10358.10,0.00
2024-12-08 16:57:59,49,8741,18,31,6006.14,10358.12,0.00
2024-12-08 16:57:59,49,8742,18,31,6042.64,10359.00,0.00
2024-12-08 16:57:59,50,8742,19,31,5921.79,10359.02,0.00
2024-12-08 16:57:59,50,8743,19,31,5870.87,10360.00,0.00
2024-12-08 16:57:59,51,8743,20,31,5755.76,10360.02,0.00
2024-12-08 16:57:59,50,8743,20,30,5858.78,10360.06,0.00
2024-12-08 16:57:59,50,8744,20,30,5844.83,10361.00,0.00
2024-12-08 16:57:59,51,8744,21,30,5730.23,10361.02,0.00
2024-12-08 16:57:59,50,8744,21,29,5832.41,10361.10,0.00
2024-12-08 16:57:59,50,8745,21,29,5864.05,10362.00,0.00
2024-12-08 16:57:59,51,8745,22,29,5749.06,10362.02,0.00
2024-12-08 16:57:59,50,8745,21,29,5846.94,10362.08,0.00
2024-12-08 16:58:00,50,8746,21,29,5916.86,10363.00,0.00
2024-12-08 16:58:00,51,8746,21,30,5800.84,10363.02,0.00
2024-12-08 16:58:00,50,8746,21,29,5867.13,10363.08,0.00
2024-12-08 16:58:00,50,8747,21,29,5893.15,10364.00,0.00
2024-12-08 16:58:00,51,8747,21,30,5777.60,10364.02,0.00
2024-12-08 16:58:00,51,8748,21,30,5771.78,10365.00,0.00
2024-12-08 16:58:00,52,8748,22,30,5660.79,10365.02,0.00
2024-12-08 16:58:00,52,8749,22,30,5629.80,10366.00,0.00
2024-12-08 16:58:00,53,8749,23,30,5523.58,10366.02,0.00
2024-12-08 16:58:00,52,8749,23,29,5621.84,10366.08,0.00
2024-12-08 16:58:00,52,8750,23,29,5632.78,10367.00,0.00
2024-12-08 16:58:00,53,8750,24,29,5526.50,10367.02,0.00
2024-12-08 16:58:00,52,8750,23,29,5479.46,10367.50,0.00
2024-12-08 16:58:00,52,8751,23,29,5611.95,10368.00,0.00
2024-12-08 16:58:00,53,8751,24,29,5506.06,10368.02,0.00
2024-12-08 16:58:00,52,8751,24,28,5591.30,10368.08,0.00
2024-12-08 16:58:00,52,8752,24,28,5598.99,10369.00,0.00
2024-12-08 16:58:00,53,8752,25,28,5493.35,10369.02,0.00
2024-12-08 16:58:00,53,8753,25,28,5474.31,10370.00,0.00
2024-12-08 16:58:00,54,8753,26,28,5372.93,10370.02,0.00
2024-12-08 16:58:00,53,8753,26,27,5431.27,10370.08,0.00
2024-12-08 16:58:00,52,8753,25,27,5504.71,10370.37,0.00
2024-12-08 16:58:00,51,8753,24,27,5479.84,10370.96,0.00
2024-12-08 16:58:00,51,8754,24,27,5679.14,10371.00,0.00
2024-12-08 16:58:00,52,8754,25,27,5569.93,10371.02,0.00
2024-12-08 16:58:00,52,8755,25,27,5555.18,10372.00,0.00
2024-12-08 16:58:00,53,8755,25,28,5450.37,10372.02,0.00
2024-12-08 16:58:00,52,8755,24,28,5553.19,10372.02,0.00
2024-12-08 16:58:00,51,8755,24,27,5621.40,10372.06,0.00
2024-12-08 16:58:00,51,8756,24,27,5637.08,10373.00,0.00
2024-12-08 16:58:00,52,8756,24,28,5528.68,10373.02,0.00
2024-12-08 16:58:00,52,8757,24,28,5518.56,10374.00,0.00
2024-12-08 16:58:00,53,8757,24,29,5414.44,10374.02,0.00
2024-12-08 16:58:00,52,8757,24,28,5480.66,10374.06,0.00
2024-12-08 16:58:00,52,8758,24,28,5500.97,10375.00,0.00
2024-12-08 16:58:00,53,8758,25,28,5397.18,10375.02,0.00
2024-12-08 16:58:00,52,8758,24,28,5455.08,10375.04,0.00
2024-12-08 16:58:00,52,8759,24,28,5515.47,10376.00,0.00
2024-12-08 16:58:00,53,8759,24,29,5411.40,10376.02,0.00
2024-12-08 16:58:00,52,8759,23,29,5513.47,10376.02,0.00
2024-12-08 16:58:00,51,8759,23,28,5589.03,10376.02,0.00
2024-12-08 16:58:00,50,8759,22,28,5652.36,10376.44,0.00
2024-12-08 16:58:00,50,8760,22,28,5703.68,10377.00,0.00
2024-12-08 16:58:00,51,8760,23,28,5591.85,10377.02,0.00
2024-12-08 16:58:00,51,8761,23,28,5551.24,10378.00,0.00
2024-12-08 16:58:00,52,8761,23,29,5444.48,10378.02,0.00
2024-12-08 16:58:00,51,8761,23,28,5520.71,10378.02,0.00
2024-12-08 16:58:00,51,8762,23,28,5491.64,10379.00,0.00
2024-12-08 16:58:00,52,8762,23,29,5386.03,10379.02,0.00
2024-12-08 16:58:00,51,8762,22,29,5273.32,10379.76,0.00
2024-12-08 16:58:00,52,8761,23,29,5165.53,10379.85,0.00
2024-12-08 16:58:00,52,8762,23,29,5365.26,10380.00,0.00
2024-12-08 16:58:00,53,8762,23,30,5264.02,10380.02,0.00
2024-12-08 16:58:00,52,8762,23,29,5337.31,10380.02,0.00
2024-12-08 16:58:00,51,8762,22,29,5435.98,10380.02,0.00
2024-12-08 16:58:00,51,8763,22,29,5717.47,10381.00,0.00
2024-12-08 16:58:00,52,8763,22,30,5607.52,10381.02,0.00
2024-12-08 16:58:00,52,8764,22,30,5571.52,10382.00,0.00
2024-12-08 16:58:00,53,8764,22,31,5466.40,10382.02,0.00
2024-12-08 16:58:00,52,8764,22,30,5543.57,10382.02,0.00
2024-12-08 16:58:00,51,8764,22,29,5591.10,10382.31,0.00
2024-12-08 16:58:00,50,8764,21,29,5593.48,10382.90,0.00
2024-12-08 16:58:00,50,8765,21,29,5790.84,10383.00,0.00
2024-12-08 16:58:00,51,8765,22,29,5677.29,10383.02,0.00
2024-12-08 16:58:00,50,8765,21,29,5692.91,10383.50,0.00
2024-12-08 16:58:00,50,8766,21,29,5845.30,10384.00,0.00
2024-12-08 16:58:00,51,8766,21,30,5730.68,10384.02,0.00
2024-12-08 16:58:00,50,8766,21,29,5814.14,10384.02,0.00
2024-12-08 16:58:00,50,8767,21,29,5832.60,10385.00,0.00
2024-12-08 16:58:00,51,8767,22,29,5718.23,10385.02,0.00
2024-12-08 16:58:00,51,8768,22,29,5708.33,10386.00,0.00
2024-12-08 16:58:00,52,8768,23,29,5598.55,10386.02,0.00
2024-12-08 16:58:00,51,8768,23,28,5679.82,10386.02,0.00
2024-12-08 16:58:00,50,8768,23,27,5756.77,10386.36,0.00
2024-12-08 16:58:00,49,8768,22,27,5759.08,10386.96,0.00
2024-12-08 16:58:00,49,8769,22,27,5966.84,10387.00,0.00
2024-12-08 16:58:00,50,8769,23,27,5847.50,10387.02,0.00
2024-12-08 16:58:00,50,8770,23,27,5841.53,10388.00,0.00
2024-12-08 16:58:00,51,8770,23,28,5726.99,10388.02,0.00
2024-12-08 16:58:00,50,8770,23,27,5810.37,10388.02,0.00
2024-12-08 16:58:00,50,8771,23,27,5832.70,10389.00,0.00
2024-12-08 16:58:00,51,8771,23,28,5718.33,10389.02,0.00
2024-12-08 16:58:00,51,8772,23,28,5711.63,10390.00,0.00
2024-12-08 16:58:00,52,8772,23,29,5601.79,10390.02,0.00
2024-12-08 16:58:00,51,8772,23,28,5683.11,10390.02,0.00
2024-12-08 16:58:00,50,8772,22,28,5790.55,10390.08,0.00
2024-12-08 16:58:00,51,8771,22,29,5516.48,10390.88,0.00
2024-12-08 16:58:01,51,8772,22,29,5729.91,10391.00,0.00
2024-12-08 16:58:01,52,8772,22,30,5619.72,10391.02,0.00
2024-12-08 16:58:01,51,8772,21,30,5628.44,10391.55,0.00
2024-12-08 16:58:01,50,8772,20,30,5732.74,10391.62,0.00
2024-12-08 16:58:01,50,8773,20,30,6106.01,10392.00,0.00
2024-12-08 16:58:01,51,8773,20,31,5986.29,10392.02,0.00
2024-12-08 16:58:01,50,8773,19,31,6055.01,10392.06,0.00
2024-12-08 16:58:01,50,8774,19,31,6149.51,10393.00,0.00
2024-12-08 16:58:01,51,8774,20,31,6028.93,10393.02,0.00
2024-12-08 16:58:01,50,8774,20,30,6120.41,10393.04,0.00
2024-12-08 16:58:01,50,8775,20,30,6113.43,10394.00,0.00
2024-12-08 16:58:01,51,8775,21,30,5993.56,10394.02,0.00
2024-12-08 16:58:01,50,8775,20,30,5989.57,10394.64,0.00
2024-12-08 16:58:01,50,8776,20,30,6116.95,10395.00,0.00
2024-12-08 16:58:01,51,8776,21,30,5997.01,10395.02,0.00
2024-12-08 16:58:01,50,8776,21,29,6077.45,10395.04,0.00
2024-12-08 16:58:01,49,8776,20,29,6199.37,10395.06,0.00
2024-12-08 16:58:01,49,8777,20,29,6171.08,10396.00,0.00
2024-12-08 16:58:01,50,8777,20,30,6047.66,10396.02,0.00
2024-12-08 16:58:01,50,8778,20,30,5979.35,10397.00,0.00
2024-12-08 16:58:01,51,8778,20,31,5862.11,10397.02,0.00
2024-12-08 16:58:01,50,8778,20,30,5941.92,10397.04,0.00
2024-12-08 16:58:01,49,8778,20,29,5968.32,10397.71,0.00
2024-12-08 16:58:01,48,8778,19,29,5985.11,10397.96,0.00
2024-12-08 16:58:01,48,8779,19,29,6197.42,10398.00,0.00
2024-12-08 16:58:01,49,8779,19,30,6070.95,10398.02,0.00
2024-12-08 16:58:01,49,8780,19,30,6034.60,10399.00,0.00
2024-12-08 16:58:01,50,8780,19,31,5913.91,10399.02,0.00
2024-12-08 16:58:01,49,8780,19,30,5992.15,10399.04,0.00
2024-12-08 16:58:01,48,8780,18,30,6049.91,10399.29,0.00
2024-12-08 16:58:01,48,8781,18,30,6148.44,10400.00,0.00
2024-12-08 16:58:01,49,8781,19,30,6022.96,10400.02,0.00
2024-12-08 16:58:01,48,8781,18,30,6042.34,10400.27,0.00
2024-12-08 16:58:01,47,8781,18,29,6077.87,10400.83,0.00
2024-12-08 16:58:01,47,8782,18,29,6281.61,10401.00,0.00
2024-12-08 16:58:01,48,8782,19,29,6150.74,10401.02,0.00
2024-12-08 16:58:01,47,8782,19,28,6237.35,10401.04,0.00
2024-12-08 16:58:01,47,8783,19,28,6271.15,10402.00,0.00
2024-12-08 16:58:01,48,8783,19,29,6140.50,10402.02,0.00
2024-12-08 16:58:01,47,8783,18,29,6179.73,10402.13,0.00
2024-12-08 16:58:01,47,8784,18,29,6310.90,10403.00,0.00
2024-12-08 16:58:01,48,8784,19,29,6179.43,10403.02,0.00
2024-12-08 16:58:01,47,8784,19,28,6268.85,10403.04,0.00
2024-12-08 16:58:01,46,8784,18,28,6341.88,10403.26,0.00
2024-12-08 16:58:01,46,8785,18,28,6414.91,10404.00,0.00
2024-12-08 16:58:01,47,8785,18,29,6278.42,10404.02,0.00
2024-12-08 16:58:01,46,8785,18,28,6412.65,10404.02,0.00
2024-12-08 16:58:01,46,8786,18,28,6352.79,10405.00,0.00
2024-12-08 16:58:01,47,8786,18,29,6217.62,10405.02,0.00
2024-12-08 16:58:01,46,8786,18,28,6314.33,10405.02,0.00
2024-12-08 16:58:01,45,8786,17,28,6454.65,10405.02,0.00
2024-12-08 16:58:01,45,8787,17,28,6440.65,10406.00,0.00
2024-12-08 16:58:01,46,8787,18,28,6300.63,10406.02,0.00
2024-12-08 16:58:01,45,8787,18,27,6325.29,10406.67,0.00
2024-12-08 16:58:01,44,8787,17,27,6386.61,10406.95,0.00
2024-12-08 16:58:01,44,8788,17,27,6618.43,10407.00,0.00
2024-12-08 16:58:01,45,8788,17,28,6471.35,10407.02,0.00
2024-12-08 16:58:01,45,8789,17,28,6440.60,10408.00,0.00
2024-12-08 16:58:01,46,8789,18,28,6300.59,10408.02,0.00
2024-12-08 16:58:01,45,8789,18,27,6435.98,10408.04,0.00
2024-12-08 16:58:01,45,8790,18,27,6454.42,10409.00,0.00
2024-12-08 16:58:01,46,8790,19,27,6314.10,10409.02,0.00
2024-12-08 16:58:01,45,8790,18,27,6396.60,10409.07,0.00
2024-12-08 16:58:01,45,8791,18,27,6510.19,10410.00,0.00
2024-12-08 16:58:01,46,8791,19,27,6368.67,10410.02,0.00
2024-12-08 16:58:01,45,8791,19,26,6459.30,10410.04,0.00
2024-12-08 16:58:01,45,8792,19,26,6476.21,10411.00,0.00
2024-12-08 16:58:01,46,8792,20,26,6335.42,10411.02,0.00
2024-12-08 16:58:01,46,8793,20,26,6315.11,10412.00,0.00
2024-12-08 16:58:01,47,8793,20,27,6180.74,10412.02,0.00
2024-12-08 16:58:01,47,8794,20,27,6140.16,10413.00,0.00
2024-12-08 16:58:01,48,8794,21,27,6012.24,10413.02,0.00
2024-12-08 16:58:01,47,8794,21,26,6135.73,10413.04,0.00
2024-12-08 16:58:01,47,8795,21,26,6136.45,10414.00,0.00
2024-12-08 16:58:01,48,8795,21,27,6008.61,10414.02,0.00
2024-12-08 16:58:01,47,8795,21,26,6036.42,10414.55,0.00
2024-12-08 16:58:01,47,8796,21,26,6142.30,10415.00,0.00
2024-12-08 16:58:01,48,8796,21,27,6014.33,10415.02,0.00
2024-12-08 16:58:01,47,8796,20,27,6141.11,10415.02,0.00
2024-12-08 16:58:01,46,8796,20,26,6229.33,10415.02,0.00
2024-12-08 16:58:01,46,8797,20,26,6263.39,10416.00,0.00
2024-12-08 16:58:01,47,8797,20,27,6130.13,10416.02,0.00
2024-12-08 16:58:01,46,8797,19,27,6206.79,10416.04,0.00
2024-12-08 16:58:01,46,8798,19,27,6333.31,10417.00,0.00
2024-12-08 16:58:01,47,8798,19,28,6198.56,10417.02,0.00
2024-12-08 16:58:01,47,8798,19,28,6185.12,10418.00,0.00
2024-12-08 16:58:01,48,8798,19,29,6056.27,10418.02,0.00
2024-12-08 16:58:01,47,8798,19,28,6182.91,10418.02,0.00
2024-12-08 16:58:02,46,8798,18,28,6182.20,10418.52,0.00
2024-12-08 16:58:02,46,8798,18,28,6359.21,10419.00,0.00
2024-12-08 16:58:02,47,8798,19,28,6223.91,10419.02,0.00
2024-12-08 16:58:02,47,8799,19,28,6228.97,10420.00,0.00
2024-12-08 16:58:02,48,8799,20,28,6099.20,10420.02,0.00
2024-12-08 16:58:02,48,8800,20,28,6080.80,10421.00,0.00
2024-12-08 16:58:02,49,8800,21,28,5956.71,10421.02,0.00
2024-12-08 16:58:02,48,8800,21,27,6069.95,10421.06,0.00
2024-12-08 16:58:02,48,8801,21,27,6101.04,10422.00,0.00
2024-12-08 16:58:02,49,8801,22,27,5976.52,10422.02,0.00
2024-12-08 16:58:02,49,8802,22,27,5981.16,10423.00,0.00
2024-12-08 16:58:02,50,8802,22,28,5861.53,10423.02,0.00
2024-12-08 16:58:02,49,8802,21,28,5979.03,10423.04,0.00
2024-12-08 16:58:02,49,8803,21,28,5964.71,10424.00,0.00
2024-12-08 16:58:02,50,8803,21,29,5845.42,10424.02,0.00
2024-12-08 16:58:02,49,8803,21,28,5960.46,10424.04,0.00
2024-12-08 16:58:02,49,8804,21,28,5988.69,10425.00,0.00
2024-12-08 16:58:02,50,8804,21,29,5868.91,10425.02,0.00
2024-12-08 16:58:02,49,8804,20,29,5953.52,10425.06,0.00
2024-12-08 16:58:02,49,8805,20,29,6026.42,10426.00,0.00
2024-12-08 16:58:02,50,8805,20,30,5905.89,10426.02,0.00
2024-12-08 16:58:02,49,8805,19,30,5920.35,10426.61,0.00
2024-12-08 16:58:02,49,8806,19,30,6007.85,10427.00,0.00
2024-12-08 16:58:02,50,8806,20,30,5887.69,10427.02,0.00
2024-12-08 16:58:02,49,8806,20,29,5988.71,10427.08,0.00
2024-12-08 16:58:02,48,8806,19,29,6005.32,10427.85,0.00
2024-12-08 16:58:02,48,8807,19,29,6207.47,10428.00,0.00
2024-12-08 16:58:02,49,8807,19,30,6080.78,10428.02,0.00
2024-12-08 16:58:02,48,8807,18,30,6200.38,10428.02,0.00
2024-12-08 16:58:02,48,8808,18,30,6272.67,10429.00,0.00
2024-12-08 16:58:02,49,8808,18,31,6144.66,10429.02,0.00
2024-12-08 16:58:02,48,8808,17,31,6173.29,10429.17,0.00
2024-12-08 16:58:02,48,8809,17,31,6304.20,10430.00,0.00
2024-12-08 16:58:02,49,8809,17,32,6175.55,10430.02,0.00
2024-12-08 16:58:02,48,8809,17,31,6291.18,10430.06,0.00
2024-12-08 16:58:02,48,8810,17,31,6324.37,10431.00,0.00
2024-12-08 16:58:02,49,8810,18,31,6195.30,10431.02,0.00
2024-12-08 16:58:02,48,8810,17,31,6216.02,10431.63,0.00
2024-12-08 16:58:02,48,8811,17,31,6326.58,10432.00,0.00
2024-12-08 16:58:02,49,8811,17,32,6197.47,10432.02,0.00
2024-12-08 16:58:02,48,8811,16,32,6161.81,10432.79,0.00
2024-12-08 16:58:02,48,8812,16,32,6357.59,10433.00,0.00
2024-12-08 16:58:02,49,8812,17,32,6227.85,10433.02,0.00
2024-12-08 16:58:02,48,8812,17,31,6348.91,10433.06,0.00
2024-12-08 16:58:02,48,8813,17,31,6380.37,10434.00,0.00
2024-12-08 16:58:02,49,8813,17,32,6250.15,10434.02,0.00
2024-12-08 16:58:02,49,8814,17,32,6247.09,10435.00,0.00
2024-12-08 16:58:02,50,8814,17,33,6122.15,10435.02,0.00
2024-12-08 16:58:02,49,8814,16,33,6098.15,10435.73,0.00
2024-12-08 16:58:02,49,8815,16,33,6283.65,10436.00,0.00
2024-12-08 16:58:02,50,8815,16,34,6157.98,10436.02,0.00
2024-12-08 16:58:02,49,8815,16,33,6277.27,10436.06,0.00
2024-12-08 16:58:02,48,8815,15,33,6351.10,10436.21,0.00
2024-12-08 16:58:02,48,8816,15,33,6476.75,10437.00,0.00
2024-12-08 16:58:02,49,8816,15,34,6344.58,10437.02,0.00
2024-12-08 16:58:02,49,8817,15,34,6322.58,10438.00,0.00
2024-12-08 16:58:02,50,8817,15,35,6196.13,10438.02,0.00
2024-12-08 16:58:02,49,8817,15,34,6273.59,10438.06,0.00
2024-12-08 16:58:02,48,8817,14,34,6293.66,10438.35,0.00
2024-12-08 16:58:02,48,8818,14,34,6444.17,10439.00,0.00
2024-12-08 16:58:02,49,8818,14,35,6312.66,10439.02,0.00
2024-12-08 16:58:02,48,8818,13,35,6404.69,10439.02,0.00
2024-12-08 16:58:02,47,8818,12,35,6410.52,10439.49,0.00
2024-12-08 16:58:02,47,8819,12,35,6579.73,10440.00,0.00
2024-12-08 16:58:02,48,8819,12,36,6442.66,10440.02,0.00
2024-12-08 16:58:02,47,8819,11,36,6490.88,10440.02,0.00
2024-12-08 16:58:02,46,8819,11,35,6593.62,10440.02,0.00
2024-12-08 16:58:02,45,8819,11,34,6708.99,10440.16,0.00
2024-12-08 16:58:02,45,8820,11,34,6853.44,10441.00,0.00
2024-12-08 16:58:02,46,8820,11,35,6704.45,10441.02,0.00
2024-12-08 16:58:02,45,8820,10,35,6715.96,10441.29,0.00
2024-12-08 16:58:02,45,8821,10,35,6874.28,10442.00,0.00
2024-12-08 16:58:02,46,8821,10,36,6724.83,10442.02,0.00
2024-12-08 16:58:02,45,8821,10,35,6830.19,10442.02,0.00
2024-12-08 16:58:02,45,8822,10,35,6867.97,10443.00,0.00
2024-12-08 16:58:02,46,8822,11,35,6718.67,10443.02,0.00
2024-12-08 16:58:02,45,8822,10,35,6689.36,10443.42,0.00
2024-12-08 16:58:02,45,8823,10,35,6861.56,10444.00,0.00
2024-12-08 16:58:02,46,8823,10,36,6712.40,10444.02,0.00
2024-12-08 16:58:02,45,8823,10,35,6819.79,10444.02,0.00
2024-12-08 16:58:02,45,8824,10,35,6857.58,10445.00,0.00
2024-12-08 16:58:02,46,8824,11,35,6708.50,10445.02,0.00
2024-12-08 16:58:03,46,8825,11,35,6703.23,10446.00,0.00
2024-12-08 16:58:03,47,8825,12,35,6560.61,10446.02,0.00
2024-12-08 16:58:03,46,8825,12,34,6660.09,10446.02,0.00
2024-12-08 16:58:03,46,8826,12,34,6694.79,10447.00,0.00
2024-12-08 16:58:03,47,8826,13,34,6552.35,10447.02,0.00
2024-12-08 16:58:03,47,8827,13,34,6551.20,10448.00,0.00
2024-12-08 16:58:03,48,8827,14,34,6414.71,10448.02,0.00
2024-12-08 16:58:03,47,8827,13,34,6547.06,10448.04,0.00
2024-12-08 16:58:03,46,8827,13,33,6641.69,10448.04,0.00
2024-12-08 16:58:03,45,8827,12,33,6747.02,10448.44,0.00
2024-12-08 16:58:03,45,8828,12,33,6921.59,10449.00,0.00
2024-12-08 16:58:03,46,8828,12,34,6771.12,10449.02,0.00
2024-12-08 16:58:03,46,8829,12,34,6765.00,10450.00,0.00
2024-12-08 16:58:03,47,8829,13,34,6621.07,10450.02,0.00
2024-12-08 16:58:03,46,8829,12,34,6630.58,10450.26,0.00
2024-12-08 16:58:03,46,8830,12,34,6781.07,10451.00,0.00
2024-12-08 16:58:03,47,8830,12,35,6636.79,10451.02,0.00
2024-12-08 16:58:03,46,8830,12,34,6774.25,10451.04,0.00
2024-12-08 16:58:03,46,8831,12,34,6797.39,10452.00,0.00
2024-12-08 16:58:03,47,8831,12,35,6652.76,10452.02,0.00
2024-12-08 16:58:03,46,8831,11,35,6796.08,10452.02,0.00
2024-12-08 16:58:03,45,8831,10,35,6827.84,10452.56,0.00
2024-12-08 16:58:03,45,8832,10,35,6936.00,10453.00,0.00
2024-12-08 16:58:03,46,8832,10,36,6785.22,10453.02,0.00
2024-12-08 16:58:03,46,8833,10,36,6755.57,10454.00,0.00
2024-12-08 16:58:03,47,8833,11,36,6611.83,10454.02,0.00
2024-12-08 16:58:03,46,8833,11,35,6723.05,10454.04,0.00
2024-12-08 16:58:03,45,8833,10,35,6744.24,10454.84,0.00
2024-12-08 16:58:03,45,8834,10,35,6960.42,10455.00,0.00
2024-12-08 16:58:03,46,8834,10,36,6809.11,10455.02,0.00
2024-12-08 16:58:03,45,8834,9,36,6956.98,10455.02,0.00
2024-12-08 16:58:03,45,8835,9,36,6955.21,10456.00,0.00
2024-12-08 16:58:03,46,8835,9,37,6804.01,10456.02,0.00
2024-12-08 16:58:03,46,8836,9,37,6791.38,10457.00,0.00
2024-12-08 16:58:03,47,8836,10,37,6646.89,10457.02,0.00
2024-12-08 16:58:03,46,8836,10,36,6789.11,10457.02,0.00
2024-12-08 16:58:03,46,8837,10,36,6820.52,10458.00,0.00
2024-12-08 16:58:03,47,8837,11,36,6675.41,10458.02,0.00
2024-12-08 16:58:03,47,8838,11,36,6663.46,10459.00,0.00
2024-12-08 16:58:03,48,8838,12,36,6524.64,10459.02,0.00
2024-12-08 16:58:03,47,8838,12,35,6618.96,10459.02,0.00
2024-12-08 16:58:03,47,8839,12,35,6646.74,10460.00,0.00
2024-12-08 16:58:03,48,8839,12,36,6508.26,10460.02,0.00
2024-12-08 16:58:03,48,8840,12,36,6493.61,10461.00,0.00
2024-12-08 16:58:03,49,8840,13,36,6361.09,10461.02,0.00
2024-12-08 16:58:03,48,8840,13,35,6452.21,10461.02,0.00
2024-12-08 16:58:03,47,8840,12,35,6466.00,10461.45,0.00
2024-12-08 16:58:03,47,8841,12,35,6623.66,10462.00,0.00
2024-12-08 16:58:03,48,8841,13,35,6485.67,10462.02,0.00
2024-12-08 16:58:03,48,8842,13,35,6473.01,10463.00,0.00
2024-12-08 16:58:03,49,8842,14,35,6340.91,10463.02,0.00
2024-12-08 16:58:03,48,8842,14,34,6429.42,10463.02,0.00
2024-12-08 16:58:03,48,8843,14,34,6452.36,10464.00,0.00
2024-12-08 16:58:03,49,8843,14,35,6320.68,10464.02,0.00
2024-12-08 16:58:03,49,8844,14,35,6308.68,10465.00,0.00
2024-12-08 16:58:03,50,8844,15,35,6182.51,10465.02,0.00
2024-12-08 16:58:03,49,8844,15,34,6265.97,10465.02,0.00
2024-12-08 16:58:03,48,8844,14,34,6295.22,10465.71,0.00
2024-12-08 16:58:03,48,8845,14,34,6482.96,10466.00,0.00
2024-12-08 16:58:03,49,8845,15,34,6350.65,10466.02,0.00
2024-12-08 16:58:03,48,8845,14,34,6371.53,10466.58,0.00
2024-12-08 16:58:03,48,8846,14,34,6468.36,10467.00,0.00
2024-12-08 16:58:03,49,8846,15,34,6336.35,10467.02,0.00
2024-12-08 16:58:03,48,8846,15,33,6426.93,10467.02,0.00
2024-12-08 16:58:03,47,8846,14,33,6485.23,10467.62,0.00
2024-12-08 16:58:03,47,8847,14,33,6579.06,10468.00,0.00
2024-12-08 16:58:03,48,8847,15,33,6442.00,10468.02,0.00
2024-12-08 16:58:03,48,8848,15,33,6411.47,10469.00,0.00
2024-12-08 16:58:03,49,8848,16,33,6280.62,10469.02,0.00
2024-12-08 16:58:03,48,8848,16,32,6370.03,10469.02,0.00
2024-12-08 16:58:03,48,8849,16,32,6377.10,10470.00,0.00
2024-12-08 16:58:03,49,8849,17,32,6246.95,10470.02,0.00
2024-12-08 16:58:03,48,8849,16,32,6377.10,10470.02,0.00
2024-12-08 16:58:03,48,8850,16,32,6352.67,10471.00,0.00
2024-12-08 16:58:03,49,8850,16,33,6223.03,10471.02,0.00
2024-12-08 16:58:03,48,8850,16,32,6256.44,10471.42,0.00
2024-12-08 16:58:03,48,8851,16,32,6326.65,10472.00,0.00
2024-12-08 16:58:03,49,8851,16,33,6197.54,10472.02,0.00
2024-12-08 16:58:03,48,8851,16,32,6324.47,10472.02,0.00
2024-12-08 16:58:04,48,8852,16,32,6353.44,10473.00,0.00
2024-12-08 16:58:04,49,8852,17,32,6223.78,10473.02,0.00
2024-12-08 16:58:04,49,8853,17,32,6219.64,10474.00,0.00
2024-12-08 16:58:04,50,8853,18,32,6095.25,10474.02,0.00
2024-12-08 16:58:04,49,8853,18,31,6174.75,10474.02,0.00
2024-12-08 16:58:04,49,8854,18,31,6201.00,10475.00,0.00
2024-12-08 16:58:04,50,8854,19,31,6076.98,10475.02,0.00
2024-12-08 16:58:04,50,8855,19,31,6071.67,10476.00,0.00
2024-12-08 16:58:04,51,8855,20,31,5952.62,10476.02,0.00
2024-12-08 16:58:04,50,8855,20,30,6029.77,10476.02,0.00
2024-12-08 16:58:04,49,8855,19,30,6003.31,10476.96,0.00
2024-12-08 16:58:04,49,8856,19,30,6212.87,10477.00,0.00
2024-12-08 16:58:04,50,8856,19,31,6088.61,10477.02,0.00
2024-12-08 16:58:04,50,8857,19,31,6082.70,10478.00,0.00
2024-12-08 16:58:04,51,8857,20,31,5963.43,10478.02,0.00
2024-12-08 16:58:04,50,8857,20,30,6042.88,10478.02,0.00
2024-12-08 16:58:04,49,8857,19,30,6127.88,10478.14,0.00
2024-12-08 16:58:04,49,8858,19,30,6252.45,10479.00,0.00
2024-12-08 16:58:04,50,8858,20,30,6127.40,10479.02,0.00
2024-12-08 16:58:04,50,8859,20,30,6119.12,10480.00,0.00
2024-12-08 16:58:04,51,8859,20,31,5999.13,10480.02,0.00
2024-12-08 16:58:04,50,8859,20,30,6081.39,10480.02,0.00
2024-12-08 16:58:04,50,8860,20,30,6105.02,10481.00,0.00
2024-12-08 16:58:04,51,8860,20,31,5985.32,10481.02,0.00
2024-12-08 16:58:04,51,8861,20,31,5975.03,10482.00,0.00
2024-12-08 16:58:04,52,8861,21,31,5860.13,10482.02,0.00
2024-12-08 16:58:04,51,8861,21,30,5940.09,10482.02,0.00
2024-12-08 16:58:04,50,8861,20,30,5907.47,10482.94,0.00
2024-12-08 16:58:04,50,8862,20,30,6110.87,10483.00,0.00
2024-12-08 16:58:04,51,8862,21,30,5991.05,10483.02,0.00
2024-12-08 16:58:04,50,8862,20,30,5964.72,10483.38,0.00
2024-12-08 16:58:04,50,8863,20,30,6109.80,10484.00,0.00
2024-12-08 16:58:04,51,8863,20,31,5990.00,10484.02,0.00
2024-12-08 16:58:04,50,8863,20,30,6067.87,10484.02,0.00
2024-12-08 16:58:04,49,8863,19,30,6146.27,10484.45,0.00
2024-12-08 16:58:04,49,8864,19,30,6217.25,10485.00,0.00
2024-12-08 16:58:04,50,8864,19,31,6092.90,10485.02,0.00
2024-12-08 16:58:04,49,8864,18,31,6095.44,10485.35,0.00
2024-12-08 16:58:04,49,8865,18,31,6241.38,10486.00,0.00
2024-12-08 16:58:04,50,8865,18,32,6116.55,10486.02,0.00
2024-12-08 16:58:04,49,8865,18,31,6200.72,10486.02,0.00
2024-12-08 16:58:04,49,8866,18,31,6226.99,10487.00,0.00
2024-12-08 16:58:04,50,8866,19,31,6102.46,10487.02,0.00
2024-12-08 16:58:04,49,8866,18,31,6054.74,10487.53,0.00
2024-12-08 16:58:04,49,8867,18,31,6219.87,10488.00,0.00
2024-12-08 16:58:04,50,8867,18,32,6095.47,10488.02,0.00
2024-12-08 16:58:04,49,8867,18,31,6181.34,10488.02,0.00
2024-12-08 16:58:04,49,8868,18,31,6207.62,10489.00,0.00
2024-12-08 16:58:04,50,8868,19,31,6083.46,10489.02,0.00
2024-12-08 16:58:04,49,8868,18,31,6055.85,10489.45,0.00
2024-12-08 16:58:04,49,8869,18,31,6212.49,10490.00,0.00
2024-12-08 16:58:04,50,8869,19,31,6088.24,10490.02,0.00
2024-12-08 16:58:04,49,8869,19,30,6176.10,10490.02,0.00
2024-12-08 16:58:04,48,8869,18,30,6237.34,10490.65,0.00
2024-12-08 16:58:04,48,8870,18,30,6331.59,10491.00,0.00
2024-12-08 16:58:04,49,8870,19,30,6202.38,10491.02,0.00
2024-12-08 16:58:04,48,8870,18,30,6170.09,10491.48,0.00
2024-12-08 16:58:04,48,8871,18,30,6334.01,10492.00,0.00
2024-12-08 16:58:04,49,8871,19,30,6204.74,10492.02,0.00
2024-12-08 16:58:04,48,8871,19,29,6296.85,10492.02,0.00
2024-12-08 16:58:04,48,8872,19,29,6323.92,10493.00,0.00
2024-12-08 16:58:04,49,8872,19,30,6194.86,10493.02,0.00
2024-12-08 16:58:04,48,8872,18,30,6153.84,10493.46,0.00
2024-12-08 16:58:04,48,8873,18,30,6313.34,10494.00,0.00
2024-12-08 16:58:04,49,8873,18,31,6184.49,10494.02,0.00
2024-12-08 16:58:04,48,8873,18,30,6278.36,10494.02,0.00
2024-12-08 16:58:04,48,8874,18,30,6305.18,10495.00,0.00
2024-12-08 16:58:04,49,8874,19,30,6176.50,10495.02,0.00
2024-12-08 16:58:04,49,8875,19,30,6157.98,10496.00,0.00
2024-12-08 16:58:04,50,8875,19,31,6034.82,10496.02,0.00
2024-12-08 16:58:04,49,8875,19,30,6125.85,10496.02,0.00
2024-12-08 16:58:04,49,8876,19,30,6152.14,10497.00,0.00
2024-12-08 16:58:04,50,8876,20,30,6029.10,10497.02,0.00
2024-12-08 16:58:04,50,8877,20,30,6014.82,10498.00,0.00
2024-12-08 16:58:04,51,8877,20,31,5896.88,10498.02,0.00
2024-12-08 16:58:04,50,8877,20,30,5983.32,10498.02,0.00
2024-12-08 16:58:04,50,8878,20,30,6006.99,10499.00,0.00
2024-12-08 16:58:04,51,8878,21,30,5889.21,10499.02,0.00
2024-12-08 16:58:04,50,8878,20,30,5845.63,10499.88,0.00
2024-12-08 16:58:04,50,8879,20,30,6043.10,10500.00,0.00
2024-12-08 16:58:04,51,8879,20,31,5924.61,10500.02,0.00
2024-12-08 16:58:04,50,8879,20,30,6011.60,10500.02,0.00
2024-12-08 16:58:05,50,8880,20,30,6035.28,10501.00,0.00
2024-12-08 16:58:05,51,8880,21,30,5916.94,10501.02,0.00
2024-12-08 16:58:05,51,8881,21,30,5901.50,10502.00,0.00
2024-12-08 16:58:05,52,8881,21,31,5788.01,10502.02,0.00
2024-12-08 16:58:05,51,8881,21,30,5872.67,10502.02,0.00
2024-12-08 16:58:05,50,8881,20,30,5849.45,10502.96,0.00
2024-12-08 16:58:05,50,8882,20,30,6055.33,10503.00,0.00
2024-12-08 16:58:05,51,8882,20,31,5936.60,10503.02,0.00
2024-12-08 16:58:05,50,8882,19,31,5891.71,10503.52,0.00
2024-12-08 16:58:05,50,8883,19,31,6051.71,10504.00,0.00
2024-12-08 16:58:05,51,8883,20,31,5933.05,10504.02,0.00
2024-12-08 16:58:05,50,8883,20,30,6024.40,10504.02,0.00
2024-12-08 16:58:05,50,8884,20,30,6048.08,10505.00,0.00
2024-12-08 16:58:05,51,8884,20,31,5929.49,10505.02,0.00
2024-12-08 16:58:05,51,8885,20,31,5913.64,10506.00,0.00
2024-12-08 16:58:05,52,8885,20,32,5799.91,10506.02,0.00
2024-12-08 16:58:05,51,8885,20,31,5888.92,10506.02,0.00
2024-12-08 16:58:05,50,8885,19,31,5929.22,10506.68,0.00
2024-12-08 16:58:05,50,8886,19,31,6105.97,10507.00,0.00
2024-12-08 16:58:05,51,8886,20,31,5986.25,10507.02,0.00
2024-12-08 16:58:05,51,8887,20,31,5970.79,10508.00,0.00
2024-12-08 16:58:05,52,8887,21,31,5855.97,10508.02,0.00
2024-12-08 16:58:05,51,8887,21,30,5946.07,10508.02,0.00
2024-12-08 16:58:05,51,8888,21,30,5967.24,10509.00,0.00
2024-12-08 16:58:05,52,8888,21,31,5852.49,10509.02,0.00
2024-12-08 16:58:05,51,8888,20,31,5853.46,10509.29,0.00
2024-12-08 16:58:05,51,8889,20,31,5985.80,10510.00,0.00
2024-12-08 16:58:05,52,8889,21,31,5870.69,10510.02,0.00
2024-12-08 16:58:05,51,8889,21,30,5963.13,10510.02,0.00
2024-12-08 16:58:05,51,8890,21,30,5984.31,10511.00,0.00
2024-12-08 16:58:05,52,8890,22,30,5869.23,10511.02,0.00
2024-12-08 16:58:05,52,8891,22,30,5851.88,10512.00,0.00
2024-12-08 16:58:05,53,8891,23,30,5741.46,10512.02,0.00
2024-12-08 16:58:05,52,8891,23,29,5831.66,10512.02,0.00
2024-12-08 16:58:05,51,8891,22,29,5875.93,10512.65,0.00
2024-12-08 16:58:05,51,8892,22,29,6045.23,10513.00,0.00
2024-12-08 16:58:05,52,8892,23,29,5928.98,10513.02,0.00
2024-12-08 16:58:05,51,8892,22,29,5888.77,10513.51,0.00
2024-12-08 16:58:05,51,8893,22,29,6043.74,10514.00,0.00
2024-12-08 16:58:05,52,8893,22,30,5927.52,10514.02,0.00
2024-12-08 16:58:05,51,8893,22,29,6019.01,10514.04,0.00
2024-12-08 16:58:05,51,8894,22,29,6042.26,10515.00,0.00
2024-12-08 16:58:05,52,8894,23,29,5926.06,10515.02,0.00
2024-12-08 16:58:05,52,8895,23,29,5914.66,10516.00,0.00
2024-12-08 16:58:05,53,8895,24,29,5803.06,10516.02,0.00
2024-12-08 16:58:05,52,8895,24,28,5884.33,10516.04,0.00
2024-12-08 16:58:05,52,8896,24,28,5905.11,10517.00,0.00
2024-12-08 16:58:05,53,8896,24,29,5793.69,10517.02,0.00
2024-12-08 16:58:05,52,8896,23,29,5816.18,10517.25,0.00
2024-12-08 16:58:05,51,8896,22,29,5891.39,10517.61,0.00
2024-12-08 16:58:05,51,8897,22,29,6056.69,10518.00,0.00
2024-12-08 16:58:05,52,8897,23,29,5940.21,10518.02,0.00
2024-12-08 16:58:05,51,8897,23,28,6025.75,10518.04,0.00
2024-12-08 16:58:05,50,8897,22,28,6089.35,10518.24,0.00
2024-12-08 16:58:05,50,8898,22,28,6220.31,10519.00,0.00
2024-12-08 16:58:05,51,8898,23,28,6098.34,10519.02,0.00
2024-12-08 16:58:05,50,8898,22,28,6138.31,10519.22,0.00
2024-12-08 16:58:05,50,8899,22,28,6267.01,10520.00,0.00
2024-12-08 16:58:05,51,8899,23,28,6144.13,10520.02,0.00
2024-12-08 16:58:05,50,8899,23,27,6237.56,10520.04,0.00
2024-12-08 16:58:05,50,8900,23,27,6258.26,10521.00,0.00
2024-12-08 16:58:05,51,8900,24,27,6135.55,10521.02,0.00
2024-12-08 16:58:05,50,8900,23,27,6129.92,10521.10,0.00
2024-12-08 16:58:05,50,8901,23,27,6239.26,10522.00,0.00
2024-12-08 16:58:05,51,8901,23,28,6116.92,10522.02,0.00
2024-12-08 16:58:05,50,8901,23,27,6211.91,10522.04,0.00
2024-12-08 16:58:05,50,8902,23,27,6226.79,10523.00,0.00
2024-12-08 16:58:05,51,8902,23,28,6104.70,10523.02,0.00
2024-12-08 16:58:05,51,8903,23,28,6074.02,10524.00,0.00
2024-12-08 16:58:05,52,8903,23,29,5957.21,10524.02,0.00
2024-12-08 16:58:05,51,8903,23,28,6047.19,10524.04,0.00
2024-12-08 16:58:05,50,8903,22,28,6164.44,10524.06,0.00
2024-12-08 16:58:05,49,8903,21,28,6135.32,10524.96,0.00
2024-12-08 16:58:05,49,8904,21,28,6345.84,10525.00,0.00
2024-12-08 16:58:05,50,8904,22,28,6218.93,10525.02,0.00
2024-12-08 16:58:05,49,8904,21,28,6266.41,10525.16,0.00
2024-12-08 16:58:05,49,8905,21,28,6373.15,10526.00,0.00
2024-12-08 16:58:05,50,8905,21,29,6245.68,10526.02,0.00
2024-12-08 16:58:05,49,8905,21,28,6347.37,10526.04,0.00
2024-12-08 16:58:05,49,8906,21,28,6349.96,10527.00,0.00
2024-12-08 16:58:05,50,8906,22,28,6222.96,10527.02,0.00
2024-12-08 16:58:05,49,8906,21,28,6300.16,10527.08,0.00
2024-12-08 16:58:05,48,8906,20,28,6326.32,10527.44,0.00
2024-12-08 16:58:05,48,8906,20,28,6459.58,10528.00,0.00
2024-12-08 16:58:05,49,8906,21,28,6327.75,10528.02,0.00
2024-12-08 16:58:05,48,8906,21,27,6428.88,10528.04,0.00
2024-12-08 16:58:06,48,8907,21,27,6427.03,10529.00,0.00
2024-12-08 16:58:06,49,8907,21,28,6295.87,10529.02,0.00
2024-12-08 16:58:06,48,8907,21,27,6326.61,10529.50,0.00
2024-12-08 16:58:06,48,8908,21,27,6405.95,10530.00,0.00
2024-12-08 16:58:06,49,8908,21,28,6275.21,10530.02,0.00
2024-12-08 16:58:06,48,8908,21,27,6385.31,10530.04,0.00
2024-12-08 16:58:06,47,8908,20,27,6418.56,10530.81,0.00
2024-12-08 16:58:06,47,8909,20,27,6622.62,10531.00,0.00
2024-12-08 16:58:06,48,8909,20,28,6484.65,10531.02,0.00
2024-12-08 16:58:06,49,8908,21,28,6172.11,10531.65,0.00
2024-12-08 16:58:06,49,8909,21,28,6391.63,10532.00,0.00
2024-12-08 16:58:06,50,8909,21,29,6263.80,10532.02,0.00
2024-12-08 16:58:06,49,8909,21,28,6346.50,10532.04,0.00
2024-12-08 16:58:06,48,8909,20,28,6362.57,10532.42,0.00
2024-12-08 16:58:06,48,8910,20,28,6740.42,10533.00,0.00
2024-12-08 16:58:06,49,8910,20,29,6602.87,10533.02,0.00
2024-12-08 16:58:06,49,8911,20,29,6595.36,10534.00,0.00
2024-12-08 16:58:06,50,8911,20,30,6463.45,10534.02,0.00
2024-12-08 16:58:06,49,8911,20,29,6552.36,10534.04,0.00
2024-12-08 16:58:06,48,8911,19,29,6629.93,10534.60,0.00
2024-12-08 16:58:06,48,8912,19,29,6720.23,10535.00,0.00
2024-12-08 16:58:06,49,8912,20,29,6583.08,10535.02,0.00
2024-12-08 16:58:06,48,8912,19,29,6549.06,10535.85,0.00
2024-12-08 16:58:06,48,8913,19,29,6753.32,10536.00,0.00
2024-12-08 16:58:06,49,8913,19,30,6615.50,10536.02,0.00
2024-12-08 16:58:06,49,8914,19,30,6598.92,10537.00,0.00
2024-12-08 16:58:06,50,8914,19,31,6466.94,10537.02,0.00
2024-12-08 16:58:06,49,8914,19,30,6592.48,10537.06,0.00
2024-12-08 16:58:06,49,8915,19,30,6623.20,10538.00,0.00
2024-12-08 16:58:06,50,8915,19,31,6490.74,10538.02,0.00
2024-12-08 16:58:06,49,8915,18,31,6470.70,10538.45,0.00
2024-12-08 16:58:06,49,8916,18,31,6628.13,10539.00,0.00
2024-12-08 16:58:06,50,8916,18,32,6495.57,10539.02,0.00
2024-12-08 16:58:06,50,8917,18,32,6477.22,10540.00,0.00
2024-12-08 16:58:06,51,8917,19,32,6350.21,10540.02,0.00
2024-12-08 16:58:06,50,8917,18,32,6473.01,10540.06,0.00
2024-12-08 16:58:06,49,8917,18,31,6602.96,10540.06,0.00
2024-12-08 16:58:06,48,8917,17,31,6591.52,10540.63,0.00
2024-12-08 16:58:06,48,8918,17,31,6771.90,10541.00,0.00
2024-12-08 16:58:06,49,8918,18,31,6633.69,10541.02,0.00
2024-12-08 16:58:06,48,8918,17,31,6603.35,10541.90,0.00
2024-12-08 16:58:06,48,8919,17,31,6812.07,10542.00,0.00
2024-12-08 16:58:06,49,8919,18,31,6673.05,10542.02,0.00
2024-12-08 16:58:06,48,8919,18,30,6809.88,10542.02,0.00
2024-12-08 16:58:06,47,8919,18,29,6907.67,10542.04,0.00
2024-12-08 16:58:06,47,8920,18,29,6941.97,10543.00,0.00
2024-12-08 16:58:06,48,8920,19,29,6797.34,10543.02,0.00
2024-12-08 16:58:06,48,8921,19,29,6788.26,10544.00,0.00
2024-12-08 16:58:06,49,8921,20,29,6649.73,10544.02,0.00
2024-12-08 16:58:06,48,8921,20,28,6737.75,10544.06,0.00
2024-12-08 16:58:06,48,8922,20,28,6771.33,10545.00,0.00
2024-12-08 16:58:06,49,8922,21,28,6633.14,10545.02,0.00
2024-12-08 16:58:06,48,8922,20,28,6656.16,10545.63,0.00
2024-12-08 16:58:06,48,8923,20,28,6836.63,10546.00,0.00
2024-12-08 16:58:06,49,8923,21,28,6697.10,10546.02,0.00
2024-12-08 16:58:06,48,8923,21,27,6788.31,10546.06,0.00
2024-12-08 16:58:06,48,8924,21,27,6821.89,10547.00,0.00
2024-12-08 16:58:06,49,8924,22,27,6682.67,10547.02,0.00
2024-12-08 16:58:06,49,8925,22,27,6670.51,10548.00,0.00
2024-12-08 16:58:06,50,8925,23,27,6537.10,10548.02,0.00
2024-12-08 16:58:06,49,8925,23,26,6625.32,10548.06,0.00
2024-12-08 16:58:06,48,8925,22,26,6760.14,10548.08,0.00
2024-12-08 16:58:06,48,8926,22,26,6795.92,10549.00,0.00
2024-12-08 16:58:06,49,8926,22,27,6657.23,10549.02,0.00
2024-12-08 16:58:06,49,8927,22,27,6644.34,10550.00,0.00
2024-12-08 16:58:06,50,8927,23,27,6511.45,10550.02,0.00
2024-12-08 16:58:06,49,8927,23,26,6599.14,10550.06,0.00
2024-12-08 16:58:06,49,8928,23,26,6629.89,10551.00,0.00
2024-12-08 16:58:06,50,8928,23,27,6497.29,10551.02,0.00
2024-12-08 16:58:06,50,8929,23,27,6492.25,10552.00,0.00
2024-12-08 16:58:06,51,8929,23,28,6364.95,10552.02,0.00
2024-12-08 16:58:06,51,8930,23,28,6344.86,10553.00,0.00
2024-12-08 16:58:06,52,8930,23,29,6222.84,10553.02,0.00
2024-12-08 16:58:06,51,8930,22,29,6340.27,10553.06,0.00
2024-12-08 16:58:06,50,8930,22,28,6464.96,10553.06,0.00
2024-12-08 16:58:06,49,8930,21,28,6484.68,10553.80,0.00
2024-12-08 16:58:06,49,8931,21,28,6678.68,10554.00,0.00
2024-12-08 16:58:06,50,8931,22,28,6545.11,10554.02,0.00
2024-12-08 16:58:06,50,8932,22,28,6535.62,10555.00,0.00
2024-12-08 16:58:06,51,8932,23,28,6407.47,10555.02,0.00
2024-12-08 16:58:06,50,8932,23,27,6489.19,10555.06,0.00
2024-12-08 16:58:06,50,8933,23,27,6517.23,10556.00,0.00
2024-12-08 16:58:06,51,8933,23,28,6389.45,10556.02,0.00
2024-12-08 16:58:06,50,8933,22,28,6449.33,10556.26,0.00
2024-12-08 16:58:06,51,8932,23,28,6314.63,10556.37,0.00
2024-12-08 16:58:06,50,8932,22,28,6443.12,10556.48,0.00
2024-12-08 16:58:07,50,8933,22,28,6599.75,10557.00,0.00
2024-12-08 16:58:07,51,8933,23,28,6470.35,10557.02,0.00
2024-12-08 16:58:07,50,8933,23,27,6553.31,10557.06,0.00
2024-12-08 16:58:07,50,8934,23,27,6792.53,10558.00,0.00
2024-12-08 16:58:07,51,8934,24,27,6659.35,10558.02,0.00
2024-12-08 16:58:07,50,8934,23,27,6737.64,10558.04,0.00
2024-12-08 16:58:07,50,8935,23,27,6805.85,10559.00,0.00
2024-12-08 16:58:07,51,8935,24,27,6672.40,10559.02,0.00
2024-12-08 16:58:07,50,8935,24,26,6761.50,10559.04,0.00
2024-12-08 16:58:07,50,8936,24,26,6787.48,10560.00,0.00
2024-12-08 16:58:07,51,8936,24,27,6654.40,10560.02,0.00
2024-12-08 16:58:07,51,8937,24,27,6642.36,10561.00,0.00
2024-12-08 16:58:07,52,8937,25,27,6514.62,10561.02,0.00
2024-12-08 16:58:07,51,8937,25,26,6598.88,10561.04,0.00
2024-12-08 16:58:07,51,8938,25,26,6622.28,10562.00,0.00
2024-12-08 16:58:07,52,8938,26,26,6494.93,10562.02,0.00
2024-12-08 16:58:07,51,8938,25,26,6519.06,10562.61,0.00
2024-12-08 16:58:07,51,8939,25,26,6613.31,10563.00,0.00
2024-12-08 16:58:07,52,8939,25,27,6486.13,10563.02,0.00
2024-12-08 16:58:07,51,8939,25,26,6569.82,10563.04,0.00
2024-12-08 16:58:07,51,8940,25,26,6593.23,10564.00,0.00
2024-12-08 16:58:07,52,8940,25,27,6466.43,10564.02,0.00
2024-12-08 16:58:07,52,8941,25,27,6455.77,10565.00,0.00
2024-12-08 16:58:07,53,8941,26,27,6333.96,10565.02,0.00
2024-12-08 16:58:07,52,8941,26,26,6409.05,10565.06,0.00
2024-12-08 16:58:07,51,8941,25,26,6390.89,10565.96,0.00
2024-12-08 16:58:07,51,8942,25,26,6593.94,10566.00,0.00
2024-12-08 16:58:07,52,8942,26,26,6467.14,10566.02,0.00
2024-12-08 16:58:07,52,8943,26,26,6454.49,10567.00,0.00
2024-12-08 16:58:07,53,8943,26,27,6332.71,10567.02,0.00
2024-12-08 16:58:07,52,8943,26,26,6409.79,10567.06,0.00
2024-12-08 16:58:07,52,8944,26,26,6430.21,10568.00,0.00
2024-12-08 16:58:07,53,8944,26,27,6308.89,10568.02,0.00
2024-12-08 16:58:07,52,8944,25,27,6258.28,10568.58,0.00
2024-12-08 16:58:07,52,8945,25,27,6417.12,10569.00,0.00
2024-12-08 16:58:07,53,8945,25,28,6296.04,10569.02,0.00
2024-12-08 16:58:07,52,8945,25,27,6376.13,10569.08,0.00
2024-12-08 16:58:07,51,8945,24,27,6484.56,10569.08,0.00
2024-12-08 16:58:07,51,8946,24,27,6591.49,10570.00,0.00
2024-12-08 16:58:07,52,8946,25,27,6464.73,10570.02,0.00
2024-12-08 16:58:07,52,8947,25,27,6455.82,10571.00,0.00
2024-12-08 16:58:07,53,8947,26,27,6334.01,10571.02,0.00
2024-12-08 16:58:07,53,8948,26,27,6307.25,10572.00,0.00
2024-12-08 16:58:07,54,8948,26,28,6190.45,10572.02,0.00
2024-12-08 16:58:07,53,8948,26,27,6293.30,10572.09,0.00
2024-12-08 16:58:07,53,8949,26,27,6314.74,10573.00,0.00
2024-12-08 16:58:07,54,8949,26,28,6197.80,10573.02,0.00
2024-12-08 16:58:07,54,8950,26,28,6228.76,10574.00,0.00
2024-12-08 16:58:07,55,8950,27,28,6115.51,10574.02,0.00
2024-12-08 16:58:07,54,8950,26,28,6221.49,10574.07,0.00
2024-12-08 16:58:07,54,8951,26,28,6245.89,10575.00,0.00
2024-12-08 16:58:07,55,8951,26,29,6132.33,10575.02,0.00
2024-12-08 16:58:07,55,8952,26,29,6118.88,10576.00,0.00
2024-12-08 16:58:07,56,8952,26,30,6009.62,10576.02,0.00
2024-12-08 16:58:07,55,8952,25,30,6116.96,10576.02,0.00
2024-12-08 16:58:07,54,8952,24,30,6226.33,10576.06,0.00
2024-12-08 16:58:07,53,8952,24,29,6299.92,10576.08,0.00
2024-12-08 16:58:07,52,8952,23,29,6374.32,10576.52,0.00
2024-12-08 16:58:07,51,8952,22,29,6441.72,10576.65,0.00
2024-12-08 16:58:07,51,8953,22,29,6608.58,10577.00,0.00
2024-12-08 16:58:07,52,8953,22,30,6481.50,10577.02,0.00
2024-12-08 16:58:07,52,8954,22,30,6467.06,10578.00,0.00
2024-12-08 16:58:07,53,8954,22,31,6345.04,10578.02,0.00
2024-12-08 16:58:07,52,8954,21,31,6363.07,10578.58,0.00
2024-12-08 16:58:07,51,8954,20,31,6457.16,10578.63,0.00
2024-12-08 16:58:07,51,8955,20,31,6615.83,10579.00,0.00
2024-12-08 16:58:07,52,8955,21,31,6488.60,10579.02,0.00
2024-12-08 16:58:07,51,8955,21,30,6599.26,10579.10,0.00
2024-12-08 16:58:07,50,8955,20,30,6598.03,10579.58,0.00
2024-12-08 16:58:07,50,8956,20,30,6752.08,10580.00,0.00
2024-12-08 16:58:07,51,8956,20,31,6619.69,10580.02,0.00
2024-12-08 16:58:07,51,8957,20,31,6583.02,10581.00,0.00
2024-12-08 16:58:07,52,8957,21,31,6456.42,10581.02,0.00
2024-12-08 16:58:07,52,8958,21,31,6396.48,10582.00,0.00
2024-12-08 16:58:07,53,8958,21,32,6275.79,10582.02,0.00
2024-12-08 16:58:07,52,8958,21,31,6384.29,10582.10,0.00
2024-12-08 16:58:07,52,8959,21,31,6357.65,10583.00,0.00
2024-12-08 16:58:07,53,8959,21,32,6237.70,10583.02,0.00
2024-12-08 16:58:08,53,8960,21,32,6155.31,10584.00,0.00
2024-12-08 16:58:08,54,8960,22,32,6041.33,10584.02,0.00
2024-12-08 16:58:08,53,8960,22,31,6067.78,10584.09,0.00
2024-12-08 16:58:08,52,8960,21,31,6098.11,10584.65,0.00
2024-12-08 16:58:08,51,8960,21,30,6176.52,10584.73,0.00
2024-12-08 16:58:08,51,8961,21,30,6306.65,10585.00,0.00
2024-12-08 16:58:08,52,8961,21,31,6185.37,10585.02,0.00
2024-12-08 16:58:08,51,8961,20,31,6304.25,10585.02,0.00
2024-12-08 16:58:08,51,8962,20,31,6227.63,10586.00,0.00
2024-12-08 16:58:08,52,8962,21,31,6107.87,10586.02,0.00
2024-12-08 16:58:08,51,8962,21,30,6177.83,10586.08,0.00
2024-12-08 16:58:08,50,8962,20,30,6210.80,10586.38,0.00
2024-12-08 16:58:08,49,8962,20,29,6283.91,10586.80,0.00
2024-12-08 16:58:08,49,8963,20,29,6478.52,10587.00,0.00
2024-12-08 16:58:08,50,8963,21,29,6348.95,10587.02,0.00
2024-12-08 16:58:08,49,8963,20,29,6405.07,10587.06,0.00
2024-12-08 16:58:08,48,8963,20,28,6525.42,10587.06,0.00
2024-12-08 16:58:08,48,8964,20,28,6647.35,10588.00,0.00
2024-12-08 16:58:08,49,8964,20,29,6511.69,10588.02,0.00
2024-12-08 16:58:08,49,8965,20,29,6493.80,10589.00,0.00
2024-12-08 16:58:08,50,8965,21,29,6363.92,10589.02,0.00
2024-12-08 16:58:08,50,8966,21,29,6334.92,10590.00,0.00
2024-12-08 16:58:08,51,8966,21,30,6210.71,10590.02,0.00
2024-12-08 16:58:08,50,8966,21,29,6328.58,10590.06,0.00
2024-12-08 16:58:08,50,8967,21,29,6348.84,10591.00,0.00
2024-12-08 16:58:08,51,8967,22,29,6224.35,10591.02,0.00
2024-12-08 16:58:08,51,8968,22,29,6211.40,10592.00,0.00
2024-12-08 16:58:08,52,8968,23,29,6091.95,10592.02,0.00
2024-12-08 16:58:08,51,8968,23,28,6165.72,10592.06,0.00
2024-12-08 16:58:08,51,8969,23,28,6185.62,10593.00,0.00
2024-12-08 16:58:08,52,8969,24,28,6066.67,10593.02,0.00
2024-12-08 16:58:08,52,8970,24,28,6052.69,10594.00,0.00
2024-12-08 16:58:08,53,8970,24,29,5938.49,10594.02,0.00
2024-12-08 16:58:08,52,8970,24,28,6007.88,10594.08,0.00
2024-12-08 16:58:08,51,8970,23,28,6034.69,10594.73,0.00
2024-12-08 16:58:08,51,8971,23,28,6206.40,10595.00,0.00
2024-12-08 16:58:08,52,8971,24,28,6087.05,10595.02,0.00
2024-12-08 16:58:08,52,8972,24,28,6066.65,10596.00,0.00
2024-12-08 16:58:08,53,8972,24,29,5952.19,10596.02,0.00
2024-12-08 16:58:08,52,8972,24,28,6023.88,10596.08,0.00
2024-12-08 16:58:08,52,8973,24,28,6036.71,10597.00,0.00
2024-12-08 16:58:08,53,8973,25,28,5922.81,10597.02,0.00
2024-12-08 16:58:08,54,8972,26,28,5706.53,10597.63,0.00
2024-12-08 16:58:08,54,8973,26,28,5831.70,10598.00,0.00
2024-12-08 16:58:08,55,8973,26,29,5725.67,10598.02,0.00
2024-12-08 16:58:08,54,8973,26,28,5792.46,10598.07,0.00
2024-12-08 16:58:08,53,8973,25,28,5841.16,10598.51,0.00
2024-12-08 16:58:08,52,8973,24,28,5842.11,10598.94,0.00
2024-12-08 16:58:08,52,8974,24,28,6243.67,10599.00,0.00
2024-12-08 16:58:08,53,8974,25,28,6125.86,10599.02,0.00
2024-12-08 16:58:08,53,8975,25,28,6069.26,10600.00,0.00
2024-12-08 16:58:08,54,8975,26,28,5956.87,10600.02,0.00
2024-12-08 16:58:08,53,8975,26,27,6029.27,10600.08,0.00
2024-12-08 16:58:08,53,8976,26,27,5990.68,10601.00,0.00
2024-12-08 16:58:08,54,8976,26,28,5879.74,10601.02,0.00
2024-12-08 16:58:08,53,8976,25,28,5859.94,10601.38,0.00
2024-12-08 16:58:08,52,8976,24,28,5875.09,10601.75,0.00
2024-12-08 16:58:08,52,8977,24,28,6052.66,10602.00,0.00
2024-12-08 16:58:08,53,8977,24,29,5938.46,10602.02,0.00
2024-12-08 16:58:08,52,8977,24,28,6013.93,10602.08,0.00
2024-12-08 16:58:08,51,8977,24,27,6075.87,10602.45,0.00
2024-12-08 16:58:08,51,8978,24,27,6142.79,10603.00,0.00
2024-12-08 16:58:08,52,8978,24,28,6024.66,10603.02,0.00
2024-12-08 16:58:08,52,8979,24,28,6013.13,10604.00,0.00
2024-12-08 16:58:08,53,8979,24,29,5899.67,10604.02,0.00
2024-12-08 16:58:08,52,8979,24,28,5976.43,10604.08,0.00
2024-12-08 16:58:08,51,8979,23,28,6087.25,10604.10,0.00
2024-12-08 16:58:08,51,8980,23,28,6200.09,10605.00,0.00
2024-12-08 16:58:08,52,8980,23,29,6080.86,10605.02,0.00
2024-12-08 16:58:08,51,8980,22,29,6102.44,10605.27,0.00
2024-12-08 16:58:08,51,8981,22,29,6233.95,10606.00,0.00
2024-12-08 16:58:08,52,8981,22,30,6114.07,10606.02,0.00
2024-12-08 16:58:08,51,8981,22,29,6198.60,10606.08,0.00
2024-12-08 16:58:08,51,8982,22,29,6226.22,10607.00,0.00
2024-12-08 16:58:08,52,8982,22,30,6106.48,10607.02,0.00
2024-12-08 16:58:08,51,8982,21,30,6170.07,10607.06,0.00
2024-12-08 16:58:08,51,8983,21,30,6237.21,10608.00,0.00
2024-12-08 16:58:08,52,8983,21,31,6117.26,10608.02,0.00
2024-12-08 16:58:08,51,8983,20,31,6235.13,10608.02,0.00
2024-12-08 16:58:08,51,8984,20,31,6298.12,10609.00,0.00
2024-12-08 16:58:08,52,8984,20,32,6177.00,10609.02,0.00
2024-12-08 16:58:08,51,8984,20,31,6285.66,10609.12,0.00
2024-12-08 16:58:08,51,8985,20,31,6317.44,10610.00,0.00
2024-12-08 16:58:08,52,8985,20,32,6195.95,10610.02,0.00
2024-12-08 16:58:08,51,8985,19,32,6155.48,10610.53,0.00
2024-12-08 16:58:09,51,8986,19,32,6313.96,10611.00,0.00
2024-12-08 16:58:09,52,8986,19,33,6192.54,10611.02,0.00
2024-12-08 16:58:09,51,8986,19,32,6259.89,10611.12,0.00
2024-12-08 16:58:09,50,8986,18,32,6340.52,10611.18,0.00
2024-12-08 16:58:09,50,8987,18,32,6466.29,10612.00,0.00
2024-12-08 16:58:09,51,8987,19,32,6339.50,10612.02,0.00
2024-12-08 16:58:09,51,8988,19,32,6334.71,10613.00,0.00
2024-12-08 16:58:09,52,8988,19,33,6212.89,10613.02,0.00
2024-12-08 16:58:09,51,8988,19,32,6282.70,10613.12,0.00
2024-12-08 16:58:09,51,8989,19,32,6314.49,10614.00,0.00
2024-12-08 16:58:09,52,8989,19,33,6193.06,10614.02,0.00
2024-12-08 16:58:09,52,8990,19,33,6186.72,10615.00,0.00
2024-12-08 16:58:09,53,8990,20,33,6069.99,10615.02,0.00
2024-12-08 16:58:09,52,8990,19,33,6179.76,10615.08,0.00
2024-12-08 16:58:09,51,8990,19,32,6259.31,10615.10,0.00
2024-12-08 16:58:09,50,8990,18,32,6350.57,10615.18,0.00
2024-12-08 16:58:09,49,8990,17,32,6460.39,10615.37,0.00
2024-12-08 16:58:09,49,8991,17,32,6607.57,10616.00,0.00
2024-12-08 16:58:09,50,8991,17,33,6475.42,10616.02,0.00
2024-12-08 16:58:09,49,8991,16,33,6605.41,10616.02,0.00
2024-12-08 16:58:09,49,8992,16,33,6597.77,10617.00,0.00
2024-12-08 16:58:09,50,8992,17,33,6465.82,10617.02,0.00
2024-12-08 16:58:09,49,8992,17,32,6547.96,10617.08,0.00
2024-12-08 16:58:09,48,8992,16,32,6615.61,10617.50,0.00
2024-12-08 16:58:09,48,8993,16,32,6784.11,10618.00,0.00
2024-12-08 16:58:09,49,8993,17,32,6645.66,10618.02,0.00
2024-12-08 16:58:09,48,8993,16,32,6588.38,10618.90,0.00
2024-12-08 16:58:09,48,8994,16,32,6798.63,10619.00,0.00
2024-12-08 16:58:09,49,8994,16,33,6659.88,10619.02,0.00
2024-12-08 16:58:09,49,8995,16,33,6632.51,10620.00,0.00
2024-12-08 16:58:09,50,8995,17,33,6499.86,10620.02,0.00
2024-12-08 16:58:09,49,8995,17,32,6623.85,10620.08,0.00
2024-12-08 16:58:09,49,8996,17,32,6642.80,10621.00,0.00
2024-12-08 16:58:09,50,8996,17,33,6509.94,10621.02,0.00
2024-12-08 16:58:09,49,8996,16,33,6519.34,10621.61,0.00
2024-12-08 16:58:09,49,8997,16,33,6624.35,10622.00,0.00
2024-12-08 16:58:09,50,8997,16,34,6491.86,10622.02,0.00
2024-12-08 16:58:09,50,8998,16,34,6453.68,10623.00,0.00
2024-12-08 16:58:09,51,8998,17,34,6327.13,10623.02,0.00
2024-12-08 16:58:09,50,8998,17,33,6445.19,10623.08,0.00
2024-12-08 16:58:09,49,8998,16,33,6429.52,10623.86,0.00
2024-12-08 16:58:09,49,8999,16,33,6631.26,10624.00,0.00
2024-12-08 16:58:09,50,8999,16,34,6498.64,10624.02,0.00
2024-12-08 16:58:09,50,9000,16,34,6471.29,10625.00,0.00
2024-12-08 16:58:09,51,9000,16,35,6344.40,10625.02,0.00
2024-12-08 16:58:09,50,9000,16,34,6422.43,10625.08,0.00
2024-12-08 16:58:09,49,9000,16,33,6514.77,10625.35,0.00
2024-12-08 16:58:09,48,9000,15,33,6566.44,10625.42,0.00
2024-12-08 16:58:09,48,9001,15,33,6726.27,10626.00,0.00
2024-12-08 16:58:09,49,9001,15,34,6589.00,10626.02,0.00
2024-12-08 16:58:09,49,9002,15,34,6582.79,10627.00,0.00
2024-12-08 16:58:09,50,9002,16,34,6451.13,10627.02,0.00
2024-12-08 16:58:09,49,9002,16,33,6530.75,10627.08,0.00
2024-12-08 16:58:09,48,9002,15,33,6616.52,10627.50,0.00
2024-12-08 16:58:09,48,9003,15,33,6696.62,10628.00,0.00
2024-12-08 16:58:09,49,9003,16,33,6559.95,10628.02,0.00
2024-12-08 16:58:09,48,9003,15,33,6645.70,10628.06,0.00
2024-12-08 16:58:09,48,9004,15,33,6719.17,10629.00,0.00
2024-12-08 16:58:09,49,9004,15,34,6582.05,10629.02,0.00
2024-12-08 16:58:09,49,9005,15,34,6561.53,10630.00,0.00
2024-12-08 16:58:09,50,9005,15,35,6430.30,10630.02,0.00
2024-12-08 16:58:09,49,9005,15,34,6548.52,10630.08,0.00
2024-12-08 16:58:09,49,9006,15,34,6578.42,10631.00,0.00
2024-12-08 16:58:09,50,9006,16,34,6446.85,10631.02,0.00
2024-12-08 16:58:09,50,9007,16,34,6441.67,10632.00,0.00
2024-12-08 16:58:09,51,9007,16,35,6315.36,10632.02,0.00
2024-12-08 16:58:09,50,9007,15,35,6437.42,10632.06,0.00
2024-12-08 16:58:09,50,9008,15,35,6422.60,10633.00,0.00
2024-12-08 16:58:09,51,9008,16,35,6296.67,10633.02,0.00
2024-12-08 16:58:09,50,9008,16,34,6416.23,10633.06,0.00
2024-12-08 16:58:09,50,9009,16,34,6444.48,10634.00,0.00
2024-12-08 16:58:09,51,9009,17,34,6318.11,10634.02,0.00
2024-12-08 16:58:09,50,9009,16,34,6376.22,10634.06,0.00
2024-12-08 16:58:09,50,9010,16,34,6447.01,10635.00,0.00
2024-12-08 16:58:10,51,9010,17,34,6320.59,10635.02,0.00
2024-12-08 16:58:10,51,9011,17,34,6300.33,10636.00,0.00
2024-12-08 16:58:10,52,9011,17,35,6179.17,10636.02,0.00
2024-12-08 16:58:10,51,9011,17,34,6294.08,10636.06,0.00
2024-12-08 16:58:10,51,9012,17,34,6319.70,10637.00,0.00
2024-12-08 16:58:10,52,9012,18,34,6198.16,10637.02,0.00
2024-12-08 16:58:10,51,9012,17,34,6186.18,10637.69,0.00
2024-12-08 16:58:10,51,9013,17,34,6361.58,10638.00,0.00
2024-12-08 16:58:10,52,9013,18,34,6239.24,10638.02,0.00
2024-12-08 16:58:10,51,9013,18,33,6315.69,10638.06,0.00
2024-12-08 16:58:10,50,9013,17,33,6378.51,10638.64,0.00
2024-12-08 16:58:10,50,9014,17,33,6463.60,10639.00,0.00
2024-12-08 16:58:10,51,9014,17,34,6336.87,10639.02,0.00
2024-12-08 16:58:10,51,9015,17,34,6322.95,10640.00,0.00
2024-12-08 16:58:10,52,9015,18,34,6201.35,10640.02,0.00
2024-12-08 16:58:10,51,9015,18,33,6279.14,10640.06,0.00
2024-12-08 16:58:10,51,9016,18,33,6296.50,10641.00,0.00
2024-12-08 16:58:10,52,9016,19,33,6175.41,10641.02,0.00
2024-12-08 16:58:10,51,9016,18,33,6159.20,10641.76,0.00
2024-12-08 16:58:10,51,9017,18,33,6333.68,10642.00,0.00
2024-12-08 16:58:10,52,9017,18,34,6211.88,10642.02,0.00
2024-12-08 16:58:10,51,9017,18,33,6289.86,10642.06,0.00
2024-12-08 16:58:10,51,9018,18,33,6307.11,10643.00,0.00
2024-12-08 16:58:10,52,9018,19,33,6185.82,10643.02,0.00
2024-12-08 16:58:10,51,9018,18,33,6305.02,10643.02,0.00
2024-12-08 16:58:10,51,9019,18,33,6292.59,10644.00,0.00
2024-12-08 16:58:10,52,9019,18,34,6171.58,10644.02,0.00
2024-12-08 16:58:10,51,9019,17,34,6290.51,10644.02,0.00
2024-12-08 16:58:10,50,9019,17,33,6375.87,10644.02,0.00
2024-12-08 16:58:10,50,9020,17,33,6392.23,10645.00,0.00
2024-12-08 16:58:10,51,9020,17,34,6266.89,10645.02,0.00
2024-12-08 16:58:10,51,9021,17,34,6251.15,10646.00,0.00
2024-12-08 16:58:10,52,9021,18,34,6130.93,10646.02,0.00
2024-12-08 16:58:10,51,9021,18,33,6213.57,10646.02,0.00
2024-12-08 16:58:10,50,9021,17,33,6285.90,10646.16,0.00
2024-12-08 16:58:10,50,9022,17,33,6405.06,10647.00,0.00
2024-12-08 16:58:10,51,9022,18,33,6279.47,10647.02,0.00
2024-12-08 16:58:10,51,9023,18,33,6269.18,10648.00,0.00
2024-12-08 16:58:10,52,9023,19,33,6148.62,10648.02,0.00
2024-12-08 16:58:10,51,9023,19,32,6231.60,10648.02,0.00
2024-12-08 16:58:10,50,9023,18,32,6341.67,10648.14,0.00
2024-12-08 16:58:10,50,9024,18,32,6377.89,10649.00,0.00
2024-12-08 16:58:10,51,9024,18,33,6252.83,10649.02,0.00
2024-12-08 16:58:10,50,9024,17,33,6373.63,10649.04,0.00
2024-12-08 16:58:10,50,9025,17,33,6442.39,10650.00,0.00
2024-12-08 16:58:10,51,9025,17,34,6316.06,10650.02,0.00
2024-12-08 16:58:10,50,9025,16,34,6348.54,10650.50,0.00
2024-12-08 16:58:10,50,9026,16,34,6508.65,10651.00,0.00
2024-12-08 16:58:10,51,9026,17,34,6381.03,10651.02,0.00
2024-12-08 16:58:10,50,9026,16,34,6315.13,10651.62,0.00
2024-12-08 16:58:10,50,9027,16,34,6487.95,10652.00,0.00
2024-12-08 16:58:10,51,9027,17,34,6360.74,10652.02,0.00
2024-12-08 16:58:10,50,9027,16,34,6483.70,10652.06,0.00
2024-12-08 16:58:10,49,9027,16,33,6609.50,10652.06,0.00
2024-12-08 16:58:10,48,9027,15,33,6616.55,10652.54,0.00
2024-12-08 16:58:10,48,9028,15,33,6788.88,10653.00,0.00
2024-12-08 16:58:10,49,9028,15,34,6650.33,10653.02,0.00
2024-12-08 16:58:10,49,9029,15,34,6638.78,10654.00,0.00
2024-12-08 16:58:10,50,9029,16,34,6506.00,10654.02,0.00
2024-12-08 16:58:10,50,9030,16,34,6469.85,10655.00,0.00
2024-12-08 16:58:10,51,9030,16,35,6342.99,10655.02,0.00
2024-12-08 16:58:10,50,9030,16,34,6461.34,10655.06,0.00
2024-12-08 16:58:10,49,9030,15,34,6420.82,10655.94,0.00
2024-12-08 16:58:10,49,9031,15,34,6631.80,10656.00,0.00
2024-12-08 16:58:10,50,9031,15,35,6499.17,10656.02,0.00
2024-12-08 16:58:10,49,9031,14,35,6430.08,10656.59,0.00
2024-12-08 16:58:10,49,9032,14,35,6592.15,10657.00,0.00
2024-12-08 16:58:10,50,9032,14,36,6460.31,10657.02,0.00
2024-12-08 16:58:10,49,9032,13,36,6453.02,10657.37,0.00
2024-12-08 16:58:10,49,9033,13,36,6582.28,10658.00,0.00
2024-12-08 16:58:10,50,9033,14,36,6450.63,10658.02,0.00
2024-12-08 16:58:10,49,9033,14,35,6575.76,10658.06,0.00
2024-12-08 16:58:10,49,9034,14,35,6539.30,10659.00,0.00
2024-12-08 16:58:10,50,9034,14,36,6408.51,10659.02,0.00
2024-12-08 16:58:10,50,9035,14,36,6351.70,10660.00,0.00
2024-12-08 16:58:10,51,9035,15,36,6227.16,10660.02,0.00
2024-12-08 16:58:10,51,9036,15,36,6166.16,10661.00,0.00
2024-12-08 16:58:10,52,9036,16,36,6047.58,10661.02,0.00
2024-12-08 16:58:10,51,9036,16,35,6159.89,10661.06,0.00
2024-12-08 16:58:10,50,9036,15,35,6115.41,10661.78,0.00
2024-12-08 16:58:10,50,9037,15,35,6220.07,10662.00,0.00
2024-12-08 16:58:10,51,9037,16,35,6098.11,10662.02,0.00
2024-12-08 16:58:10,51,9038,16,35,6089.25,10663.00,0.00
2024-12-08 16:58:10,52,9038,16,36,5972.15,10663.02,0.00
2024-12-08 16:58:10,51,9038,16,35,6043.26,10663.06,0.00
2024-12-08 16:58:11,50,9038,15,35,6082.66,10663.66,0.00
2024-12-08 16:58:11,50,9039,15,35,6174.62,10664.00,0.00
2024-12-08 16:58:11,51,9039,16,35,6053.55,10664.02,0.00
2024-12-08 16:58:11,51,9040,16,35,6036.45,10665.00,0.00
2024-12-08 16:58:11,52,9040,16,36,5920.37,10665.02,0.00
2024-12-08 16:58:11,51,9040,16,35,5992.54,10665.06,0.00
2024-12-08 16:58:11,50,9040,15,35,6060.34,10665.52,0.00
2024-12-08 16:58:11,50,9041,15,35,6098.09,10666.00,0.00
2024-12-08 16:58:11,51,9041,15,36,5978.52,10666.02,0.00
2024-12-08 16:58:11,51,9042,15,36,5905.58,10667.00,0.00
2024-12-08 16:58:11,52,9042,15,37,5792.01,10667.02,0.00
2024-12-08 16:58:11,51,9042,15,36,5863.75,10667.06,0.00
2024-12-08 16:58:11,50,9042,15,35,5850.72,10667.68,0.00
2024-12-08 16:58:11,49,9042,14,35,5888.26,10667.96,0.00
2024-12-08 16:58:11,49,9043,14,35,6101.64,10668.00,0.00
2024-12-08 16:58:11,50,9043,14,36,5979.61,10668.02,0.00
2024-12-08 16:58:11,50,9044,14,36,5972.85,10669.00,0.00
2024-12-08 16:58:11,51,9044,14,37,5855.74,10669.02,0.00
2024-12-08 16:58:11,50,9044,14,36,5932.32,10669.06,0.00
2024-12-08 16:58:11,49,9044,13,36,5999.30,10669.55,0.00
2024-12-08 16:58:11,49,9045,13,36,6082.37,10670.00,0.00
2024-12-08 16:58:11,50,9045,14,36,5960.72,10670.02,0.00
2024-12-08 16:58:11,49,9045,14,35,6078.02,10670.04,0.00
2024-12-08 16:58:11,48,9045,13,35,6072.34,10670.67,0.00
2024-12-08 16:58:11,48,9046,13,35,6259.34,10671.00,0.00
2024-12-08 16:58:11,49,9046,14,35,6131.60,10671.02,0.00
2024-12-08 16:58:11,48,9046,14,34,6221.55,10671.04,0.00
2024-12-08 16:58:11,48,9047,14,34,6253.25,10672.00,0.00
2024-12-08 16:58:11,49,9047,15,34,6125.64,10672.02,0.00
2024-12-08 16:58:11,49,9048,15,34,6116.57,10673.00,0.00
2024-12-08 16:58:11,50,9048,15,35,5994.24,10673.02,0.00
2024-12-08 16:58:11,49,9048,15,34,6081.72,10673.04,0.00
2024-12-08 16:58:11,49,9049,15,34,6110.61,10674.00,0.00
2024-12-08 16:58:11,50,9049,15,35,5988.40,10674.02,0.00
2024-12-08 16:58:11,50,9050,15,35,5975.77,10675.00,0.00
2024-12-08 16:58:11,51,9050,16,35,5858.60,10675.02,0.00
2024-12-08 16:58:11,50,9050,16,34,5943.75,10675.04,0.00
2024-12-08 16:58:11,50,9051,16,34,5965.28,10676.00,0.00
2024-12-08 16:58:11,51,9051,17,34,5848.31,10676.02,0.00
2024-12-08 16:58:11,51,9052,17,34,5832.84,10677.00,0.00
2024-12-08 16:58:11,52,9052,17,35,5720.67,10677.02,0.00
2024-12-08 16:58:11,51,9052,17,34,5803.53,10677.04,0.00
2024-12-08 16:58:11,51,9053,17,34,5821.23,10678.00,0.00
2024-12-08 16:58:11,52,9053,17,35,5709.28,10678.02,0.00
2024-12-08 16:58:11,52,9054,17,35,5694.09,10679.00,0.00
2024-12-08 16:58:11,53,9054,17,36,5586.65,10679.02,0.00
2024-12-08 16:58:11,52,9054,17,35,5667.39,10679.04,0.00
2024-12-08 16:58:11,51,9054,16,35,5715.32,10679.55,0.00
2024-12-08 16:58:11,51,9055,16,35,5876.88,10680.00,0.00
2024-12-08 16:58:11,52,9055,16,36,5763.86,10680.02,0.00
2024-12-08 16:58:11,52,9056,16,36,5748.57,10681.00,0.00
2024-12-08 16:58:11,53,9056,17,36,5640.11,10681.02,0.00
2024-12-08 16:58:11,52,9056,17,35,5723.93,10681.04,0.00
2024-12-08 16:58:11,52,9057,17,35,5742.06,10682.00,0.00
2024-12-08 16:58:11,53,9057,17,36,5633.72,10682.02,0.00
2024-12-08 16:58:11,52,9057,17,35,5666.92,10682.31,0.00
2024-12-08 16:58:11,52,9058,17,35,5729.96,10683.00,0.00
2024-12-08 16:58:11,53,9058,17,36,5621.84,10683.02,0.00
2024-12-08 16:58:11,52,9058,17,35,5705.30,10683.04,0.00
2024-12-08 16:58:11,51,9058,16,35,5760.98,10683.55,0.00
2024-12-08 16:58:11,50,9058,15,35,5869.82,10683.62,0.00
2024-12-08 16:58:11,49,9058,14,35,5936.38,10683.80,0.00
2024-12-08 16:58:11,49,9059,14,35,6132.79,10684.00,0.00
2024-12-08 16:58:11,50,9059,15,35,6010.13,10684.02,0.00
2024-12-08 16:58:11,49,9059,14,35,5947.70,10684.59,0.00
2024-12-08 16:58:11,49,9060,14,35,6122.46,10685.00,0.00
2024-12-08 16:58:11,50,9060,14,36,6000.01,10685.02,0.00
2024-12-08 16:58:11,49,9060,14,35,6098.47,10685.04,0.00
2024-12-08 16:58:11,49,9061,14,35,6127.39,10686.00,0.00
2024-12-08 16:58:11,50,9061,14,36,6004.84,10686.02,0.00
2024-12-08 16:58:11,49,9061,13,36,6125.21,10686.02,0.00
2024-12-08 16:58:11,49,9062,13,36,6115.09,10687.00,0.00
2024-12-08 16:58:11,50,9062,14,36,5992.79,10687.02,0.00
2024-12-08 16:58:11,49,9062,14,35,6093.28,10687.02,0.00
2024-12-08 16:58:11,49,9063,14,35,6120.02,10688.00,0.00
2024-12-08 16:58:11,50,9063,15,35,5997.62,10688.02,0.00
2024-12-08 16:58:11,49,9063,14,35,5988.16,10688.67,0.00
2024-12-08 16:58:11,49,9064,14,35,6171.65,10689.00,0.00
2024-12-08 16:58:11,50,9064,15,35,6048.22,10689.02,0.00
2024-12-08 16:58:12,49,9064,15,34,6147.66,10689.02,0.00
2024-12-08 16:58:12,49,9065,15,34,6173.69,10690.00,0.00
2024-12-08 16:58:12,50,9065,16,34,6050.22,10690.02,0.00
2024-12-08 16:58:12,49,9065,15,34,6072.38,10690.51,0.00
2024-12-08 16:58:12,48,9065,14,34,6132.11,10690.83,0.00
2024-12-08 16:58:12,48,9066,14,34,6337.14,10691.00,0.00
2024-12-08 16:58:12,49,9066,14,35,6207.81,10691.02,0.00
2024-12-08 16:58:12,48,9066,14,34,6312.64,10691.02,0.00
2024-12-08 16:58:12,48,9067,14,34,6336.83,10692.00,0.00
2024-12-08 16:58:12,49,9067,14,35,6207.50,10692.02,0.00
2024-12-08 16:58:12,49,9068,14,35,6185.38,10693.00,0.00
2024-12-08 16:58:12,50,9068,15,35,6061.68,10693.02,0.00
2024-12-08 16:58:12,49,9068,15,34,6163.56,10693.02,0.00
2024-12-08 16:58:12,48,9068,14,34,6143.91,10693.96,0.00
2024-12-08 16:58:12,48,9069,14,34,6362.26,10694.00,0.00
2024-12-08 16:58:12,49,9069,14,35,6232.42,10694.02,0.00
2024-12-08 16:58:12,50,9068,14,36,6026.30,10694.36,0.00
2024-12-08 16:58:12,50,9069,14,36,6272.78,10695.00,0.00
2024-12-08 16:58:12,51,9069,15,36,6149.79,10695.02,0.00
2024-12-08 16:58:12,50,9069,15,35,6251.39,10695.02,0.00
2024-12-08 16:58:12,49,9069,14,35,6366.73,10695.12,0.00
2024-12-08 16:58:12,49,9070,14,35,6622.07,10696.00,0.00
2024-12-08 16:58:12,50,9070,14,36,6489.63,10696.02,0.00
2024-12-08 16:58:12,50,9071,14,36,6424.88,10697.00,0.00
2024-12-08 16:58:12,51,9071,14,37,6298.90,10697.02,0.00
2024-12-08 16:58:12,50,9071,14,36,6405.62,10697.02,0.00
2024-12-08 16:58:12,50,9072,14,36,6376.47,10698.00,0.00
2024-12-08 16:58:12,51,9072,15,36,6251.44,10698.02,0.00
2024-12-08 16:58:12,51,9073,15,36,6167.64,10699.00,0.00
2024-12-08 16:58:12,52,9073,16,36,6049.03,10699.02,0.00
2024-12-08 16:58:12,51,9073,16,35,6150.86,10699.02,0.00
2024-12-08 16:58:12,50,9073,15,35,6266.27,10699.08,0.00
2024-12-08 16:58:12,49,9073,15,34,6174.47,10699.92,0.00
2024-12-08 16:58:12,49,9074,15,34,6384.15,10700.00,0.00
2024-12-08 16:58:12,50,9074,15,35,6256.47,10700.02,0.00
2024-12-08 16:58:12,49,9074,14,35,6327.39,10700.12,0.00
2024-12-08 16:58:12,48,9074,13,35,6436.95,10700.19,0.00
2024-12-08 16:58:12,48,9075,13,35,6573.50,10701.00,0.00
2024-12-08 16:58:12,49,9075,14,35,6439.34,10701.02,0.00
2024-12-08 16:58:12,48,9075,14,34,6553.43,10701.02,0.00
2024-12-08 16:58:12,48,9076,14,34,6583.03,10702.00,0.00
2024-12-08 16:58:12,49,9076,14,35,6448.68,10702.02,0.00
2024-12-08 16:58:12,48,9076,13,35,6532.70,10702.06,0.00
2024-12-08 16:58:12,48,9077,13,35,6566.75,10703.00,0.00
2024-12-08 16:58:12,49,9077,13,36,6432.74,10703.02,0.00
2024-12-08 16:58:12,48,9077,13,35,6548.92,10703.02,0.00
2024-12-08 16:58:12,47,9077,12,35,6552.19,10703.94,0.00
2024-12-08 16:58:12,47,9078,12,35,6773.14,10704.00,0.00
2024-12-08 16:58:12,48,9078,13,35,6632.04,10704.02,0.00
2024-12-08 16:58:12,47,9078,12,35,6611.94,10704.85,0.00
2024-12-08 16:58:12,47,9079,12,35,6823.89,10705.00,0.00
2024-12-08 16:58:12,48,9079,12,36,6681.72,10705.02,0.00
2024-12-08 16:58:12,47,9079,12,35,6787.45,10705.04,0.00
2024-12-08 16:58:12,47,9080,12,35,6822.24,10706.00,0.00
2024-12-08 16:58:12,48,9080,12,36,6680.11,10706.02,0.00
2024-12-08 16:58:12,48,9081,12,36,6665.12,10707.00,0.00
2024-12-08 16:58:12,49,9081,13,36,6529.10,10707.02,0.00
2024-12-08 16:58:12,48,9081,13,35,6627.20,10707.04,0.00
2024-12-08 16:58:12,47,9081,12,35,6629.84,10707.96,0.00
2024-12-08 16:58:12,47,9082,12,35,6853.14,10708.00,0.00
2024-12-08 16:58:12,48,9082,12,36,6710.36,10708.02,0.00
2024-12-08 16:58:12,47,9082,11,36,6784.80,10708.08,0.00
2024-12-08 16:58:12,47,9083,11,36,6915.30,10709.00,0.00
2024-12-08 16:58:12,48,9083,12,36,6771.23,10709.02,0.00
2024-12-08 16:58:12,47,9083,12,35,6876.56,10709.04,0.00
2024-12-08 16:58:12,47,9084,12,35,6911.39,10710.00,0.00
2024-12-08 16:58:12,48,9084,12,36,6767.40,10710.02,0.00
2024-12-08 16:58:12,48,9085,12,36,6749.87,10711.00,0.00
2024-12-08 16:58:12,49,9085,12,37,6612.12,10711.02,0.00
2024-12-08 16:58:12,48,9085,12,36,6743.92,10711.02,0.00
2024-12-08 16:58:12,47,9085,12,35,6853.22,10711.02,0.00
2024-12-08 16:58:12,47,9086,12,35,6885.77,10712.00,0.00
2024-12-08 16:58:12,48,9086,13,35,6742.32,10712.02,0.00
2024-12-08 16:58:12,47,9086,12,35,6696.72,10712.57,0.00
2024-12-08 16:58:12,47,9087,12,35,6879.39,10713.00,0.00
2024-12-08 16:58:12,48,9087,12,36,6736.07,10713.02,0.00
2024-12-08 16:58:12,47,9087,12,35,6838.36,10713.02,0.00
2024-12-08 16:58:12,46,9087,11,35,6917.51,10713.65,0.00
2024-12-08 16:58:12,46,9088,11,35,7020.28,10714.00,0.00
2024-12-08 16:58:12,47,9088,11,36,6870.91,10714.02,0.00
2024-12-08 16:58:12,47,9089,11,36,6857.88,10715.00,0.00
2024-12-08 16:58:12,48,9089,11,37,6715.00,10715.02,0.00
2024-12-08 16:58:12,47,9089,11,36,6814.56,10715.02,0.00
2024-12-08 16:58:12,46,9089,10,36,6899.92,10715.24,0.00
2024-12-08 16:58:12,46,9090,10,36,7051.88,10716.00,0.00
2024-12-08 16:58:12,47,9090,10,37,6901.84,10716.02,0.00
2024-12-08 16:58:13,47,9091,10,37,6888.80,10717.00,0.00
2024-12-08 16:58:13,48,9091,10,38,6745.28,10717.02,0.00
2024-12-08 16:58:13,47,9091,10,37,6845.48,10717.02,0.00
2024-12-08 16:58:13,46,9091,9,37,6862.07,10717.91,0.00
2024-12-08 16:58:13,46,9092,9,37,7085.81,10718.00,0.00
2024-12-08 16:58:13,47,9092,10,37,6935.05,10718.02,0.00
2024-12-08 16:58:13,47,9093,10,37,6922.02,10719.00,0.00
2024-12-08 16:58:13,48,9093,10,38,6777.81,10719.02,0.00
2024-12-08 16:58:13,47,9093,10,37,6880.96,10719.02,0.00
2024-12-08 16:58:13,47,9094,10,37,6913.54,10720.00,0.00
2024-12-08 16:58:13,48,9094,10,38,6769.50,10720.02,0.00
2024-12-08 16:58:13,47,9094,9,38,6770.03,10720.40,0.00
2024-12-08 16:58:13,47,9095,9,38,6870.30,10721.00,0.00
2024-12-08 16:58:13,48,9095,10,38,6727.17,10721.02,0.00
2024-12-08 16:58:13,47,9095,10,37,6831.53,10721.02,0.00
2024-12-08 16:58:13,46,9095,9,37,6919.54,10721.24,0.00
2024-12-08 16:58:13,45,9095,8,37,7014.52,10721.58,0.00
2024-12-08 16:58:13,45,9096,8,37,7207.86,10722.00,0.00
2024-12-08 16:58:13,46,9096,9,37,7051.16,10722.02,0.00
2024-12-08 16:58:13,46,9097,9,37,7040.17,10723.00,0.00
2024-12-08 16:58:13,47,9097,9,38,6890.37,10723.02,0.00
2024-12-08 16:58:13,46,9097,9,37,7000.54,10723.02,0.00
2024-12-08 16:58:13,46,9098,9,37,7036.16,10724.00,0.00
2024-12-08 16:58:13,47,9098,10,37,6886.45,10724.02,0.00
2024-12-08 16:58:13,46,9098,9,37,6891.80,10724.39,0.00
2024-12-08 16:58:13,46,9099,9,37,7060.13,10725.00,0.00
2024-12-08 16:58:13,47,9099,10,37,6909.92,10725.02,0.00
2024-12-08 16:58:13,46,9099,10,36,7015.83,10725.02,0.00
2024-12-08 16:58:13,46,9100,10,36,7051.46,10726.00,0.00
2024-12-08 16:58:13,47,9100,10,37,6901.43,10726.02,0.00
2024-12-08 16:58:13,47,9101,10,37,6888.38,10727.00,0.00
2024-12-08 16:58:13,48,9101,11,37,6744.87,10727.02,0.00
2024-12-08 16:58:13,47,9101,11,36,6840.46,10727.04,0.00
2024-12-08 16:58:13,46,9101,10,36,6903.03,10727.35,0.00
2024-12-08 16:58:13,46,9102,10,36,7066.77,10728.00,0.00
2024-12-08 16:58:13,47,9102,11,36,6916.41,10728.02,0.00
2024-12-08 16:58:13,47,9103,11,36,6903.36,10729.00,0.00
2024-12-08 16:58:13,48,9103,11,37,6759.54,10729.02,0.00
2024-12-08 16:58:13,47,9103,11,36,6864.56,10729.02,0.00
2024-12-08 16:58:13,47,9104,11,36,6897.16,10730.00,0.00
2024-12-08 16:58:13,48,9104,12,36,6753.47,10730.02,0.00
2024-12-08 16:58:13,48,9105,12,36,6738.44,10731.00,0.00
2024-12-08 16:58:13,49,9105,12,37,6600.92,10731.02,0.00
2024-12-08 16:58:13,48,9105,12,36,6700.44,10731.02,0.00
2024-12-08 16:58:13,48,9106,12,36,6729.79,10732.00,0.00
2024-12-08 16:58:13,49,9106,12,37,6592.45,10732.02,0.00
2024-12-08 16:58:13,49,9107,12,37,6574.90,10733.00,0.00
2024-12-08 16:58:13,50,9107,12,38,6443.40,10733.02,0.00
2024-12-08 16:58:13,49,9107,12,37,6539.85,10733.02,0.00
2024-12-08 16:58:13,48,9107,11,37,6562.16,10733.83,0.00
2024-12-08 16:58:13,48,9108,11,37,6768.01,10734.00,0.00
2024-12-08 16:58:13,49,9108,11,38,6629.88,10734.02,0.00
2024-12-08 16:58:13,49,9109,11,38,6612.94,10735.00,0.00
2024-12-08 16:58:13,50,9109,11,39,6480.68,10735.02,0.00
2024-12-08 16:58:13,49,9109,11,38,6580.07,10735.02,0.00
2024-12-08 16:58:13,48,9109,10,38,6585.76,10735.92,0.00
2024-12-08 16:58:13,48,9110,10,38,6800.54,10736.00,0.00
2024-12-08 16:58:13,49,9110,10,39,6661.76,10736.02,0.00
2024-12-08 16:58:13,49,9111,10,39,6644.85,10737.00,0.00
2024-12-08 16:58:13,50,9111,11,39,6511.95,10737.02,0.00
2024-12-08 16:58:13,49,9111,11,38,6607.60,10737.02,0.00
2024-12-08 16:58:13,48,9111,10,38,6671.82,10737.67,0.00
2024-12-08 16:58:13,48,9112,10,38,6859.97,10738.00,0.00
2024-12-08 16:58:13,49,9112,11,38,6719.97,10738.02,0.00
2024-12-08 16:58:13,49,9113,11,38,6703.07,10739.00,0.00
2024-12-08 16:58:13,50,9113,12,38,6569.01,10739.02,0.00
2024-12-08 16:58:13,49,9113,12,37,6668.00,10739.02,0.00
2024-12-08 16:58:13,49,9114,12,37,6694.92,10740.00,0.00
2024-12-08 16:58:13,50,9114,13,37,6561.02,10740.02,0.00
2024-12-08 16:58:13,50,9115,13,37,6546.09,10741.00,0.00
2024-12-08 16:58:13,51,9115,14,37,6417.73,10741.02,0.00
2024-12-08 16:58:13,50,9115,14,36,6507.43,10741.04,0.00
2024-12-08 16:58:13,50,9116,14,36,6533.81,10742.00,0.00
2024-12-08 16:58:13,51,9116,15,36,6405.69,10742.02,0.00
2024-12-08 16:58:13,51,9117,15,36,6391.20,10743.00,0.00
2024-12-08 16:58:13,52,9117,15,37,6268.29,10743.02,0.00
2024-12-08 16:58:13,51,9117,15,36,6355.39,10743.04,0.00
2024-12-08 16:58:13,50,9117,14,36,6418.88,10743.62,0.00
2024-12-08 16:58:13,49,9117,13,36,6549.88,10743.63,0.00
2024-12-08 16:58:13,49,9118,13,36,6642.24,10744.00,0.00
2024-12-08 16:58:13,50,9118,14,36,6509.39,10744.02,0.00
2024-12-08 16:58:13,50,9119,14,36,6490.66,10745.00,0.00
2024-12-08 16:58:13,51,9119,15,36,6363.39,10745.02,0.00
2024-12-08 16:58:13,50,9119,15,35,6456.28,10745.04,0.00
2024-12-08 16:58:14,50,9120,15,35,6482.67,10746.00,0.00
2024-12-08 16:58:14,51,9120,16,35,6355.55,10746.02,0.00
2024-12-08 16:58:14,51,9121,16,35,6335.32,10747.00,0.00
2024-12-08 16:58:14,52,9121,17,35,6213.48,10747.02,0.00
2024-12-08 16:58:14,51,9121,17,34,6303.71,10747.04,0.00
2024-12-08 16:58:14,51,9122,17,34,6327.48,10748.00,0.00
2024-12-08 16:58:14,52,9122,17,35,6205.79,10748.02,0.00
2024-12-08 16:58:14,51,9122,16,35,6216.12,10748.65,0.00
2024-12-08 16:58:14,51,9123,16,35,6308.76,10749.00,0.00
2024-12-08 16:58:14,52,9123,17,35,6187.44,10749.02,0.00
2024-12-08 16:58:14,51,9123,16,35,6255.05,10749.02,0.00
2024-12-08 16:58:14,50,9123,16,34,6350.06,10749.02,0.00
2024-12-08 16:58:14,50,9124,16,34,6460.30,10750.00,0.00
2024-12-08 16:58:14,51,9124,17,34,6333.63,10750.02,0.00
2024-12-08 16:58:14,51,9125,17,34,6313.13,10751.00,0.00
2024-12-08 16:58:14,52,9125,17,35,6191.73,10751.02,0.00
2024-12-08 16:58:14,51,9125,17,34,6285.73,10751.02,0.00
2024-12-08 16:58:14,50,9125,16,34,6298.28,10751.82,0.00
2024-12-08 16:58:14,50,9126,16,34,6494.10,10752.00,0.00
2024-12-08 16:58:14,51,9126,17,34,6366.76,10752.02,0.00
2024-12-08 16:58:14,50,9126,16,34,6356.89,10752.76,0.00
2024-12-08 16:58:14,50,9127,16,34,6546.32,10753.00,0.00
2024-12-08 16:58:14,51,9127,16,35,6417.96,10753.02,0.00
2024-12-08 16:58:14,50,9127,16,34,6518.36,10753.02,0.00
2024-12-08 16:58:14,50,9128,16,34,6542.62,10754.00,0.00
2024-12-08 16:58:14,51,9128,17,34,6414.34,10754.02,0.00
2024-12-08 16:58:14,51,9129,17,34,6393.84,10755.00,0.00
2024-12-08 16:58:14,52,9129,18,34,6270.89,10755.02,0.00
2024-12-08 16:58:14,51,9129,18,33,6368.54,10755.02,0.00
2024-12-08 16:58:14,50,9129,17,33,6382.37,10755.84,0.00
2024-12-08 16:58:14,50,9130,17,33,6580.41,10756.00,0.00
2024-12-08 16:58:14,51,9130,18,33,6451.38,10756.02,0.00
2024-12-08 16:58:14,51,9131,18,33,6431.87,10757.00,0.00
2024-12-08 16:58:14,52,9131,19,33,6308.18,10757.02,0.00
2024-12-08 16:58:14,51,9131,19,32,6400.23,10757.02,0.00
2024-12-08 16:58:14,51,9132,19,32,6421.92,10758.00,0.00
2024-12-08 16:58:14,52,9132,19,33,6298.42,10758.02,0.00
2024-12-08 16:58:14,53,9131,20,33,6096.54,10758.45,0.00
2024-12-08 16:58:14,53,9132,20,33,6237.66,10759.00,0.00
2024-12-08 16:58:14,54,9132,20,34,6122.15,10759.02,0.00
2024-12-08 16:58:14,53,9132,20,33,6209.24,10759.02,0.00
2024-12-08 16:58:14,53,9133,20,33,6429.08,10760.00,0.00
2024-12-08 16:58:14,54,9133,20,34,6310.02,10760.02,0.00
2024-12-08 16:58:14,53,9133,19,34,6321.90,10760.62,0.00
2024-12-08 16:58:14,53,9134,19,34,6484.59,10761.00,0.00
2024-12-08 16:58:14,54,9134,19,35,6364.51,10761.02,0.00
2024-12-08 16:58:14,53,9134,19,34,6456.17,10761.02,0.00
2024-12-08 16:58:14,53,9135,19,34,6473.01,10762.00,0.00
2024-12-08 16:58:14,54,9135,20,34,6353.14,10762.02,0.00
2024-12-08 16:58:14,54,9136,20,34,6330.93,10763.00,0.00
2024-12-08 16:58:14,55,9136,21,34,6215.82,10763.02,0.00
2024-12-08 16:58:14,54,9136,21,33,6303.03,10763.02,0.00
2024-12-08 16:58:14,54,9137,21,33,6317.57,10764.00,0.00
2024-12-08 16:58:14,55,9137,21,34,6202.70,10764.02,0.00
2024-12-08 16:58:14,55,9138,21,34,6178.81,10765.00,0.00
2024-12-08 16:58:14,56,9138,21,35,6068.47,10765.02,0.00
2024-12-08 16:58:14,55,9138,21,34,6153.36,10765.02,0.00
2024-12-08 16:58:14,54,9138,21,33,6177.63,10765.09,0.00
2024-12-08 16:58:14,54,9139,21,33,6199.55,10766.00,0.00
2024-12-08 16:58:14,55,9139,22,33,6086.83,10766.02,0.00
2024-12-08 16:58:14,54,9139,21,33,6145.75,10766.11,0.00
2024-12-08 16:58:14,54,9140,21,33,6248.00,10767.00,0.00
2024-12-08 16:58:14,55,9140,21,34,6134.40,10767.02,0.00
2024-12-08 16:58:14,54,9140,21,33,6220.08,10767.02,0.00
2024-12-08 16:58:14,53,9140,20,33,6266.34,10767.02,0.00
2024-12-08 16:58:14,53,9141,20,33,6361.41,10768.00,0.00
2024-12-08 16:58:14,54,9141,20,34,6243.61,10768.02,0.00
2024-12-08 16:58:14,54,9142,20,34,6220.07,10769.00,0.00
2024-12-08 16:58:14,55,9142,21,34,6106.98,10769.02,0.00
2024-12-08 16:58:14,54,9142,21,33,6192.15,10769.02,0.00
2024-12-08 16:58:14,53,9142,20,33,6295.95,10769.08,0.00
2024-12-08 16:58:14,53,9143,20,33,6397.31,10770.00,0.00
2024-12-08 16:58:14,54,9143,21,33,6278.84,10770.02,0.00
2024-12-08 16:58:14,54,9144,21,33,6259.78,10771.00,0.00
2024-12-08 16:58:14,55,9144,21,34,6145.96,10771.02,0.00
2024-12-08 16:58:14,54,9144,21,33,6225.87,10771.04,0.00
2024-12-08 16:58:14,54,9145,21,33,6241.73,10772.00,0.00
2024-12-08 16:58:14,55,9145,21,34,6128.25,10772.02,0.00
2024-12-08 16:58:14,55,9146,21,34,6111.02,10773.00,0.00
2024-12-08 16:58:15,56,9146,22,34,6001.90,10773.02,0.00
2024-12-08 16:58:15,55,9146,22,33,6077.73,10773.04,0.00
2024-12-08 16:58:15,54,9146,21,33,6041.01,10773.94,0.00
2024-12-08 16:58:15,54,9147,21,33,6234.57,10774.00,0.00
2024-12-08 16:58:15,55,9147,22,33,6121.21,10774.02,0.00
2024-12-08 16:58:15,56,9146,22,34,5919.80,10774.55,0.00
2024-12-08 16:58:15,56,9147,22,34,6046.11,10775.00,0.00
2024-12-08 16:58:15,57,9147,22,35,5940.03,10775.02,0.00
2024-12-08 16:58:15,56,9147,22,34,6013.40,10775.04,0.00
2024-12-08 16:58:15,55,9147,21,34,6059.44,10775.62,0.00
2024-12-08 16:58:15,55,9148,21,34,6332.03,10776.00,0.00
2024-12-08 16:58:15,56,9148,22,34,6218.96,10776.02,0.00
2024-12-08 16:58:15,56,9149,22,34,6198.40,10777.00,0.00
2024-12-08 16:58:15,57,9149,23,34,6089.65,10777.02,0.00
2024-12-08 16:58:15,56,9149,23,33,6167.61,10777.04,0.00
2024-12-08 16:58:15,56,9150,23,33,6179.73,10778.00,0.00
2024-12-08 16:58:15,57,9150,23,34,6071.31,10778.02,0.00
2024-12-08 16:58:15,56,9150,22,34,6011.51,10778.61,0.00
2024-12-08 16:58:15,56,9151,22,34,6161.94,10779.00,0.00
2024-12-08 16:58:15,57,9151,22,35,6053.83,10779.02,0.00
2024-12-08 16:58:15,56,9151,22,34,6131.14,10779.04,0.00
2024-12-08 16:58:15,55,9151,21,34,6175.57,10779.58,0.00
2024-12-08 16:58:15,55,9152,21,34,6326.80,10780.00,0.00
2024-12-08 16:58:15,56,9152,21,35,6213.82,10780.02,0.00
2024-12-08 16:58:15,56,9153,21,35,6193.49,10781.00,0.00
2024-12-08 16:58:15,57,9153,21,36,6084.83,10781.02,0.00
2024-12-08 16:58:15,56,9153,21,35,6164.61,10781.04,0.00
2024-12-08 16:58:15,55,9153,20,35,6178.58,10781.42,0.00
2024-12-08 16:58:15,55,9154,20,35,6312.29,10782.00,0.00
2024-12-08 16:58:15,56,9154,20,36,6199.57,10782.02,0.00
2024-12-08 16:58:15,55,9154,19,36,6243.73,10782.18,0.00
2024-12-08 16:58:15,55,9155,19,36,6352.08,10783.00,0.00
2024-12-08 16:58:15,56,9155,20,36,6238.65,10783.02,0.00
2024-12-08 16:58:15,55,9155,20,35,6324.64,10783.04,0.00
2024-12-08 16:58:15,54,9155,19,35,6362.04,10783.37,0.00
2024-12-08 16:58:15,54,9156,19,35,6494.28,10784.00,0.00
2024-12-08 16:58:15,55,9156,19,36,6376.20,10784.02,0.00
2024-12-08 16:58:15,54,9156,18,36,6388.56,10784.31,0.00
2024-12-08 16:58:15,53,9156,17,36,6485.85,10784.53,0.00
2024-12-08 16:58:15,53,9157,17,36,6638.82,10785.00,0.00
2024-12-08 16:58:15,54,9157,18,36,6515.88,10785.02,0.00
2024-12-08 16:58:15,53,9157,18,35,6626.82,10785.04,0.00
2024-12-08 16:58:15,52,9157,17,35,6665.23,10785.38,0.00
2024-12-08 16:58:15,51,9157,16,35,6773.72,10785.59,0.00
2024-12-08 16:58:15,51,9158,16,35,6941.14,10786.00,0.00
2024-12-08 16:58:15,52,9158,17,35,6807.65,10786.02,0.00
2024-12-08 16:58:15,52,9159,17,35,6785.46,10787.00,0.00
2024-12-08 16:58:15,53,9159,17,36,6657.44,10787.02,0.00
2024-12-08 16:58:15,52,9159,17,35,6760.58,10787.04,0.00
2024-12-08 16:58:15,52,9160,17,35,6781.94,10788.00,0.00
2024-12-08 16:58:15,53,9160,17,36,6653.98,10788.02,0.00
2024-12-08 16:58:15,52,9160,16,36,6612.08,10788.54,0.00
2024-12-08 16:58:15,52,9161,16,36,6770.12,10789.00,0.00
2024-12-08 16:58:15,53,9161,16,37,6642.39,10789.02,0.00
2024-12-08 16:58:15,52,9161,16,36,6745.23,10789.04,0.00
2024-12-08 16:58:15,52,9162,16,36,6766.60,10790.00,0.00
2024-12-08 16:58:15,53,9162,17,36,6638.93,10790.02,0.00
2024-12-08 16:58:15,53,9163,17,36,6664.59,10791.00,0.00
2024-12-08 16:58:15,54,9163,18,36,6541.18,10791.02,0.00
2024-12-08 16:58:15,54,9164,18,36,6537.28,10792.00,0.00
2024-12-08 16:58:15,55,9164,19,36,6418.42,10792.02,0.00
2024-12-08 16:58:15,55,9165,19,36,6391.54,10793.00,0.00
2024-12-08 16:58:15,56,9165,19,37,6277.41,10793.02,0.00
2024-12-08 16:58:15,55,9165,19,36,6377.81,10793.04,0.00
2024-12-08 16:58:15,55,9166,19,36,6392.13,10794.00,0.00
2024-12-08 16:58:15,56,9166,20,36,6277.99,10794.02,0.00
2024-12-08 16:58:15,56,9167,20,36,6249.65,10795.00,0.00
2024-12-08 16:58:15,57,9167,20,37,6140.01,10795.02,0.00
2024-12-08 16:58:15,56,9167,20,36,6230.38,10795.04,0.00
2024-12-08 16:58:15,56,9168,20,36,6242.52,10796.00,0.00
2024-12-08 16:58:15,57,9168,21,36,6133.00,10796.02,0.00
2024-12-08 16:58:15,56,9168,20,36,6138.52,10796.32,0.00
2024-12-08 16:58:15,56,9169,20,36,6258.52,10797.00,0.00
2024-12-08 16:58:15,57,9169,20,37,6148.73,10797.02,0.00
2024-12-08 16:58:15,56,9169,20,36,6235.39,10797.05,0.00
2024-12-08 16:58:15,56,9170,20,36,6249.46,10798.00,0.00
2024-12-08 16:58:15,57,9170,21,36,6139.82,10798.02,0.00
2024-12-08 16:58:15,57,9171,21,36,6115.82,10799.00,0.00
2024-12-08 16:58:15,58,9171,21,37,6010.38,10799.02,0.00
2024-12-08 16:58:15,57,9171,21,36,6085.52,10799.07,0.00
2024-12-08 16:58:15,56,9171,20,36,6182.65,10799.16,0.00
2024-12-08 16:58:15,56,9172,20,36,6208.25,10800.00,0.00
2024-12-08 16:58:15,57,9172,21,36,6099.34,10800.02,0.00
2024-12-08 16:58:16,57,9173,21,36,6074.04,10801.00,0.00
2024-12-08 16:58:16,58,9173,21,37,5969.31,10801.02,0.00
2024-12-08 16:58:16,57,9173,21,36,6045.62,10801.07,0.00
2024-12-08 16:58:16,57,9174,21,36,6059.44,10802.00,0.00
2024-12-08 16:58:16,58,9174,22,36,5954.97,10802.02,0.00
2024-12-08 16:58:16,57,9174,21,36,5930.28,10802.74,0.00
2024-12-08 16:58:16,57,9175,21,36,6091.55,10803.00,0.00
2024-12-08 16:58:16,58,9175,22,36,5986.53,10803.02,0.00
2024-12-08 16:58:16,57,9175,22,35,6089.66,10803.02,0.00
2024-12-08 16:58:16,56,9175,22,34,6173.33,10803.05,0.00
2024-12-08 16:58:16,55,9175,21,34,6279.70,10803.11,0.00
2024-12-08 16:58:16,55,9176,21,34,6301.86,10804.00,0.00
2024-12-08 16:58:16,56,9176,22,34,6189.33,10804.02,0.00
2024-12-08 16:58:16,55,9176,21,34,6139.24,10804.87,0.00
2024-12-08 16:58:16,55,9177,21,34,6322.03,10805.00,0.00
2024-12-08 16:58:16,56,9177,22,34,6209.14,10805.02,0.00
2024-12-08 16:58:16,55,9177,21,34,6208.44,10805.69,0.00
2024-12-08 16:58:16,55,9178,21,34,6293.14,10806.00,0.00
2024-12-08 16:58:16,56,9178,21,35,6180.77,10806.02,0.00
2024-12-08 16:58:16,55,9178,21,34,6283.32,10806.04,0.00
2024-12-08 16:58:16,55,9179,21,34,6297.66,10807.00,0.00
2024-12-08 16:58:16,56,9179,21,35,6185.20,10807.02,0.00
2024-12-08 16:58:16,55,9179,21,34,6279.98,10807.04,0.00
2024-12-08 16:58:16,54,9179,20,34,6284.67,10807.85,0.00
2024-12-08 16:58:16,54,9180,20,34,6468.91,10808.00,0.00
2024-12-08 16:58:16,55,9180,21,34,6351.30,10808.02,0.00
2024-12-08 16:58:16,55,9181,21,34,6324.37,10809.00,0.00
2024-12-08 16:58:16,56,9181,22,34,6211.44,10809.02,0.00
2024-12-08 16:58:16,55,9181,22,33,6308.65,10809.04,0.00
2024-12-08 16:58:16,54,9181,21,33,6293.91,10809.94,0.00
2024-12-08 16:58:16,54,9182,21,33,6488.13,10810.00,0.00
2024-12-08 16:58:16,55,9182,21,34,6370.16,10810.02,0.00
2024-12-08 16:58:16,55,9183,21,34,6343.23,10811.00,0.00
2024-12-08 16:58:16,56,9183,22,34,6229.96,10811.02,0.00
2024-12-08 16:58:16,55,9183,22,33,6329.47,10811.04,0.00
2024-12-08 16:58:16,54,9183,21,33,6420.70,10811.15,0.00
2024-12-08 16:58:16,54,9184,21,33,6529.37,10812.00,0.00
2024-12-08 16:58:16,55,9184,21,34,6410.66,10812.02,0.00
2024-12-08 16:58:16,54,9184,20,34,6485.30,10812.06,0.00
2024-12-08 16:58:16,54,9185,20,34,6503.92,10813.00,0.00
2024-12-08 16:58:16,55,9185,21,34,6385.66,10813.02,0.00
2024-12-08 16:58:16,54,9185,21,33,6479.89,10813.04,0.00
2024-12-08 16:58:16,53,9185,20,33,6519.35,10813.64,0.00
2024-12-08 16:58:16,53,9186,20,33,6684.89,10814.00,0.00
2024-12-08 16:58:16,54,9186,21,33,6561.10,10814.02,0.00
2024-12-08 16:58:16,54,9187,21,33,6575.16,10815.00,0.00
2024-12-08 16:58:16,55,9187,21,34,6455.62,10815.02,0.00
2024-12-08 16:58:16,54,9187,20,34,6498.55,10815.06,0.00
2024-12-08 16:58:16,54,9188,20,34,6594.78,10816.00,0.00
2024-12-08 16:58:16,55,9188,20,35,6474.87,10816.02,0.00
2024-12-08 16:58:16,54,9188,20,34,6554.72,10816.04,0.00
2024-12-08 16:58:16,54,9189,20,34,6567.92,10817.00,0.00
2024-12-08 16:58:16,55,9189,21,34,6448.50,10817.02,0.00
2024-12-08 16:58:16,55,9190,21,34,6420.79,10818.00,0.00
2024-12-08 16:58:16,56,9190,22,34,6306.13,10818.02,0.00
2024-12-08 16:58:16,55,9190,22,33,6391.29,10818.04,0.00
2024-12-08 16:58:16,55,9191,22,33,6403.74,10819.00,0.00
2024-12-08 16:58:16,56,9191,23,33,6289.39,10819.02,0.00
2024-12-08 16:58:16,56,9192,23,33,6261.86,10820.00,0.00
2024-12-08 16:58:16,57,9192,23,34,6152.01,10820.02,0.00
2024-12-08 16:58:16,56,9192,23,33,6232.88,10820.04,0.00
2024-12-08 16:58:16,56,9193,23,33,6240.09,10821.00,0.00
2024-12-08 16:58:16,57,9193,24,33,6130.62,10821.02,0.00
2024-12-08 16:58:16,57,9194,24,33,6104.81,10822.00,0.00
2024-12-08 16:58:16,58,9194,25,33,5999.56,10822.02,0.00
2024-12-08 16:58:16,57,9194,25,32,6070.64,10822.04,0.00
2024-12-08 16:58:16,57,9195,25,32,6071.62,10823.00,0.00
2024-12-08 16:58:16,58,9195,25,33,5966.94,10823.02,0.00
2024-12-08 16:58:16,58,9196,25,33,5938.52,10824.00,0.00
2024-12-08 16:58:16,59,9196,25,34,5837.86,10824.02,0.00
2024-12-08 16:58:16,58,9196,25,33,5906.79,10824.03,0.00
2024-12-08 16:58:16,57,9196,24,33,5852.52,10824.96,0.00
2024-12-08 16:58:16,57,9197,24,33,6038.65,10825.00,0.00
2024-12-08 16:58:16,58,9197,24,34,5934.54,10825.02,0.00
2024-12-08 16:58:16,57,9197,23,34,6036.75,10825.02,0.00
2024-12-08 16:58:16,56,9197,22,34,6080.80,10825.14,0.00
2024-12-08 16:58:16,56,9198,22,34,6173.63,10826.00,0.00
2024-12-08 16:58:16,57,9198,23,34,6065.33,10826.02,0.00
2024-12-08 16:58:16,56,9198,23,33,6144.64,10826.02,0.00
2024-12-08 16:58:16,55,9198,22,33,6248.50,10826.07,0.00
2024-12-08 16:58:16,55,9199,22,33,6255.78,10827.00,0.00
2024-12-08 16:58:16,56,9199,23,33,6144.07,10827.02,0.00
2024-12-08 16:58:16,55,9199,22,33,6194.59,10827.22,0.00
2024-12-08 16:58:17,55,9200,22,33,6219.42,10828.00,0.00
2024-12-08 16:58:17,56,9200,23,33,6108.36,10828.02,0.00
2024-12-08 16:58:17,55,9200,23,32,6191.86,10828.02,0.00
2024-12-08 16:58:17,55,9201,23,32,6183.08,10829.00,0.00
2024-12-08 16:58:17,56,9201,24,32,6072.67,10829.02,0.00
2024-12-08 16:58:17,56,9202,24,32,6029.54,10830.00,0.00
2024-12-08 16:58:17,57,9202,24,33,5923.76,10830.02,0.00
2024-12-08 16:58:17,56,9202,24,32,6000.53,10830.02,0.00
2024-12-08 16:58:17,56,9203,24,32,5984.68,10831.00,0.00
2024-12-08 16:58:17,57,9203,25,32,5879.68,10831.02,0.00
2024-12-08 16:58:17,56,9203,24,32,5841.54,10831.79,0.00
2024-12-08 16:58:17,56,9204,24,32,5944.84,10832.00,0.00
2024-12-08 16:58:17,57,9204,24,33,5840.54,10832.02,0.00
2024-12-08 16:58:17,56,9204,24,32,5917.76,10832.02,0.00
2024-12-08 16:58:17,56,9205,24,32,5919.27,10833.00,0.00
2024-12-08 16:58:17,57,9205,25,32,5815.43,10833.02,0.00
2024-12-08 16:58:17,57,9206,25,32,5790.22,10834.00,0.00
2024-12-08 16:58:17,58,9206,26,32,5690.39,10834.02,0.00
2024-12-08 16:58:17,57,9206,26,31,5763.61,10834.02,0.00
2024-12-08 16:58:17,56,9206,25,31,5849.59,10834.07,0.00
2024-12-08 16:58:17,56,9207,25,31,5939.23,10835.00,0.00
2024-12-08 16:58:17,57,9207,25,32,5835.03,10835.02,0.00
2024-12-08 16:58:17,56,9207,24,32,5894.74,10835.07,0.00
2024-12-08 16:58:17,56,9208,24,32,5921.15,10836.00,0.00
2024-12-08 16:58:17,57,9208,25,32,5817.27,10836.02,0.00
2024-12-08 16:58:17,56,9208,25,31,5896.00,10836.02,0.00
2024-12-08 16:58:17,56,9209,25,31,5906.22,10837.00,0.00
2024-12-08 16:58:17,57,9209,25,32,5802.60,10837.02,0.00
2024-12-08 16:58:17,57,9210,25,32,5785.07,10838.00,0.00
2024-12-08 16:58:17,58,9210,26,32,5685.32,10838.02,0.00
2024-12-08 16:58:17,57,9210,26,31,5758.45,10838.02,0.00
2024-12-08 16:58:17,57,9211,26,31,5766.58,10839.00,0.00
2024-12-08 16:58:17,58,9211,27,31,5667.16,10839.02,0.00
2024-12-08 16:58:17,58,9212,27,31,5648.88,10840.00,0.00
2024-12-08 16:58:17,59,9212,27,32,5553.14,10840.02,0.00
2024-12-08 16:58:17,58,9212,27,31,5624.58,10840.02,0.00
2024-12-08 16:58:17,58,9213,27,31,5630.71,10841.00,0.00
2024-12-08 16:58:17,59,9213,27,32,5535.28,10841.02,0.00
2024-12-08 16:58:17,58,9213,26,32,5537.35,10841.29,0.00
2024-12-08 16:58:17,58,9214,26,32,5648.06,10842.00,0.00
2024-12-08 16:58:17,59,9214,26,33,5552.33,10842.02,0.00
2024-12-08 16:58:17,58,9214,26,32,5623.75,10842.02,0.00
2024-12-08 16:58:17,58,9215,26,32,5629.88,10843.00,0.00
2024-12-08 16:58:17,59,9215,26,33,5534.46,10843.02,0.00
2024-12-08 16:58:17,58,9215,25,33,5553.30,10843.22,0.00
2024-12-08 16:58:17,58,9216,25,33,5656.58,10844.00,0.00
2024-12-08 16:58:17,59,9216,25,34,5560.70,10844.02,0.00
2024-12-08 16:58:17,58,9216,25,33,5634.14,10844.02,0.00
2024-12-08 16:58:17,57,9216,24,33,5695.00,10844.21,0.00
2024-12-08 16:58:17,56,9216,23,33,5788.40,10844.29,0.00
2024-12-08 16:58:17,56,9217,23,33,5905.03,10845.00,0.00
2024-12-08 16:58:17,57,9217,23,34,5801.43,10845.02,0.00
2024-12-08 16:58:17,56,9217,22,34,5853.05,10845.13,0.00
2024-12-08 16:58:17,56,9218,22,34,5886.50,10846.00,0.00
2024-12-08 16:58:17,57,9218,23,34,5783.22,10846.02,0.00
2024-12-08 16:58:17,56,9218,23,33,5859.39,10846.04,0.00
2024-12-08 16:58:17,55,9218,22,33,5905.81,10846.58,0.00
2024-12-08 16:58:17,54,9218,21,33,5975.06,10846.74,0.00
2024-12-08 16:58:17,54,9219,21,33,6148.01,10847.00,0.00
2024-12-08 16:58:17,55,9219,22,33,6036.23,10847.02,0.00
2024-12-08 16:58:17,55,9220,22,33,6016.07,10848.00,0.00
2024-12-08 16:58:17,56,9220,22,34,5908.64,10848.02,0.00
2024-12-08 16:58:17,55,9220,22,33,5990.43,10848.04,0.00
2024-12-08 16:58:17,55,9221,22,33,6004.79,10849.00,0.00
2024-12-08 16:58:17,56,9221,22,34,5897.56,10849.02,0.00
2024-12-08 16:58:17,56,9222,22,34,5876.56,10850.00,0.00
2024-12-08 16:58:17,57,9222,23,34,5773.46,10850.02,0.00
2024-12-08 16:58:17,56,9222,23,33,5853.32,10850.04,0.00
2024-12-08 16:58:17,56,9223,23,33,5865.48,10851.00,0.00
2024-12-08 16:58:17,57,9223,23,34,5762.57,10851.02,0.00
2024-12-08 16:58:17,57,9224,23,34,5741.60,10852.00,0.00
2024-12-08 16:58:17,58,9224,23,35,5642.61,10852.02,0.00
2024-12-08 16:58:17,57,9224,23,34,5720.67,10852.04,0.00
2024-12-08 16:58:17,56,9224,22,34,5763.99,10852.57,0.00
2024-12-08 16:58:17,56,9225,22,34,5834.04,10853.00,0.00
2024-12-08 16:58:17,57,9225,23,34,5731.69,10853.02,0.00
2024-12-08 16:58:17,56,9225,22,34,5746.91,10853.25,0.00
2024-12-08 16:58:17,56,9226,22,34,5859.78,10854.00,0.00
2024-12-08 16:58:17,57,9226,23,34,5756.97,10854.02,0.00
2024-12-08 16:58:17,56,9226,23,33,5840.40,10854.04,0.00
2024-12-08 16:58:18,56,9227,23,33,5852.56,10855.00,0.00
2024-12-08 16:58:18,57,9227,24,33,5749.88,10855.02,0.00
2024-12-08 16:58:18,56,9227,23,33,5683.33,10855.57,0.00
2024-12-08 16:58:18,56,9228,23,33,5830.96,10856.00,0.00
2024-12-08 16:58:18,57,9228,23,34,5728.67,10856.02,0.00
2024-12-08 16:58:18,56,9228,23,33,5811.58,10856.04,0.00
2024-12-08 16:58:18,56,9229,23,33,5823.75,10857.00,0.00
2024-12-08 16:58:18,57,9229,23,34,5721.57,10857.02,0.00
2024-12-08 16:58:18,57,9230,23,34,5700.75,10858.00,0.00
2024-12-08 16:58:18,58,9230,24,34,5602.46,10858.02,0.00
2024-12-08 16:58:18,59,9229,25,34,5505.67,10858.07,0.00
2024-12-08 16:58:18,58,9229,24,34,5668.67,10858.69,0.00
2024-12-08 16:58:18,58,9230,24,34,5822.42,10859.00,0.00
2024-12-08 16:58:18,59,9230,24,35,5723.74,10859.02,0.00
2024-12-08 16:58:18,59,9231,24,35,5932.10,10860.00,0.00
2024-12-08 16:58:18,60,9231,24,36,5833.24,10860.02,0.00
2024-12-08 16:58:18,60,9232,24,36,5847.13,10861.00,0.00
2024-12-08 16:58:18,61,9232,24,37,5751.27,10861.02,0.00
2024-12-08 16:58:18,60,9232,23,37,5748.57,10861.57,0.00
2024-12-08 16:58:18,60,9233,23,37,5839.41,10862.00,0.00
2024-12-08 16:58:18,61,9233,23,38,5743.69,10862.02,0.00
2024-12-08 16:58:18,61,9234,23,38,5709.08,10863.00,0.00
2024-12-08 16:58:18,62,9234,24,38,5617.00,10863.02,0.00
2024-12-08 16:58:18,61,9234,24,37,5698.40,10863.03,0.00
2024-12-08 16:58:18,60,9234,23,37,5780.74,10863.15,0.00
2024-12-08 16:58:18,59,9234,23,36,5875.20,10863.17,0.00
2024-12-08 16:58:18,58,9234,22,36,5873.42,10863.93,0.00
2024-12-08 16:58:18,58,9235,22,36,6053.29,10864.00,0.00
2024-12-08 16:58:18,59,9235,22,37,5950.69,10864.02,0.00
2024-12-08 16:58:18,58,9235,21,37,5924.20,10864.45,0.00
2024-12-08 16:58:18,58,9236,21,37,6051.97,10865.00,0.00
2024-12-08 16:58:18,59,9236,21,38,5949.40,10865.02,0.00
2024-12-08 16:58:18,58,9236,21,37,6042.61,10865.03,0.00
2024-12-08 16:58:18,57,9236,20,37,6050.10,10865.44,0.00
2024-12-08 16:58:18,57,9237,20,37,6180.14,10866.00,0.00
2024-12-08 16:58:18,58,9237,21,37,6073.58,10866.02,0.00
2024-12-08 16:58:18,57,9237,20,37,6045.69,10866.74,0.00
2024-12-08 16:58:18,57,9238,20,37,6207.96,10867.00,0.00
2024-12-08 16:58:18,58,9238,20,38,6100.92,10867.02,0.00
2024-12-08 16:58:18,57,9238,20,37,6200.33,10867.04,0.00
2024-12-08 16:58:18,56,9238,19,37,6299.62,10867.13,0.00
2024-12-08 16:58:18,56,9239,19,37,6321.52,10868.00,0.00
2024-12-08 16:58:18,57,9239,20,37,6210.62,10868.02,0.00
2024-12-08 16:58:18,57,9240,20,37,6180.68,10869.00,0.00
2024-12-08 16:58:18,58,9240,20,38,6074.12,10869.02,0.00
2024-12-08 16:58:18,57,9240,20,37,6169.24,10869.04,0.00
2024-12-08 16:58:18,57,9241,20,37,6179.34,10870.00,0.00
2024-12-08 16:58:18,58,9241,20,38,6072.80,10870.02,0.00
2024-12-08 16:58:18,57,9241,19,38,6108.84,10870.23,0.00
2024-12-08 16:58:18,57,9242,19,38,6216.14,10871.00,0.00
2024-12-08 16:58:18,58,9242,19,39,6108.97,10871.02,0.00
2024-12-08 16:58:18,57,9242,19,38,6204.70,10871.04,0.00
2024-12-08 16:58:18,56,9242,18,38,6196.57,10871.61,0.00
2024-12-08 16:58:18,56,9243,18,38,6270.65,10872.00,0.00
2024-12-08 16:58:18,57,9243,18,39,6160.64,10872.02,0.00
2024-12-08 16:58:18,57,9244,18,39,6069.83,10873.00,0.00
2024-12-08 16:58:18,58,9244,18,40,5965.18,10873.02,0.00
2024-12-08 16:58:18,57,9244,18,39,6058.39,10873.04,0.00
2024-12-08 16:58:18,56,9244,17,39,6128.68,10873.38,0.00
2024-12-08 16:58:18,56,9245,17,39,6042.30,10874.00,0.00
2024-12-08 16:58:18,57,9245,18,39,5936.30,10874.02,0.00
2024-12-08 16:58:18,56,9245,17,39,5927.75,10874.09,0.00
2024-12-08 16:58:18,55,9245,16,39,5972.54,10874.65,0.00
2024-12-08 16:58:18,54,9245,15,39,6046.35,10874.72,0.00
2024-12-08 16:58:18,54,9246,15,39,6217.75,10875.00,0.00
2024-12-08 16:58:18,55,9246,15,40,6104.70,10875.02,0.00
2024-12-08 16:58:18,54,9246,15,39,6205.67,10875.04,0.00
2024-12-08 16:58:18,53,9246,14,39,6313.56,10875.11,0.00
2024-12-08 16:58:18,53,9247,14,39,6340.79,10876.00,0.00
2024-12-08 16:58:18,54,9247,14,40,6223.36,10876.02,0.00
2024-12-08 16:58:18,53,9247,13,40,6275.17,10876.19,0.00
2024-12-08 16:58:18,52,9247,12,40,6347.98,10876.63,0.00
2024-12-08 16:58:18,52,9248,12,40,6517.44,10877.00,0.00
2024-12-08 16:58:18,53,9248,13,40,6394.47,10877.02,0.00
2024-12-08 16:58:18,52,9248,12,40,6515.35,10877.02,0.00
2024-12-08 16:58:18,51,9248,12,39,6632.43,10877.02,0.00
2024-12-08 16:58:18,50,9248,11,39,6675.92,10877.10,0.00
2024-12-08 16:58:18,50,9249,11,39,6794.44,10878.00,0.00
2024-12-08 16:58:18,51,9249,12,39,6661.21,10878.02,0.00
2024-12-08 16:58:18,51,9250,12,39,6637.45,10879.00,0.00
2024-12-08 16:58:18,52,9250,12,40,6509.81,10879.02,0.00
2024-12-08 16:58:18,51,9250,12,39,6618.25,10879.02,0.00
2024-12-08 16:58:18,50,9250,11,39,6737.60,10879.12,0.00
2024-12-08 16:58:18,50,9251,11,39,6768.72,10880.00,0.00
2024-12-08 16:58:18,51,9251,12,39,6636.00,10880.02,0.00
2024-12-08 16:58:18,50,9251,11,39,6620.95,10880.44,0.00
2024-12-08 16:58:18,50,9252,11,39,6772.63,10881.00,0.00
2024-12-08 16:58:18,51,9252,11,40,6639.84,10881.02,0.00
2024-12-08 16:58:18,50,9252,11,39,6748.70,10881.04,0.00
2024-12-08 16:58:19,50,9253,11,39,6768.80,10882.00,0.00
2024-12-08 16:58:19,51,9253,11,40,6636.08,10882.02,0.00
2024-12-08 16:58:19,51,9254,11,40,6607.70,10883.00,0.00
2024-12-08 16:58:19,52,9254,11,41,6480.63,10883.02,0.00
2024-12-08 16:58:19,51,9254,11,40,6584.23,10883.04,0.00
2024-12-08 16:58:19,50,9254,10,40,6620.47,10883.72,0.00
2024-12-08 16:58:19,50,9255,10,40,6807.88,10884.00,0.00
2024-12-08 16:58:19,51,9255,10,41,6674.40,10884.02,0.00
2024-12-08 16:58:19,51,9256,10,41,6644.34,10885.00,0.00
2024-12-08 16:58:19,52,9256,10,42,6516.56,10885.02,0.00
2024-12-08 16:58:19,51,9256,10,41,6618.73,10885.04,0.00
2024-12-08 16:58:19,50,9256,10,40,6589.88,10885.50,0.00
2024-12-08 16:58:19,50,9257,10,40,6666.45,10886.00,0.00
2024-12-08 16:58:19,51,9257,11,40,6535.74,10886.02,0.00
2024-12-08 16:58:19,50,9257,10,40,6508.00,10886.84,0.00
2024-12-08 16:58:19,50,9258,10,40,6708.44,10887.00,0.00
2024-12-08 16:58:19,51,9258,10,41,6576.90,10887.02,0.00
2024-12-08 16:58:19,50,9258,10,40,6684.49,10887.04,0.00
2024-12-08 16:58:19,49,9258,10,39,6678.79,10887.25,0.00
2024-12-08 16:58:19,49,9259,10,39,6730.43,10888.00,0.00
2024-12-08 16:58:19,50,9259,10,40,6595.82,10888.02,0.00
2024-12-08 16:58:19,50,9260,10,40,6576.82,10889.00,0.00
2024-12-08 16:58:19,51,9260,10,41,6447.87,10889.02,0.00
2024-12-08 16:58:19,50,9260,10,40,6548.52,10889.04,0.00
2024-12-08 16:58:19,49,9260,9,40,6569.29,10889.84,0.00
2024-12-08 16:58:19,49,9261,9,40,6773.89,10890.00,0.00
2024-12-08 16:58:19,50,9261,9,41,6638.41,10890.02,0.00
2024-12-08 16:58:19,49,9261,8,41,6585.27,10890.59,0.00
2024-12-08 16:58:19,49,9262,8,41,6763.40,10891.00,0.00
2024-12-08 16:58:19,50,9262,9,41,6628.13,10891.02,0.00
2024-12-08 16:58:19,49,9262,9,40,6732.28,10891.04,0.00
2024-12-08 16:58:19,49,9263,9,40,6761.80,10892.00,0.00
2024-12-08 16:58:19,50,9263,9,41,6626.56,10892.02,0.00
2024-12-08 16:58:19,50,9264,9,41,6607.56,10893.00,0.00
2024-12-08 16:58:19,51,9264,10,41,6478.00,10893.02,0.00
2024-12-08 16:58:19,50,9264,10,40,6579.24,10893.04,0.00
2024-12-08 16:58:19,50,9265,10,40,6605.99,10894.00,0.00
2024-12-08 16:58:19,51,9265,10,41,6476.46,10894.02,0.00
2024-12-08 16:58:19,50,9265,9,41,6421.36,10894.96,0.00
2024-12-08 16:58:19,50,9266,9,41,6634.92,10895.00,0.00
2024-12-08 16:58:19,51,9266,10,41,6504.83,10895.02,0.00
2024-12-08 16:58:19,50,9266,10,40,6608.78,10895.04,0.00
2024-12-08 16:58:19,49,9266,9,40,6677.29,10895.65,0.00
2024-12-08 16:58:19,49,9267,9,40,6773.17,10896.00,0.00
2024-12-08 16:58:19,50,9267,9,41,6637.71,10896.02,0.00
2024-12-08 16:58:19,50,9268,9,41,6618.96,10897.00,0.00
2024-12-08 16:58:19,51,9268,9,42,6489.18,10897.02,0.00
2024-12-08 16:58:19,50,9268,9,41,6586.27,10897.04,0.00
2024-12-08 16:58:19,49,9268,8,41,6585.33,10897.94,0.00
2024-12-08 16:58:19,49,9269,8,41,6801.11,10898.00,0.00
2024-12-08 16:58:19,50,9269,8,42,6665.08,10898.02,0.00
2024-12-08 16:58:19,50,9270,8,42,6647.00,10899.00,0.00
2024-12-08 16:58:19,51,9270,8,43,6516.67,10899.02,0.00
2024-12-08 16:58:19,50,9270,8,42,6614.30,10899.04,0.00
2024-12-08 16:58:19,50,9271,8,42,6641.07,10900.00,0.00
2024-12-08 16:58:19,51,9271,8,43,6510.85,10900.02,0.00
2024-12-08 16:58:19,50,9271,7,43,6464.10,10900.92,0.00
2024-12-08 16:58:19,50,9272,7,43,6673.46,10901.00,0.00
2024-12-08 16:58:19,51,9272,7,44,6542.61,10901.02,0.00
2024-12-08 16:58:19,50,9272,7,43,6638.58,10901.04,0.00
2024-12-08 16:58:19,49,9272,6,43,6767.52,10901.04,0.00
2024-12-08 16:58:19,49,9273,6,43,6886.05,10902.00,0.00
2024-12-08 16:58:19,50,9273,7,43,6748.33,10902.02,0.00
2024-12-08 16:58:19,51,9272,8,43,6411.80,10902.76,0.00
2024-12-08 16:58:19,51,9273,8,43,6803.23,10903.00,0.00
2024-12-08 16:58:19,52,9273,9,43,6672.40,10903.02,0.00
2024-12-08 16:58:19,51,9273,9,42,6769.02,10903.04,0.00
2024-12-08 16:58:19,50,9273,8,42,6823.24,10903.36,0.00
2024-12-08 16:58:19,50,9274,8,42,7190.09,10904.00,0.00
2024-12-08 16:58:19,51,9274,9,42,7049.11,10904.02,0.00
2024-12-08 16:58:19,51,9275,9,42,7028.38,10905.00,0.00
2024-12-08 16:58:19,52,9275,9,43,6893.21,10905.02,0.00
2024-12-08 16:58:19,51,9275,9,42,6987.76,10905.06,0.00
2024-12-08 16:58:19,51,9276,9,42,7014.05,10906.00,0.00
2024-12-08 16:58:19,52,9276,10,42,6879.16,10906.02,0.00
2024-12-08 16:58:19,52,9277,10,42,6857.81,10907.00,0.00
2024-12-08 16:58:19,53,9277,11,42,6728.42,10907.02,0.00
2024-12-08 16:58:19,52,9277,11,41,6820.06,10907.06,0.00
2024-12-08 16:58:19,52,9278,11,41,6843.75,10908.00,0.00
2024-12-08 16:58:19,53,9278,12,41,6714.63,10908.02,0.00
2024-12-08 16:58:19,52,9278,11,41,6770.39,10908.19,0.00
2024-12-08 16:58:19,52,9279,11,41,6892.63,10909.00,0.00
2024-12-08 16:58:19,53,9279,12,41,6762.58,10909.02,0.00
2024-12-08 16:58:19,52,9279,11,41,6890.54,10909.02,0.00
2024-12-08 16:58:19,51,9279,11,40,6991.43,10909.04,0.00
2024-12-08 16:58:20,51,9280,11,40,7015.59,10910.00,0.00
2024-12-08 16:58:20,52,9280,12,40,6880.68,10910.02,0.00
2024-12-08 16:58:20,52,9281,12,40,6858.23,10911.00,0.00
2024-12-08 16:58:20,53,9281,12,41,6728.83,10911.02,0.00
2024-12-08 16:58:20,52,9281,12,40,6826.76,10911.04,0.00
2024-12-08 16:58:20,52,9282,12,40,6848.36,10912.00,0.00
2024-12-08 16:58:20,53,9282,13,40,6719.15,10912.02,0.00
2024-12-08 16:58:20,53,9283,13,40,6695.06,10913.00,0.00
2024-12-08 16:58:20,54,9283,13,41,6571.07,10913.02,0.00
2024-12-08 16:58:20,53,9283,13,40,6666.23,10913.04,0.00
2024-12-08 16:58:20,53,9284,13,40,6685.37,10914.00,0.00
2024-12-08 16:58:20,54,9284,14,40,6561.57,10914.02,0.00
2024-12-08 16:58:20,54,9285,14,40,6535.89,10915.00,0.00
2024-12-08 16:58:20,55,9285,15,40,6417.06,10915.02,0.00
2024-12-08 16:58:20,54,9285,15,39,6505.58,10915.04,0.00
2024-12-08 16:58:20,53,9285,14,39,6490.92,10915.96,0.00
2024-12-08 16:58:20,53,9285,14,39,6692.78,10916.00,0.00
2024-12-08 16:58:20,54,9285,14,40,6568.84,10916.02,0.00
2024-12-08 16:58:20,54,9286,14,40,6543.16,10917.00,0.00
2024-12-08 16:58:20,55,9286,15,40,6424.19,10917.02,0.00
2024-12-08 16:58:20,54,9286,15,39,6514.86,10917.04,0.00
2024-12-08 16:58:20,53,9286,14,39,6575.15,10917.49,0.00
2024-12-08 16:58:20,53,9287,14,39,6725.17,10918.00,0.00
2024-12-08 16:58:20,54,9287,14,40,6600.63,10918.02,0.00
2024-12-08 16:58:20,54,9288,14,40,6572.22,10919.00,0.00
2024-12-08 16:58:20,55,9288,15,40,6452.73,10919.02,0.00
2024-12-08 16:58:20,54,9288,15,39,6543.92,10919.04,0.00
2024-12-08 16:58:20,54,9289,15,39,6555.53,10920.00,0.00
2024-12-08 16:58:20,55,9289,16,39,6436.33,10920.02,0.00
2024-12-08 16:58:20,54,9289,15,39,6437.73,10920.70,0.00
2024-12-08 16:58:20,54,9290,15,39,6521.74,10921.00,0.00
2024-12-08 16:58:20,55,9290,16,39,6403.16,10921.02,0.00
2024-12-08 16:58:20,54,9290,16,38,6495.45,10921.04,0.00
2024-12-08 16:58:20,55,9289,16,39,6371.41,10921.13,0.00
2024-12-08 16:58:20,55,9290,16,39,6506.76,10922.00,0.00
2024-12-08 16:58:20,56,9290,16,40,6390.56,10922.02,0.00
2024-12-08 16:58:20,56,9291,16,40,6552.18,10923.00,0.00
2024-12-08 16:58:20,57,9291,17,40,6437.22,10923.02,0.00
2024-12-08 16:58:20,56,9291,17,39,6522.92,10923.04,0.00
2024-12-08 16:58:20,55,9291,16,39,6502.57,10923.71,0.00
2024-12-08 16:58:20,55,9292,16,39,6662.33,10924.00,0.00
2024-12-08 16:58:20,56,9292,16,40,6543.36,10924.02,0.00
2024-12-08 16:58:20,56,9293,16,40,6504.78,10925.00,0.00
2024-12-08 16:58:20,57,9293,17,40,6390.66,10925.02,0.00
2024-12-08 16:58:20,56,9293,17,39,6473.57,10925.04,0.00
2024-12-08 16:58:20,55,9293,16,39,6447.05,10925.64,0.00
2024-12-08 16:58:20,55,9294,16,39,6601.66,10926.00,0.00
2024-12-08 16:58:20,56,9294,16,40,6483.78,10926.02,0.00
2024-12-08 16:58:20,56,9295,16,40,6455.12,10927.00,0.00
2024-12-08 16:58:20,57,9295,16,41,6341.87,10927.02,0.00
2024-12-08 16:58:20,56,9295,16,40,6425.85,10927.04,0.00
2024-12-08 16:58:20,55,9295,15,40,6408.41,10927.60,0.00
2024-12-08 16:58:20,55,9296,15,40,6563.66,10928.00,0.00
2024-12-08 16:58:20,56,9296,15,41,6446.45,10928.02,0.00
2024-12-08 16:58:20,56,9297,15,41,6479.22,10929.00,0.00
2024-12-08 16:58:20,57,9297,15,42,6365.55,10929.02,0.00
2024-12-08 16:58:20,56,9297,14,42,6476.31,10929.02,0.00
2024-12-08 16:58:20,56,9298,14,42,6525.28,10930.00,0.00
2024-12-08 16:58:20,57,9298,14,43,6410.81,10930.02,0.00
2024-12-08 16:58:20,56,9298,13,43,6414.36,10930.66,0.00
2024-12-08 16:58:20,56,9299,13,43,6521.56,10931.00,0.00
2024-12-08 16:58:20,57,9299,14,43,6407.15,10931.02,0.00
2024-12-08 16:58:20,57,9300,14,43,6377.05,10932.00,0.00
2024-12-08 16:58:20,58,9300,14,44,6267.10,10932.02,0.00
2024-12-08 16:58:20,57,9300,14,43,6357.87,10932.02,0.00
2024-12-08 16:58:20,56,9300,13,43,6320.07,10932.89,0.00
2024-12-08 16:58:20,56,9301,13,43,6503.68,10933.00,0.00
2024-12-08 16:58:20,57,9301,14,43,6389.58,10933.02,0.00
2024-12-08 16:58:20,57,9302,14,43,6359.47,10934.00,0.00
2024-12-08 16:58:20,58,9302,15,43,6249.82,10934.02,0.00
2024-12-08 16:58:20,57,9302,15,42,6342.20,10934.02,0.00
2024-12-08 16:58:20,57,9303,15,42,6350.46,10935.00,0.00
2024-12-08 16:58:20,58,9303,16,42,6240.97,10935.02,0.00
2024-12-08 16:58:20,58,9304,16,42,6209.48,10936.00,0.00
2024-12-08 16:58:20,59,9304,16,43,6104.24,10936.02,0.00
2024-12-08 16:58:20,58,9304,16,42,6192.51,10936.02,0.00
2024-12-08 16:58:20,58,9305,16,42,6198.74,10937.00,0.00
2024-12-08 16:58:20,59,9305,17,42,6093.67,10937.02,0.00
2024-12-08 16:58:20,58,9305,16,42,6087.79,10937.67,0.00
2024-12-08 16:58:21,58,9306,16,42,6165.36,10938.00,0.00
2024-12-08 16:58:21,59,9306,17,42,6060.86,10938.02,0.00
2024-12-08 16:58:21,58,9306,17,41,6150.27,10938.02,0.00
2024-12-08 16:58:21,58,9307,17,41,6156.49,10939.00,0.00
2024-12-08 16:58:21,59,9307,17,42,6052.15,10939.02,0.00
2024-12-08 16:58:21,58,9307,16,42,6103.73,10939.16,0.00
2024-12-08 16:58:21,58,9308,16,42,6124.99,10940.00,0.00
2024-12-08 16:58:21,59,9308,17,42,6021.18,10940.02,0.00
2024-12-08 16:58:21,58,9308,17,41,6109.90,10940.02,0.00
2024-12-08 16:58:21,57,9308,16,41,6148.30,10940.65,0.00
2024-12-08 16:58:21,57,9309,16,41,6225.34,10941.00,0.00
2024-12-08 16:58:21,58,9309,17,41,6118.00,10941.02,0.00
2024-12-08 16:58:21,57,9309,16,41,6075.84,10941.53,0.00
2024-12-08 16:58:21,58,9308,17,41,5942.98,10941.81,0.00
2024-12-08 16:58:21,58,9309,17,41,6131.77,10942.00,0.00
2024-12-08 16:58:21,59,9309,18,41,6027.84,10942.02,0.00
2024-12-08 16:58:21,58,9309,18,40,6116.68,10942.02,0.00
2024-12-08 16:58:21,58,9310,18,40,6311.57,10943.00,0.00
2024-12-08 16:58:21,59,9310,18,41,6204.59,10943.02,0.00
2024-12-08 16:58:21,58,9310,17,41,6153.32,10943.55,0.00
2024-12-08 16:58:21,58,9311,17,41,6293.28,10944.00,0.00
2024-12-08 16:58:21,59,9311,17,42,6186.61,10944.02,0.00
2024-12-08 16:58:21,58,9311,17,41,6280.07,10944.02,0.00
2024-12-08 16:58:21,58,9312,17,41,6286.30,10945.00,0.00
2024-12-08 16:58:21,59,9312,17,42,6179.76,10945.02,0.00
2024-12-08 16:58:21,58,9312,16,42,6132.02,10945.86,0.00
2024-12-08 16:58:21,58,9313,16,42,6305.75,10946.00,0.00
2024-12-08 16:58:21,59,9313,16,43,6198.87,10946.02,0.00
2024-12-08 16:58:21,58,9313,16,42,6294.43,10946.02,0.00
2024-12-08 16:58:21,58,9314,16,42,6299.44,10947.00,0.00
2024-12-08 16:58:21,59,9314,17,42,6192.67,10947.02,0.00
2024-12-08 16:58:21,58,9314,16,42,6139.25,10947.55,0.00
2024-12-08 16:58:21,58,9315,16,42,6277.07,10948.00,0.00
2024-12-08 16:58:21,59,9315,16,43,6170.68,10948.02,0.00
2024-12-08 16:58:21,58,9315,16,42,6267.63,10948.02,0.00
2024-12-08 16:58:21,58,9316,16,42,6270.44,10949.00,0.00
2024-12-08 16:58:21,59,9316,17,42,6164.16,10949.02,0.00
2024-12-08 16:58:21,59,9317,17,42,6126.53,10950.00,0.00
2024-12-08 16:58:21,60,9317,18,42,6024.43,10950.02,0.00
2024-12-08 16:58:21,59,9317,18,41,6119.11,10950.02,0.00
2024-12-08 16:58:21,59,9318,18,41,6116.72,10951.00,0.00
2024-12-08 16:58:21,60,9318,18,42,6014.77,10951.02,0.00
2024-12-08 16:58:21,59,9318,17,42,5997.18,10951.68,0.00
2024-12-08 16:58:21,59,9319,17,42,6073.52,10952.00,0.00
2024-12-08 16:58:21,60,9319,17,43,5972.29,10952.02,0.00
2024-12-08 16:58:21,59,9319,17,42,6066.09,10952.02,0.00
2024-12-08 16:58:21,58,9319,16,42,6023.58,10952.97,0.00
2024-12-08 16:58:21,58,9320,16,42,6208.66,10953.00,0.00
2024-12-08 16:58:21,59,9320,16,43,6103.43,10953.02,0.00
2024-12-08 16:58:21,59,9321,16,43,6060.64,10954.00,0.00
2024-12-08 16:58:21,60,9321,17,43,5959.63,10954.02,0.00
2024-12-08 16:58:21,59,9321,17,42,6055.07,10954.02,0.00
2024-12-08 16:58:21,58,9321,16,42,6095.38,10954.36,0.00
2024-12-08 16:58:21,58,9322,16,42,6204.55,10955.00,0.00
2024-12-08 16:58:21,59,9322,17,42,6099.39,10955.02,0.00
2024-12-08 16:58:21,59,9323,17,42,6056.88,10956.00,0.00
2024-12-08 16:58:21,60,9323,18,42,5955.94,10956.02,0.00
2024-12-08 16:58:21,59,9323,18,41,6049.46,10956.02,0.00
2024-12-08 16:58:21,59,9324,18,41,6045.22,10957.00,0.00
2024-12-08 16:58:21,60,9324,18,42,5944.46,10957.02,0.00
2024-12-08 16:58:21,59,9324,17,42,5922.74,10957.70,0.00
2024-12-08 16:58:21,59,9325,17,42,6075.27,10958.00,0.00
2024-12-08 16:58:21,60,9325,18,42,5974.01,10958.02,0.00
2024-12-08 16:58:21,59,9325,18,41,6067.84,10958.02,0.00
2024-12-08 16:58:21,59,9326,18,41,6062.54,10959.00,0.00
2024-12-08 16:58:21,60,9326,18,42,5961.49,10959.02,0.00
2024-12-08 16:58:21,60,9327,18,42,5915.06,10960.00,0.00
2024-12-08 16:58:21,61,9327,19,42,5818.10,10960.02,0.00
2024-12-08 16:58:21,60,9327,19,41,5909.58,10960.02,0.00
2024-12-08 16:58:21,59,9327,19,40,5959.81,10960.44,0.00
2024-12-08 16:58:21,59,9328,19,40,6003.49,10961.00,0.00
2024-12-08 16:58:21,60,9328,20,40,5903.44,10961.02,0.00
2024-12-08 16:58:21,59,9328,19,40,5866.01,10961.80,0.00
2024-12-08 16:58:21,59,9329,19,40,6029.67,10962.00,0.00
2024-12-08 16:58:21,60,9329,19,41,5929.17,10962.02,0.00
2024-12-08 16:58:21,59,9329,19,40,6025.95,10962.02,0.00
2024-12-08 16:58:21,58,9329,18,40,6058.33,10962.67,0.00
2024-12-08 16:58:21,58,9330,18,40,6136.08,10963.00,0.00
2024-12-08 16:58:21,59,9330,18,41,6032.08,10963.02,0.00
2024-12-08 16:58:21,58,9330,17,41,6068.10,10963.26,0.00
2024-12-08 16:58:21,58,9331,17,41,6176.33,10964.00,0.00
2024-12-08 16:58:21,59,9331,17,42,6071.65,10964.02,0.00
2024-12-08 16:58:21,58,9331,17,41,6174.44,10964.02,0.00
2024-12-08 16:58:22,58,9332,17,41,6180.68,10965.00,0.00
2024-12-08 16:58:22,59,9332,18,41,6075.92,10965.02,0.00
2024-12-08 16:58:22,58,9332,18,40,6140.98,10965.02,0.00
2024-12-08 16:58:22,57,9332,17,40,6141.42,10965.82,0.00
2024-12-08 16:58:22,57,9333,17,40,6314.70,10966.00,0.00
2024-12-08 16:58:22,58,9333,17,41,6205.82,10966.02,0.00
2024-12-08 16:58:22,57,9333,16,41,6208.99,10966.35,0.00
2024-12-08 16:58:22,57,9334,16,41,6329.57,10967.00,0.00
2024-12-08 16:58:22,58,9334,16,42,6220.44,10967.02,0.00
2024-12-08 16:58:22,57,9334,16,41,6327.65,10967.02,0.00
2024-12-08 16:58:22,57,9335,16,41,6334.37,10968.00,0.00
2024-12-08 16:58:22,58,9335,17,41,6225.15,10968.02,0.00
2024-12-08 16:58:22,57,9335,17,40,6293.96,10968.02,0.00
2024-12-08 16:58:22,57,9336,17,40,6302.23,10969.00,0.00
2024-12-08 16:58:22,58,9336,17,41,6193.57,10969.02,0.00
2024-12-08 16:58:22,57,9336,17,40,6261.82,10969.02,0.00
2024-12-08 16:58:22,56,9336,16,40,6354.10,10969.20,0.00
2024-12-08 16:58:22,56,9337,16,40,6384.01,10970.00,0.00
2024-12-08 16:58:22,57,9337,16,41,6272.01,10970.02,0.00
2024-12-08 16:58:22,56,9337,16,40,6342.87,10970.02,0.00
2024-12-08 16:58:22,56,9338,16,40,6353.25,10971.00,0.00
2024-12-08 16:58:22,57,9338,16,41,6241.79,10971.02,0.00
2024-12-08 16:58:22,57,9339,16,41,6211.56,10972.00,0.00
2024-12-08 16:58:22,58,9339,17,41,6104.46,10972.02,0.00
2024-12-08 16:58:22,57,9339,17,40,6209.63,10972.02,0.00
2024-12-08 16:58:22,56,9339,16,40,6217.10,10972.80,0.00
2024-12-08 16:58:22,56,9340,16,40,6391.64,10973.00,0.00
2024-12-08 16:58:22,57,9340,16,41,6279.50,10973.02,0.00
2024-12-08 16:58:22,57,9341,16,41,6249.27,10974.00,0.00
2024-12-08 16:58:22,58,9341,16,42,6141.52,10974.02,0.00
2024-12-08 16:58:22,57,9341,16,41,6247.35,10974.02,0.00
2024-12-08 16:58:22,57,9342,16,41,6255.62,10975.00,0.00
2024-12-08 16:58:22,58,9342,16,42,6147.76,10975.02,0.00
2024-12-08 16:58:22,57,9342,15,42,6079.01,10975.96,0.00
2024-12-08 16:58:22,57,9343,15,42,6267.74,10976.00,0.00
2024-12-08 16:58:22,58,9343,15,43,6159.67,10976.02,0.00
2024-12-08 16:58:22,57,9343,15,42,6265.81,10976.02,0.00
2024-12-08 16:58:22,57,9344,15,42,6274.09,10977.00,0.00
2024-12-08 16:58:22,58,9344,16,42,6165.91,10977.02,0.00
2024-12-08 16:58:22,57,9344,16,41,6233.65,10977.02,0.00
2024-12-08 16:58:22,56,9344,15,41,6251.05,10977.45,0.00
2024-12-08 16:58:22,56,9345,15,41,6386.71,10978.00,0.00
2024-12-08 16:58:22,57,9345,16,41,6274.66,10978.02,0.00
2024-12-08 16:58:22,56,9345,16,40,6345.54,10978.02,0.00
2024-12-08 16:58:22,56,9346,16,40,6355.92,10979.00,0.00
2024-12-08 16:58:22,57,9346,16,41,6244.41,10979.02,0.00
2024-12-08 16:58:22,56,9346,16,40,6314.75,10979.02,0.00
2024-12-08 16:58:22,55,9346,15,40,6358.02,10979.67,0.00
2024-12-08 16:58:22,55,9347,15,40,6521.98,10980.00,0.00
2024-12-08 16:58:22,56,9347,16,40,6405.52,10980.02,0.00
2024-12-08 16:58:22,55,9347,16,39,6480.06,10980.02,0.00
2024-12-08 16:58:22,55,9348,16,39,6492.63,10981.00,0.00
2024-12-08 16:58:22,56,9348,17,39,6376.69,10981.02,0.00
2024-12-08 16:58:22,55,9348,17,38,6450.70,10981.02,0.00
2024-12-08 16:58:22,54,9348,16,38,6513.33,10981.30,0.00
2024-12-08 16:58:22,54,9349,16,38,6639.90,10982.00,0.00
2024-12-08 16:58:22,55,9349,16,39,6519.17,10982.02,0.00
2024-12-08 16:58:22,54,9349,15,39,6530.39,10982.65,0.00
2024-12-08 16:58:22,54,9350,15,39,6614.06,10983.00,0.00
2024-12-08 16:58:22,55,9350,15,40,6493.81,10983.02,0.00
2024-12-08 16:58:22,54,9350,15,39,6607.96,10983.02,0.00
2024-12-08 16:58:22,54,9351,15,39,6622.80,10984.00,0.00
2024-12-08 16:58:22,55,9351,16,39,6502.39,10984.02,0.00
2024-12-08 16:58:22,54,9351,15,39,6515.00,10984.06,0.00
2024-12-08 16:58:22,54,9352,15,39,6615.27,10985.00,0.00
2024-12-08 16:58:22,55,9352,15,40,6494.99,10985.02,0.00
2024-12-08 16:58:22,54,9352,15,39,6601.03,10985.02,0.00
2024-12-08 16:58:22,54,9353,15,39,6615.87,10986.00,0.00
2024-12-08 16:58:22,55,9353,15,40,6495.58,10986.02,0.00
2024-12-08 16:58:22,55,9354,15,40,6468.21,10987.00,0.00
2024-12-08 16:58:22,56,9354,16,40,6352.70,10987.02,0.00
2024-12-08 16:58:22,55,9354,16,39,6454.22,10987.02,0.00
2024-12-08 16:58:22,54,9354,15,39,6433.92,10987.96,0.00
2024-12-08 16:58:22,54,9355,15,39,6633.35,10988.00,0.00
2024-12-08 16:58:22,55,9355,16,39,6512.75,10988.02,0.00
2024-12-08 16:58:22,55,9356,16,39,6485.37,10989.00,0.00
2024-12-08 16:58:22,56,9356,16,40,6369.56,10989.02,0.00
2024-12-08 16:58:22,55,9356,16,39,6469.39,10989.02,0.00
2024-12-08 16:58:22,55,9357,16,39,6481.96,10990.00,0.00
2024-12-08 16:58:22,56,9357,17,39,6366.21,10990.02,0.00
2024-12-08 16:58:22,56,9358,17,39,6337.35,10991.00,0.00
2024-12-08 16:58:22,57,9358,18,39,6226.17,10991.02,0.00
2024-12-08 16:58:22,56,9358,18,38,6321.65,10991.02,0.00
2024-12-08 16:58:23,56,9359,18,38,6332.04,10992.00,0.00
2024-12-08 16:58:23,57,9359,18,39,6220.95,10992.02,0.00
2024-12-08 16:58:23,56,9359,17,39,6187.21,10992.82,0.00
2024-12-08 16:58:23,56,9360,17,39,6364.02,10993.00,0.00
2024-12-08 16:58:23,57,9360,18,39,6252.38,10993.02,0.00
2024-12-08 16:58:23,56,9360,18,38,6346.36,10993.02,0.00
2024-12-08 16:58:23,56,9360,18,38,6356.75,10994.00,0.00
2024-12-08 16:58:23,57,9360,19,38,6245.23,10994.02,0.00
2024-12-08 16:58:23,56,9360,18,38,6297.59,10994.16,0.00
2024-12-08 16:58:23,55,9360,17,38,6390.13,10994.22,0.00
2024-12-08 16:58:23,55,9361,17,38,6504.59,10995.00,0.00
2024-12-08 16:58:23,56,9361,17,39,6388.44,10995.02,0.00
2024-12-08 16:58:23,55,9361,17,38,6463.77,10995.09,0.00
2024-12-08 16:58:23,55,9362,17,38,6484.33,10996.00,0.00
2024-12-08 16:58:23,56,9362,17,39,6368.54,10996.02,0.00
2024-12-08 16:58:23,56,9363,17,39,6354.15,10997.00,0.00
2024-12-08 16:58:23,57,9363,18,39,6242.68,10997.02,0.00
2024-12-08 16:58:23,56,9363,17,39,6233.56,10997.70,0.00
2024-12-08 16:58:23,55,9363,16,39,6261.44,10997.96,0.00
2024-12-08 16:58:23,55,9364,16,39,6457.42,10998.00,0.00
2024-12-08 16:58:23,56,9364,17,39,6342.11,10998.02,0.00
2024-12-08 16:58:23,55,9364,17,38,6441.28,10998.09,0.00
2024-12-08 16:58:23,55,9365,17,38,6461.84,10999.00,0.00
2024-12-08 16:58:23,56,9365,17,39,6346.45,10999.02,0.00
2024-12-08 16:58:23,55,9365,16,39,6461.41,10999.02,0.00
2024-12-08 16:58:23,55,9366,16,39,6433.73,11000.00,0.00
2024-12-08 16:58:23,56,9366,17,39,6318.84,11000.02,0.00
2024-12-08 16:58:23,55,9366,17,38,6405.74,11000.07,0.00
2024-12-08 16:58:23,54,9366,16,38,6423.04,11000.81,0.00
2024-12-08 16:58:23,54,9367,16,38,6606.53,11001.00,0.00
2024-12-08 16:58:23,55,9367,17,38,6486.41,11001.02,0.00
2024-12-08 16:58:23,54,9367,16,38,6486.35,11001.09,0.00
2024-12-08 16:58:23,54,9368,16,38,6588.84,11002.00,0.00
2024-12-08 16:58:23,55,9368,17,38,6469.05,11002.02,0.00
2024-12-08 16:58:23,54,9368,17,37,6560.33,11002.07,0.00
2024-12-08 16:58:23,54,9369,17,37,6579.46,11003.00,0.00
2024-12-08 16:58:23,55,9369,18,37,6459.83,11003.02,0.00
2024-12-08 16:58:23,55,9370,18,37,6432.82,11004.00,0.00
2024-12-08 16:58:23,56,9370,18,38,6317.95,11004.02,0.00
2024-12-08 16:58:23,55,9370,18,37,6400.82,11004.07,0.00
2024-12-08 16:58:23,55,9371,18,37,6418.70,11005.00,0.00
2024-12-08 16:58:23,56,9371,18,38,6304.08,11005.02,0.00
2024-12-08 16:58:23,56,9372,18,38,6280.66,11006.00,0.00
2024-12-08 16:58:23,57,9372,19,38,6170.47,11006.02,0.00
2024-12-08 16:58:23,56,9372,19,37,6247.26,11006.07,0.00
2024-12-08 16:58:23,56,9373,19,37,6263.54,11007.00,0.00
2024-12-08 16:58:23,57,9373,19,38,6153.65,11007.02,0.00
2024-12-08 16:58:23,57,9374,19,38,6135.04,11008.00,0.00
2024-12-08 16:58:23,58,9374,19,39,6029.27,11008.02,0.00
2024-12-08 16:58:23,57,9374,19,38,6096.44,11008.09,0.00
2024-12-08 16:58:23,57,9375,19,38,6112.43,11009.00,0.00
2024-12-08 16:58:23,58,9375,20,38,6007.04,11009.02,0.00
2024-12-08 16:58:23,57,9375,19,38,5973.97,11009.75,0.00
2024-12-08 16:58:23,57,9376,19,38,6140.27,11010.00,0.00
2024-12-08 16:58:23,58,9376,20,38,6034.41,11010.02,0.00
2024-12-08 16:58:23,57,9376,20,37,6103.59,11010.09,0.00
2024-12-08 16:58:23,56,9376,19,37,6204.74,11010.14,0.00
2024-12-08 16:58:23,56,9377,19,37,6222.14,11011.00,0.00
2024-12-08 16:58:23,57,9377,20,37,6112.98,11011.02,0.00
2024-12-08 16:58:23,57,9378,20,37,6083.10,11012.00,0.00
2024-12-08 16:58:23,58,9378,21,37,5978.22,11012.02,0.00
2024-12-08 16:58:23,57,9378,21,36,6048.34,11012.09,0.00
2024-12-08 16:58:23,57,9379,21,36,6055.80,11013.00,0.00
2024-12-08 16:58:23,58,9379,22,36,5951.39,11013.02,0.00
2024-12-08 16:58:23,58,9380,22,36,5923.51,11014.00,0.00
2024-12-08 16:58:23,59,9380,22,37,5823.11,11014.02,0.00
2024-12-08 16:58:23,58,9380,22,36,5891.23,11014.09,0.00
2024-12-08 16:58:23,58,9381,22,36,5899.60,11015.00,0.00
2024-12-08 16:58:23,59,9381,22,37,5799.60,11015.02,0.00
2024-12-08 16:58:23,58,9381,21,37,5787.69,11015.64,0.00
2024-12-08 16:58:23,58,9382,21,37,5932.45,11016.00,0.00
2024-12-08 16:58:23,59,9382,21,38,5831.90,11016.02,0.00
2024-12-08 16:58:23,58,9382,21,37,5900.17,11016.09,0.00
2024-12-08 16:58:23,57,9382,20,37,5997.91,11016.14,0.00
2024-12-08 16:58:23,56,9382,19,37,6061.80,11016.30,0.00
2024-12-08 16:58:23,55,9382,18,37,6025.90,11016.75,0.00
2024-12-08 16:58:23,55,9383,18,37,6198.34,11017.00,0.00
2024-12-08 16:58:23,56,9383,19,37,6087.66,11017.02,0.00
2024-12-08 16:58:23,55,9383,18,37,6140.25,11017.07,0.00
2024-12-08 16:58:23,55,9384,18,37,6192.12,11018.00,0.00
2024-12-08 16:58:23,56,9384,19,37,6081.55,11018.02,0.00
2024-12-08 16:58:23,55,9384,19,36,6158.07,11018.07,0.00
2024-12-08 16:58:24,55,9385,19,36,6169.19,11019.00,0.00
2024-12-08 16:58:24,56,9385,19,37,6059.02,11019.02,0.00
2024-12-08 16:58:24,55,9385,19,36,6157.17,11019.02,0.00
2024-12-08 16:58:24,54,9385,18,36,6195.75,11019.20,0.00
2024-12-08 16:58:24,54,9386,18,36,6303.28,11020.00,0.00
2024-12-08 16:58:24,55,9386,19,36,6188.67,11020.02,0.00
2024-12-08 16:58:24,54,9386,19,35,6272.67,11020.06,0.00
2024-12-08 16:58:24,53,9386,18,35,6274.83,11020.53,0.00
2024-12-08 16:58:24,53,9387,18,35,6419.98,11021.00,0.00
2024-12-08 16:58:24,54,9387,19,35,6301.09,11021.02,0.00
2024-12-08 16:58:24,54,9388,19,35,6267.33,11022.00,0.00
2024-12-08 16:58:24,55,9388,20,35,6153.38,11022.02,0.00
2024-12-08 16:58:24,54,9388,20,34,6238.76,11022.06,0.00
2024-12-08 16:58:24,54,9389,20,34,6246.80,11023.00,0.00
2024-12-08 16:58:24,55,9389,20,35,6133.22,11023.02,0.00
2024-12-08 16:58:24,54,9389,19,35,6126.48,11023.63,0.00
2024-12-08 16:58:24,53,9389,18,35,6200.82,11023.77,0.00
2024-12-08 16:58:24,53,9390,18,35,6384.03,11024.00,0.00
2024-12-08 16:58:24,54,9390,19,35,6265.81,11024.02,0.00
2024-12-08 16:58:24,53,9390,19,34,6348.68,11024.08,0.00
2024-12-08 16:58:24,53,9391,19,34,6360.73,11025.00,0.00
2024-12-08 16:58:24,54,9391,20,34,6242.94,11025.02,0.00
2024-12-08 16:58:24,53,9391,20,33,6261.62,11025.49,0.00
2024-12-08 16:58:24,53,9392,20,33,6338.40,11026.00,0.00
2024-12-08 16:58:24,54,9392,21,33,6221.03,11026.02,0.00
2024-12-08 16:58:24,53,9392,21,32,6336.32,11026.02,0.00
2024-12-08 16:58:24,52,9392,21,31,6424.26,11026.06,0.00
2024-12-08 16:58:24,52,9393,21,31,6448.16,11027.00,0.00
2024-12-08 16:58:24,53,9393,22,31,6326.49,11027.02,0.00
2024-12-08 16:58:24,52,9393,22,30,6446.04,11027.02,0.00
2024-12-08 16:58:24,52,9394,22,30,6428.52,11028.00,0.00
2024-12-08 16:58:24,53,9394,22,31,6307.22,11028.02,0.00
2024-12-08 16:58:24,52,9394,22,30,6394.59,11028.04,0.00
2024-12-08 16:58:24,52,9395,22,30,6416.38,11029.00,0.00
2024-12-08 16:58:24,53,9395,22,31,6295.31,11029.02,0.00
2024-12-08 16:58:24,52,9395,21,31,6288.26,11029.69,0.00
2024-12-08 16:58:24,52,9396,21,31,6466.65,11030.00,0.00
2024-12-08 16:58:24,53,9396,22,31,6344.63,11030.02,0.00
2024-12-08 16:58:24,52,9396,22,30,6434.83,11030.04,0.00
2024-12-08 16:58:24,52,9397,22,30,6456.62,11031.00,0.00
2024-12-08 16:58:24,53,9397,22,31,6334.80,11031.02,0.00
2024-12-08 16:58:24,53,9398,22,31,6310.40,11032.00,0.00
2024-12-08 16:58:24,54,9398,22,32,6193.54,11032.02,0.00
2024-12-08 16:58:24,53,9398,22,31,6281.26,11032.04,0.00
2024-12-08 16:58:24,53,9399,22,31,6300.56,11033.00,0.00
2024-12-08 16:58:24,54,9399,22,32,6183.88,11033.02,0.00
2024-12-08 16:58:24,54,9400,22,32,6162.22,11034.00,0.00
2024-12-08 16:58:24,55,9400,23,32,6050.18,11034.02,0.00
2024-12-08 16:58:24,54,9400,23,31,6133.62,11034.04,0.00
2024-12-08 16:58:24,54,9400,23,31,6150.52,11035.00,0.00
2024-12-08 16:58:24,55,9400,23,32,6038.69,11035.02,0.00
2024-12-08 16:58:24,55,9401,23,32,6017.03,11036.00,0.00
2024-12-08 16:58:24,56,9401,24,32,5909.58,11036.02,0.00
2024-12-08 16:58:24,55,9401,24,31,5990.95,11036.04,0.00
2024-12-08 16:58:24,54,9401,23,31,6015.27,11036.72,0.00
2024-12-08 16:58:24,54,9402,23,31,6189.18,11037.00,0.00
2024-12-08 16:58:24,55,9402,23,32,6076.65,11037.02,0.00
2024-12-08 16:58:24,54,9402,22,32,6037.63,11037.80,0.00
2024-12-08 16:58:24,54,9403,22,32,6219.72,11038.00,0.00
2024-12-08 16:58:24,55,9403,22,33,6106.63,11038.02,0.00
2024-12-08 16:58:24,54,9403,22,32,6193.15,11038.04,0.00
2024-12-08 16:58:24,54,9404,22,32,6208.08,11039.00,0.00
2024-12-08 16:58:24,55,9404,22,33,6095.21,11039.02,0.00
2024-12-08 16:58:24,54,9404,21,33,6046.56,11039.48,0.00
2024-12-08 16:58:24,54,9405,21,33,6194.10,11040.00,0.00
2024-12-08 16:58:24,55,9405,22,33,6081.48,11040.02,0.00
2024-12-08 16:58:24,54,9405,22,32,6169.57,11040.04,0.00
2024-12-08 16:58:24,53,9405,21,32,6158.26,11040.55,0.00
2024-12-08 16:58:24,53,9406,21,32,6316.90,11041.00,0.00
2024-12-08 16:58:24,54,9406,21,33,6199.92,11041.02,0.00
2024-12-08 16:58:24,54,9407,21,33,6176.77,11042.00,0.00
2024-12-08 16:58:24,55,9407,22,33,6064.47,11042.02,0.00
2024-12-08 16:58:24,54,9407,22,32,6154.28,11042.04,0.00
2024-12-08 16:58:24,53,9407,21,32,6162.27,11042.49,0.00
2024-12-08 16:58:24,53,9408,21,32,6314.72,11043.00,0.00
2024-12-08 16:58:24,54,9408,22,32,6197.78,11043.02,0.00
2024-12-08 16:58:24,54,9409,22,32,6176.19,11044.00,0.00
2024-12-08 16:58:24,55,9409,22,33,6063.90,11044.02,0.00
2024-12-08 16:58:24,54,9409,22,32,6153.70,11044.04,0.00
2024-12-08 16:58:24,54,9410,22,32,6170.61,11045.00,0.00
2024-12-08 16:58:24,55,9410,22,33,6058.42,11045.02,0.00
2024-12-08 16:58:24,54,9410,21,33,6066.36,11045.59,0.00
2024-12-08 16:58:25,54,9410,21,33,6149.85,11046.00,0.00
2024-12-08 16:58:25,55,9410,21,34,6038.04,11046.02,0.00
2024-12-08 16:58:25,54,9410,21,33,6129.40,11046.04,0.00
2024-12-08 16:58:25,53,9410,20,33,6170.97,11046.64,0.00
2024-12-08 16:58:25,53,9411,20,33,6340.09,11047.00,0.00
2024-12-08 16:58:25,54,9411,21,33,6222.68,11047.02,0.00
2024-12-08 16:58:25,53,9411,20,33,6231.71,11047.62,0.00
2024-12-08 16:58:25,52,9411,19,33,6289.79,11047.88,0.00
2024-12-08 16:58:25,52,9412,19,33,6489.60,11048.00,0.00
2024-12-08 16:58:25,53,9412,19,34,6367.15,11048.02,0.00
2024-12-08 16:58:25,52,9412,19,33,6470.48,11048.04,0.00
2024-12-08 16:58:25,52,9413,19,33,6492.21,11049.00,0.00
2024-12-08 16:58:25,53,9413,19,34,6369.72,11049.02,0.00
2024-12-08 16:58:25,52,9413,18,34,6350.74,11049.44,0.00
2024-12-08 16:58:25,52,9414,18,34,6500.81,11050.00,0.00
2024-12-08 16:58:25,53,9414,18,35,6378.15,11050.02,0.00
2024-12-08 16:58:25,52,9414,18,34,6483.81,11050.04,0.00
2024-12-08 16:58:25,52,9415,18,34,6503.63,11051.00,0.00
2024-12-08 16:58:25,53,9415,19,34,6380.92,11051.02,0.00
2024-12-08 16:58:25,52,9415,18,34,6442.00,11051.04,0.00
2024-12-08 16:58:25,52,9416,18,34,6504.29,11052.00,0.00
2024-12-08 16:58:25,53,9416,18,35,6381.57,11052.02,0.00
2024-12-08 16:58:25,52,9416,18,34,6485.17,11052.04,0.00
2024-12-08 16:58:25,52,9417,18,34,6505.20,11053.00,0.00
2024-12-08 16:58:25,53,9417,19,34,6382.46,11053.02,0.00
2024-12-08 16:58:25,52,9417,18,34,6345.97,11053.50,0.00
2024-12-08 16:58:25,52,9418,18,34,6501.21,11054.00,0.00
2024-12-08 16:58:25,53,9418,18,35,6378.55,11054.02,0.00
2024-12-08 16:58:25,52,9418,18,34,6494.65,11054.06,0.00
2024-12-08 16:58:25,52,9419,18,34,6516.05,11055.00,0.00
2024-12-08 16:58:25,53,9419,18,35,6393.10,11055.02,0.00
2024-12-08 16:58:25,53,9420,18,35,6366.06,11056.00,0.00
2024-12-08 16:58:25,54,9420,19,35,6248.17,11056.02,0.00
2024-12-08 16:58:25,53,9420,18,35,6363.98,11056.02,0.00
2024-12-08 16:58:25,52,9420,18,34,6467.23,11056.04,0.00
2024-12-08 16:58:25,51,9420,17,34,6435.97,11056.65,0.00
2024-12-08 16:58:25,51,9421,17,34,6614.02,11057.00,0.00
2024-12-08 16:58:25,52,9421,17,35,6486.83,11057.02,0.00
2024-12-08 16:58:25,51,9421,16,35,6484.08,11057.39,0.00
2024-12-08 16:58:25,51,9422,16,35,6634.13,11058.00,0.00
2024-12-08 16:58:25,52,9422,16,36,6506.55,11058.02,0.00
2024-12-08 16:58:25,51,9422,16,35,6614.62,11058.04,0.00
2024-12-08 16:58:25,50,9422,15,35,6678.36,11058.06,0.00
2024-12-08 16:58:25,49,9422,14,35,6807.90,11058.12,0.00
2024-12-08 16:58:25,49,9423,14,35,6937.13,11059.00,0.00
2024-12-08 16:58:25,50,9423,14,36,6798.39,11059.02,0.00
2024-12-08 16:58:25,49,9423,13,36,6802.45,11059.35,0.00
2024-12-08 16:58:25,49,9424,13,36,6956.41,11060.00,0.00
2024-12-08 16:58:25,50,9424,13,37,6817.29,11060.02,0.00
2024-12-08 16:58:25,49,9424,13,36,6938.36,11060.04,0.00
2024-12-08 16:58:25,48,9424,12,36,6981.68,11060.38,0.00
2024-12-08 16:58:25,48,9425,12,36,7143.46,11061.00,0.00
2024-12-08 16:58:25,49,9425,13,36,6997.68,11061.02,0.00
2024-12-08 16:58:25,49,9426,13,36,6980.25,11062.00,0.00
2024-12-08 16:58:25,50,9426,13,37,6840.64,11062.02,0.00
2024-12-08 16:58:25,49,9426,13,36,6959.93,11062.04,0.00
2024-12-08 16:58:25,49,9427,13,36,6989.91,11063.00,0.00
2024-12-08 16:58:25,50,9427,14,36,6850.11,11063.02,0.00
2024-12-08 16:58:25,49,9427,13,36,6856.72,11063.08,0.00
2024-12-08 16:58:25,49,9428,13,36,6981.51,11064.00,0.00
2024-12-08 16:58:25,50,9428,13,37,6841.88,11064.02,0.00
2024-12-08 16:58:25,49,9428,13,36,6952.16,11064.04,0.00
2024-12-08 16:58:25,49,9429,13,36,6982.14,11065.00,0.00
2024-12-08 16:58:25,50,9429,14,36,6842.50,11065.02,0.00
2024-12-08 16:58:25,50,9430,14,36,6823.20,11066.00,0.00
2024-12-08 16:58:25,51,9430,15,36,6689.41,11066.02,0.00
2024-12-08 16:58:25,50,9430,15,35,6796.64,11066.04,0.00
2024-12-08 16:58:25,49,9430,14,35,6793.66,11066.96,0.00
2024-12-08 16:58:25,49,9431,14,35,7015.02,11067.00,0.00
2024-12-08 16:58:25,50,9431,14,36,6874.72,11067.02,0.00
2024-12-08 16:58:25,49,9431,13,36,6888.55,11067.06,0.00
2024-12-08 16:58:25,48,9431,12,36,6967.83,11067.63,0.00
2024-12-08 16:58:25,48,9432,12,36,7157.21,11068.00,0.00
2024-12-08 16:58:25,49,9432,12,37,7011.14,11068.02,0.00
2024-12-08 16:58:25,48,9432,12,36,7127.23,11068.04,0.00
2024-12-08 16:58:25,47,9432,11,36,7144.91,11068.51,0.00
2024-12-08 16:58:25,47,9433,11,36,7326.63,11069.00,0.00
2024-12-08 16:58:25,48,9433,11,37,7173.99,11069.02,0.00
2024-12-08 16:58:25,47,9433,10,37,7241.85,11069.04,0.00
2024-12-08 16:58:25,47,9434,10,37,7324.94,11070.00,0.00
2024-12-08 16:58:25,48,9434,10,38,7172.33,11070.02,0.00
2024-12-08 16:58:25,47,9434,10,37,7287.26,11070.04,0.00
2024-12-08 16:58:25,47,9435,10,37,7323.25,11071.00,0.00
2024-12-08 16:58:25,48,9435,11,37,7170.68,11071.02,0.00
2024-12-08 16:58:25,48,9436,11,37,7155.18,11072.00,0.00
2024-12-08 16:58:25,49,9436,11,38,7009.15,11072.02,0.00
2024-12-08 16:58:25,48,9436,11,37,7113.67,11072.06,0.00
2024-12-08 16:58:25,48,9437,11,37,7148.34,11073.00,0.00
2024-12-08 16:58:25,49,9437,11,38,7002.45,11073.02,0.00
2024-12-08 16:58:25,49,9438,11,38,6983.53,11074.00,0.00
2024-12-08 16:58:26,50,9438,12,38,6843.86,11074.02,0.00
2024-12-08 16:58:26,49,9438,12,37,6945.12,11074.06,0.00
2024-12-08 16:58:26,48,9438,11,37,6947.21,11074.96,0.00
2024-12-08 16:58:26,48,9439,11,37,7173.35,11075.00,0.00
2024-12-08 16:58:26,49,9439,11,38,7026.95,11075.02,0.00
2024-12-08 16:58:26,49,9440,11,38,7006.70,11076.00,0.00
2024-12-08 16:58:26,50,9440,12,38,6866.56,11076.02,0.00
2024-12-08 16:58:26,49,9440,12,37,6981.83,11076.04,0.00
2024-12-08 16:58:26,49,9441,12,37,7009.04,11077.00,0.00
2024-12-08 16:58:26,50,9441,13,37,6868.86,11077.02,0.00
2024-12-08 16:58:26,49,9441,12,37,6871.08,11077.73,0.00
2024-12-08 16:58:26,49,9442,12,37,7067.97,11078.00,0.00
2024-12-08 16:58:26,50,9442,12,38,6926.61,11078.02,0.00
2024-12-08 16:58:26,49,9442,12,37,7027.28,11078.04,0.00
2024-12-08 16:58:26,49,9443,12,37,7054.90,11079.00,0.00
2024-12-08 16:58:26,50,9443,12,38,6913.80,11079.02,0.00
2024-12-08 16:58:26,50,9444,12,38,6893.06,11080.00,0.00
2024-12-08 16:58:26,51,9444,13,38,6757.91,11080.02,0.00
2024-12-08 16:58:26,50,9444,13,37,6855.39,11080.04,0.00
2024-12-08 16:58:26,50,9445,13,37,6881.99,11081.00,0.00
2024-12-08 16:58:26,51,9445,13,38,6747.05,11081.02,0.00
2024-12-08 16:58:26,50,9445,12,38,6879.78,11081.02,0.00
2024-12-08 16:58:26,49,9445,11,38,6848.85,11081.88,0.00
2024-12-08 16:58:26,49,9446,11,38,7061.52,11082.00,0.00
2024-12-08 16:58:26,50,9446,11,39,6920.29,11082.02,0.00
2024-12-08 16:58:26,49,9446,11,38,7027.60,11082.02,0.00
2024-12-08 16:58:26,49,9447,11,38,7055.38,11083.00,0.00
2024-12-08 16:58:26,50,9447,11,39,6914.27,11083.02,0.00
2024-12-08 16:58:26,49,9447,10,39,6884.01,11083.88,0.00
2024-12-08 16:58:26,49,9448,10,39,7096.73,11084.00,0.00
2024-12-08 16:58:26,50,9448,11,39,6954.80,11084.02,0.00
2024-12-08 16:58:26,49,9448,11,38,7060.54,11084.02,0.00
2024-12-08 16:58:26,49,9449,11,38,7088.32,11085.00,0.00
2024-12-08 16:58:26,50,9449,11,39,6946.56,11085.02,0.00
2024-12-08 16:58:26,50,9450,11,39,6926.45,11086.00,0.00
2024-12-08 16:58:26,51,9450,12,39,6790.64,11086.02,0.00
2024-12-08 16:58:26,50,9450,12,38,6886.54,11086.02,0.00
2024-12-08 16:58:26,49,9450,11,38,6957.33,11086.27,0.00
2024-12-08 16:58:26,49,9451,11,38,7102.65,11087.00,0.00
2024-12-08 16:58:26,50,9451,11,39,6960.60,11087.02,0.00
2024-12-08 16:58:26,50,9452,11,39,6945.18,11088.00,0.00
2024-12-08 16:58:26,51,9452,12,39,6809.00,11088.02,0.00
2024-12-08 16:58:26,50,9452,12,38,6898.61,11088.02,0.00
2024-12-08 16:58:26,50,9453,12,38,6921.37,11089.00,0.00
2024-12-08 16:58:26,51,9453,13,38,6785.66,11089.02,0.00
2024-12-08 16:58:26,50,9453,12,38,6849.99,11089.12,0.00
2024-12-08 16:58:26,50,9454,12,38,6974.78,11090.00,0.00
2024-12-08 16:58:26,51,9454,12,39,6838.02,11090.02,0.00
2024-12-08 16:58:26,50,9454,12,38,6930.42,11090.02,0.00
2024-12-08 16:58:26,50,9455,12,38,6952.30,11091.00,0.00
2024-12-08 16:58:26,51,9455,12,39,6815.98,11091.02,0.00
2024-12-08 16:58:26,50,9455,11,39,6772.34,11091.88,0.00
2024-12-08 16:58:26,50,9456,11,39,6980.96,11092.00,0.00
2024-12-08 16:58:26,51,9456,11,40,6844.08,11092.02,0.00
2024-12-08 16:58:26,50,9456,11,39,6931.02,11092.04,0.00
2024-12-08 16:58:26,50,9457,11,39,6958.26,11093.00,0.00
2024-12-08 16:58:26,51,9457,12,39,6821.83,11093.02,0.00
2024-12-08 16:58:26,51,9458,12,39,6802.32,11094.00,0.00
2024-12-08 16:58:26,52,9458,12,40,6671.51,11094.02,0.00
2024-12-08 16:58:26,51,9458,12,39,6758.82,11094.04,0.00
2024-12-08 16:58:26,51,9459,12,39,6783.36,11095.00,0.00
2024-12-08 16:58:26,52,9459,12,40,6652.91,11095.02,0.00
2024-12-08 16:58:26,52,9460,12,40,6636.02,11096.00,0.00
2024-12-08 16:58:26,53,9460,13,40,6510.81,11096.02,0.00
2024-12-08 16:58:26,52,9460,13,39,6595.48,11096.04,0.00
2024-12-08 16:58:26,51,9460,12,39,6632.06,11096.73,0.00
2024-12-08 16:58:26,51,9461,12,39,6819.39,11097.00,0.00
2024-12-08 16:58:26,52,9461,12,40,6688.25,11097.02,0.00
2024-12-08 16:58:26,52,9462,12,40,6671.92,11098.00,0.00
2024-12-08 16:58:26,53,9462,12,41,6546.04,11098.02,0.00
2024-12-08 16:58:26,52,9462,12,40,6631.38,11098.04,0.00
2024-12-08 16:58:26,51,9462,11,40,6622.52,11098.92,0.00
2024-12-08 16:58:26,51,9462,11,40,6831.50,11099.00,0.00
2024-12-08 16:58:26,52,9462,12,40,6700.13,11099.02,0.00
2024-12-08 16:58:26,52,9463,12,40,6684.73,11100.00,0.00
2024-12-08 16:58:26,53,9463,13,40,6558.61,11100.02,0.00
2024-12-08 16:58:26,52,9463,13,39,6644.18,11100.04,0.00
2024-12-08 16:58:26,52,9464,13,39,6666.12,11101.00,0.00
2024-12-08 16:58:26,53,9464,14,39,6540.34,11101.02,0.00
2024-12-08 16:58:26,53,9465,14,39,6523.51,11102.00,0.00
2024-12-08 16:58:27,54,9465,15,39,6402.70,11102.02,0.00
2024-12-08 16:58:27,53,9465,15,38,6485.81,11102.04,0.00
2024-12-08 16:58:27,53,9466,15,38,6505.24,11103.00,0.00
2024-12-08 16:58:27,54,9466,16,38,6384.77,11103.02,0.00
2024-12-08 16:58:27,54,9467,16,38,6367.81,11104.00,0.00
2024-12-08 16:58:27,55,9467,16,39,6252.03,11104.02,0.00
2024-12-08 16:58:27,54,9467,16,38,6332.85,11104.04,0.00
2024-12-08 16:58:27,54,9468,16,38,6349.87,11105.00,0.00
2024-12-08 16:58:27,55,9468,16,39,6234.42,11105.02,0.00
2024-12-08 16:58:27,55,9469,16,39,6217.27,11106.00,0.00
2024-12-08 16:58:27,56,9469,16,40,6106.25,11106.02,0.00
2024-12-08 16:58:27,55,9469,16,39,6182.95,11106.04,0.00
2024-12-08 16:58:27,55,9470,16,39,6197.64,11107.00,0.00
2024-12-08 16:58:27,56,9470,16,40,6086.97,11107.02,0.00
2024-12-08 16:58:27,55,9470,15,40,6067.35,11107.71,0.00
2024-12-08 16:58:27,55,9471,15,40,6237.21,11108.00,0.00
2024-12-08 16:58:27,56,9471,16,40,6125.83,11108.02,0.00
2024-12-08 16:58:27,55,9471,16,39,6200.86,11108.04,0.00
2024-12-08 16:58:27,54,9471,15,39,6238.21,11108.69,0.00
2024-12-08 16:58:27,54,9472,15,39,6409.19,11109.00,0.00
2024-12-08 16:58:27,55,9472,16,39,6292.66,11109.02,0.00
2024-12-08 16:58:27,55,9473,16,39,6274.14,11110.00,0.00
2024-12-08 16:58:27,56,9473,16,40,6162.10,11110.02,0.00
2024-12-08 16:58:27,55,9473,16,39,6239.80,11110.04,0.00
2024-12-08 16:58:27,55,9474,16,39,6252.61,11111.00,0.00
2024-12-08 16:58:27,56,9474,17,39,6140.95,11111.02,0.00
2024-12-08 16:58:27,56,9475,17,39,6119.56,11112.00,0.00
2024-12-08 16:58:27,57,9475,17,40,6012.20,11112.02,0.00
2024-12-08 16:58:27,56,9475,16,40,6117.70,11112.02,0.00
2024-12-08 16:58:27,55,9475,16,39,6198.62,11112.02,0.00
2024-12-08 16:58:27,54,9475,15,39,6307.26,11112.07,0.00
2024-12-08 16:58:27,54,9476,15,39,6325.66,11113.00,0.00
2024-12-08 16:58:27,55,9476,16,39,6210.65,11113.02,0.00
2024-12-08 16:58:27,54,9476,15,39,6183.36,11113.44,0.00
2024-12-08 16:58:27,54,9477,15,39,6327.80,11114.00,0.00
2024-12-08 16:58:27,55,9477,15,40,6212.75,11114.02,0.00
2024-12-08 16:58:27,54,9477,15,39,6296.93,11114.02,0.00
2024-12-08 16:58:27,53,9477,14,39,6409.47,11114.08,0.00
2024-12-08 16:58:27,53,9478,14,39,6430.57,11115.00,0.00
2024-12-08 16:58:27,54,9478,15,39,6311.48,11115.02,0.00
2024-12-08 16:58:27,53,9478,14,39,6255.72,11115.53,0.00
2024-12-08 16:58:27,53,9479,14,39,6413.34,11116.00,0.00
2024-12-08 16:58:27,54,9479,15,39,6294.58,11116.02,0.00
2024-12-08 16:58:27,53,9479,15,38,6383.98,11116.02,0.00
2024-12-08 16:58:27,53,9480,15,38,6400.28,11117.00,0.00
2024-12-08 16:58:28,54,9480,15,39,6281.75,11117.02,0.00
2024-12-08 16:58:28,54,9481,15,39,6257.74,11118.00,0.00
2024-12-08 16:58:28,55,9481,15,40,6143.97,11118.02,0.00
2024-12-08 16:58:28,54,9481,15,39,6230.98,11118.02,0.00
2024-12-08 16:58:28,54,9482,15,39,6245.95,11119.00,0.00
2024-12-08 16:58:28,55,9482,15,40,6132.39,11119.02,0.00
2024-12-08 16:58:28,55,9483,15,40,6110.67,11120.00,0.00
2024-12-08 16:58:28,56,9483,15,41,6001.55,11120.02,0.00
2024-12-08 16:58:28,55,9483,15,40,6084.39,11120.02,0.00
2024-12-08 16:58:28,54,9483,14,40,6047.05,11120.63,0.00
2024-12-08 16:58:28,54,9484,14,40,6212.03,11121.00,0.00
2024-12-08 16:58:28,55,9484,14,41,6099.09,11121.02,0.00
2024-12-08 16:58:28,54,9484,13,41,6106.33,11121.06,0.00
2024-12-08 16:58:28,54,9485,13,41,6207.79,11122.00,0.00
2024-12-08 16:58:28,55,9485,14,41,6094.92,11122.02,0.00
2024-12-08 16:58:28,54,9485,14,40,6199.73,11122.02,0.00
2024-12-08 16:58:28,53,9485,13,40,6257.73,11122.55,0.00
2024-12-08 16:58:28,53,9486,13,40,6333.58,11123.00,0.00
2024-12-08 16:58:28,54,9486,14,40,6216.29,11123.02,0.00
2024-12-08 16:58:28,54,9487,14,40,6194.76,11124.00,0.00
2024-12-08 16:58:28,55,9487,14,41,6082.13,11124.02,0.00
2024-12-08 16:58:28,54,9487,14,40,6170.04,11124.02,0.00
2024-12-08 16:58:28,54,9488,14,40,6185.02,11125.00,0.00
2024-12-08 16:58:28,55,9488,14,41,6072.56,11125.02,0.00
2024-12-08 16:58:28,55,9489,14,41,6050.68,11126.00,0.00
2024-12-08 16:58:28,56,9489,15,41,5942.63,11126.02,0.00
2024-12-08 16:58:28,55,9489,15,40,6026.40,11126.02,0.00
2024-12-08 16:58:28,54,9489,14,40,6019.10,11126.83,0.00
2024-12-08 16:58:28,54,9490,14,40,6205.24,11127.00,0.00
2024-12-08 16:58:28,55,9490,15,40,6092.42,11127.02,0.00
2024-12-08 16:58:28,54,9490,14,40,6151.70,11127.13,0.00
2024-12-08 16:58:28,54,9491,14,40,6180.68,11128.00,0.00
2024-12-08 16:58:28,55,9491,14,41,6068.30,11128.02,0.00
2024-12-08 16:58:28,54,9491,14,40,6158.01,11128.02,0.00
2024-12-08 16:58:28,54,9492,14,40,6165.13,11129.00,0.00
2024-12-08 16:58:28,55,9492,14,41,6053.03,11129.02,0.00
2024-12-08 16:58:28,54,9492,13,41,6065.86,11129.54,0.00
2024-12-08 16:58:28,54,9493,13,41,6126.42,11130.00,0.00
2024-12-08 16:58:28,55,9493,13,42,6015.03,11130.02,0.00
2024-12-08 16:58:28,54,9493,13,41,6105.81,11130.02,0.00
2024-12-08 16:58:28,53,9493,12,41,6051.55,11130.94,0.00
2024-12-08 16:58:28,53,9494,12,41,6255.30,11131.00,0.00
2024-12-08 16:58:28,54,9494,13,41,6139.46,11131.02,0.00
2024-12-08 16:58:28,53,9494,12,41,6093.81,11131.51,0.00
2024-12-08 16:58:28,53,9495,12,41,6222.90,11132.00,0.00
2024-12-08 16:58:28,54,9495,12,42,6107.67,11132.02,0.00
2024-12-08 16:58:28,53,9495,12,41,6204.00,11132.02,0.00
2024-12-08 16:58:28,53,9496,12,41,6195.84,11133.00,0.00
2024-12-08 16:58:28,54,9496,13,41,6081.10,11133.02,0.00
2024-12-08 16:58:28,54,9497,13,41,6038.98,11134.00,0.00
2024-12-08 16:58:28,55,9497,14,41,5929.18,11134.02,0.00
2024-12-08 16:58:28,54,9497,14,40,6020.42,11134.02,0.00
2024-12-08 16:58:28,54,9498,14,40,6029.82,11135.00,0.00
2024-12-08 16:58:28,55,9498,14,41,5920.19,11135.02,0.00
2024-12-08 16:58:28,54,9498,13,41,5922.60,11135.04,0.00
2024-12-08 16:58:28,53,9498,12,41,5975.46,11135.57,0.00
2024-12-08 16:58:28,53,9499,12,41,6137.43,11136.00,0.00
2024-12-08 16:58:28,54,9499,13,41,6023.77,11136.02,0.00
2024-12-08 16:58:28,53,9499,13,40,6118.52,11136.02,0.00
2024-12-08 16:58:28,52,9499,12,40,6167.97,11136.62,0.00
2024-12-08 16:58:28,51,9499,11,40,6286.75,11136.65,0.00
2024-12-08 16:58:28,51,9500,11,40,6378.72,11137.00,0.00
2024-12-08 16:58:28,52,9500,11,41,6256.05,11137.02,0.00
2024-12-08 16:58:28,52,9501,11,41,6233.05,11138.00,0.00
2024-12-08 16:58:28,53,9501,12,41,6115.44,11138.02,0.00
2024-12-08 16:58:28,52,9501,12,40,6211.63,11138.02,0.00
2024-12-08 16:58:28,51,9501,11,40,6198.52,11138.92,0.00
2024-12-08 16:58:28,51,9502,11,40,6408.25,11139.00,0.00
2024-12-08 16:58:28,52,9502,12,40,6285.02,11139.02,0.00
2024-12-08 16:58:28,52,9503,12,40,6261.81,11140.00,0.00
2024-12-08 16:58:28,53,9503,12,41,6143.66,11140.02,0.00
2024-12-08 16:58:29,52,9503,12,40,6242.53,11140.02,0.00
2024-12-08 16:58:29,52,9504,12,40,6262.33,11141.00,0.00
2024-12-08 16:58:29,53,9504,13,40,6144.17,11141.02,0.00
2024-12-08 16:58:29,52,9504,12,40,6126.50,11141.38,0.00
2024-12-08 16:58:29,52,9505,12,40,6272.60,11142.00,0.00
2024-12-08 16:58:29,53,9505,12,41,6154.25,11142.02,0.00
2024-12-08 16:58:29,52,9505,12,40,6255.46,11142.02,0.00
2024-12-08 16:58:29,52,9506,12,40,6275.31,11143.00,0.00
2024-12-08 16:58:29,53,9506,12,41,6156.91,11143.02,0.00
2024-12-08 16:58:29,53,9507,12,41,6132.23,11144.00,0.00
2024-12-08 16:58:29,54,9507,12,42,6018.67,11144.02,0.00
2024-12-08 16:58:29,53,9507,12,41,6117.51,11144.02,0.00
2024-12-08 16:58:29,52,9507,11,41,6092.09,11144.96,0.00
2024-12-08 16:58:29,52,9508,11,41,6302.15,11145.00,0.00
2024-12-08 16:58:29,53,9508,12,41,6183.24,11145.02,0.00
2024-12-08 16:58:29,52,9508,11,41,6131.17,11145.90,0.00
2024-12-08 16:58:29,52,9509,11,41,6334.87,11146.00,0.00
2024-12-08 16:58:29,53,9509,12,41,6215.34,11146.02,0.00
2024-12-08 16:58:29,52,9509,12,40,6319.87,11146.02,0.00
2024-12-08 16:58:29,52,9510,12,40,6339.73,11147.00,0.00
2024-12-08 16:58:29,53,9510,13,40,6220.11,11147.02,0.00
2024-12-08 16:58:29,53,9511,13,40,6195.43,11148.00,0.00
2024-12-08 16:58:29,54,9511,13,41,6080.70,11148.02,0.00
2024-12-08 16:58:29,53,9511,13,40,6182.81,11148.02,0.00
2024-12-08 16:58:29,52,9511,12,40,6229.12,11148.67,0.00
2024-12-08 16:58:29,51,9511,11,40,6281.54,11148.96,0.00
2024-12-08 16:58:29,51,9512,11,40,6495.80,11149.00,0.00
2024-12-08 16:58:29,52,9512,12,40,6370.88,11149.02,0.00
2024-12-08 16:58:29,51,9512,11,40,6386.60,11149.31,0.00
2024-12-08 16:58:29,51,9513,11,40,6529.18,11150.00,0.00
2024-12-08 16:58:29,52,9513,12,40,6403.62,11150.02,0.00
2024-12-08 16:58:29,51,9513,12,39,6516.06,11150.02,0.00
2024-12-08 16:58:29,51,9514,12,39,6538.51,11151.00,0.00
2024-12-08 16:58:29,52,9514,12,40,6412.77,11151.02,0.00
2024-12-08 16:58:29,52,9515,12,40,6389.75,11152.00,0.00
2024-12-08 16:58:29,53,9515,12,41,6269.19,11152.02,0.00
2024-12-08 16:58:29,52,9515,12,40,6374.74,11152.02,0.00
2024-12-08 16:58:29,52,9516,12,40,6394.61,11153.00,0.00
2024-12-08 16:58:29,53,9516,13,40,6273.96,11153.02,0.00
2024-12-08 16:58:29,52,9516,12,40,6281.06,11153.35,0.00
2024-12-08 16:58:29,52,9517,12,40,6423.07,11154.00,0.00
2024-12-08 16:58:29,53,9517,12,41,6301.88,11154.02,0.00
2024-12-08 16:58:29,52,9517,12,40,6410.20,11154.02,0.00
2024-12-08 16:58:29,52,9518,12,40,6430.08,11155.00,0.00
2024-12-08 16:58:29,53,9518,12,41,6308.76,11155.02,0.00
2024-12-08 16:58:29,52,9518,11,41,6239.44,11155.63,0.00
2024-12-08 16:58:29,52,9519,11,41,6413.50,11156.00,0.00
2024-12-08 16:58:29,53,9519,11,42,6292.49,11156.02,0.00
2024-12-08 16:58:29,52,9519,11,41,6400.62,11156.02,0.00
2024-12-08 16:58:29,52,9520,11,41,6420.51,11157.00,0.00
2024-12-08 16:58:29,53,9520,12,41,6299.37,11157.02,0.00
2024-12-08 16:58:29,53,9521,12,41,6274.67,11158.00,0.00
2024-12-08 16:58:29,54,9521,13,41,6158.47,11158.02,0.00
2024-12-08 16:58:29,53,9521,13,40,6264.14,11158.02,0.00
2024-12-08 16:58:29,52,9521,12,40,6279.87,11158.79,0.00
2024-12-08 16:58:29,52,9522,12,40,6471.02,11159.00,0.00
2024-12-08 16:58:29,53,9522,13,40,6348.92,11159.02,0.00
2024-12-08 16:58:29,53,9523,13,40,6324.22,11160.00,0.00
2024-12-08 16:58:29,54,9523,14,40,6207.11,11160.02,0.00
2024-12-08 16:58:29,53,9523,14,39,6315.80,11160.02,0.00
2024-12-08 16:58:29,53,9524,14,39,6333.21,11161.00,0.00
2024-12-08 16:58:29,54,9524,15,39,6215.93,11161.02,0.00
2024-12-08 16:58:29,54,9525,15,39,6189.62,11162.00,0.00
2024-12-08 16:58:29,55,9525,15,40,6077.08,11162.02,0.00
2024-12-08 16:58:29,54,9525,15,39,6181.35,11162.02,0.00
2024-12-08 16:58:29,54,9526,15,39,6196.37,11163.00,0.00
2024-12-08 16:58:29,55,9526,15,40,6083.71,11163.02,0.00
2024-12-08 16:58:29,54,9526,14,40,6064.92,11163.41,0.00
2024-12-08 16:58:29,54,9527,14,40,6205.90,11164.00,0.00
2024-12-08 16:58:29,55,9527,14,41,6093.07,11164.02,0.00
2024-12-08 16:58:29,54,9527,14,40,6197.63,11164.02,0.00
2024-12-08 16:58:29,54,9528,14,40,6210.08,11165.00,0.00
2024-12-08 16:58:29,55,9528,15,40,6097.17,11165.02,0.00
2024-12-08 16:58:29,55,9529,15,40,6063.02,11166.00,0.00
2024-12-08 16:58:29,56,9529,15,41,5954.75,11166.02,0.00
2024-12-08 16:58:29,55,9529,15,40,6052.86,11166.02,0.00
2024-12-08 16:58:29,55,9530,15,40,6050.73,11167.00,0.00
2024-12-08 16:58:29,56,9530,15,41,5942.68,11167.02,0.00
2024-12-08 16:58:29,55,9530,14,41,5970.86,11167.22,0.00
2024-12-08 16:58:29,54,9530,13,41,6016.95,11167.65,0.00
2024-12-08 16:58:29,54,9531,13,41,6184.73,11168.00,0.00
2024-12-08 16:58:29,55,9531,14,41,6072.28,11168.02,0.00
2024-12-08 16:58:29,54,9531,14,40,6176.45,11168.02,0.00
2024-12-08 16:58:30,53,9531,13,40,6142.59,11168.55,0.00
2024-12-08 16:58:30,53,9532,13,40,6303.08,11169.00,0.00
2024-12-08 16:58:30,54,9532,14,40,6186.36,11169.02,0.00
2024-12-08 16:58:30,54,9533,14,40,6140.71,11170.00,0.00
2024-12-08 16:58:30,55,9533,14,41,6029.07,11170.02,0.00
2024-12-08 16:58:30,54,9533,14,40,6134.51,11170.02,0.00
2024-12-08 16:58:30,54,9534,14,40,6137.65,11171.00,0.00
2024-12-08 16:58:30,55,9534,15,40,6026.05,11171.02,0.00
2024-12-08 16:58:30,55,9535,15,40,5994.79,11172.00,0.00
2024-12-08 16:58:30,56,9535,16,40,5887.74,11172.02,0.00
2024-12-08 16:58:30,55,9535,16,39,5988.70,11172.02,0.00
2024-12-08 16:58:30,55,9536,16,39,6001.22,11173.00,0.00
2024-12-08 16:58:30,56,9536,16,40,5894.06,11173.02,0.00
2024-12-08 16:58:30,56,9537,16,40,5864.66,11174.00,0.00
2024-12-08 16:58:30,57,9537,17,40,5761.77,11174.02,0.00
2024-12-08 16:58:30,56,9537,17,39,5860.66,11174.02,0.00
2024-12-08 16:58:30,55,9537,17,38,5940.53,11174.25,0.00
2024-12-08 16:58:30,54,9537,16,38,5992.66,11174.39,0.00
2024-12-08 16:58:30,53,9537,15,38,6080.57,11174.62,0.00
2024-12-08 16:58:30,53,9538,15,38,6249.51,11175.00,0.00
2024-12-08 16:58:30,54,9538,16,38,6133.78,11175.02,0.00
2024-12-08 16:58:30,54,9539,16,38,6107.42,11176.00,0.00
2024-12-08 16:58:30,55,9539,17,38,5996.38,11176.02,0.00
2024-12-08 16:58:30,54,9539,17,37,6103.28,11176.02,0.00
2024-12-08 16:58:30,54,9540,17,37,6118.32,11177.00,0.00
2024-12-08 16:58:30,55,9540,17,38,6007.08,11177.02,0.00
2024-12-08 16:58:30,55,9541,17,38,5979.16,11178.00,0.00
2024-12-08 16:58:30,56,9541,18,38,5872.39,11178.02,0.00
2024-12-08 16:58:30,55,9541,18,37,5977.13,11178.02,0.00
2024-12-08 16:58:30,55,9542,18,37,5989.86,11179.00,0.00
2024-12-08 16:58:30,56,9542,18,38,5882.90,11179.02,0.00
2024-12-08 16:58:30,55,9542,17,38,5833.54,11179.49,0.00
2024-12-08 16:58:30,56,9541,18,38,5723.42,11179.57,0.00
2024-12-08 16:58:30,56,9542,18,38,5923.35,11180.00,0.00
2024-12-08 16:58:30,57,9542,19,38,5819.43,11180.02,0.00
2024-12-08 16:58:30,56,9542,19,37,5913.37,11180.02,0.00
2024-12-08 16:58:30,55,9542,18,37,5872.78,11180.62,0.00
2024-12-08 16:58:30,54,9542,17,37,5979.47,11180.63,0.00
2024-12-08 16:58:30,54,9543,17,37,6352.41,11181.00,0.00
2024-12-08 16:58:30,55,9543,17,38,6236.91,11181.02,0.00
2024-12-08 16:58:30,54,9543,17,37,6343.43,11181.02,0.00
2024-12-08 16:58:30,53,9543,16,37,6437.85,11181.19,0.00
2024-12-08 16:58:30,53,9544,16,37,6558.63,11182.00,0.00
2024-12-08 16:58:30,54,9544,16,38,6437.18,11182.02,0.00
2024-12-08 16:58:30,53,9544,16,37,6496.15,11182.19,0.00
2024-12-08 16:58:30,53,9545,16,37,6532.56,11183.00,0.00
2024-12-08 16:58:30,54,9545,16,38,6411.58,11183.02,0.00
2024-12-08 16:58:30,53,9545,16,37,6524.12,11183.02,0.00
2024-12-08 16:58:30,53,9546,16,37,6541.58,11184.00,0.00
2024-12-08 16:58:30,54,9546,16,38,6420.44,11184.02,0.00
2024-12-08 16:58:30,54,9547,16,38,6394.09,11185.00,0.00
2024-12-08 16:58:30,55,9547,17,38,6277.83,11185.02,0.00
2024-12-08 16:58:30,54,9547,17,37,6387.88,11185.02,0.00
2024-12-08 16:58:30,54,9548,17,37,6402.95,11186.00,0.00
2024-12-08 16:58:30,55,9548,18,37,6286.53,11186.02,0.00
2024-12-08 16:58:30,55,9549,18,37,6258.62,11187.00,0.00
2024-12-08 16:58:30,56,9549,19,37,6146.85,11187.02,0.00
2024-12-08 16:58:30,55,9549,19,36,6250.48,11187.02,0.00
2024-12-08 16:58:30,54,9549,18,36,6246.30,11187.50,0.00
2024-12-08 16:58:30,54,9550,18,36,6397.87,11188.00,0.00
2024-12-08 16:58:30,55,9550,18,37,6281.55,11188.02,0.00
2024-12-08 16:58:30,54,9550,17,37,6232.34,11188.50,0.00
2024-12-08 16:58:30,54,9551,17,37,6383.94,11189.00,0.00
2024-12-08 16:58:30,55,9551,18,37,6267.87,11189.02,0.00
2024-12-08 16:58:30,54,9551,18,36,6375.65,11189.02,0.00
2024-12-08 16:58:30,54,9552,18,36,6390.73,11190.00,0.00
2024-12-08 16:58:30,55,9552,19,36,6274.54,11190.02,0.00
2024-12-08 16:58:30,54,9552,18,36,6268.59,11190.35,0.00
2024-12-08 16:58:30,53,9552,17,36,6359.58,11190.60,0.00
2024-12-08 16:58:30,53,9553,17,36,6526.67,11191.00,0.00
2024-12-08 16:58:30,54,9553,17,37,6405.81,11191.02,0.00
2024-12-08 16:58:30,53,9553,17,36,6518.23,11191.02,0.00
2024-12-08 16:58:30,52,9553,16,36,6575.01,11191.62,0.00
2024-12-08 16:58:30,52,9554,16,36,6661.39,11192.00,0.00
2024-12-08 16:58:30,53,9554,16,37,6535.70,11192.02,0.00
2024-12-08 16:58:30,52,9554,15,37,6541.18,11192.65,0.00
2024-12-08 16:58:30,52,9555,15,37,6717.95,11193.00,0.00
2024-12-08 16:58:30,53,9555,16,37,6591.20,11193.02,0.00
2024-12-08 16:58:30,52,9555,16,36,6707.19,11193.02,0.00
2024-12-08 16:58:30,52,9556,16,36,6727.16,11194.00,0.00
2024-12-08 16:58:30,53,9556,16,37,6600.23,11194.02,0.00
2024-12-08 16:58:31,53,9557,16,37,6575.47,11195.00,0.00
2024-12-08 16:58:31,54,9557,16,38,6453.71,11195.02,0.00
2024-12-08 16:58:31,53,9557,16,37,6567.03,11195.02,0.00
2024-12-08 16:58:31,53,9558,16,37,6584.51,11196.00,0.00
2024-12-08 16:58:31,54,9558,17,37,6462.58,11196.02,0.00
2024-12-08 16:58:31,53,9558,16,37,6523.30,11196.17,0.00
2024-12-08 16:58:31,53,9559,16,37,6557.64,11197.00,0.00
2024-12-08 16:58:31,54,9559,17,37,6436.20,11197.02,0.00
2024-12-08 16:58:31,53,9559,17,36,6551.30,11197.02,0.00
2024-12-08 16:58:31,53,9560,17,36,6568.79,11198.00,0.00
2024-12-08 16:58:31,54,9560,17,37,6447.14,11198.02,0.00
2024-12-08 16:58:31,54,9561,17,37,6420.76,11199.00,0.00
2024-12-08 16:58:31,55,9561,17,38,6304.02,11199.02,0.00
2024-12-08 16:58:31,54,9561,17,37,6416.61,11199.02,0.00
2024-12-08 16:58:31,53,9561,16,37,6394.55,11199.96,0.00
2024-12-08 16:58:31,53,9562,16,37,6601.66,11200.00,0.00
2024-12-08 16:58:31,54,9562,17,37,6479.41,11200.02,0.00
2024-12-08 16:58:31,54,9563,17,37,6453.02,11201.00,0.00
2024-12-08 16:58:31,55,9563,18,37,6335.69,11201.02,0.00
2024-12-08 16:58:31,54,9563,18,36,6442.65,11201.02,0.00
2024-12-08 16:58:31,53,9563,17,36,6494.78,11201.64,0.00
2024-12-08 16:58:31,52,9563,16,36,6566.00,11201.88,0.00
2024-12-08 16:58:31,52,9564,16,36,6768.59,11202.00,0.00
2024-12-08 16:58:31,53,9564,17,36,6640.88,11202.02,0.00
2024-12-08 16:58:31,53,9565,17,36,6616.11,11203.00,0.00
2024-12-08 16:58:31,54,9565,18,36,6493.59,11203.02,0.00
2024-12-08 16:58:31,53,9565,18,35,6603.42,11203.02,0.00
2024-12-08 16:58:31,53,9566,18,35,6620.93,11204.00,0.00
2024-12-08 16:58:31,54,9566,19,35,6498.32,11204.02,0.00
2024-12-08 16:58:31,54,9567,19,35,6471.92,11205.00,0.00
2024-12-08 16:58:31,55,9567,20,35,6354.25,11205.02,0.00
2024-12-08 16:58:31,54,9567,20,34,6461.55,11205.02,0.00
2024-12-08 16:58:31,54,9568,20,34,6476.65,11206.00,0.00
2024-12-08 16:58:31,55,9568,21,34,6358.89,11206.02,0.00
2024-12-08 16:58:31,55,9569,21,34,6330.93,11207.00,0.00
2024-12-08 16:58:31,56,9569,21,35,6217.88,11207.02,0.00
2024-12-08 16:58:31,55,9569,21,34,6322.78,11207.02,0.00
2024-12-08 16:58:31,54,9569,20,34,6363.42,11207.69,0.00
2024-12-08 16:58:31,54,9570,20,34,6452.90,11208.00,0.00
2024-12-08 16:58:31,55,9570,20,35,6335.57,11208.02,0.00
2024-12-08 16:58:31,55,9571,20,35,6307.61,11209.00,0.00
2024-12-08 16:58:31,56,9571,21,35,6194.97,11209.02,0.00
2024-12-08 16:58:31,55,9571,21,34,6299.46,11209.02,0.00
2024-12-08 16:58:31,55,9572,21,34,6312.25,11210.00,0.00
2024-12-08 16:58:31,56,9572,22,34,6199.53,11210.02,0.00
2024-12-08 16:58:31,56,9573,22,34,6170.05,11211.00,0.00
2024-12-08 16:58:31,57,9573,22,35,6061.80,11211.02,0.00
2024-12-08 16:58:31,56,9573,22,34,6160.04,11211.02,0.00
2024-12-08 16:58:31,55,9573,21,34,6198.98,11211.67,0.00
2024-12-08 16:58:31,55,9574,21,34,6284.83,11212.00,0.00
2024-12-08 16:58:31,56,9574,22,34,6172.60,11212.02,0.00
2024-12-08 16:58:31,55,9574,21,34,6172.84,11212.35,0.00
2024-12-08 16:58:31,55,9575,21,34,6303.74,11213.00,0.00
2024-12-08 16:58:31,56,9575,21,35,6191.18,11213.02,0.00
2024-12-08 16:58:31,55,9575,21,34,6293.55,11213.02,0.00
2024-12-08 16:58:31,55,9576,21,34,6306.34,11214.00,0.00
2024-12-08 16:58:31,56,9576,22,34,6193.73,11214.02,0.00
2024-12-08 16:58:31,56,9577,22,34,6164.24,11215.00,0.00
2024-12-08 16:58:31,57,9577,23,34,6056.10,11215.02,0.00
2024-12-08 16:58:31,56,9577,23,33,6152.23,11215.02,0.00
2024-12-08 16:58:31,56,9578,23,33,6162.79,11216.00,0.00
2024-12-08 16:58:31,57,9578,23,34,6054.67,11216.02,0.00
2024-12-08 16:58:31,57,9579,23,34,6023.72,11217.00,0.00
2024-12-08 16:58:31,58,9579,24,34,5919.87,11217.02,0.00
2024-12-08 16:58:31,57,9579,24,33,6011.92,11217.02,0.00
2024-12-08 16:58:31,56,9579,23,33,5993.55,11217.89,0.00
2024-12-08 16:58:31,56,9580,23,33,6181.92,11218.00,0.00
2024-12-08 16:58:31,57,9580,24,33,6073.46,11218.02,0.00
2024-12-08 16:58:31,57,9581,24,33,6042.51,11219.00,0.00
2024-12-08 16:58:31,58,9581,24,34,5938.33,11219.02,0.00
2024-12-08 16:58:31,57,9581,24,33,6032.67,11219.02,0.00
2024-12-08 16:58:31,57,9582,24,33,6041.08,11220.00,0.00
2024-12-08 16:58:31,58,9582,24,34,5936.93,11220.02,0.00
2024-12-08 16:58:31,57,9582,23,34,5925.27,11220.68,0.00
2024-12-08 16:58:31,57,9583,23,34,6008.15,11221.00,0.00
2024-12-08 16:58:31,58,9583,24,34,5904.56,11221.02,0.00
2024-12-08 16:58:31,57,9583,24,33,6000.28,11221.02,0.00
2024-12-08 16:58:31,56,9583,23,33,5969.67,11221.95,0.00
2024-12-08 16:58:31,56,9584,23,33,6164.08,11222.00,0.00
2024-12-08 16:58:31,57,9584,24,33,6055.94,11222.02,0.00
2024-12-08 16:58:31,57,9585,24,33,6024.98,11223.00,0.00
2024-12-08 16:58:32,58,9585,24,34,5921.10,11223.02,0.00
2024-12-08 16:58:32,57,9585,24,33,6013.16,11223.02,0.00
2024-12-08 16:58:32,56,9585,23,33,6000.73,11223.88,0.00
2024-12-08 16:58:32,56,9586,23,33,6187.23,11224.00,0.00
2024-12-08 16:58:32,57,9586,24,33,6078.68,11224.02,0.00
2024-12-08 16:58:32,56,9586,23,33,6067.30,11224.71,0.00
2024-12-08 16:58:32,56,9587,23,33,6157.38,11225.00,0.00
2024-12-08 16:58:32,57,9587,23,34,6049.35,11225.02,0.00
2024-12-08 16:58:32,56,9587,23,33,6143.35,11225.02,0.00
2024-12-08 16:58:32,56,9588,23,33,6153.92,11226.00,0.00
2024-12-08 16:58:32,57,9588,24,33,6045.95,11226.02,0.00
2024-12-08 16:58:32,56,9588,23,33,6097.83,11226.16,0.00
2024-12-08 16:58:32,56,9589,23,33,6124.39,11227.00,0.00
2024-12-08 16:58:32,57,9589,23,34,6016.95,11227.02,0.00
2024-12-08 16:58:32,56,9589,23,33,6112.36,11227.02,0.00
2024-12-08 16:58:32,56,9590,23,33,6122.93,11228.00,0.00
2024-12-08 16:58:32,57,9590,24,33,6015.51,11228.02,0.00
2024-12-08 16:58:32,57,9591,24,33,6021.51,11229.00,0.00
2024-12-08 16:58:32,58,9591,25,33,5917.69,11229.02,0.00
2024-12-08 16:58:32,58,9592,25,33,5892.18,11230.00,0.00
2024-12-08 16:58:32,59,9592,25,34,5792.31,11230.02,0.00
2024-12-08 16:58:32,58,9592,25,33,5872.81,11230.02,0.00
2024-12-08 16:58:32,58,9593,25,33,5879.15,11231.00,0.00
2024-12-08 16:58:32,59,9593,25,34,5779.50,11231.02,0.00
2024-12-08 16:58:32,58,9593,24,34,5701.26,11231.64,0.00
2024-12-08 16:58:32,58,9594,24,34,5854.49,11232.00,0.00
2024-12-08 16:58:32,59,9594,25,34,5755.26,11232.02,0.00
2024-12-08 16:58:32,58,9594,25,33,5846.75,11232.02,0.00
2024-12-08 16:58:32,57,9594,24,33,5829.34,11232.56,0.00
2024-12-08 16:58:32,56,9594,23,33,5917.48,11232.70,0.00
2024-12-08 16:58:32,56,9595,23,33,6084.18,11233.00,0.00
2024-12-08 16:58:32,57,9595,24,33,5977.44,11233.02,0.00
2024-12-08 16:58:32,56,9595,23,33,5991.91,11233.04,0.00
2024-12-08 16:58:32,56,9596,23,33,6084.72,11234.00,0.00
2024-12-08 16:58:32,57,9596,23,34,5977.97,11234.02,0.00
2024-12-08 16:58:32,56,9596,23,33,6078.71,11234.02,0.00
2024-12-08 16:58:32,56,9597,23,33,6089.28,11235.00,0.00
2024-12-08 16:58:32,57,9597,23,34,5982.45,11235.02,0.00
2024-12-08 16:58:32,56,9597,22,34,5977.05,11235.39,0.00
2024-12-08 16:58:32,56,9598,22,34,6109.88,11236.00,0.00
2024-12-08 16:58:32,57,9598,23,34,6002.69,11236.02,0.00
2024-12-08 16:58:32,56,9598,23,33,6095.84,11236.02,0.00
2024-12-08 16:58:32,55,9598,22,33,6192.41,11236.15,0.00
2024-12-08 16:58:32,55,9599,22,33,6219.48,11237.00,0.00
2024-12-08 16:58:32,56,9599,23,33,6108.42,11237.02,0.00
2024-12-08 16:58:32,56,9600,23,33,6078.86,11238.00,0.00
2024-12-08 16:58:32,57,9600,24,33,5972.22,11238.02,0.00
2024-12-08 16:58:32,56,9600,24,32,6066.82,11238.02,0.00
2024-12-08 16:58:32,56,9601,24,32,6077.40,11239.00,0.00
2024-12-08 16:58:32,57,9601,25,32,5970.78,11239.02,0.00
2024-12-08 16:58:32,57,9602,25,32,5939.76,11240.00,0.00
2024-12-08 16:58:32,58,9602,26,32,5837.35,11240.02,0.00
2024-12-08 16:58:32,57,9602,26,31,5929.90,11240.02,0.00
2024-12-08 16:58:32,56,9602,25,31,6017.78,11240.18,0.00
2024-12-08 16:58:32,56,9603,25,31,6046.36,11241.00,0.00
2024-12-08 16:58:32,57,9603,25,32,5940.28,11241.02,0.00
2024-12-08 16:58:32,56,9603,24,32,5900.20,11241.80,0.00
2024-12-08 16:58:32,56,9604,24,32,6079.02,11242.00,0.00
2024-12-08 16:58:32,57,9604,24,33,5972.37,11242.02,0.00
2024-12-08 16:58:32,56,9604,24,32,6068.98,11242.02,0.00
2024-12-08 16:58:32,56,9605,24,32,6079.56,11243.00,0.00
2024-12-08 16:58:32,57,9605,24,33,5972.90,11243.02,0.00
2024-12-08 16:58:32,57,9606,24,33,5941.87,11244.00,0.00
2024-12-08 16:58:32,58,9606,25,33,5839.42,11244.02,0.00
2024-12-08 16:58:32,57,9606,25,32,5933.98,11244.02,0.00
2024-12-08 16:58:32,56,9606,24,32,5883.63,11244.68,0.00
2024-12-08 16:58:32,56,9607,24,32,6048.51,11245.00,0.00
2024-12-08 16:58:32,57,9607,24,33,5942.40,11245.02,0.00
2024-12-08 16:58:32,56,9607,23,33,5902.30,11245.80,0.00
2024-12-08 16:58:32,56,9608,23,33,6081.18,11246.00,0.00
2024-12-08 16:58:32,57,9608,23,34,5974.50,11246.02,0.00
2024-12-08 16:58:32,56,9608,23,33,6071.14,11246.02,0.00
2024-12-08 16:58:32,55,9608,22,33,6157.05,11246.22,0.00
2024-12-08 16:58:32,55,9609,22,33,6192.30,11247.00,0.00
2024-12-08 16:58:32,56,9609,22,34,6081.72,11247.02,0.00
2024-12-08 16:58:32,56,9610,22,34,6052.36,11248.00,0.00
2024-12-08 16:58:32,57,9610,22,35,5946.18,11248.02,0.00
2024-12-08 16:58:32,56,9610,22,34,6038.31,11248.04,0.00
2024-12-08 16:58:32,55,9610,21,34,6011.34,11248.95,0.00
2024-12-08 16:58:32,55,9611,21,34,6209.76,11249.00,0.00
2024-12-08 16:58:32,56,9611,21,35,6098.87,11249.02,0.00
2024-12-08 16:58:32,55,9611,20,35,6101.37,11249.07,0.00
2024-12-08 16:58:33,55,9612,20,35,6202.13,11250.00,0.00
2024-12-08 16:58:33,56,9612,20,36,6091.38,11250.02,0.00
2024-12-08 16:58:33,55,9612,19,36,6144.87,11250.04,0.00
2024-12-08 16:58:33,54,9612,19,35,6241.99,11250.04,0.00
2024-12-08 16:58:33,54,9613,19,35,6342.55,11251.00,0.00
2024-12-08 16:58:33,55,9613,20,35,6227.23,11251.02,0.00
2024-12-08 16:58:33,55,9614,20,35,6202.71,11252.00,0.00
2024-12-08 16:58:33,56,9614,20,36,6091.94,11252.02,0.00
2024-12-08 16:58:33,55,9614,20,35,6184.30,11252.04,0.00
2024-12-08 16:58:33,54,9614,19,35,6178.71,11252.52,0.00
2024-12-08 16:58:33,53,9614,18,35,6283.56,11252.62,0.00
2024-12-08 16:58:33,53,9615,18,35,6453.71,11253.00,0.00
2024-12-08 16:58:33,54,9615,19,35,6334.20,11253.02,0.00
2024-12-08 16:58:33,53,9615,18,35,6320.29,11253.74,0.00
2024-12-08 16:58:33,53,9616,18,35,6503.13,11254.00,0.00
2024-12-08 16:58:33,54,9616,19,35,6382.70,11254.02,0.00
2024-12-08 16:58:33,53,9616,19,34,6484.02,11254.04,0.00
2024-12-08 16:58:33,53,9617,19,34,6503.70,11255.00,0.00
2024-12-08 16:58:33,54,9617,19,35,6383.27,11255.02,0.00
2024-12-08 16:58:33,53,9617,18,35,6331.91,11255.57,0.00
2024-12-08 16:58:33,53,9618,18,35,6495.79,11256.00,0.00
2024-12-08 16:58:33,54,9618,19,35,6375.49,11256.02,0.00
2024-12-08 16:58:33,53,9618,19,34,6478.80,11256.04,0.00
2024-12-08 16:58:33,52,9618,18,34,6519.10,11256.40,0.00
2024-12-08 16:58:33,52,9619,18,34,6668.64,11257.00,0.00
2024-12-08 16:58:33,53,9619,19,34,6542.82,11257.02,0.00
2024-12-08 16:58:33,52,9619,18,34,6515.47,11257.48,0.00
2024-12-08 16:58:33,52,9620,18,34,6673.02,11258.00,0.00
2024-12-08 16:58:33,53,9620,19,34,6547.12,11258.02,0.00
2024-12-08 16:58:33,52,9620,19,33,6657.87,11258.04,0.00
2024-12-08 16:58:33,52,9621,19,33,6678.61,11259.00,0.00
2024-12-08 16:58:33,53,9621,19,34,6552.60,11259.02,0.00
2024-12-08 16:58:33,52,9621,18,34,6618.48,11259.06,0.00
2024-12-08 16:58:33,52,9622,18,34,6728.04,11260.00,0.00
2024-12-08 16:58:33,53,9622,19,34,6601.09,11260.02,0.00
2024-12-08 16:58:33,52,9622,19,33,6715.05,11260.04,0.00
2024-12-08 16:58:33,51,9622,18,33,6692.46,11260.63,0.00
2024-12-08 16:58:33,51,9623,18,33,6870.08,11261.00,0.00
2024-12-08 16:58:33,52,9623,19,33,6737.97,11261.02,0.00
2024-12-08 16:58:33,52,9624,19,33,6713.13,11262.00,0.00
2024-12-08 16:58:33,53,9624,20,33,6586.46,11262.02,0.00
2024-12-08 16:58:33,52,9624,20,32,6695.80,11262.04,0.00
2024-12-08 16:58:33,52,9625,20,32,6716.96,11263.00,0.00
2024-12-08 16:58:33,53,9625,21,32,6590.23,11263.02,0.00
2024-12-08 16:58:33,52,9625,20,32,6656.35,11263.17,0.00
2024-12-08 16:58:33,52,9626,20,32,6692.94,11264.00,0.00
2024-12-08 16:58:33,53,9626,21,32,6566.66,11264.02,0.00
2024-12-08 16:58:33,52,9626,21,31,6673.45,11264.04,0.00
2024-12-08 16:58:33,52,9627,21,31,6695.57,11265.00,0.00
2024-12-08 16:58:33,53,9627,21,32,6569.24,11265.02,0.00
2024-12-08 16:58:33,52,9627,20,32,6632.78,11265.17,0.00
2024-12-08 16:58:33,52,9628,20,32,6670.16,11266.00,0.00
2024-12-08 16:58:33,53,9628,20,33,6544.31,11266.02,0.00
2024-12-08 16:58:33,52,9628,20,32,6652.83,11266.04,0.00
2024-12-08 16:58:33,51,9628,19,32,6679.63,11266.43,0.00
2024-12-08 16:58:33,51,9629,19,32,6836.90,11267.00,0.00
2024-12-08 16:58:33,52,9629,19,33,6705.42,11267.02,0.00
2024-12-08 16:58:33,52,9630,19,33,6682.18,11268.00,0.00
2024-12-08 16:58:33,53,9630,19,34,6556.10,11268.02,0.00
2024-12-08 16:58:33,52,9630,19,33,6664.85,11268.04,0.00
2024-12-08 16:58:33,52,9631,19,33,6687.11,11269.00,0.00
2024-12-08 16:58:33,53,9631,20,33,6560.94,11269.02,0.00
2024-12-08 16:58:33,52,9631,19,33,6516.39,11269.88,0.00
2024-12-08 16:58:33,52,9632,19,33,6720.21,11270.00,0.00
2024-12-08 16:58:33,53,9632,20,33,6593.42,11270.02,0.00
2024-12-08 16:58:33,52,9632,20,32,6705.04,11270.04,0.00
2024-12-08 16:58:33,52,9633,20,32,6727.31,11271.00,0.00
2024-12-08 16:58:33,53,9633,21,32,6600.38,11271.02,0.00
2024-12-08 16:58:33,52,9633,20,32,6666.62,11271.04,0.00
2024-12-08 16:58:33,52,9634,20,32,6732.24,11272.00,0.00
2024-12-08 16:58:33,53,9634,21,32,6605.22,11272.02,0.00
2024-12-08 16:58:33,52,9634,20,32,6730.08,11272.02,0.00
2024-12-08 16:58:33,51,9634,20,31,6846.57,11272.02,0.00
2024-12-08 16:58:33,51,9635,20,31,6869.28,11273.00,0.00
2024-12-08 16:58:33,52,9635,21,31,6737.18,11273.02,0.00
2024-12-08 16:58:33,52,9636,21,31,6713.93,11274.00,0.00
2024-12-08 16:58:33,53,9636,22,31,6587.25,11274.02,0.00
2024-12-08 16:58:33,52,9636,22,30,6700.92,11274.02,0.00
2024-12-08 16:58:33,52,9637,22,30,6721.03,11275.00,0.00
2024-12-08 16:58:33,53,9637,22,31,6594.22,11275.02,0.00
2024-12-08 16:58:33,53,9638,22,31,6570.29,11276.00,0.00
2024-12-08 16:58:33,54,9638,23,31,6448.62,11276.02,0.00
2024-12-08 16:58:33,53,9638,23,30,6542.64,11276.04,0.00
2024-12-08 16:58:33,52,9638,22,30,6597.23,11276.65,0.00
2024-12-08 16:58:34,52,9639,22,30,6688.56,11277.00,0.00
2024-12-08 16:58:34,53,9639,23,30,6562.36,11277.02,0.00
2024-12-08 16:58:34,52,9639,22,30,6521.03,11277.87,0.00
2024-12-08 16:58:34,52,9640,22,30,6722.81,11278.00,0.00
2024-12-08 16:58:34,53,9640,23,30,6595.97,11278.02,0.00
2024-12-08 16:58:34,52,9640,23,29,6696.79,11278.04,0.00
2024-12-08 16:58:34,52,9641,23,29,6719.07,11279.00,0.00
2024-12-08 16:58:34,53,9641,23,30,6592.30,11279.02,0.00
2024-12-08 16:58:34,52,9641,22,30,6664.87,11279.12,0.00
2024-12-08 16:58:34,52,9642,22,30,6782.58,11280.00,0.00
2024-12-08 16:58:34,53,9642,23,30,6654.60,11280.02,0.00
2024-12-08 16:58:34,52,9642,23,29,6752.22,11280.06,0.00
2024-12-08 16:58:34,52,9643,23,29,6776.67,11281.00,0.00
2024-12-08 16:58:34,53,9643,24,29,6648.80,11281.02,0.00
2024-12-08 16:58:34,52,9643,23,29,6711.59,11281.04,0.00
2024-12-08 16:58:34,52,9644,23,29,6777.27,11282.00,0.00
2024-12-08 16:58:34,53,9644,24,29,6649.40,11282.02,0.00
2024-12-08 16:58:34,52,9644,24,28,6749.07,11282.04,0.00
2024-12-08 16:58:34,52,9645,24,28,6771.36,11283.00,0.00
2024-12-08 16:58:34,53,9645,25,28,6643.60,11283.02,0.00
2024-12-08 16:58:34,53,9646,25,28,6618.64,11284.00,0.00
2024-12-08 16:58:34,54,9646,26,28,6496.07,11284.02,0.00
2024-12-08 16:58:34,53,9646,26,27,6588.84,11284.04,0.00
2024-12-08 16:58:34,53,9647,26,27,6608.58,11285.00,0.00
2024-12-08 16:58:34,54,9647,26,28,6486.20,11285.02,0.00
2024-12-08 16:58:34,53,9647,25,28,6461.86,11285.43,0.00
2024-12-08 16:58:34,53,9648,25,28,6611.29,11286.00,0.00
2024-12-08 16:58:34,54,9648,26,28,6488.86,11286.02,0.00
2024-12-08 16:58:34,53,9648,26,27,6579.35,11286.04,0.00
2024-12-08 16:58:34,53,9649,26,27,6599.10,11287.00,0.00
2024-12-08 16:58:34,54,9649,26,28,6476.90,11287.02,0.00
2024-12-08 16:58:34,54,9650,26,28,6452.64,11288.00,0.00
2024-12-08 16:58:34,55,9650,27,28,6335.32,11288.02,0.00
2024-12-08 16:58:34,54,9650,27,27,6423.37,11288.04,0.00
2024-12-08 16:58:34,54,9651,27,27,6440.67,11289.00,0.00
2024-12-08 16:58:34,55,9651,28,27,6323.56,11289.02,0.00
2024-12-08 16:58:34,55,9652,28,27,6302.55,11290.00,0.00
2024-12-08 16:58:34,56,9652,28,28,6190.00,11290.02,0.00
2024-12-08 16:58:34,55,9652,28,27,6271.76,11290.04,0.00
2024-12-08 16:58:34,55,9653,28,27,6286.68,11291.00,0.00
2024-12-08 16:58:34,56,9653,29,27,6174.42,11291.02,0.00
2024-12-08 16:58:34,56,9654,29,27,6154.17,11292.00,0.00
2024-12-08 16:58:34,57,9654,29,28,6046.21,11292.02,0.00
2024-12-08 16:58:34,56,9654,29,27,6123.93,11292.04,0.00
2024-12-08 16:58:34,55,9654,28,27,6163.45,11292.65,0.00
2024-12-08 16:58:34,54,9654,27,27,6196.91,11292.96,0.00
2024-12-08 16:58:34,54,9655,27,27,6401.87,11293.00,0.00
2024-12-08 16:58:34,55,9655,28,27,6285.48,11293.02,0.00
2024-12-08 16:58:34,55,9656,28,27,6264.83,11294.00,0.00
2024-12-08 16:58:34,56,9656,29,27,6152.95,11294.02,0.00
2024-12-08 16:58:34,55,9656,29,26,6234.03,11294.04,0.00
2024-12-08 16:58:34,55,9657,29,26,6247.53,11295.00,0.00
2024-12-08 16:58:34,56,9657,30,26,6135.96,11295.02,0.00
2024-12-08 16:58:34,56,9658,30,26,6116.74,11296.00,0.00
2024-12-08 16:58:34,57,9658,30,27,6009.43,11296.02,0.00
2024-12-08 16:58:34,56,9658,30,26,6084.47,11296.04,0.00
2024-12-08 16:58:34,55,9658,29,26,6186.90,11296.09,0.00
2024-12-08 16:58:34,55,9659,29,26,6206.55,11297.00,0.00
2024-12-08 16:58:34,56,9659,29,27,6095.72,11297.02,0.00
2024-12-08 16:58:34,56,9660,29,27,6075.83,11298.00,0.00
2024-12-08 16:58:34,57,9660,29,28,5969.24,11298.02,0.00
2024-12-08 16:58:34,56,9660,29,27,6045.57,11298.04,0.00
2024-12-08 16:58:34,55,9660,28,27,6054.78,11298.40,0.00
2024-12-08 16:58:34,55,9661,28,27,6192.80,11299.00,0.00
2024-12-08 16:58:34,56,9661,28,28,6082.21,11299.02,0.00
2024-12-08 16:58:34,55,9661,27,28,6182.52,11299.02,0.00
2024-12-08 16:58:34,55,9662,27,28,6235.75,11300.00,0.00
2024-12-08 16:58:34,56,9662,27,29,6124.40,11300.02,0.00
2024-12-08 16:58:34,55,9662,27,28,6204.94,11300.02,0.00
2024-12-08 16:58:34,55,9663,27,28,6217.66,11301.00,0.00
2024-12-08 16:58:34,56,9663,28,28,6106.63,11301.02,0.00
2024-12-08 16:58:34,56,9664,28,28,6089.47,11302.00,0.00
2024-12-08 16:58:34,57,9664,29,28,5982.64,11302.02,0.00
2024-12-08 16:58:34,56,9664,29,27,6061.22,11302.02,0.00
2024-12-08 16:58:34,56,9665,29,27,6071.85,11303.00,0.00
2024-12-08 16:58:34,57,9665,30,27,5965.32,11303.02,0.00
2024-12-08 16:58:34,56,9665,29,27,5898.76,11303.55,0.00
2024-12-08 16:58:34,56,9666,29,27,6050.45,11304.00,0.00
2024-12-08 16:58:34,57,9666,30,27,5944.30,11304.02,0.00
2024-12-08 16:58:34,56,9666,30,26,6027.36,11304.05,0.00
2024-12-08 16:58:35,56,9667,30,26,6042.01,11305.00,0.00
2024-12-08 16:58:35,57,9667,31,26,5936.01,11305.02,0.00
2024-12-08 16:58:35,56,9667,30,26,5948.49,11305.23,0.00
2024-12-08 16:58:35,56,9668,30,26,6064.02,11306.00,0.00
2024-12-08 16:58:35,57,9668,31,26,5957.63,11306.02,0.00
2024-12-08 16:58:35,56,9668,31,25,6025.67,11306.05,0.00
2024-12-08 16:58:35,55,9668,30,25,6069.44,11306.64,0.00
2024-12-08 16:58:35,55,9669,30,25,6151.96,11307.00,0.00
2024-12-08 16:58:35,56,9669,31,25,6042.10,11307.02,0.00
2024-12-08 16:58:35,55,9669,30,25,6041.43,11307.60,0.00
2024-12-08 16:58:35,55,9670,30,25,6202.10,11308.00,0.00
2024-12-08 16:58:35,56,9670,30,26,6091.34,11308.02,0.00
2024-12-08 16:58:35,55,9670,30,25,6165.10,11308.05,0.00
2024-12-08 16:58:35,55,9671,30,25,6181.95,11309.00,0.00
2024-12-08 16:58:35,56,9671,30,26,6071.56,11309.02,0.00
2024-12-08 16:58:35,56,9672,30,26,6057.41,11310.00,0.00
2024-12-08 16:58:35,57,9672,30,27,5951.14,11310.02,0.00
2024-12-08 16:58:35,56,9672,30,26,6021.07,11310.05,0.00
2024-12-08 16:58:35,55,9672,29,26,5974.71,11310.96,0.00
2024-12-08 16:58:35,55,9673,29,26,6176.27,11311.00,0.00
2024-12-08 16:58:35,56,9673,30,26,6065.98,11311.02,0.00
2024-12-08 16:58:35,55,9673,29,26,6112.52,11311.04,0.00
2024-12-08 16:58:35,55,9674,29,26,6167.08,11312.00,0.00
2024-12-08 16:58:35,56,9674,30,26,6056.95,11312.02,0.00
2024-12-08 16:58:35,55,9674,30,25,6134.18,11312.04,0.00
2024-12-08 16:58:35,55,9675,30,25,6147.30,11313.00,0.00
2024-12-08 16:58:35,56,9675,30,26,6037.52,11313.02,0.00
2024-12-08 16:58:35,55,9675,29,26,6091.79,11313.13,0.00
2024-12-08 16:58:35,55,9676,29,26,6197.31,11314.00,0.00
2024-12-08 16:58:35,56,9676,29,27,6086.64,11314.02,0.00
2024-12-08 16:58:35,55,9676,29,26,6166.46,11314.04,0.00
2024-12-08 16:58:35,55,9677,29,26,6178.87,11315.00,0.00
2024-12-08 16:58:35,56,9677,29,27,6068.54,11315.02,0.00
2024-12-08 16:58:35,55,9677,28,27,6057.60,11315.36,0.00
2024-12-08 16:58:35,55,9678,28,27,6187.99,11316.00,0.00
2024-12-08 16:58:35,56,9678,28,28,6077.49,11316.02,0.00
2024-12-08 16:58:35,55,9678,28,27,6159.19,11316.04,0.00
2024-12-08 16:58:35,55,9679,28,27,6167.39,11317.00,0.00
2024-12-08 16:58:35,56,9679,29,27,6057.26,11317.02,0.00
2024-12-08 16:58:35,56,9680,29,27,6028.88,11318.00,0.00
2024-12-08 16:58:35,57,9680,30,27,5923.11,11318.02,0.00
2024-12-08 16:58:35,56,9680,30,26,6002.61,11318.04,0.00
2024-12-08 16:58:35,55,9680,29,26,6105.60,11318.09,0.00
2024-12-08 16:58:35,55,9681,29,26,6113.09,11319.00,0.00
2024-12-08 16:58:35,56,9681,30,26,6003.93,11319.02,0.00
2024-12-08 16:58:35,56,9682,30,26,5971.31,11320.00,0.00
2024-12-08 16:58:35,57,9682,30,27,5866.55,11320.02,0.00
2024-12-08 16:58:35,56,9682,30,26,5947.06,11320.04,0.00
2024-12-08 16:58:35,55,9682,29,26,5989.74,11320.58,0.00
2024-12-08 16:58:35,55,9683,29,26,6133.52,11321.00,0.00
2024-12-08 16:58:35,56,9683,29,27,6023.99,11321.02,0.00
2024-12-08 16:58:35,56,9684,29,27,5994.00,11322.00,0.00
2024-12-08 16:58:35,57,9684,30,27,5888.85,11322.02,0.00
2024-12-08 16:58:35,56,9684,30,26,5969.74,11322.04,0.00
2024-12-08 16:58:35,55,9684,29,26,6075.22,11322.05,0.00
2024-12-08 16:58:35,54,9684,28,26,6185.64,11322.07,0.00
2024-12-08 16:58:35,53,9684,27,26,6281.98,11322.09,0.00
2024-12-08 16:58:35,53,9685,27,26,6385.13,11323.00,0.00
2024-12-08 16:58:35,54,9685,27,27,6266.89,11323.02,0.00
2024-12-08 16:58:35,53,9685,26,27,6333.87,11323.08,0.00
2024-12-08 16:58:35,53,9686,26,27,6362.57,11324.00,0.00
2024-12-08 16:58:35,54,9686,27,27,6244.75,11324.02,0.00
2024-12-08 16:58:35,53,9686,27,26,6334.80,11324.04,0.00
2024-12-08 16:58:35,52,9686,26,26,6410.73,11324.17,0.00
2024-12-08 16:58:35,52,9687,26,26,6532.90,11325.00,0.00
2024-12-08 16:58:35,53,9687,27,26,6409.64,11325.02,0.00
2024-12-08 16:58:35,52,9687,26,26,6502.41,11325.02,0.00
2024-12-08 16:58:35,52,9688,26,26,6565.72,11326.00,0.00
2024-12-08 16:58:35,53,9688,26,27,6441.84,11326.02,0.00
2024-12-08 16:58:35,52,9688,26,26,6535.23,11326.02,0.00
2024-12-08 16:58:35,52,9689,26,26,6555.41,11327.00,0.00
2024-12-08 16:58:35,53,9689,27,26,6431.72,11327.02,0.00
2024-12-08 16:58:35,53,9690,27,26,6423.08,11328.00,0.00
2024-12-08 16:58:35,54,9690,27,27,6304.14,11328.02,0.00
2024-12-08 16:58:35,53,9690,27,26,6384.61,11328.02,0.00
2024-12-08 16:58:35,53,9691,27,26,6402.27,11329.00,0.00
2024-12-08 16:58:35,54,9691,28,26,6283.71,11329.02,0.00
2024-12-08 16:58:35,54,9692,28,26,6273.91,11330.00,0.00
2024-12-08 16:58:35,55,9692,29,26,6159.84,11330.02,0.00
2024-12-08 16:58:35,54,9692,29,25,6238.24,11330.02,0.00
2024-12-08 16:58:35,53,9692,28,25,6311.10,11330.19,0.00
2024-12-08 16:58:35,53,9693,28,25,6285.34,11331.00,0.00
2024-12-08 16:58:35,54,9693,28,26,6168.94,11331.02,0.00
2024-12-08 16:58:35,53,9693,27,26,6238.31,11331.06,0.00
2024-12-08 16:58:35,52,9693,27,25,6145.64,11331.83,0.00
2024-12-08 16:58:36,52,9694,27,25,6344.06,11332.00,0.00
2024-12-08 16:58:36,53,9694,28,25,6224.37,11332.02,0.00
2024-12-08 16:58:36,52,9694,28,24,6309.20,11332.02,0.00
2024-12-08 16:58:36,51,9694,27,24,6430.69,11332.04,0.00
2024-12-08 16:58:36,50,9694,26,24,6520.76,11332.08,0.00
2024-12-08 16:58:36,50,9695,26,24,6635.96,11333.00,0.00
2024-12-08 16:58:36,51,9695,27,24,6505.84,11333.02,0.00
2024-12-08 16:58:36,51,9696,27,24,6489.85,11334.00,0.00
2024-12-08 16:58:36,52,9696,27,25,6365.05,11334.02,0.00
2024-12-08 16:58:36,51,9696,27,24,6456.52,11334.02,0.00
2024-12-08 16:58:36,51,9697,27,24,6477.52,11335.00,0.00
2024-12-08 16:58:36,52,9697,27,25,6352.95,11335.02,0.00
2024-12-08 16:58:36,51,9697,26,25,6424.18,11335.04,0.00
2024-12-08 16:58:36,51,9698,26,25,6538.10,11336.00,0.00
2024-12-08 16:58:36,52,9698,26,26,6412.37,11336.02,0.00
2024-12-08 16:58:36,51,9698,26,25,6493.65,11336.02,0.00
2024-12-08 16:58:36,51,9699,26,25,6516.45,11337.00,0.00
2024-12-08 16:58:36,52,9699,27,25,6391.14,11337.02,0.00
2024-12-08 16:58:36,51,9699,26,25,6451.99,11337.06,0.00
2024-12-08 16:58:36,50,9699,25,25,6525.47,11337.54,0.00
2024-12-08 16:58:36,50,9700,25,25,6700.41,11338.00,0.00
2024-12-08 16:58:36,51,9700,25,26,6569.03,11338.02,0.00
2024-12-08 16:58:36,51,9701,25,26,6547.37,11339.00,0.00
2024-12-08 16:58:36,52,9701,26,26,6421.46,11339.02,0.00
2024-12-08 16:58:36,51,9701,26,25,6545.15,11339.02,0.00
2024-12-08 16:58:36,51,9702,26,25,6567.96,11340.00,0.00
2024-12-08 16:58:36,52,9702,26,26,6441.65,11340.02,0.00
2024-12-08 16:58:36,52,9703,26,26,6445.02,11341.00,0.00
2024-12-08 16:58:36,53,9703,26,27,6323.41,11341.02,0.00
2024-12-08 16:58:36,52,9703,25,27,6445.02,11341.02,0.00
2024-12-08 16:58:36,52,9704,25,27,6421.60,11342.00,0.00
2024-12-08 16:58:36,53,9704,25,28,6300.43,11342.02,0.00
2024-12-08 16:58:36,52,9704,25,27,6412.87,11342.02,0.00
2024-12-08 16:58:36,51,9704,24,27,6440.45,11342.63,0.00
2024-12-08 16:58:36,51,9705,24,27,6620.85,11343.00,0.00
2024-12-08 16:58:36,52,9705,24,28,6493.53,11343.02,0.00
2024-12-08 16:58:36,52,9706,24,28,6494.81,11344.00,0.00
2024-12-08 16:58:36,53,9706,25,28,6372.26,11344.02,0.00
2024-12-08 16:58:36,52,9706,24,28,6411.21,11344.06,0.00
2024-12-08 16:58:36,52,9707,24,28,6522.85,11345.00,0.00
2024-12-08 16:58:36,53,9707,25,28,6399.78,11345.02,0.00
2024-12-08 16:58:36,52,9707,25,27,6514.13,11345.04,0.00
2024-12-08 16:58:36,51,9707,24,27,6610.83,11345.29,0.00
2024-12-08 16:58:36,51,9708,24,27,6664.69,11346.00,0.00
2024-12-08 16:58:36,52,9708,24,28,6536.52,11346.02,0.00
2024-12-08 16:58:36,52,9709,24,28,6536.55,11347.00,0.00
2024-12-08 16:58:36,53,9709,24,29,6413.22,11347.02,0.00
2024-12-08 16:58:36,53,9710,24,29,6387.36,11348.00,0.00
2024-12-08 16:58:36,54,9710,25,29,6269.08,11348.02,0.00
2024-12-08 16:58:36,53,9710,25,28,6378.81,11348.04,0.00
2024-12-08 16:58:36,52,9710,24,28,6334.00,11348.96,0.00
2024-12-08 16:58:36,52,9711,24,28,6547.90,11349.00,0.00
2024-12-08 16:58:36,53,9711,25,28,6424.36,11349.02,0.00
2024-12-08 16:58:36,53,9712,25,28,6423.23,11350.00,0.00
2024-12-08 16:58:36,54,9712,26,28,6304.28,11350.02,0.00
2024-12-08 16:58:36,54,9713,26,28,6277.50,11351.00,0.00
2024-12-08 16:58:36,55,9713,27,28,6163.37,11351.02,0.00
2024-12-08 16:58:36,54,9713,27,27,6269.11,11351.06,0.00
2024-12-08 16:58:36,53,9713,26,27,6301.55,11351.62,0.00
2024-12-08 16:58:36,53,9714,26,27,6473.18,11352.00,0.00
2024-12-08 16:58:36,54,9714,26,28,6353.30,11352.02,0.00
2024-12-08 16:58:36,54,9715,26,28,6353.08,11353.00,0.00
2024-12-08 16:58:36,55,9715,26,29,6237.57,11353.02,0.00
2024-12-08 16:58:36,54,9715,25,29,6250.93,11353.54,0.00
2024-12-08 16:58:36,53,9715,24,29,6320.47,11353.64,0.00
2024-12-08 16:58:36,52,9715,23,29,6439.83,11353.65,0.00
2024-12-08 16:58:36,52,9716,23,29,6619.15,11354.00,0.00
2024-12-08 16:58:36,53,9716,23,30,6494.26,11354.02,0.00
2024-12-08 16:58:36,52,9716,22,30,6614.79,11354.06,0.00
2024-12-08 16:58:36,51,9716,22,29,6735.60,11354.08,0.00
2024-12-08 16:58:36,50,9716,21,29,6731.85,11354.52,0.00
2024-12-08 16:58:36,50,9717,21,29,6904.81,11355.00,0.00
2024-12-08 16:58:36,51,9717,21,30,6769.42,11355.02,0.00
2024-12-08 16:58:36,50,9717,20,30,6811.76,11355.22,0.00
2024-12-08 16:58:36,50,9718,20,30,6950.84,11356.00,0.00
2024-12-08 16:58:36,51,9718,20,31,6814.55,11356.02,0.00
2024-12-08 16:58:36,51,9719,20,31,6792.88,11357.00,0.00
2024-12-08 16:58:36,52,9719,21,31,6662.25,11357.02,0.00
2024-12-08 16:58:36,51,9719,21,30,6783.99,11357.08,0.00
2024-12-08 16:58:36,50,9719,20,30,6883.37,11357.20,0.00
2024-12-08 16:58:36,49,9719,19,30,6973.10,11357.63,0.00
2024-12-08 16:58:36,49,9720,19,30,7163.48,11358.00,0.00
2024-12-08 16:58:36,50,9720,19,31,7020.21,11358.02,0.00
2024-12-08 16:58:36,50,9721,19,31,7011.94,11359.00,0.00
2024-12-08 16:58:36,51,9721,19,32,6874.45,11359.02,0.00
2024-12-08 16:58:36,50,9721,19,31,6959.71,11359.08,0.00
2024-12-08 16:58:36,49,9721,18,31,7011.24,11359.37,0.00
2024-12-08 16:58:37,49,9722,18,31,7171.70,11360.00,0.00
2024-12-08 16:58:37,50,9722,18,32,7028.27,11360.02,0.00
2024-12-08 16:58:37,50,9723,18,32,7019.09,11361.00,0.00
2024-12-08 16:58:37,51,9723,18,33,6881.46,11361.02,0.00
2024-12-08 16:58:37,50,9723,18,32,6969.12,11361.08,0.00
2024-12-08 16:58:37,50,9724,18,32,7001.21,11362.00,0.00
2024-12-08 16:58:37,51,9724,19,32,6863.93,11362.02,0.00
2024-12-08 16:58:37,50,9724,18,32,6946.69,11362.10,0.00
2024-12-08 16:58:37,49,9724,17,32,7084.77,11362.12,0.00
2024-12-08 16:58:37,49,9725,17,32,7136.47,11363.00,0.00
2024-12-08 16:58:37,50,9725,18,32,6993.74,11363.02,0.00
2024-12-08 16:58:37,49,9725,18,31,7087.78,11363.08,0.00
2024-12-08 16:58:37,49,9726,18,31,7121.08,11364.00,0.00
2024-12-08 16:58:37,50,9726,18,32,6978.66,11364.02,0.00
2024-12-08 16:58:37,49,9726,17,32,7039.95,11364.16,0.00
2024-12-08 16:58:37,49,9727,17,32,7172.95,11365.00,0.00
2024-12-08 16:58:37,50,9727,17,33,7029.49,11365.02,0.00
2024-12-08 16:58:37,50,9727,17,33,7003.42,11366.00,0.00
2024-12-08 16:58:37,51,9727,17,34,6866.10,11366.02,0.00
2024-12-08 16:58:37,50,9727,17,33,6987.53,11366.10,0.00
2024-12-08 16:58:37,49,9727,16,33,7053.69,11366.33,0.00
2024-12-08 16:58:37,49,9728,16,33,7202.60,11367.00,0.00
2024-12-08 16:58:37,50,9728,17,33,7058.54,11367.02,0.00
2024-12-08 16:58:37,50,9729,17,33,7044.67,11368.00,0.00
2024-12-08 16:58:37,51,9729,18,33,6906.54,11368.02,0.00
2024-12-08 16:58:37,51,9730,18,33,6879.95,11369.00,0.00
2024-12-08 16:58:37,52,9730,18,34,6747.64,11369.02,0.00
2024-12-08 16:58:37,51,9730,18,33,6868.82,11369.10,0.00
2024-12-08 16:58:37,51,9731,18,33,6900.62,11370.00,0.00
2024-12-08 16:58:37,52,9731,19,33,6767.91,11370.02,0.00
2024-12-08 16:58:37,51,9731,18,33,6777.34,11370.61,0.00
2024-12-08 16:58:37,51,9732,18,33,6956.00,11371.00,0.00
2024-12-08 16:58:37,52,9732,18,34,6822.23,11371.02,0.00
2024-12-08 16:58:37,51,9732,18,33,6902.50,11371.10,0.00
2024-12-08 16:58:37,51,9733,18,33,6934.31,11372.00,0.00
2024-12-08 16:58:37,52,9733,19,33,6800.96,11372.02,0.00
2024-12-08 16:58:37,52,9734,19,33,6792.38,11373.00,0.00
2024-12-08 16:58:37,53,9734,20,33,6664.22,11373.02,0.00
2024-12-08 16:58:37,52,9734,20,32,6737.72,11373.10,0.00
2024-12-08 16:58:37,52,9735,20,32,6766.73,11374.00,0.00
2024-12-08 16:58:37,53,9735,21,32,6639.05,11374.02,0.00
2024-12-08 16:58:37,53,9736,21,32,6629.12,11375.00,0.00
2024-12-08 16:58:37,54,9736,21,33,6506.36,11375.02,0.00
2024-12-08 16:58:37,53,9736,21,32,6577.63,11375.09,0.00
2024-12-08 16:58:37,52,9736,20,32,6652.54,11375.54,0.00
2024-12-08 16:58:37,52,9737,20,32,6731.63,11376.00,0.00
2024-12-08 16:58:37,53,9737,21,32,6604.62,11376.02,0.00
2024-12-08 16:58:37,53,9738,21,32,6593.07,11377.00,0.00
2024-12-08 16:58:37,54,9738,22,32,6470.98,11377.02,0.00
2024-12-08 16:58:37,53,9738,22,31,6543.71,11377.09,0.00
2024-12-08 16:58:37,52,9738,21,31,6535.81,11377.88,0.00
2024-12-08 16:58:37,52,9739,21,31,6741.56,11378.00,0.00
2024-12-08 16:58:37,53,9739,22,31,6614.36,11378.02,0.00
2024-12-08 16:58:37,53,9740,22,31,6602.10,11379.00,0.00
2024-12-08 16:58:37,54,9740,23,31,6479.84,11379.02,0.00
2024-12-08 16:58:37,53,9740,23,30,6554.88,11379.09,0.00
2024-12-08 16:58:37,52,9740,22,30,6622.45,11379.50,0.00
2024-12-08 16:58:37,52,9741,22,30,6784.76,11380.00,0.00
2024-12-08 16:58:37,53,9741,22,31,6656.74,11380.02,0.00
2024-12-08 16:58:37,53,9742,22,31,6647.77,11381.00,0.00
2024-12-08 16:58:37,54,9742,23,31,6524.67,11381.02,0.00
2024-12-08 16:58:37,53,9742,22,31,6622.01,11381.04,0.00
2024-12-08 16:58:37,52,9742,22,30,6696.84,11381.12,0.00
2024-12-08 16:58:37,52,9743,22,30,6815.61,11382.00,0.00
2024-12-08 16:58:37,53,9743,22,31,6687.01,11382.02,0.00
2024-12-08 16:58:37,54,9742,22,32,6563.18,11382.06,0.00
2024-12-08 16:58:37,53,9742,21,32,6785.81,11382.57,0.00
2024-12-08 16:58:37,53,9743,21,32,6951.51,11383.00,0.00
2024-12-08 16:58:37,54,9743,22,32,6822.77,11383.02,0.00
2024-12-08 16:58:37,53,9743,21,32,6943.30,11383.08,0.00
2024-12-08 16:58:37,52,9743,21,31,7028.67,11383.10,0.00
2024-12-08 16:58:37,52,9744,21,31,7276.64,11384.00,0.00
2024-12-08 16:58:37,53,9744,21,32,7139.34,11384.02,0.00
2024-12-08 16:58:37,53,9745,21,32,7126.08,11385.00,0.00
2024-12-08 16:58:37,54,9745,22,32,6994.12,11385.02,0.00
2024-12-08 16:58:37,54,9746,22,32,6964.84,11386.00,0.00
2024-12-08 16:58:37,55,9746,23,32,6838.20,11386.02,0.00
2024-12-08 16:58:37,54,9746,23,31,6954.32,11386.09,0.00
2024-12-08 16:58:37,54,9747,23,31,6973.00,11387.00,0.00
2024-12-08 16:58:37,55,9747,24,31,6846.22,11387.02,0.00
2024-12-08 16:58:37,54,9747,23,31,6897.11,11387.07,0.00
2024-12-08 16:58:38,54,9748,23,31,6953.43,11388.00,0.00
2024-12-08 16:58:38,55,9748,24,31,6827.01,11388.02,0.00
2024-12-08 16:58:38,54,9748,24,30,6902.84,11388.07,0.00
2024-12-08 16:58:38,53,9748,23,30,6961.58,11388.62,0.00
2024-12-08 16:58:38,53,9749,23,30,7047.81,11389.00,0.00
2024-12-08 16:58:38,54,9749,24,30,6917.29,11389.02,0.00
2024-12-08 16:58:38,54,9750,24,30,6894.43,11390.00,0.00
2024-12-08 16:58:38,55,9750,24,31,6769.07,11390.02,0.00
2024-12-08 16:58:38,55,9751,24,31,6729.96,11391.00,0.00
2024-12-08 16:58:38,56,9751,24,32,6609.78,11391.02,0.00
2024-12-08 16:58:38,55,9751,23,32,6716.54,11391.07,0.00
2024-12-08 16:58:38,54,9751,23,31,6838.81,11391.07,0.00
2024-12-08 16:58:38,54,9752,23,31,6860.49,11392.00,0.00
2024-12-08 16:58:38,55,9752,23,32,6735.75,11392.02,0.00
2024-12-08 16:58:38,55,9753,23,32,6723.88,11393.00,0.00
2024-12-08 16:58:38,56,9753,23,33,6603.81,11393.02,0.00
2024-12-08 16:58:38,56,9754,23,33,6573.87,11394.00,0.00
2024-12-08 16:58:38,57,9754,23,34,6458.54,11394.02,0.00
2024-12-08 16:58:38,56,9754,22,34,6569.82,11394.04,0.00
2024-12-08 16:58:38,55,9754,22,33,6685.13,11394.05,0.00
2024-12-08 16:58:38,54,9754,21,33,6754.15,11394.26,0.00
2024-12-08 16:58:38,54,9755,21,33,6881.25,11395.00,0.00
2024-12-08 16:58:38,55,9755,22,33,6756.14,11395.02,0.00
2024-12-08 16:58:38,55,9756,22,33,6741.21,11396.00,0.00
2024-12-08 16:58:38,56,9756,23,33,6620.83,11396.02,0.00
2024-12-08 16:58:38,55,9756,23,32,6695.64,11396.05,0.00
2024-12-08 16:58:38,55,9757,23,32,6712.79,11397.00,0.00
2024-12-08 16:58:38,56,9757,24,32,6592.92,11397.02,0.00
2024-12-08 16:58:38,56,9758,24,32,6576.83,11398.00,0.00
2024-12-08 16:58:38,57,9758,25,32,6461.45,11398.02,0.00
2024-12-08 16:58:38,56,9758,25,31,6534.10,11398.05,0.00
2024-12-08 16:58:38,55,9758,24,31,6498.41,11398.96,0.00
2024-12-08 16:58:38,55,9759,24,31,6701.54,11399.00,0.00
2024-12-08 16:58:38,56,9759,25,31,6581.86,11399.02,0.00
2024-12-08 16:58:38,56,9760,25,31,6566.76,11400.00,0.00
2024-12-08 16:58:38,57,9760,25,32,6451.55,11400.02,0.00
2024-12-08 16:58:38,56,9760,25,31,6524.02,11400.05,0.00
2024-12-08 16:58:38,55,9760,24,31,6627.52,11400.05,0.00
2024-12-08 16:58:38,55,9761,24,31,6727.59,11401.00,0.00
2024-12-08 16:58:38,56,9761,25,31,6607.45,11401.02,0.00
2024-12-08 16:58:38,55,9761,24,31,6665.44,11401.13,0.00
2024-12-08 16:58:38,54,9761,23,31,6746.63,11401.50,0.00
2024-12-08 16:58:38,54,9762,23,31,6901.12,11402.00,0.00
2024-12-08 16:58:38,55,9762,24,31,6775.65,11402.02,0.00
2024-12-08 16:58:38,54,9762,23,31,6896.92,11402.04,0.00
2024-12-08 16:58:38,53,9762,23,30,6986.17,11402.04,0.00
2024-12-08 16:58:38,53,9763,23,30,7006.13,11403.00,0.00
2024-12-08 16:58:38,54,9763,24,30,6876.39,11403.02,0.00
2024-12-08 16:58:38,53,9763,23,30,6825.87,11403.53,0.00
2024-12-08 16:58:38,53,9764,23,30,6987.60,11404.00,0.00
2024-12-08 16:58:38,54,9764,24,30,6858.20,11404.02,0.00
2024-12-08 16:58:38,53,9764,24,29,6946.73,11404.04,0.00
2024-12-08 16:58:38,53,9765,24,29,6966.69,11405.00,0.00
2024-12-08 16:58:38,54,9765,25,29,6837.68,11405.02,0.00
2024-12-08 16:58:38,53,9765,24,29,6874.06,11405.45,0.00
2024-12-08 16:58:38,53,9766,24,29,6947.83,11406.00,0.00
2024-12-08 16:58:38,54,9766,25,29,6819.17,11406.02,0.00
2024-12-08 16:58:38,53,9766,25,28,6909.11,11406.04,0.00
2024-12-08 16:58:38,53,9767,25,28,6929.07,11407.00,0.00
2024-12-08 16:58:38,54,9767,26,28,6800.76,11407.02,0.00
2024-12-08 16:58:38,54,9768,26,28,6776.83,11408.00,0.00
2024-12-08 16:58:38,55,9768,27,28,6653.62,11408.02,0.00
2024-12-08 16:58:38,54,9768,27,27,6740.93,11408.04,0.00
2024-12-08 16:58:38,53,9768,26,27,6727.67,11408.91,0.00
2024-12-08 16:58:38,53,9769,26,27,6932.23,11409.00,0.00
2024-12-08 16:58:38,54,9769,26,28,6803.86,11409.02,0.00
2024-12-08 16:58:38,53,9769,25,28,6812.03,11409.68,0.00
2024-12-08 16:58:38,53,9770,25,28,6910.82,11410.00,0.00
2024-12-08 16:58:38,54,9770,25,29,6782.84,11410.02,0.00
2024-12-08 16:58:38,53,9770,25,28,6872.08,11410.04,0.00
2024-12-08 16:58:38,53,9771,25,28,6892.04,11411.00,0.00
2024-12-08 16:58:38,54,9771,26,28,6764.41,11411.02,0.00
2024-12-08 16:58:38,53,9771,25,28,6742.25,11411.77,0.00
2024-12-08 16:58:38,53,9772,25,28,6931.90,11412.00,0.00
2024-12-08 16:58:38,54,9772,26,28,6803.53,11412.02,0.00
2024-12-08 16:58:38,53,9772,26,27,6895.31,11412.04,0.00
2024-12-08 16:58:38,53,9773,26,27,6915.28,11413.00,0.00
2024-12-08 16:58:38,54,9773,26,28,6787.22,11413.02,0.00
2024-12-08 16:58:38,53,9773,25,28,6738.97,11413.57,0.00
2024-12-08 16:58:38,53,9774,25,28,6905.12,11414.00,0.00
2024-12-08 16:58:38,54,9774,25,29,6777.25,11414.02,0.00
2024-12-08 16:58:38,53,9774,25,28,6862.06,11414.04,0.00
2024-12-08 16:58:38,52,9774,24,28,6934.86,11414.21,0.00
2024-12-08 16:58:39,52,9775,24,28,7064.90,11415.00,0.00
2024-12-08 16:58:39,53,9775,25,28,6931.60,11415.02,0.00
2024-12-08 16:58:39,53,9776,25,28,6911.30,11416.00,0.00
2024-12-08 16:58:39,54,9776,26,28,6783.32,11416.02,0.00
2024-12-08 16:58:39,53,9776,26,27,6870.39,11416.04,0.00
2024-12-08 16:58:39,52,9776,25,27,6874.77,11416.52,0.00
2024-12-08 16:58:39,52,9777,25,27,7039.79,11417.00,0.00
2024-12-08 16:58:39,53,9777,26,27,6906.97,11417.02,0.00
2024-12-08 16:58:39,53,9778,26,27,6886.44,11418.00,0.00
2024-12-08 16:58:39,54,9778,27,27,6758.92,11418.02,0.00
2024-12-08 16:58:39,53,9778,27,26,6847.68,11418.04,0.00
2024-12-08 16:58:39,53,9779,27,26,6867.66,11419.00,0.00
2024-12-08 16:58:39,54,9779,28,26,6740.48,11419.02,0.00
2024-12-08 16:58:39,54,9780,28,26,6719.84,11420.00,0.00
2024-12-08 16:58:39,55,9780,29,26,6597.66,11420.02,0.00
2024-12-08 16:58:39,54,9780,29,25,6683.90,11420.04,0.00
2024-12-08 16:58:39,54,9781,29,25,6701.39,11421.00,0.00
2024-12-08 16:58:39,55,9781,29,26,6579.55,11421.02,0.00
2024-12-08 16:58:39,55,9782,29,26,6558.66,11422.00,0.00
2024-12-08 16:58:39,56,9782,30,26,6441.54,11422.02,0.00
2024-12-08 16:58:39,55,9782,30,25,6525.45,11422.04,0.00
2024-12-08 16:58:39,54,9782,29,25,6549.85,11422.41,0.00
2024-12-08 16:58:39,54,9783,29,25,6694.10,11423.00,0.00
2024-12-08 16:58:39,55,9783,29,26,6572.39,11423.02,0.00
2024-12-08 16:58:39,54,9783,28,26,6620.12,11423.19,0.00
2024-12-08 16:58:39,54,9784,28,26,6739.11,11424.00,0.00
2024-12-08 16:58:39,55,9784,29,26,6616.58,11424.02,0.00
2024-12-08 16:58:39,54,9784,29,25,6705.28,11424.04,0.00
2024-12-08 16:58:39,53,9784,28,25,6746.11,11424.32,0.00
2024-12-08 16:58:39,53,9785,28,25,6884.54,11425.00,0.00
2024-12-08 16:58:39,54,9785,28,26,6757.05,11425.02,0.00
2024-12-08 16:58:39,54,9786,28,26,6734.64,11426.00,0.00
2024-12-08 16:58:39,55,9786,29,26,6612.20,11426.02,0.00
2024-12-08 16:58:39,54,9786,29,25,6702.92,11426.04,0.00
2024-12-08 16:58:39,54,9787,29,25,6720.42,11427.00,0.00
2024-12-08 16:58:39,55,9787,30,25,6598.23,11427.02,0.00
2024-12-08 16:58:39,54,9787,29,25,6646.41,11427.19,0.00
2024-12-08 16:58:39,54,9788,29,25,6765.45,11428.00,0.00
2024-12-08 16:58:39,55,9788,30,25,6642.44,11428.02,0.00
2024-12-08 16:58:39,56,9787,30,26,6523.83,11428.05,0.00
2024-12-08 16:58:39,55,9787,30,25,6708.95,11428.05,0.00
2024-12-08 16:58:39,55,9788,30,25,6726.15,11429.00,0.00
2024-12-08 16:58:39,56,9788,30,26,6606.04,11429.02,0.00
2024-12-08 16:58:39,57,9787,30,27,6422.07,11429.30,0.00
2024-12-08 16:58:39,57,9788,30,27,6760.19,11430.00,0.00
2024-12-08 16:58:39,58,9788,31,27,6643.64,11430.02,0.00
2024-12-08 16:58:39,57,9788,31,26,6734.14,11430.04,0.00
2024-12-08 16:58:39,56,9788,30,26,6853.27,11430.04,0.00
2024-12-08 16:58:39,56,9789,30,26,7070.23,11431.00,0.00
2024-12-08 16:58:39,57,9789,30,27,6946.19,11431.02,0.00
2024-12-08 16:58:39,57,9790,30,27,6916.32,11432.00,0.00
2024-12-08 16:58:39,58,9790,30,28,6797.07,11432.02,0.00
2024-12-08 16:58:39,57,9790,30,27,6888.26,11432.04,0.00
2024-12-08 16:58:39,57,9791,30,27,6898.87,11433.00,0.00
2024-12-08 16:58:39,58,9791,30,28,6779.93,11433.02,0.00
2024-12-08 16:58:39,58,9792,30,28,6749.99,11434.00,0.00
2024-12-08 16:58:39,59,9792,30,29,6635.59,11434.02,0.00
2024-12-08 16:58:39,58,9792,30,28,6724.38,11434.03,0.00
2024-12-08 16:58:39,58,9793,30,28,6732.84,11435.00,0.00
2024-12-08 16:58:39,59,9793,30,29,6618.72,11435.02,0.00
2024-12-08 16:58:39,58,9793,29,29,6616.48,11435.64,0.00
2024-12-08 16:58:39,58,9794,29,29,6772.48,11436.00,0.00
2024-12-08 16:58:39,59,9794,30,29,6657.70,11436.02,0.00
2024-12-08 16:58:39,58,9794,30,28,6748.84,11436.03,0.00
2024-12-08 16:58:39,57,9794,29,28,6755.71,11436.81,0.00
2024-12-08 16:58:39,57,9795,29,28,6934.43,11437.00,0.00
2024-12-08 16:58:39,58,9795,30,28,6814.87,11437.02,0.00
2024-12-08 16:58:39,58,9796,30,28,6784.75,11438.00,0.00
2024-12-08 16:58:39,59,9796,31,28,6669.76,11438.02,0.00
2024-12-08 16:58:39,58,9796,31,27,6759.13,11438.03,0.00
2024-12-08 16:58:39,58,9797,31,27,6767.60,11439.00,0.00
2024-12-08 16:58:39,59,9797,32,27,6652.89,11439.02,0.00
2024-12-08 16:58:39,58,9797,31,27,6659.50,11439.60,0.00
2024-12-08 16:58:39,58,9798,31,27,6736.80,11440.00,0.00
2024-12-08 16:58:39,59,9798,32,27,6622.61,11440.02,0.00
2024-12-08 16:58:39,58,9798,32,26,6711.17,11440.03,0.00
2024-12-08 16:58:39,57,9798,31,26,6684.60,11440.60,0.00
2024-12-08 16:58:39,58,9797,32,26,6549.72,11440.79,0.00
2024-12-08 16:58:40,58,9798,32,26,6745.19,11441.00,0.00
2024-12-08 16:58:40,59,9798,33,26,6630.86,11441.02,0.00
2024-12-08 16:58:40,59,9799,33,26,6798.36,11442.00,0.00
2024-12-08 16:58:40,60,9799,34,26,6685.05,11442.02,0.00
2024-12-08 16:58:40,59,9799,34,25,6769.28,11442.03,0.00
2024-12-08 16:58:40,58,9799,33,25,6805.26,11442.36,0.00
2024-12-08 16:58:40,57,9799,32,25,6897.65,11442.60,0.00
2024-12-08 16:58:40,57,9800,32,25,7052.53,11443.00,0.00
2024-12-08 16:58:40,58,9800,33,25,6930.94,11443.02,0.00
2024-12-08 16:58:40,58,9801,33,25,6905.48,11444.00,0.00
2024-12-08 16:58:40,59,9801,33,26,6788.44,11444.02,0.00
2024-12-08 16:58:40,58,9801,33,25,6864.08,11444.09,0.00
2024-12-08 16:58:40,59,9800,33,26,6674.87,11444.75,0.00
2024-12-08 16:58:40,59,9801,33,26,6789.54,11445.00,0.00
2024-12-08 16:58:40,60,9801,33,27,6676.38,11445.02,0.00
2024-12-08 16:58:40,60,9802,33,27,6838.08,11446.00,0.00
2024-12-08 16:58:40,61,9802,34,27,6725.99,11446.02,0.00
2024-12-08 16:58:40,60,9802,34,26,6798.05,11446.08,0.00
2024-12-08 16:58:40,59,9802,33,26,6783.18,11446.51,0.00
2024-12-08 16:58:40,59,9803,33,26,6921.30,11447.00,0.00
2024-12-08 16:58:40,60,9803,34,26,6805.94,11447.02,0.00
2024-12-08 16:58:40,59,9803,33,26,6811.73,11447.58,0.00
2024-12-08 16:58:40,58,9803,32,26,6925.24,11447.60,0.00
2024-12-08 16:58:40,58,9804,32,26,7052.71,11448.00,0.00
2024-12-08 16:58:40,59,9804,32,27,6933.17,11448.02,0.00
2024-12-08 16:58:40,58,9804,31,27,7000.05,11448.12,0.00
2024-12-08 16:58:40,58,9805,31,27,7038.71,11449.00,0.00
2024-12-08 16:58:40,59,9805,31,28,6919.41,11449.02,0.00
2024-12-08 16:58:40,59,9806,31,28,6877.10,11450.00,0.00
2024-12-08 16:58:40,60,9806,32,28,6762.48,11450.02,0.00
2024-12-08 16:58:40,59,9806,32,27,6851.15,11450.08,0.00
2024-12-08 16:58:40,60,9805,33,27,6681.85,11450.60,0.00
2024-12-08 16:58:40,59,9805,32,27,6718.45,11450.97,0.00
2024-12-08 16:58:40,59,9806,32,27,6905.96,11451.00,0.00
2024-12-08 16:58:40,60,9806,33,27,6790.87,11451.02,0.00
2024-12-08 16:58:40,60,9807,33,27,6943.77,11452.00,0.00
2024-12-08 16:58:40,61,9807,33,28,6829.94,11452.02,0.00
2024-12-08 16:58:40,60,9807,33,27,6911.35,11452.08,0.00
2024-12-08 16:58:40,60,9808,33,27,6913.26,11453.00,0.00
2024-12-08 16:58:40,61,9808,34,27,6799.93,11453.02,0.00
2024-12-08 16:58:40,61,9809,34,27,6757.19,11454.00,0.00
2024-12-08 16:58:40,62,9809,35,27,6648.20,11454.02,0.00
2024-12-08 16:58:40,61,9809,35,26,6715.91,11454.10,0.00
2024-12-08 16:58:40,60,9809,34,26,6806.99,11454.17,0.00
2024-12-08 16:58:40,60,9810,34,26,6886.60,11455.00,0.00
2024-12-08 16:58:40,61,9810,34,27,6773.70,11455.02,0.00
2024-12-08 16:58:40,61,9811,34,27,6726.95,11456.00,0.00
2024-12-08 16:58:40,62,9811,34,28,6618.45,11456.02,0.00
2024-12-08 16:58:40,61,9811,34,27,6687.54,11456.10,0.00
2024-12-08 16:58:40,61,9812,34,27,6682.49,11457.00,0.00
2024-12-08 16:58:40,62,9812,35,27,6574.71,11457.02,0.00
2024-12-08 16:58:40,61,9812,34,27,6581.18,11457.33,0.00
2024-12-08 16:58:40,61,9813,34,27,6680.39,11458.00,0.00
2024-12-08 16:58:40,62,9813,35,27,6572.64,11458.02,0.00
2024-12-08 16:58:40,61,9813,35,26,6642.85,11458.10,0.00
2024-12-08 16:58:40,61,9814,35,26,6642.90,11459.00,0.00
2024-12-08 16:58:40,62,9814,35,27,6535.76,11459.02,0.00
2024-12-08 16:58:40,62,9815,35,27,6495.17,11460.00,0.00
2024-12-08 16:58:40,63,9815,35,28,6392.07,11460.02,0.00
2024-12-08 16:58:40,62,9815,35,27,6460.07,11460.10,0.00
2024-12-08 16:58:40,62,9816,35,27,6459.24,11461.00,0.00
2024-12-08 16:58:40,63,9816,35,28,6356.72,11461.02,0.00
2024-12-08 16:58:40,62,9816,34,28,6279.35,11461.90,0.00
2024-12-08 16:58:40,62,9817,34,28,6453.19,11462.00,0.00
2024-12-08 16:58:40,63,9817,34,29,6350.76,11462.02,0.00
2024-12-08 16:58:40,62,9817,34,28,6419.94,11462.10,0.00
2024-12-08 16:58:40,61,9817,33,28,6455.66,11462.10,0.00
2024-12-08 16:58:40,60,9817,32,28,6559.44,11462.13,0.00
2024-12-08 16:58:40,60,9818,32,28,6642.08,11463.00,0.00
2024-12-08 16:58:40,61,9818,32,29,6533.20,11463.02,0.00
2024-12-08 16:58:40,61,9819,32,29,6497.21,11464.00,0.00
2024-12-08 16:58:40,62,9819,33,29,6392.41,11464.02,0.00
2024-12-08 16:58:40,61,9819,33,28,6454.01,11464.12,0.00
2024-12-08 16:58:40,60,9819,32,28,6537.03,11464.17,0.00
2024-12-08 16:58:40,60,9820,32,28,6623.43,11465.00,0.00
2024-12-08 16:58:40,61,9820,32,29,6514.85,11465.02,0.00
2024-12-08 16:58:40,62,9819,32,30,6332.23,11465.40,0.00
2024-12-08 16:58:40,62,9820,32,30,6452.38,11466.00,0.00
2024-12-08 16:58:40,63,9820,33,30,6349.96,11466.02,0.00
2024-12-08 16:58:40,62,9820,32,30,6439.46,11466.13,0.00
2024-12-08 16:58:41,62,9821,32,30,6590.76,11467.00,0.00
2024-12-08 16:58:41,63,9821,32,31,6486.14,11467.02,0.00
2024-12-08 16:58:41,62,9821,32,30,6568.60,11467.16,0.00
2024-12-08 16:58:41,63,9820,32,31,6411.81,11467.65,0.00
2024-12-08 16:58:41,63,9821,32,31,6510.69,11468.00,0.00
2024-12-08 16:58:41,64,9821,32,32,6408.96,11468.02,0.00
2024-12-08 16:58:41,63,9821,31,32,6402.70,11468.56,0.00
2024-12-08 16:58:41,63,9822,31,32,6700.32,11469.00,0.00
2024-12-08 16:58:41,64,9822,31,33,6595.62,11469.02,0.00
2024-12-08 16:58:41,64,9823,31,33,6533.21,11470.00,0.00
2024-12-08 16:58:41,65,9823,32,33,6432.70,11470.02,0.00
2024-12-08 16:58:41,64,9823,32,32,6515.32,11470.16,0.00
2024-12-08 16:58:41,63,9823,32,31,6545.75,11470.65,0.00
2024-12-08 16:58:41,62,9823,31,31,6577.45,11470.94,0.00
2024-12-08 16:58:41,62,9824,31,31,6755.11,11471.00,0.00
2024-12-08 16:58:41,63,9824,31,32,6647.89,11471.02,0.00
2024-12-08 16:58:41,62,9824,30,32,6617.60,11471.45,0.00
2024-12-08 16:58:41,62,9825,30,32,6723.23,11472.00,0.00
2024-12-08 16:58:41,63,9825,31,32,6616.51,11472.02,0.00
2024-12-08 16:58:41,62,9825,30,32,6515.64,11472.68,0.00
2024-12-08 16:58:41,62,9826,30,32,6663.93,11473.00,0.00
2024-12-08 16:58:41,63,9826,30,33,6558.16,11473.02,0.00
2024-12-08 16:58:41,62,9826,29,33,6649.03,11473.15,0.00
2024-12-08 16:58:41,61,9826,29,32,6754.27,11473.16,0.00
2024-12-08 16:58:41,60,9826,28,32,6804.99,11473.63,0.00
2024-12-08 16:58:41,60,9827,28,32,6877.96,11474.00,0.00
2024-12-08 16:58:41,61,9827,28,33,6765.20,11474.02,0.00
2024-12-08 16:58:41,60,9827,27,33,6841.63,11474.08,0.00
2024-12-08 16:58:41,60,9828,27,33,6887.38,11475.00,0.00
2024-12-08 16:58:41,61,9828,28,33,6774.47,11475.02,0.00
2024-12-08 16:58:41,60,9828,28,32,6833.85,11475.15,0.00
2024-12-08 16:58:41,60,9829,28,32,6844.98,11476.00,0.00
2024-12-08 16:58:41,61,9829,29,32,6732.77,11476.02,0.00
2024-12-08 16:58:41,60,9829,28,32,6841.16,11476.03,0.00
2024-12-08 16:58:41,59,9829,27,32,6945.87,11476.12,0.00
2024-12-08 16:58:41,59,9830,27,32,6936.74,11477.00,0.00
2024-12-08 16:58:41,60,9830,28,32,6821.13,11477.02,0.00
2024-12-08 16:58:41,60,9831,28,32,6776.21,11478.00,0.00
2024-12-08 16:58:41,61,9831,28,33,6665.12,11478.02,0.00
2024-12-08 16:58:41,60,9831,27,33,6772.39,11478.03,0.00
2024-12-08 16:58:41,59,9831,27,32,6869.69,11478.12,0.00
2024-12-08 16:58:41,59,9832,27,32,6876.63,11479.00,0.00
2024-12-08 16:58:41,60,9832,27,33,6762.02,11479.02,0.00
2024-12-08 16:58:41,59,9832,26,33,6872.75,11479.03,0.00
2024-12-08 16:58:41,59,9833,26,33,6851.30,11480.00,0.00
2024-12-08 16:58:41,60,9833,27,33,6737.12,11480.02,0.00
2024-12-08 16:58:41,61,9832,28,33,6540.28,11480.48,0.00
2024-12-08 16:58:41,60,9832,27,33,6620.21,11480.88,0.00
2024-12-08 16:58:41,60,9833,27,33,6798.25,11481.00,0.00
2024-12-08 16:58:41,61,9833,28,33,6686.80,11481.02,0.00
2024-12-08 16:58:41,60,9833,28,32,6781.05,11481.12,0.00
2024-12-08 16:58:41,60,9834,28,32,6973.29,11482.00,0.00
2024-12-08 16:58:41,61,9834,29,32,6858.98,11482.02,0.00
2024-12-08 16:58:41,60,9834,28,32,6861.71,11482.60,0.00
2024-12-08 16:58:41,60,9835,28,32,6939.12,11483.00,0.00
2024-12-08 16:58:41,61,9835,28,33,6825.36,11483.02,0.00
2024-12-08 16:58:41,61,9836,28,33,6773.76,11484.00,0.00
2024-12-08 16:58:41,62,9836,28,34,6664.51,11484.02,0.00
2024-12-08 16:58:41,61,9836,28,33,6758.72,11484.12,0.00
2024-12-08 16:58:41,61,9837,28,33,6752.51,11485.00,0.00
2024-12-08 16:58:41,62,9837,29,33,6643.60,11485.02,0.00
2024-12-08 16:58:41,62,9838,29,33,6634.35,11486.00,0.00
2024-12-08 16:58:41,63,9838,30,33,6529.04,11486.02,0.00
2024-12-08 16:58:41,63,9839,30,33,6500.15,11487.00,0.00
2024-12-08 16:58:41,64,9839,30,34,6398.59,11487.02,0.00
2024-12-08 16:58:41,64,9840,30,34,6349.26,11488.00,0.00
2024-12-08 16:58:41,65,9840,30,35,6251.58,11488.02,0.00
2024-12-08 16:58:41,64,9840,30,34,6331.33,11488.13,0.00
2024-12-08 16:58:41,64,9841,30,34,6333.00,11489.00,0.00
2024-12-08 16:58:41,65,9841,31,34,6235.57,11489.02,0.00
2024-12-08 16:58:41,65,9842,31,34,6240.86,11490.00,0.00
2024-12-08 16:58:41,66,9842,32,34,6146.31,11490.02,0.00
2024-12-08 16:58:41,65,9842,31,34,6210.82,11490.05,0.00
2024-12-08 16:58:41,65,9843,31,34,6240.53,11491.00,0.00
2024-12-08 16:58:41,66,9843,32,34,6145.98,11491.02,0.00
2024-12-08 16:58:41,65,9843,31,34,6231.02,11491.09,0.00
2024-12-08 16:58:41,65,9844,31,34,6208.74,11492.00,0.00
2024-12-08 16:58:41,66,9844,32,34,6114.66,11492.02,0.00
2024-12-08 16:58:41,65,9844,32,33,6175.16,11492.09,0.00
2024-12-08 16:58:42,65,9845,32,33,6177.24,11493.00,0.00
2024-12-08 16:58:42,66,9845,32,34,6083.65,11493.02,0.00
2024-12-08 16:58:42,66,9846,32,34,6074.34,11494.00,0.00
2024-12-08 16:58:42,67,9846,33,34,5983.67,11494.01,0.00
2024-12-08 16:58:42,66,9846,32,34,6066.46,11494.08,0.00
2024-12-08 16:58:42,66,9847,32,34,6039.95,11495.00,0.00
2024-12-08 16:58:42,67,9847,32,35,5949.80,11495.01,0.00
2024-12-08 16:58:42,66,9847,32,34,6015.58,11495.08,0.00
2024-12-08 16:58:42,66,9848,32,34,6014.35,11496.00,0.00
2024-12-08 16:58:42,67,9848,32,35,5924.58,11496.01,0.00
2024-12-08 16:58:42,66,9848,31,35,5958.65,11496.17,0.00
2024-12-08 16:58:42,66,9849,31,35,6037.52,11497.00,0.00
2024-12-08 16:58:42,67,9849,32,35,5947.41,11497.01,0.00
2024-12-08 16:58:42,66,9849,32,34,6002.69,11497.09,0.00
2024-12-08 16:58:42,66,9850,32,34,6002.07,11498.00,0.00
2024-12-08 16:58:42,67,9850,32,35,5912.49,11498.01,0.00
2024-12-08 16:58:42,66,9850,31,35,5949.84,11498.15,0.00
2024-12-08 16:58:42,65,9850,30,35,5981.51,11498.68,0.00
2024-12-08 16:58:42,65,9851,30,35,6064.83,11499.00,0.00
2024-12-08 16:58:42,66,9851,31,35,5972.94,11499.02,0.00
2024-12-08 16:58:42,65,9851,30,35,6061.30,11499.03,0.00
2024-12-08 16:58:42,64,9851,30,34,6125.47,11499.08,0.00
2024-12-08 16:58:42,64,9852,30,34,6126.20,11500.00,0.00
2024-12-08 16:58:42,65,9852,31,34,6031.95,11500.02,0.00
2024-12-08 16:58:42,64,9852,30,34,6008.51,11500.64,0.00
2024-12-08 16:58:42,64,9853,30,34,6145.78,11501.00,0.00
2024-12-08 16:58:42,65,9853,31,34,6051.23,11501.02,0.00
2024-12-08 16:58:42,66,9852,32,34,5959.55,11501.05,0.00
2024-12-08 16:58:42,65,9852,32,33,6150.34,11501.09,0.00
2024-12-08 16:58:42,66,9851,33,33,5980.82,11501.79,0.00
2024-12-08 16:58:42,66,9852,33,33,6223.38,11502.00,0.00
2024-12-08 16:58:42,67,9852,33,34,6130.49,11502.01,0.00
2024-12-08 16:58:42,66,9852,32,34,6175.04,11502.12,0.00
2024-12-08 16:58:42,65,9852,31,34,6145.56,11502.68,0.00
2024-12-08 16:58:42,65,9853,31,34,6637.90,11503.00,0.00
2024-12-08 16:58:42,66,9853,32,34,6537.32,11503.02,0.00
2024-12-08 16:58:42,65,9853,32,33,6609.60,11503.08,0.00
2024-12-08 16:58:42,64,9853,31,33,6679.67,11503.20,0.00
2024-12-08 16:58:42,64,9854,31,33,6766.71,11504.00,0.00
2024-12-08 16:58:42,65,9854,31,34,6662.60,11504.02,0.00
2024-12-08 16:58:42,64,9854,30,34,6716.41,11504.14,0.00
2024-12-08 16:58:42,64,9855,30,34,6728.82,11505.00,0.00
2024-12-08 16:58:42,65,9855,31,34,6625.30,11505.02,0.00
2024-12-08 16:58:42,64,9855,31,33,6701.87,11505.08,0.00
2024-12-08 16:58:42,63,9855,30,33,6746.70,11505.60,0.00
2024-12-08 16:58:42,63,9856,30,33,6810.24,11506.00,0.00
2024-12-08 16:58:42,64,9856,31,33,6703.83,11506.02,0.00
2024-12-08 16:58:42,63,9856,30,33,6806.60,11506.03,0.00
2024-12-08 16:58:42,62,9856,29,33,6831.09,11506.26,0.00
2024-12-08 16:58:42,62,9857,29,33,6931.46,11507.00,0.00
2024-12-08 16:58:42,63,9857,30,33,6821.44,11507.02,0.00
2024-12-08 16:58:42,62,9857,29,33,6925.72,11507.06,0.00
2024-12-08 16:58:42,61,9857,29,32,7001.54,11507.10,0.00
2024-12-08 16:58:42,61,9858,29,32,7010.60,11508.00,0.00
2024-12-08 16:58:42,62,9858,29,33,6897.52,11508.02,0.00
2024-12-08 16:58:42,62,9859,29,33,6889.42,11509.00,0.00
2024-12-08 16:58:42,63,9859,29,34,6780.06,11509.02,0.00
2024-12-08 16:58:42,64,9858,30,34,6566.56,11509.67,0.00
2024-12-08 16:58:42,63,9858,29,34,6655.65,11509.75,0.00
2024-12-08 16:58:42,63,9859,29,34,6809.30,11510.00,0.00
2024-12-08 16:58:42,64,9859,30,34,6702.90,11510.02,0.00
2024-12-08 16:58:42,63,9859,29,34,6789.22,11510.03,0.00
2024-12-08 16:58:42,63,9860,29,34,7007.22,11511.00,0.00
2024-12-08 16:58:42,64,9860,29,35,6897.73,11511.02,0.00
2024-12-08 16:58:42,63,9860,29,34,6970.70,11511.10,0.00
2024-12-08 16:58:42,63,9861,29,34,6976.77,11512.00,0.00
2024-12-08 16:58:42,64,9861,29,35,6867.75,11512.02,0.00
2024-12-08 16:58:42,64,9862,29,35,6838.01,11513.00,0.00
2024-12-08 16:58:42,65,9862,30,35,6732.81,11513.02,0.00
2024-12-08 16:58:42,64,9862,30,34,6789.47,11513.13,0.00
2024-12-08 16:58:42,64,9863,30,34,6797.23,11514.00,0.00
2024-12-08 16:58:42,65,9863,30,35,6692.66,11514.02,0.00
2024-12-08 16:58:42,65,9864,30,35,6664.91,11515.00,0.00
2024-12-08 16:58:42,66,9864,31,35,6563.93,11515.02,0.00
2024-12-08 16:58:42,65,9864,30,35,6640.12,11515.12,0.00
2024-12-08 16:58:42,64,9864,30,34,6706.09,11515.13,0.00
2024-12-08 16:58:42,64,9865,30,34,6785.81,11516.00,0.00
2024-12-08 16:58:42,65,9865,31,34,6681.42,11516.02,0.00
2024-12-08 16:58:43,65,9866,31,34,6653.02,11517.00,0.00
2024-12-08 16:58:43,66,9866,32,34,6552.22,11517.02,0.00
2024-12-08 16:58:43,65,9866,32,33,6605.20,11517.12,0.00
2024-12-08 16:58:43,65,9867,32,33,6611.07,11518.00,0.00
2024-12-08 16:58:43,66,9867,32,34,6510.90,11518.02,0.00
2024-12-08 16:58:43,66,9868,32,34,6484.54,11519.00,0.00
2024-12-08 16:58:43,67,9868,32,35,6387.75,11519.01,0.00
2024-12-08 16:58:43,66,9868,32,34,6475.48,11519.09,0.00
2024-12-08 16:58:43,65,9868,32,33,6536.12,11519.11,0.00
2024-12-08 16:58:43,64,9868,31,33,6489.78,11519.97,0.00
2024-12-08 16:58:43,64,9869,31,33,6666.19,11520.00,0.00
2024-12-08 16:58:43,65,9869,32,33,6563.64,11520.02,0.00
2024-12-08 16:58:43,65,9870,32,33,6536.77,11521.00,0.00
2024-12-08 16:58:43,66,9870,32,34,6437.73,11521.02,0.00
2024-12-08 16:58:43,67,9869,33,34,6334.78,11521.10,0.00
2024-12-08 16:58:43,66,9869,33,33,6563.51,11521.12,0.00
2024-12-08 16:58:43,66,9870,33,33,6567.54,11522.00,0.00
2024-12-08 16:58:43,67,9870,33,34,6469.52,11522.01,0.00
2024-12-08 16:58:43,67,9871,33,34,6652.72,11523.00,0.00
2024-12-08 16:58:43,68,9871,33,35,6554.88,11523.01,0.00
2024-12-08 16:58:43,68,9872,33,35,6558.73,11524.00,0.00
2024-12-08 16:58:43,69,9872,34,35,6463.68,11524.01,0.00
2024-12-08 16:58:43,68,9872,33,35,6453.82,11524.63,0.00
2024-12-08 16:58:43,68,9873,33,35,6549.53,11525.00,0.00
2024-12-08 16:58:43,69,9873,34,35,6454.61,11525.01,0.00
2024-12-08 16:58:43,69,9874,34,35,6418.18,11526.00,0.00
2024-12-08 16:58:43,70,9874,34,36,6326.49,11526.01,0.00
2024-12-08 16:58:43,69,9874,34,35,6384.79,11526.07,0.00
2024-12-08 16:58:43,68,9874,33,35,6337.99,11526.94,0.00
2024-12-08 16:58:43,68,9875,33,35,6500.76,11527.00,0.00
2024-12-08 16:58:43,69,9875,33,36,6406.55,11527.01,0.00
2024-12-08 16:58:43,68,9875,32,36,6345.13,11527.56,0.00
2024-12-08 16:58:43,68,9876,32,36,6463.46,11528.00,0.00
2024-12-08 16:58:43,69,9876,33,36,6369.79,11528.01,0.00
2024-12-08 16:58:43,68,9876,32,36,6459.37,11528.04,0.00
2024-12-08 16:58:43,67,9876,32,35,6528.25,11528.07,0.00
2024-12-08 16:58:43,66,9876,31,35,6564.17,11528.33,0.00
2024-12-08 16:58:43,66,9877,31,35,6660.44,11529.00,0.00
2024-12-08 16:58:43,67,9877,31,36,6561.03,11529.01,0.00
2024-12-08 16:58:43,67,9878,31,36,6519.81,11530.00,0.00
2024-12-08 16:58:43,68,9878,32,36,6423.93,11530.01,0.00
2024-12-08 16:58:43,67,9878,31,36,6516.38,11530.03,0.00
2024-12-08 16:58:43,66,9878,31,35,6588.91,11530.06,0.00
2024-12-08 16:58:43,66,9879,31,35,6583.76,11531.00,0.00
2024-12-08 16:58:43,67,9879,32,35,6485.50,11531.01,0.00
2024-12-08 16:58:43,66,9879,31,35,6580.43,11531.03,0.00
2024-12-08 16:58:43,65,9879,30,35,6582.32,11531.06,0.00
2024-12-08 16:58:43,65,9880,30,35,6649.94,11532.00,0.00
2024-12-08 16:58:43,66,9880,31,35,6549.19,11532.02,0.00
2024-12-08 16:58:43,65,9880,31,34,6625.12,11532.05,0.00
2024-12-08 16:58:43,65,9881,31,34,6619.91,11533.00,0.00
2024-12-08 16:58:43,66,9881,31,35,6519.60,11533.02,0.00
2024-12-08 16:58:43,65,9881,30,35,6502.84,11533.14,0.00
2024-12-08 16:58:43,65,9882,30,35,6579.30,11534.00,0.00
2024-12-08 16:58:43,66,9882,31,35,6479.61,11534.02,0.00
2024-12-08 16:58:43,65,9882,31,34,6554.47,11534.05,0.00
2024-12-08 16:58:43,65,9883,31,34,6549.61,11535.00,0.00
2024-12-08 16:58:43,66,9883,32,34,6450.37,11535.02,0.00
2024-12-08 16:58:43,65,9883,31,34,6546.86,11535.03,0.00
2024-12-08 16:58:43,65,9884,31,34,6507.52,11536.00,0.00
2024-12-08 16:58:43,66,9884,31,35,6408.92,11536.02,0.00
2024-12-08 16:58:43,65,9884,31,34,6488.01,11536.03,0.00
2024-12-08 16:58:43,65,9885,31,34,6481.78,11537.00,0.00
2024-12-08 16:58:43,66,9885,32,34,6383.57,11537.02,0.00
2024-12-08 16:58:43,66,9886,32,34,6342.14,11538.00,0.00
2024-12-08 16:58:43,67,9886,33,34,6247.48,11538.01,0.00
2024-12-08 16:58:43,66,9886,33,33,6322.92,11538.03,0.00
2024-12-08 16:58:43,66,9887,33,33,6316.04,11539.00,0.00
2024-12-08 16:58:43,67,9887,34,33,6221.78,11539.01,0.00
2024-12-08 16:58:43,66,9887,33,33,6200.80,11539.39,0.00
2024-12-08 16:58:43,66,9888,33,33,6306.10,11540.00,0.00
2024-12-08 16:58:43,67,9888,34,33,6211.98,11540.01,0.00
2024-12-08 16:58:43,66,9888,34,32,6290.37,11540.03,0.00
2024-12-08 16:58:43,66,9889,34,32,6283.92,11541.00,0.00
2024-12-08 16:58:43,67,9889,35,32,6190.13,11541.01,0.00
2024-12-08 16:58:43,66,9889,34,32,6233.25,11541.15,0.00
2024-12-08 16:58:43,66,9890,34,32,6241.29,11542.00,0.00
2024-12-08 16:58:43,67,9890,34,33,6148.13,11542.01,0.00
2024-12-08 16:58:43,66,9890,34,32,6227.30,11542.03,0.00
2024-12-08 16:58:43,66,9891,34,32,6220.84,11543.00,0.00
2024-12-08 16:58:43,67,9891,35,32,6127.99,11543.01,0.00
2024-12-08 16:58:43,66,9891,34,32,6176.01,11543.09,0.00
2024-12-08 16:58:44,66,9892,34,32,6176.52,11544.00,0.00
2024-12-08 16:58:44,67,9892,35,32,6084.33,11544.01,0.00
2024-12-08 16:58:44,66,9892,35,31,6164.29,11544.03,0.00
2024-12-08 16:58:44,67,9891,35,32,5993.36,11544.75,0.00
2024-12-08 16:58:44,67,9892,35,32,6096.92,11545.00,0.00
2024-12-08 16:58:44,68,9892,35,33,6007.26,11545.01,0.00
2024-12-08 16:58:44,68,9893,35,33,6133.87,11546.00,0.00
2024-12-08 16:58:44,69,9893,35,34,6044.98,11546.01,0.00
2024-12-08 16:58:44,68,9893,35,33,6122.00,11546.03,0.00
2024-12-08 16:58:44,67,9893,34,33,6099.30,11546.55,0.00
2024-12-08 16:58:44,67,9894,34,33,6220.24,11547.00,0.00
2024-12-08 16:58:44,68,9894,35,33,6128.76,11547.01,0.00
2024-12-08 16:58:44,67,9894,34,33,6105.27,11547.40,0.00
2024-12-08 16:58:44,67,9895,34,33,6209.07,11548.00,0.00
2024-12-08 16:58:44,68,9895,34,34,6117.76,11548.01,0.00
2024-12-08 16:58:44,67,9895,34,33,6197.01,11548.03,0.00
2024-12-08 16:58:44,68,9894,35,33,6032.99,11548.66,0.00
2024-12-08 16:58:44,68,9895,35,33,6133.43,11549.00,0.00
2024-12-08 16:58:44,69,9895,36,33,6044.54,11549.01,0.00
2024-12-08 16:58:44,69,9896,36,33,6163.23,11550.00,0.00
2024-12-08 16:58:44,70,9896,37,33,6075.19,11550.01,0.00
2024-12-08 16:58:44,69,9896,37,32,6153.20,11550.03,0.00
2024-12-08 16:58:44,70,9895,37,33,6020.50,11550.40,0.00
2024-12-08 16:58:44,70,9896,37,33,6118.25,11551.00,0.00
2024-12-08 16:58:44,71,9896,37,34,6032.08,11551.01,0.00
2024-12-08 16:58:44,70,9896,36,34,6040.77,11551.26,0.00
2024-12-08 16:58:44,70,9897,36,34,6280.78,11552.00,0.00
2024-12-08 16:58:44,71,9897,36,35,6192.32,11552.01,0.00
2024-12-08 16:58:44,70,9897,36,34,6267.58,11552.03,0.00
2024-12-08 16:58:44,69,9897,35,34,6343.39,11552.16,0.00
2024-12-08 16:58:44,68,9897,34,34,6380.08,11552.62,0.00
2024-12-08 16:58:44,68,9898,34,34,6438.11,11553.00,0.00
2024-12-08 16:58:44,69,9898,34,35,6344.80,11553.01,0.00
2024-12-08 16:58:44,68,9898,33,35,6340.51,11553.32,0.00
2024-12-08 16:58:44,68,9899,33,35,6432.70,11554.00,0.00
2024-12-08 16:58:44,69,9899,34,35,6339.47,11554.01,0.00
2024-12-08 16:58:44,68,9899,34,34,6420.81,11554.03,0.00
2024-12-08 16:58:44,67,9899,33,34,6502.19,11554.15,0.00
2024-12-08 16:58:44,67,9900,33,34,6507.14,11555.00,0.00
2024-12-08 16:58:44,68,9900,34,34,6411.45,11555.01,0.00
2024-12-08 16:58:44,68,9901,34,34,6367.27,11556.00,0.00
2024-12-08 16:58:44,69,9901,34,35,6274.99,11556.01,0.00
2024-12-08 16:58:44,68,9901,34,34,6351.99,11556.03,0.00
2024-12-08 16:58:44,67,9901,33,34,6374.13,11556.66,0.00
2024-12-08 16:58:44,67,9902,33,34,6436.67,11557.00,0.00
2024-12-08 16:58:44,68,9902,34,34,6342.01,11557.01,0.00
2024-12-08 16:58:44,67,9902,33,34,6397.87,11557.04,0.00
2024-12-08 16:58:44,67,9903,33,34,6389.27,11558.00,0.00
2024-12-08 16:58:44,68,9903,34,34,6295.31,11558.01,0.00
2024-12-08 16:58:44,67,9903,34,33,6375.47,11558.03,0.00
2024-12-08 16:58:44,66,9903,33,33,6400.58,11558.65,0.00
2024-12-08 16:58:44,65,9903,32,33,6429.27,11558.97,0.00
2024-12-08 16:58:44,65,9904,32,33,6603.56,11559.00,0.00
2024-12-08 16:58:44,66,9904,33,33,6503.50,11559.02,0.00
2024-12-08 16:58:44,67,9903,34,33,6208.53,11559.85,0.00
2024-12-08 16:58:44,67,9904,34,33,6379.17,11560.00,0.00
2024-12-08 16:58:44,68,9904,35,33,6285.36,11560.01,0.00
2024-12-08 16:58:44,67,9904,35,32,6373.85,11560.04,0.00
2024-12-08 16:58:44,67,9905,35,32,6534.39,11561.00,0.00
2024-12-08 16:58:44,68,9905,36,32,6438.29,11561.01,0.00
2024-12-08 16:58:44,67,9905,35,32,6530.94,11561.03,0.00
2024-12-08 16:58:44,68,9904,36,32,6348.55,11561.47,0.00
2024-12-08 16:58:44,67,9904,35,32,6484.81,11561.64,0.00
2024-12-08 16:58:44,67,9905,35,32,6615.73,11562.00,0.00
2024-12-08 16:58:44,68,9905,36,32,6518.44,11562.01,0.00
2024-12-08 16:58:44,67,9905,36,31,6601.93,11562.03,0.00
2024-12-08 16:58:44,67,9906,36,31,6758.01,11563.00,0.00
2024-12-08 16:58:44,68,9906,36,32,6658.63,11563.01,0.00
2024-12-08 16:58:44,68,9907,36,32,6601.71,11564.00,0.00
2024-12-08 16:58:44,69,9907,37,32,6506.04,11564.01,0.00
2024-12-08 16:58:44,68,9907,37,31,6583.00,11564.06,0.00
2024-12-08 16:58:44,68,9908,37,31,6560.43,11565.00,0.00
2024-12-08 16:58:44,69,9908,38,31,6465.36,11565.01,0.00
2024-12-08 16:58:44,68,9908,37,31,6478.94,11565.12,0.00
2024-12-08 16:58:44,68,9909,37,31,6528.53,11566.00,0.00
2024-12-08 16:58:44,69,9909,37,32,6433.92,11566.01,0.00
2024-12-08 16:58:44,68,9909,37,31,6506.44,11566.06,0.00
2024-12-08 16:58:44,68,9910,37,31,6480.18,11567.00,0.00
2024-12-08 16:58:44,69,9910,38,31,6386.26,11567.01,0.00
2024-12-08 16:58:44,68,9910,37,31,6422.15,11567.15,0.00
2024-12-08 16:58:44,68,9911,37,31,6473.91,11568.00,0.00
2024-12-08 16:58:44,69,9911,37,32,6380.09,11568.01,0.00
2024-12-08 16:58:44,68,9911,37,31,6453.51,11568.06,0.00
2024-12-08 16:58:45,68,9912,37,31,6428.87,11569.00,0.00
2024-12-08 16:58:45,69,9912,37,32,6335.70,11569.01,0.00
2024-12-08 16:58:45,69,9912,37,32,6275.82,11570.00,0.00
2024-12-08 16:58:45,70,9912,38,32,6186.16,11570.01,0.00
2024-12-08 16:58:45,69,9912,38,31,6255.71,11570.06,0.00
2024-12-08 16:58:45,68,9912,37,31,6197.75,11570.97,0.00
2024-12-08 16:58:45,68,9913,37,31,6364.53,11571.00,0.00
2024-12-08 16:58:45,69,9913,38,31,6272.29,11571.01,0.00
2024-12-08 16:58:45,68,9913,37,31,6311.61,11571.16,0.00
2024-12-08 16:58:45,67,9913,36,31,6306.58,11571.51,0.00
2024-12-08 16:58:45,67,9914,36,31,6422.64,11572.00,0.00
2024-12-08 16:58:45,68,9914,36,32,6328.19,11572.01,0.00
2024-12-08 16:58:45,67,9914,36,31,6396.75,11572.07,0.00
2024-12-08 16:58:45,67,9915,36,31,6383.90,11573.00,0.00
2024-12-08 16:58:45,68,9915,36,32,6290.02,11573.01,0.00
2024-12-08 16:58:45,68,9916,36,32,6236.40,11574.00,0.00
2024-12-08 16:58:45,69,9916,37,32,6146.02,11574.01,0.00
2024-12-08 16:58:45,68,9916,37,31,6209.19,11574.09,0.00
2024-12-08 16:58:45,67,9916,36,31,6278.50,11574.16,0.00
2024-12-08 16:58:45,66,9916,36,30,6357.23,11574.27,0.00
2024-12-08 16:58:45,66,9917,36,30,6433.26,11575.00,0.00
2024-12-08 16:58:45,67,9917,36,31,6337.24,11575.01,0.00
2024-12-08 16:58:45,67,9918,36,31,6310.46,11576.00,0.00
2024-12-08 16:58:45,68,9918,37,31,6217.66,11576.01,0.00
2024-12-08 16:58:45,68,9919,37,31,6172.62,11577.00,0.00
2024-12-08 16:58:45,69,9919,37,32,6083.16,11577.01,0.00
2024-12-08 16:58:45,69,9920,37,32,6010.91,11578.00,0.00
2024-12-08 16:58:45,70,9920,38,32,5925.04,11578.01,0.00
2024-12-08 16:58:45,69,9920,38,31,5980.72,11578.09,0.00
2024-12-08 16:58:45,69,9921,38,31,5939.81,11579.00,0.00
2024-12-08 16:58:45,70,9921,39,31,5854.96,11579.01,0.00
2024-12-08 16:58:45,69,9921,39,30,5928.01,11579.09,0.00
2024-12-08 16:58:45,68,9921,38,30,5956.78,11579.54,0.00
2024-12-08 16:58:45,68,9922,38,30,6048.23,11580.00,0.00
2024-12-08 16:58:45,69,9922,39,30,5960.58,11580.01,0.00
2024-12-08 16:58:45,68,9922,39,29,6022.57,11580.10,0.00
2024-12-08 16:58:45,68,9923,39,29,5993.39,11581.00,0.00
2024-12-08 16:58:45,69,9923,39,30,5906.53,11581.01,0.00
2024-12-08 16:58:45,68,9923,38,30,5940.63,11581.18,0.00
2024-12-08 16:58:45,67,9923,38,29,5947.52,11581.76,0.00
2024-12-08 16:58:45,67,9924,38,29,6035.79,11582.00,0.00
2024-12-08 16:58:45,68,9924,38,30,5947.03,11582.01,0.00
2024-12-08 16:58:45,67,9924,38,29,6006.42,11582.10,0.00
2024-12-08 16:58:45,67,9925,38,29,6000.37,11583.00,0.00
2024-12-08 16:58:45,68,9925,38,30,5912.13,11583.01,0.00
2024-12-08 16:58:45,68,9926,38,30,5870.09,11584.00,0.00
2024-12-08 16:58:45,69,9926,38,31,5785.01,11584.01,0.00
2024-12-08 16:58:45,68,9926,37,31,5829.21,11584.07,0.00
2024-12-08 16:58:45,67,9926,37,30,5895.47,11584.09,0.00
2024-12-08 16:58:45,67,9927,37,30,5953.15,11585.00,0.00
2024-12-08 16:58:45,68,9927,38,30,5865.60,11585.01,0.00
2024-12-08 16:58:45,69,9926,38,31,5624.11,11585.65,0.00
2024-12-08 16:58:45,69,9927,38,31,5820.93,11586.00,0.00
2024-12-08 16:58:45,70,9927,38,32,5737.77,11586.01,0.00
2024-12-08 16:58:45,69,9927,37,32,5811.55,11586.09,0.00
2024-12-08 16:58:45,68,9927,37,31,5874.86,11586.09,0.00
2024-12-08 16:58:45,68,9928,37,31,6017.90,11587.00,0.00
2024-12-08 16:58:45,69,9928,38,31,5930.68,11587.01,0.00
2024-12-08 16:58:45,69,9929,38,31,5869.19,11588.00,0.00
2024-12-08 16:58:45,70,9929,38,32,5785.34,11588.01,0.00
2024-12-08 16:58:45,69,9929,38,31,5840.65,11588.09,0.00
2024-12-08 16:58:45,68,9929,37,31,5869.40,11588.57,0.00
2024-12-08 16:58:45,68,9930,37,31,5890.19,11589.00,0.00
2024-12-08 16:58:45,69,9930,37,32,5804.82,11589.01,0.00
2024-12-08 16:58:45,69,9931,37,32,5737.30,11590.00,0.00
2024-12-08 16:58:45,70,9931,38,32,5655.34,11590.01,0.00
2024-12-08 16:58:45,69,9931,37,32,5732.27,11590.04,0.00
2024-12-08 16:58:45,68,9931,37,31,5792.71,11590.07,0.00
2024-12-08 16:58:45,67,9931,36,31,5796.15,11590.57,0.00
2024-12-08 16:58:45,67,9932,36,31,5893.74,11591.00,0.00
2024-12-08 16:58:45,68,9932,37,31,5807.07,11591.01,0.00
2024-12-08 16:58:45,67,9932,37,30,5875.65,11591.07,0.00
2024-12-08 16:58:45,67,9933,37,30,5830.39,11592.00,0.00
2024-12-08 16:58:45,68,9933,38,30,5744.65,11592.01,0.00
2024-12-08 16:58:45,67,9933,37,30,5771.57,11592.07,0.00
2024-12-08 16:58:45,66,9933,37,29,5839.53,11592.09,0.00
2024-12-08 16:58:45,65,9933,36,29,5924.04,11592.14,0.00
2024-12-08 16:58:45,64,9933,35,29,5943.78,11592.67,0.00
2024-12-08 16:58:45,64,9934,35,29,6051.92,11593.00,0.00
2024-12-08 16:58:45,65,9934,36,29,5958.81,11593.02,0.00
2024-12-08 16:58:45,64,9934,35,29,5952.38,11593.33,0.00
2024-12-08 16:58:45,63,9934,35,28,5958.00,11593.89,0.00
2024-12-08 16:58:45,63,9935,35,28,6129.24,11594.00,0.00
2024-12-08 16:58:45,64,9935,35,29,6033.47,11594.02,0.00
2024-12-08 16:58:45,63,9935,35,28,6094.29,11594.10,0.00
2024-12-08 16:58:46,63,9936,35,28,6083.45,11595.00,0.00
2024-12-08 16:58:46,64,9936,35,29,5988.40,11595.02,0.00
2024-12-08 16:58:46,63,9936,34,29,6027.07,11595.16,0.00
2024-12-08 16:58:46,63,9937,34,29,6097.81,11596.00,0.00
2024-12-08 16:58:46,64,9937,34,30,6002.53,11596.02,0.00
2024-12-08 16:58:46,63,9937,34,29,6062.85,11596.10,0.00
2024-12-08 16:58:46,62,9937,33,29,6095.17,11596.10,0.00
2024-12-08 16:58:46,62,9938,33,29,6163.25,11597.00,0.00
2024-12-08 16:58:46,63,9938,34,29,6065.42,11597.02,0.00
2024-12-08 16:58:46,62,9938,33,29,6092.21,11597.19,0.00
2024-12-08 16:58:46,61,9938,32,29,6142.17,11597.59,0.00
2024-12-08 16:58:46,61,9939,32,29,6273.70,11598.00,0.00
2024-12-08 16:58:46,62,9939,33,29,6172.51,11598.02,0.00
2024-12-08 16:58:46,61,9939,33,28,6231.89,11598.12,0.00
2024-12-08 16:58:46,61,9940,33,28,6229.82,11599.00,0.00
2024-12-08 16:58:46,62,9940,34,28,6129.34,11599.02,0.00
2024-12-08 16:58:46,62,9941,34,28,6092.38,11600.00,0.00
2024-12-08 16:58:46,63,9941,35,28,5995.67,11600.02,0.00
2024-12-08 16:58:46,62,9941,35,27,6049.36,11600.11,0.00
2024-12-08 16:58:46,61,9941,34,27,6087.92,11600.62,0.00
2024-12-08 16:58:46,61,9942,34,27,6138.04,11601.00,0.00
2024-12-08 16:58:46,62,9942,34,28,6039.04,11601.02,0.00
2024-12-08 16:58:46,61,9942,33,28,6136.14,11601.02,0.00
2024-12-08 16:58:46,60,9942,32,28,6234.54,11601.03,0.00
2024-12-08 16:58:46,60,9943,32,28,6203.25,11602.00,0.00
2024-12-08 16:58:46,61,9943,33,28,6101.56,11602.02,0.00
2024-12-08 16:58:46,60,9943,32,28,6176.17,11602.08,0.00
2024-12-08 16:58:46,59,9943,31,28,6280.85,11602.08,0.00
2024-12-08 16:58:46,58,9943,31,27,6347.14,11602.09,0.00
2024-12-08 16:58:46,58,9944,31,27,6419.89,11603.00,0.00
2024-12-08 16:58:46,59,9944,31,28,6311.08,11603.02,0.00
2024-12-08 16:58:46,59,9945,31,28,6277.63,11604.00,0.00
2024-12-08 16:58:46,60,9945,32,28,6173.00,11604.02,0.00
2024-12-08 16:58:46,59,9945,31,28,6267.81,11604.08,0.00
2024-12-08 16:58:46,58,9945,31,27,6333.86,11604.09,0.00
2024-12-08 16:58:46,57,9945,30,27,6306.44,11604.58,0.00
2024-12-08 16:58:46,57,9946,30,27,6461.49,11605.00,0.00
2024-12-08 16:58:46,58,9946,31,27,6350.08,11605.02,0.00
2024-12-08 16:58:46,58,9947,31,27,6337.55,11606.00,0.00
2024-12-08 16:58:46,59,9947,32,27,6230.14,11606.02,0.00
2024-12-08 16:58:46,58,9947,32,26,6289.54,11606.09,0.00
2024-12-08 16:58:46,58,9948,32,26,6304.08,11607.00,0.00
2024-12-08 16:58:46,59,9948,32,27,6197.23,11607.02,0.00
2024-12-08 16:58:46,59,9949,32,27,6183.85,11608.00,0.00
2024-12-08 16:58:46,60,9949,32,28,6080.78,11608.02,0.00
2024-12-08 16:58:46,59,9949,32,27,6138.60,11608.08,0.00
2024-12-08 16:58:46,58,9949,31,27,6164.77,11608.62,0.00
2024-12-08 16:58:46,58,9950,31,27,6321.18,11609.00,0.00
2024-12-08 16:58:46,59,9950,32,27,6214.04,11609.02,0.00
2024-12-08 16:58:46,58,9950,31,27,6319.18,11609.02,0.00
2024-12-08 16:58:46,57,9950,30,27,6428.00,11609.02,0.00
2024-12-08 16:58:46,57,9951,30,27,6418.62,11610.00,0.00
2024-12-08 16:58:46,58,9951,31,27,6307.95,11610.02,0.00
2024-12-08 16:58:46,57,9951,31,26,6375.85,11610.05,0.00
2024-12-08 16:58:46,56,9951,30,26,6489.71,11610.05,0.00
2024-12-08 16:58:46,55,9951,29,26,6558.88,11610.47,0.00
2024-12-08 16:58:46,55,9952,29,26,6624.72,11611.00,0.00
2024-12-08 16:58:46,56,9952,30,26,6506.42,11611.02,0.00
2024-12-08 16:58:46,55,9952,29,26,6618.46,11611.05,0.00
2024-12-08 16:58:46,54,9952,28,26,6621.62,11611.28,0.00
2024-12-08 16:58:46,54,9953,28,26,6753.28,11612.00,0.00
2024-12-08 16:58:46,55,9953,29,26,6630.49,11612.02,0.00
2024-12-08 16:58:46,54,9953,29,25,6732.18,11612.06,0.00
2024-12-08 16:58:46,53,9953,28,25,6843.63,11612.19,0.00
2024-12-08 16:58:46,52,9953,27,25,6954.47,11612.37,0.00
2024-12-08 16:58:46,52,9954,27,25,7015.23,11613.00,0.00
2024-12-08 16:58:46,53,9954,27,26,6882.87,11613.02,0.00
2024-12-08 16:58:46,53,9955,27,26,6866.17,11614.00,0.00
2024-12-08 16:58:46,54,9955,28,26,6739.02,11614.02,0.00
2024-12-08 16:58:46,53,9955,28,25,6822.36,11614.06,0.00
2024-12-08 16:58:46,52,9955,27,25,6926.54,11614.13,0.00
2024-12-08 16:58:46,52,9956,27,25,7049.94,11615.00,0.00
2024-12-08 16:58:46,53,9956,28,25,6916.93,11615.02,0.00
2024-12-08 16:58:46,53,9957,28,25,6899.08,11616.00,0.00
2024-12-08 16:58:46,54,9957,28,26,6771.32,11616.02,0.00
2024-12-08 16:58:46,53,9957,28,25,6857.44,11616.06,0.00
2024-12-08 16:58:46,53,9957,28,25,6879.94,11617.00,0.00
2024-12-08 16:58:46,54,9957,28,26,6752.54,11617.02,0.00
2024-12-08 16:58:46,54,9958,28,26,6733.28,11618.00,0.00
2024-12-08 16:58:46,55,9958,29,26,6610.85,11618.02,0.00
2024-12-08 16:58:46,56,9957,29,27,6492.80,11618.05,0.00
2024-12-08 16:58:46,55,9957,29,26,6725.38,11618.07,0.00
2024-12-08 16:58:46,54,9957,28,26,6848.26,11618.07,0.00
2024-12-08 16:58:46,54,9958,28,26,6956.41,11619.00,0.00
2024-12-08 16:58:46,55,9958,28,27,6829.93,11619.02,0.00
2024-12-08 16:58:46,55,9959,28,27,7022.98,11620.00,0.00
2024-12-08 16:58:46,56,9959,28,28,6897.57,11620.02,0.00
2024-12-08 16:58:46,55,9959,28,27,6982.86,11620.05,0.00
2024-12-08 16:58:47,55,9960,28,27,7000.34,11621.00,0.00
2024-12-08 16:58:47,56,9960,29,27,6875.34,11621.02,0.00
2024-12-08 16:58:47,56,9961,29,27,6866.67,11622.00,0.00
2024-12-08 16:58:47,57,9961,29,28,6746.20,11622.02,0.00
2024-12-08 16:58:47,56,9961,28,28,6860.46,11622.07,0.00
2024-12-08 16:58:47,56,9962,28,28,6835.40,11623.00,0.00
2024-12-08 16:58:47,57,9962,29,28,6715.48,11623.02,0.00
2024-12-08 16:58:47,56,9962,29,27,6814.68,11623.13,0.00
2024-12-08 16:58:47,56,9963,29,27,6836.02,11624.00,0.00
2024-12-08 16:58:47,57,9963,30,27,6716.08,11624.02,0.00
2024-12-08 16:58:47,57,9964,30,27,6704.03,11625.00,0.00
2024-12-08 16:58:47,58,9964,31,27,6588.45,11625.02,0.00
2024-12-08 16:58:47,57,9964,30,27,6585.22,11625.23,0.00
2024-12-08 16:58:47,57,9965,30,27,6699.94,11626.00,0.00
2024-12-08 16:58:47,58,9965,31,27,6584.42,11626.02,0.00
2024-12-08 16:58:47,57,9965,30,27,6689.77,11626.11,0.00
2024-12-08 16:58:47,56,9965,30,26,6803.00,11626.11,0.00
2024-12-08 16:58:47,56,9966,30,26,6824.32,11627.00,0.00
2024-12-08 16:58:47,57,9966,30,27,6704.59,11627.02,0.00
2024-12-08 16:58:47,57,9967,30,27,6692.00,11628.00,0.00
2024-12-08 16:58:47,58,9967,31,27,6576.62,11628.02,0.00
2024-12-08 16:58:47,58,9968,31,27,6543.10,11629.00,0.00
2024-12-08 16:58:47,59,9968,32,27,6432.20,11629.02,0.00
2024-12-08 16:58:47,58,9968,32,26,6531.10,11629.10,0.00
2024-12-08 16:58:47,58,9969,32,26,6547.68,11630.00,0.00
2024-12-08 16:58:47,59,9969,33,26,6436.70,11630.02,0.00
2024-12-08 16:58:47,58,9969,32,26,6543.44,11630.05,0.00
2024-12-08 16:58:47,57,9969,31,26,6487.67,11630.65,0.00
2024-12-08 16:58:47,57,9970,31,26,6651.16,11631.00,0.00
2024-12-08 16:58:47,58,9970,32,26,6536.48,11631.02,0.00
2024-12-08 16:58:47,58,9971,32,26,6502.95,11632.00,0.00
2024-12-08 16:58:47,59,9971,33,26,6392.73,11632.02,0.00
2024-12-08 16:58:47,58,9971,32,26,6498.95,11632.03,0.00
2024-12-08 16:58:47,57,9971,32,25,6606.86,11632.07,0.00
2024-12-08 16:58:47,57,9972,32,25,6621.69,11633.00,0.00
2024-12-08 16:58:47,58,9972,32,26,6507.52,11633.02,0.00
2024-12-08 16:58:47,58,9973,32,26,6491.49,11634.00,0.00
2024-12-08 16:58:47,59,9973,32,27,6381.46,11634.02,0.00
2024-12-08 16:58:47,58,9973,32,26,6445.38,11634.07,0.00
2024-12-08 16:58:47,58,9974,32,26,6457.22,11635.00,0.00
2024-12-08 16:58:47,59,9974,33,26,6347.78,11635.02,0.00
2024-12-08 16:58:47,59,9975,33,26,6322.22,11636.00,0.00
2024-12-08 16:58:47,60,9975,34,26,6216.85,11636.02,0.00
2024-12-08 16:58:47,59,9975,34,25,6289.00,11636.07,0.00
2024-12-08 16:58:47,58,9975,33,25,6281.34,11636.47,0.00
2024-12-08 16:58:47,58,9976,33,25,6419.12,11637.00,0.00
2024-12-08 16:58:47,59,9976,33,26,6310.32,11637.02,0.00
2024-12-08 16:58:47,58,9976,32,26,6324.18,11637.47,0.00
2024-12-08 16:58:47,58,9977,32,26,6395.99,11638.00,0.00
2024-12-08 16:58:47,59,9977,33,26,6287.58,11638.02,0.00
2024-12-08 16:58:47,58,9977,33,25,6362.25,11638.07,0.00
2024-12-08 16:58:47,58,9978,33,25,6373.63,11639.00,0.00
2024-12-08 16:58:47,59,9978,34,25,6265.61,11639.02,0.00
2024-12-08 16:58:47,58,9978,33,25,6265.14,11639.57,0.00
2024-12-08 16:58:47,58,9979,33,25,6414.72,11640.00,0.00
2024-12-08 16:58:47,59,9979,33,26,6306.00,11640.02,0.00
2024-12-08 16:58:47,58,9979,32,26,6317.52,11640.50,0.00
2024-12-08 16:58:47,58,9980,32,26,6372.19,11641.00,0.00
2024-12-08 16:58:47,59,9980,32,27,6264.19,11641.02,0.00
2024-12-08 16:58:47,58,9980,32,26,6364.19,11641.07,0.00
2024-12-08 16:58:47,58,9981,32,26,6366.29,11642.00,0.00
2024-12-08 16:58:47,59,9981,33,26,6258.38,11642.02,0.00
2024-12-08 16:58:47,59,9982,33,26,6231.84,11643.00,0.00
2024-12-08 16:58:47,60,9982,34,26,6127.97,11643.02,0.00
2024-12-08 16:58:47,59,9982,34,25,6186.47,11643.07,0.00
2024-12-08 16:58:47,59,9983,34,25,6183.43,11644.00,0.00
2024-12-08 16:58:47,60,9983,35,25,6080.37,11644.02,0.00
2024-12-08 16:58:47,61,9982,35,26,5921.58,11644.23,0.00
2024-12-08 16:58:47,60,9982,34,26,6065.77,11644.35,0.00
2024-12-08 16:58:47,60,9983,34,26,6169.95,11645.00,0.00
2024-12-08 16:58:47,61,9983,34,27,6068.80,11645.02,0.00
2024-12-08 16:58:47,60,9983,34,26,6127.27,11645.07,0.00
2024-12-08 16:58:47,60,9984,34,26,6312.75,11646.00,0.00
2024-12-08 16:58:47,61,9984,34,27,6209.26,11646.02,0.00
2024-12-08 16:58:47,61,9985,34,27,6171.40,11647.00,0.00
2024-12-08 16:58:47,62,9985,35,27,6071.86,11647.02,0.00
2024-12-08 16:58:47,61,9985,35,26,6131.32,11647.07,0.00
2024-12-08 16:58:48,60,9985,34,26,6125.77,11647.63,0.00
2024-12-08 16:58:48,60,9986,34,26,6277.43,11648.00,0.00
2024-12-08 16:58:48,61,9986,35,26,6174.52,11648.02,0.00
2024-12-08 16:58:48,60,9986,34,26,6230.85,11648.08,0.00
2024-12-08 16:58:48,59,9986,33,26,6227.71,11648.41,0.00
2024-12-08 16:58:48,59,9987,33,26,6355.86,11649.00,0.00
2024-12-08 16:58:48,60,9987,34,26,6249.93,11649.02,0.00
2024-12-08 16:58:48,59,9987,34,25,6314.42,11649.07,0.00
2024-12-08 16:58:48,58,9987,33,25,6393.43,11649.10,0.00
2024-12-08 16:58:48,58,9988,33,25,6488.61,11650.00,0.00
2024-12-08 16:58:48,59,9988,34,25,6378.63,11650.02,0.00
2024-12-08 16:58:48,59,9989,34,25,6360.42,11651.00,0.00
2024-12-08 16:58:48,60,9989,35,25,6254.41,11651.02,0.00
2024-12-08 16:58:48,59,9989,35,24,6318.96,11651.07,0.00
2024-12-08 16:58:48,58,9989,34,24,6296.09,11651.50,0.00
2024-12-08 16:58:48,58,9990,34,24,6436.61,11652.00,0.00
2024-12-08 16:58:48,59,9990,34,25,6327.51,11652.02,0.00
2024-12-08 16:58:48,59,9991,34,25,6309.08,11653.00,0.00
2024-12-08 16:58:48,60,9991,34,26,6203.93,11653.02,0.00
2024-12-08 16:58:48,59,9991,34,25,6269.60,11653.07,0.00
2024-12-08 16:58:48,58,9991,33,25,6326.57,11653.50,0.00
2024-12-08 16:58:48,58,9992,33,25,6387.13,11654.00,0.00
2024-12-08 16:58:48,59,9992,33,26,6278.87,11654.02,0.00
2024-12-08 16:58:48,58,9992,32,26,6377.11,11654.10,0.00
2024-12-08 16:58:48,57,9992,31,26,6294.97,11654.95,0.00
2024-12-08 16:58:48,57,9993,31,26,6493.34,11655.00,0.00
2024-12-08 16:58:48,58,9993,31,27,6381.39,11655.02,0.00
2024-12-08 16:58:48,57,9993,31,26,6442.26,11655.11,0.00
2024-12-08 16:58:48,56,9993,30,26,6492.59,11655.25,0.00
2024-12-08 16:58:48,55,9993,29,26,6581.67,11655.49,0.00
2024-12-08 16:58:48,55,9994,29,26,6734.61,11656.00,0.00
2024-12-08 16:58:48,56,9994,29,27,6614.35,11656.02,0.00
2024-12-08 16:58:48,56,9995,29,27,6602.60,11657.00,0.00
2024-12-08 16:58:48,57,9995,30,27,6486.76,11657.02,0.00
2024-12-08 16:58:48,58,9994,31,27,6372.92,11657.07,0.00
2024-12-08 16:58:48,57,9994,31,26,6634.06,11657.12,0.00
2024-12-08 16:58:48,57,9995,31,26,6654.80,11658.00,0.00
2024-12-08 16:58:48,58,9995,32,26,6540.06,11658.02,0.00
2024-12-08 16:58:48,57,9995,31,26,6601.67,11658.12,0.00
2024-12-08 16:58:48,57,9996,31,26,6846.12,11659.00,0.00
2024-12-08 16:58:48,58,9996,32,26,6728.09,11659.02,0.00
2024-12-08 16:58:48,57,9996,32,25,6799.13,11659.11,0.00
2024-12-08 16:58:48,56,9996,31,25,6856.25,11659.64,0.00
2024-12-08 16:58:48,56,9997,31,25,6939.82,11660.00,0.00
2024-12-08 16:58:48,57,9997,32,25,6818.07,11660.02,0.00
2024-12-08 16:58:48,56,9997,31,25,6863.11,11660.13,0.00
2024-12-08 16:58:48,56,9998,31,25,6928.20,11661.00,0.00
2024-12-08 16:58:48,57,9998,32,25,6806.65,11661.02,0.00
2024-12-08 16:58:48,56,9998,31,25,6902.98,11661.11,0.00
2024-12-08 16:58:48,55,9998,31,24,6983.97,11661.11,0.00
2024-12-08 16:58:48,55,9999,31,24,7092.66,11662.00,0.00
2024-12-08 16:58:48,56,9999,32,24,6966.00,11662.02,0.00
2024-12-08 16:58:48,55,9999,31,24,7086.32,11662.05,0.00
2024-12-08 16:58:48,54,9999,30,24,7114.94,11662.54,0.00
2024-12-08 16:58:48,54,10000,30,24,7277.29,11663.00,0.00
2024-12-08 16:58:48,55,10000,30,25,7144.97,11663.02,0.00
2024-12-08 16:58:48,54,10000,30,24,7221.19,11663.11,0.00
2024-12-08 16:58:48,53,10000,29,24,7316.53,11663.45,0.00
2024-12-08 16:58:48,53,10001,29,24,7385.17,11664.00,0.00
2024-12-08 16:58:48,54,10001,29,25,7248.41,11664.02,0.00
2024-12-08 16:58:48,53,10001,28,25,7295.02,11664.19,0.00
2024-12-08 16:58:48,53,10002,28,25,7420.54,11665.00,0.00
2024-12-08 16:58:48,54,10002,29,25,7283.12,11665.02,0.00
2024-12-08 16:58:48,54,10003,29,25,7255.30,11666.00,0.00
2024-12-08 16:58:48,55,10003,30,25,7123.39,11666.02,0.00
2024-12-08 16:58:48,54,10003,30,24,7240.23,11666.11,0.00
2024-12-08 16:58:48,54,10004,30,24,7266.73,11667.00,0.00
2024-12-08 16:58:48,55,10004,30,25,7134.61,11667.02,0.00
2024-12-08 16:58:48,56,10003,31,25,7005.13,11667.07,0.00
2024-12-08 16:58:48,56,10004,31,25,7010.88,11668.00,0.00
2024-12-08 16:58:48,57,10004,32,25,6887.88,11668.02,0.00
2024-12-08 16:58:48,56,10004,32,24,6955.58,11668.11,0.00
2024-12-08 16:58:48,55,10004,31,24,7015.34,11668.27,0.00
2024-12-08 16:58:48,55,10005,31,24,7355.28,11669.00,0.00
2024-12-08 16:58:48,56,10005,32,24,7223.94,11669.02,0.00
2024-12-08 16:58:48,56,10006,32,24,7208.71,11670.00,0.00
2024-12-08 16:58:48,57,10006,32,25,7082.24,11670.02,0.00
2024-12-08 16:58:48,57,10007,32,25,7049.67,11671.00,0.00
2024-12-08 16:58:48,58,10007,33,25,6928.12,11671.02,0.00
2024-12-08 16:58:48,57,10007,33,24,7031.28,11671.12,0.00
2024-12-08 16:58:48,57,10008,33,24,7051.87,11672.00,0.00
2024-12-08 16:58:48,58,10008,34,24,6930.29,11672.02,0.00
2024-12-08 16:58:48,57,10008,33,24,7041.67,11672.11,0.00
2024-12-08 16:58:48,56,10008,32,24,7085.28,11672.45,0.00
2024-12-08 16:58:48,56,10009,32,24,7166.95,11673.00,0.00
2024-12-08 16:58:48,57,10009,32,25,7041.22,11673.02,0.00
2024-12-08 16:58:48,56,10009,31,25,6979.87,11673.86,0.00
2024-12-08 16:58:49,56,10010,31,25,7171.77,11674.00,0.00
2024-12-08 16:58:49,57,10010,32,25,7045.95,11674.02,0.00
2024-12-08 16:58:49,56,10010,32,24,7155.13,11674.11,0.00
2024-12-08 16:58:49,56,10011,32,24,7175.53,11675.00,0.00
2024-12-08 16:58:49,57,10011,33,24,7049.64,11675.02,0.00
2024-12-08 16:58:49,56,10011,32,24,7093.70,11675.13,0.00
2024-12-08 16:58:49,56,10012,32,24,7200.60,11676.00,0.00
2024-12-08 16:58:49,57,10012,33,24,7074.27,11676.02,0.00
2024-12-08 16:58:49,57,10013,33,24,7042.10,11677.00,0.00
2024-12-08 16:58:49,58,10013,34,24,6920.69,11677.02,0.00
2024-12-08 16:58:49,57,10013,34,23,7029.85,11677.11,0.00
2024-12-08 16:58:49,57,10014,34,23,7048.85,11678.00,0.00
2024-12-08 16:58:49,58,10014,35,23,6927.32,11678.02,0.00
2024-12-08 16:58:49,58,10015,35,23,6905.55,11679.00,0.00
2024-12-08 16:58:49,59,10015,35,24,6788.51,11679.02,0.00
2024-12-08 16:58:49,58,10015,35,23,6852.53,11679.10,0.00
2024-12-08 16:58:49,58,10016,35,23,6869.19,11680.00,0.00
2024-12-08 16:58:49,59,10016,35,24,6752.76,11680.02,0.00
2024-12-08 16:58:49,58,10016,34,24,6790.91,11680.17,0.00
2024-12-08 16:58:49,58,10017,34,24,6895.85,11681.00,0.00
2024-12-08 16:58:49,59,10017,35,24,6778.97,11681.02,0.00
2024-12-08 16:58:49,58,10017,35,23,6847.16,11681.10,0.00
2024-12-08 16:58:49,58,10018,35,23,6863.83,11682.00,0.00
2024-12-08 16:58:49,59,10018,36,23,6747.49,11682.02,0.00
2024-12-08 16:58:49,58,10018,35,23,6715.20,11682.79,0.00
2024-12-08 16:58:49,58,10019,35,23,6892.61,11683.00,0.00
2024-12-08 16:58:49,59,10019,36,23,6775.78,11683.02,0.00
2024-12-08 16:58:49,58,10019,36,22,6846.31,11683.10,0.00
2024-12-08 16:58:49,58,10020,36,22,6862.98,11684.00,0.00
2024-12-08 16:58:49,59,10020,36,23,6746.66,11684.02,0.00
2024-12-08 16:58:49,59,10021,36,23,6721.01,11685.00,0.00
2024-12-08 16:58:49,60,10021,36,24,6609.00,11685.02,0.00
2024-12-08 16:58:49,59,10021,36,23,6675.49,11685.10,0.00
2024-12-08 16:58:49,59,10022,36,23,6687.25,11686.00,0.00
2024-12-08 16:58:49,60,10022,37,23,6575.80,11686.02,0.00
2024-12-08 16:58:49,59,10022,36,23,6685.87,11686.02,0.00
2024-12-08 16:58:49,59,10023,36,23,6666.87,11687.00,0.00
2024-12-08 16:58:49,60,10023,36,24,6555.76,11687.02,0.00
2024-12-08 16:58:49,59,10023,36,23,6617.38,11687.08,0.00
2024-12-08 16:58:49,59,10024,36,23,6627.40,11688.00,0.00
2024-12-08 16:58:49,60,10024,37,23,6516.94,11688.02,0.00
2024-12-08 16:58:49,59,10024,36,23,6443.71,11688.90,0.00
2024-12-08 16:58:49,59,10025,36,23,6630.01,11689.00,0.00
2024-12-08 16:58:49,60,10025,36,24,6519.51,11689.02,0.00
2024-12-08 16:58:49,59,10025,35,24,6620.13,11689.08,0.00
2024-12-08 16:58:49,59,10026,35,24,6591.18,11690.00,0.00
2024-12-08 16:58:49,60,10026,35,25,6481.33,11690.02,0.00
2024-12-08 16:58:49,59,10026,35,24,6571.39,11690.12,0.00
2024-12-08 16:58:49,59,10027,35,24,6586.76,11691.00,0.00
2024-12-08 16:58:49,60,10027,35,25,6476.98,11691.02,0.00
2024-12-08 16:58:49,59,10027,34,25,6582.81,11691.03,0.00
2024-12-08 16:58:49,58,10027,33,25,6692.29,11691.07,0.00
2024-12-08 16:58:49,58,10028,33,25,6687.13,11692.00,0.00
2024-12-08 16:58:49,59,10028,34,25,6573.78,11692.02,0.00
2024-12-08 16:58:49,58,10028,33,25,6681.10,11692.07,0.00
2024-12-08 16:58:49,58,10029,33,25,6653.43,11693.00,0.00
2024-12-08 16:58:49,59,10029,33,26,6540.66,11693.02,0.00
2024-12-08 16:58:49,58,10029,33,25,6643.37,11693.07,0.00
2024-12-08 16:58:49,58,10030,33,25,6656.01,11694.00,0.00
2024-12-08 16:58:49,59,10030,33,26,6543.20,11694.02,0.00
2024-12-08 16:58:49,58,10030,32,26,6500.99,11694.50,0.00
2024-12-08 16:58:49,58,10031,32,26,6644.48,11695.00,0.00
2024-12-08 16:58:49,59,10031,32,27,6531.86,11695.02,0.00
2024-12-08 16:58:49,58,10031,31,27,6559.22,11695.07,0.00
2024-12-08 16:58:49,57,10031,31,26,6654.37,11695.07,0.00
2024-12-08 16:58:49,57,10032,31,26,6751.36,11696.00,0.00
2024-12-08 16:58:49,58,10032,32,26,6634.96,11696.02,0.00
2024-12-08 16:58:49,58,10033,32,26,6622.77,11697.00,0.00
2024-12-08 16:58:49,59,10033,32,27,6510.52,11697.02,0.00
2024-12-08 16:58:49,59,10034,32,27,6475.39,11698.00,0.00
2024-12-08 16:58:49,60,10034,32,28,6367.46,11698.02,0.00
2024-12-08 16:58:49,59,10034,32,27,6461.53,11698.08,0.00
2024-12-08 16:58:49,59,10035,32,27,6473.96,11699.00,0.00
2024-12-08 16:58:49,60,10035,33,27,6366.06,11699.02,0.00
2024-12-08 16:58:49,59,10035,32,27,6288.09,11699.97,0.00
2024-12-08 16:58:49,59,10036,32,27,6482.44,11700.00,0.00
2024-12-08 16:58:49,60,10036,33,27,6374.40,11700.02,0.00
2024-12-08 16:58:49,59,10036,32,27,6383.19,11700.53,0.00
2024-12-08 16:58:49,59,10037,32,27,6446.97,11701.00,0.00
2024-12-08 16:58:49,60,10037,32,28,6339.52,11701.02,0.00
2024-12-08 16:58:49,59,10037,32,27,6437.07,11701.08,0.00
2024-12-08 16:58:49,59,10038,32,27,6448.94,11702.00,0.00
2024-12-08 16:58:49,60,10038,33,27,6341.46,11702.02,0.00
2024-12-08 16:58:49,59,10038,32,27,6443.00,11702.05,0.00
2024-12-08 16:58:50,59,10039,32,27,6434.44,11703.00,0.00
2024-12-08 16:58:50,60,10039,33,27,6327.19,11703.02,0.00
2024-12-08 16:58:50,60,10040,33,27,6287.17,11704.00,0.00
2024-12-08 16:58:50,61,10040,33,28,6184.10,11704.02,0.00
2024-12-08 16:58:50,60,10040,33,27,6271.60,11704.12,0.00
2024-12-08 16:58:50,60,10041,33,27,6280.59,11705.00,0.00
2024-12-08 16:58:50,61,10041,33,28,6177.63,11705.02,0.00
2024-12-08 16:58:50,60,10041,32,28,6272.82,11705.08,0.00
2024-12-08 16:58:50,60,10042,32,28,6261.13,11706.00,0.00
2024-12-08 16:58:50,61,10042,33,28,6158.49,11706.02,0.00
2024-12-08 16:58:50,60,10042,33,27,6210.44,11706.10,0.00
2024-12-08 16:58:50,59,10042,32,27,6288.26,11706.10,0.00
2024-12-08 16:58:50,58,10042,31,27,6368.04,11706.28,0.00
2024-12-08 16:58:50,58,10043,31,27,6485.54,11707.00,0.00
2024-12-08 16:58:50,59,10043,32,27,6375.61,11707.02,0.00
2024-12-08 16:58:50,60,10042,33,27,6139.02,11707.83,0.00
2024-12-08 16:58:50,60,10043,33,27,6284.66,11708.00,0.00
2024-12-08 16:58:50,61,10043,33,28,6181.63,11708.02,0.00
2024-12-08 16:58:50,60,10043,32,28,6197.39,11708.42,0.00
2024-12-08 16:58:50,59,10043,31,28,6270.81,11708.68,0.00
2024-12-08 16:58:50,59,10044,31,28,6568.16,11709.00,0.00
2024-12-08 16:58:50,60,10044,32,28,6458.69,11709.02,0.00
2024-12-08 16:58:50,59,10044,32,27,6528.50,11709.08,0.00
2024-12-08 16:58:50,59,10045,32,27,6540.94,11710.00,0.00
2024-12-08 16:58:50,60,10045,33,27,6431.92,11710.02,0.00
2024-12-08 16:58:50,60,10046,33,27,6394.23,11711.00,0.00
2024-12-08 16:58:50,61,10046,34,27,6289.40,11711.02,0.00
2024-12-08 16:58:50,60,10046,33,27,6380.60,11711.12,0.00
2024-12-08 16:58:50,59,10046,33,26,6484.78,11711.12,0.00
2024-12-08 16:58:50,59,10047,33,26,6497.08,11712.00,0.00
2024-12-08 16:58:50,60,10047,34,26,6388.80,11712.02,0.00
2024-12-08 16:58:50,60,10048,34,26,6364.56,11713.00,0.00
2024-12-08 16:58:50,61,10048,34,27,6260.22,11713.02,0.00
2024-12-08 16:58:50,60,10048,34,26,6311.88,11713.12,0.00
2024-12-08 16:58:50,60,10049,34,26,6313.51,11714.00,0.00
2024-12-08 16:58:50,61,10049,34,27,6210.01,11714.02,0.00
2024-12-08 16:58:50,61,10050,34,27,6178.19,11715.00,0.00
2024-12-08 16:58:50,62,10050,35,27,6078.54,11715.02,0.00
2024-12-08 16:58:50,61,10050,35,26,6128.28,11715.12,0.00
2024-12-08 16:58:50,60,10050,34,26,6054.98,11715.97,0.00
2024-12-08 16:58:50,60,10051,34,26,6246.36,11716.00,0.00
2024-12-08 16:58:50,61,10051,35,26,6143.96,11716.02,0.00
2024-12-08 16:58:50,61,10052,35,26,6106.41,11717.00,0.00
2024-12-08 16:58:50,62,10052,36,26,6007.92,11717.02,0.00
2024-12-08 16:58:50,63,10051,37,26,5912.55,11717.05,0.00
2024-12-08 16:58:50,62,10051,37,25,6063.81,11717.13,0.00
2024-12-08 16:58:50,62,10052,37,25,6052.00,11718.00,0.00
2024-12-08 16:58:50,63,10052,37,26,5955.94,11718.02,0.00
2024-12-08 16:58:50,64,10051,38,26,5755.11,11718.66,0.00
2024-12-08 16:58:50,64,10052,38,26,6091.82,11719.00,0.00
2024-12-08 16:58:50,65,10052,38,27,5998.10,11719.02,0.00
2024-12-08 16:58:50,64,10052,37,27,6083.34,11719.08,0.00
2024-12-08 16:58:50,63,10052,37,26,6144.57,11719.10,0.00
2024-12-08 16:58:50,62,10052,36,26,6159.13,11719.66,0.00
2024-12-08 16:58:50,62,10053,36,26,6396.96,11720.00,0.00
2024-12-08 16:58:50,63,10053,37,26,6295.42,11720.02,0.00
2024-12-08 16:58:50,63,10054,37,26,6230.67,11721.00,0.00
2024-12-08 16:58:50,64,10054,37,27,6133.32,11721.02,0.00
2024-12-08 16:58:50,65,10053,38,27,6031.77,11721.11,0.00
2024-12-08 16:58:50,65,10054,38,27,6076.80,11722.00,0.00
2024-12-08 16:58:50,66,10054,38,28,5984.73,11722.02,0.00
2024-12-08 16:58:50,65,10054,37,28,6060.63,11722.15,0.00
2024-12-08 16:58:50,64,10054,37,27,6151.66,11722.16,0.00
2024-12-08 16:58:50,64,10055,37,27,6292.10,11723.00,0.00
2024-12-08 16:58:50,65,10055,37,28,6195.30,11723.02,0.00
2024-12-08 16:58:50,64,10055,36,28,6099.41,11723.73,0.00
2024-12-08 16:58:50,64,10056,36,28,6220.82,11724.00,0.00
2024-12-08 16:58:50,65,10056,37,28,6125.12,11724.02,0.00
2024-12-08 16:58:50,64,10056,36,28,6188.37,11724.14,0.00
2024-12-08 16:58:50,63,10056,36,27,6247.51,11724.14,0.00
2024-12-08 16:58:50,62,10056,35,27,6306.49,11724.50,0.00
2024-12-08 16:58:50,62,10057,35,27,6397.75,11725.00,0.00
2024-12-08 16:58:50,63,10057,36,27,6296.20,11725.02,0.00
2024-12-08 16:58:50,63,10058,36,27,6245.21,11726.00,0.00
2024-12-08 16:58:50,64,10058,36,28,6147.63,11726.02,0.00
2024-12-08 16:58:50,63,10058,35,28,6064.24,11726.81,0.00
2024-12-08 16:58:50,62,10058,34,28,6139.51,11726.87,0.00
2024-12-08 16:58:50,62,10059,34,28,6313.62,11727.00,0.00
2024-12-08 16:58:50,63,10059,35,28,6213.40,11727.02,0.00
2024-12-08 16:58:50,62,10059,35,27,6294.75,11727.16,0.00
2024-12-08 16:58:50,62,10060,35,27,6308.71,11728.00,0.00
2024-12-08 16:58:50,63,10060,35,28,6208.57,11728.02,0.00
2024-12-08 16:58:50,63,10061,35,28,6193.57,11729.00,0.00
2024-12-08 16:58:50,64,10061,36,28,6096.80,11729.02,0.00
2024-12-08 16:58:50,64,10062,36,28,6055.28,11730.00,0.00
2024-12-08 16:58:51,65,10062,36,29,5962.13,11730.02,0.00
2024-12-08 16:58:51,64,10062,35,29,6044.99,11730.09,0.00
2024-12-08 16:58:51,63,10062,35,28,6131.65,11730.16,0.00
2024-12-08 16:58:51,63,10063,35,28,6145.16,11731.00,0.00
2024-12-08 16:58:51,64,10063,35,29,6049.14,11731.02,0.00
2024-12-08 16:58:51,63,10063,34,29,6034.46,11731.56,0.00
2024-12-08 16:58:51,63,10064,34,29,6168.83,11732.00,0.00
2024-12-08 16:58:51,64,10064,35,29,6072.45,11732.02,0.00
2024-12-08 16:58:51,63,10064,34,29,6101.85,11732.21,0.00
2024-12-08 16:58:51,63,10065,34,29,6195.43,11733.00,0.00
2024-12-08 16:58:51,64,10065,34,30,6098.63,11733.02,0.00
2024-12-08 16:58:51,63,10065,33,30,6190.76,11733.05,0.00
2024-12-08 16:58:51,62,10065,32,30,6279.29,11733.15,0.00
2024-12-08 16:58:51,61,10065,32,29,6380.30,11733.15,0.00
2024-12-08 16:58:51,61,10066,32,29,6396.18,11734.00,0.00
2024-12-08 16:58:51,62,10066,32,30,6293.02,11734.02,0.00
2024-12-08 16:58:51,61,10066,31,30,6336.59,11734.10,0.00
2024-12-08 16:58:51,61,10067,31,30,6385.19,11735.00,0.00
2024-12-08 16:58:51,62,10067,32,30,6282.20,11735.02,0.00
2024-12-08 16:58:51,61,10067,31,30,6358.31,11735.18,0.00
2024-12-08 16:58:51,61,10068,31,30,6416.52,11736.00,0.00
2024-12-08 16:58:51,62,10068,31,31,6313.02,11736.02,0.00
2024-12-08 16:58:51,61,10068,31,30,6389.63,11736.18,0.00
2024-12-08 16:58:51,61,10069,31,30,6409.37,11737.00,0.00
2024-12-08 16:58:51,62,10069,31,31,6305.99,11737.02,0.00
2024-12-08 16:58:51,61,10069,30,31,6394.02,11737.15,0.00
2024-12-08 16:58:51,60,10069,29,31,6445.82,11737.18,0.00
2024-12-08 16:58:51,60,10070,29,31,6546.09,11738.00,0.00
2024-12-08 16:58:51,61,10070,30,31,6438.78,11738.02,0.00
2024-12-08 16:58:51,62,10069,30,32,6325.49,11738.13,0.00
2024-12-08 16:58:51,62,10070,30,32,6433.92,11739.00,0.00
2024-12-08 16:58:51,63,10070,31,32,6331.79,11739.02,0.00
2024-12-08 16:58:51,62,10070,31,31,6413.15,11739.16,0.00
2024-12-08 16:58:51,62,10071,31,31,6618.14,11740.00,0.00
2024-12-08 16:58:51,63,10071,31,32,6513.09,11740.02,0.00
2024-12-08 16:58:51,64,10070,32,32,6328.94,11740.44,0.00
2024-12-08 16:58:51,64,10071,32,32,6461.59,11741.00,0.00
2024-12-08 16:58:51,65,10071,32,33,6362.18,11741.02,0.00
2024-12-08 16:58:51,64,10071,31,33,6351.39,11741.64,0.00
2024-12-08 16:58:51,63,10071,30,33,6360.92,11741.94,0.00
2024-12-08 16:58:51,63,10072,30,33,6726.25,11742.00,0.00
2024-12-08 16:58:51,64,10072,31,33,6621.16,11742.02,0.00
2024-12-08 16:58:51,63,10072,31,32,6702.08,11742.17,0.00
2024-12-08 16:58:51,63,10073,31,32,6716.82,11743.00,0.00
2024-12-08 16:58:51,64,10073,32,32,6611.87,11743.02,0.00
2024-12-08 16:58:51,63,10073,31,32,6713.23,11743.03,0.00
2024-12-08 16:58:51,62,10073,30,32,6819.61,11743.03,0.00
2024-12-08 16:58:51,61,10073,29,32,6917.97,11743.13,0.00
2024-12-08 16:58:51,61,10074,29,32,6969.95,11744.00,0.00
2024-12-08 16:58:51,62,10074,29,33,6857.53,11744.02,0.00
2024-12-08 16:58:51,62,10075,29,33,6817.31,11745.00,0.00
2024-12-08 16:58:51,63,10075,30,33,6709.10,11745.02,0.00
2024-12-08 16:58:51,62,10075,30,32,6802.20,11745.13,0.00
2024-12-08 16:58:51,62,10076,30,32,6812.09,11746.00,0.00
2024-12-08 16:58:51,63,10076,31,32,6703.96,11746.02,0.00
2024-12-08 16:58:51,62,10076,30,32,6796.98,11746.13,0.00
2024-12-08 16:58:51,62,10077,30,32,6843.95,11747.00,0.00
2024-12-08 16:58:51,63,10077,30,33,6735.31,11747.02,0.00
2024-12-08 16:58:51,62,10077,29,33,6831.97,11747.11,0.00
2024-12-08 16:58:51,61,10077,29,32,6903.53,11747.12,0.00
2024-12-08 16:58:51,61,10078,29,32,6909.97,11748.00,0.00
2024-12-08 16:58:51,62,10078,30,32,6798.52,11748.02,0.00
2024-12-08 16:58:51,61,10078,29,32,6810.41,11748.46,0.00
2024-12-08 16:58:51,60,10078,28,32,6838.11,11748.93,0.00
2024-12-08 16:58:51,60,10079,28,32,7026.14,11749.00,0.00
2024-12-08 16:58:51,61,10079,28,33,6910.95,11749.02,0.00
2024-12-08 16:58:51,60,10079,28,32,6973.31,11749.12,0.00
2024-12-08 16:58:51,59,10079,28,31,7074.06,11749.19,0.00
2024-12-08 16:58:51,58,10079,28,30,7176.32,11749.34,0.00
2024-12-08 16:58:51,58,10080,28,30,7221.35,11750.00,0.00
2024-12-08 16:58:51,59,10080,29,30,7098.95,11750.02,0.00
2024-12-08 16:58:51,58,10080,28,30,7084.87,11750.62,0.00
2024-12-08 16:58:51,58,10081,28,30,7243.18,11751.00,0.00
2024-12-08 16:58:51,59,10081,28,31,7120.41,11751.02,0.00
2024-12-08 16:58:51,58,10081,28,30,7190.55,11751.12,0.00
2024-12-08 16:58:51,58,10082,28,30,7209.35,11752.00,0.00
2024-12-08 16:58:51,59,10082,29,30,7087.16,11752.02,0.00
2024-12-08 16:58:51,59,10083,29,30,7060.20,11753.00,0.00
2024-12-08 16:58:51,60,10083,29,31,6942.53,11753.02,0.00
2024-12-08 16:58:51,59,10083,29,30,7010.44,11753.12,0.00
2024-12-08 16:58:51,59,10084,29,30,7026.93,11754.00,0.00
2024-12-08 16:58:51,60,10084,29,31,6909.82,11754.02,0.00
2024-12-08 16:58:51,60,10085,29,31,6884.13,11755.00,0.00
2024-12-08 16:58:51,61,10085,30,31,6771.28,11755.02,0.00
2024-12-08 16:58:51,60,10085,30,30,6835.19,11755.12,0.00
2024-12-08 16:58:51,59,10085,29,30,6830.53,11755.53,0.00
2024-12-08 16:58:51,59,10086,29,30,6974.33,11756.00,0.00
2024-12-08 16:58:51,60,10086,30,30,6858.09,11756.02,0.00
2024-12-08 16:58:51,59,10086,29,30,6848.09,11756.29,0.00
2024-12-08 16:58:52,59,10087,29,30,6964.14,11757.00,0.00
2024-12-08 16:58:52,60,10087,29,31,6848.07,11757.02,0.00
2024-12-08 16:58:52,59,10087,28,31,6959.92,11757.05,0.00
2024-12-08 16:58:52,58,10087,28,30,7037.37,11757.10,0.00
2024-12-08 16:58:52,58,10088,28,30,7054.15,11758.00,0.00
2024-12-08 16:58:52,59,10088,29,30,6934.59,11758.02,0.00
2024-12-08 16:58:52,59,10089,29,30,6909.89,11759.00,0.00
2024-12-08 16:58:52,60,10089,29,31,6794.73,11759.02,0.00
2024-12-08 16:58:52,59,10089,29,30,6862.10,11759.10,0.00
2024-12-08 16:58:52,59,10090,29,30,6876.60,11760.00,0.00
2024-12-08 16:58:52,60,10090,30,30,6761.99,11760.02,0.00
2024-12-08 16:58:52,60,10091,30,30,6737.07,11761.00,0.00
2024-12-08 16:58:52,61,10091,31,30,6626.62,11761.02,0.00
2024-12-08 16:58:52,60,10091,31,29,6692.02,11761.10,0.00
2024-12-08 16:58:52,59,10091,30,29,6793.50,11761.10,0.00
2024-12-08 16:58:52,59,10092,30,29,6887.73,11762.00,0.00
2024-12-08 16:58:52,60,10092,30,30,6772.94,11762.02,0.00
2024-12-08 16:58:52,60,10093,30,30,6750.09,11763.00,0.00
2024-12-08 16:58:52,61,10093,30,31,6639.43,11763.02,0.00
2024-12-08 16:58:52,60,10093,30,30,6703.07,11763.10,0.00
2024-12-08 16:58:52,60,10094,30,30,6715.37,11764.00,0.00
2024-12-08 16:58:52,61,10094,30,31,6605.28,11764.02,0.00
2024-12-08 16:58:52,60,10094,29,31,6705.60,11764.10,0.00
2024-12-08 16:58:52,60,10095,29,31,6754.61,11765.00,0.00
2024-12-08 16:58:52,61,10095,29,32,6643.88,11765.02,0.00
2024-12-08 16:58:52,61,10096,29,32,6639.29,11766.00,0.00
2024-12-08 16:58:52,62,10096,29,33,6532.20,11766.02,0.00
2024-12-08 16:58:52,61,10096,28,33,6547.40,11766.13,0.00
2024-12-08 16:58:52,61,10097,28,33,6635.01,11767.00,0.00
2024-12-08 16:58:52,62,10097,29,33,6528.00,11767.02,0.00
2024-12-08 16:58:52,61,10097,28,33,6628.26,11767.07,0.00
2024-12-08 16:58:52,60,10097,28,32,6709.31,11767.08,0.00
2024-12-08 16:58:52,59,10097,27,32,6819.05,11767.10,0.00
2024-12-08 16:58:52,59,10098,27,32,6913.34,11768.00,0.00
2024-12-08 16:58:52,60,10098,27,33,6798.11,11768.02,0.00
2024-12-08 16:58:52,60,10099,27,33,6772.33,11769.00,0.00
2024-12-08 16:58:52,61,10099,27,34,6661.31,11769.02,0.00
2024-12-08 16:58:52,60,10099,27,33,6731.17,11769.08,0.00
2024-12-08 16:58:52,60,10100,27,33,6741.31,11770.00,0.00
2024-12-08 16:58:52,61,10100,27,34,6630.79,11770.02,0.00
2024-12-08 16:58:52,60,10100,26,34,6580.83,11770.57,0.00
2024-12-08 16:58:52,60,10101,26,34,6725.65,11771.00,0.00
2024-12-08 16:58:52,61,10101,27,34,6615.39,11771.02,0.00
2024-12-08 16:58:52,60,10101,26,34,6717.83,11771.08,0.00
2024-12-08 16:58:52,59,10101,25,34,6749.67,11771.14,0.00
2024-12-08 16:58:52,60,10100,25,35,6629.36,11771.23,0.00
2024-12-08 16:58:52,60,10101,25,35,6829.06,11772.00,0.00
2024-12-08 16:58:52,61,10101,26,35,6717.10,11772.02,0.00
2024-12-08 16:58:52,60,10101,26,34,6815.35,11772.10,0.00
2024-12-08 16:58:52,60,10102,26,34,7018.50,11773.00,0.00
2024-12-08 16:58:52,61,10102,26,35,6903.45,11773.02,0.00
2024-12-08 16:58:52,61,10103,26,35,6874.05,11774.00,0.00
2024-12-08 16:58:52,62,10103,27,35,6763.18,11774.02,0.00
2024-12-08 16:58:52,61,10103,26,35,6866.36,11774.07,0.00
2024-12-08 16:58:52,60,10103,26,34,6937.63,11774.08,0.00
2024-12-08 16:58:52,59,10103,25,34,7003.62,11774.20,0.00
2024-12-08 16:58:52,59,10104,25,34,7101.55,11775.00,0.00
2024-12-08 16:58:52,60,10104,25,35,6983.19,11775.02,0.00
2024-12-08 16:58:52,60,10105,25,35,6952.22,11776.00,0.00
2024-12-08 16:58:52,61,10105,26,35,6838.25,11776.02,0.00
2024-12-08 16:58:52,60,10105,25,35,6946.03,11776.07,0.00
2024-12-08 16:58:52,59,10105,24,35,6958.61,11776.56,0.00
2024-12-08 16:58:52,59,10106,24,35,7020.89,11777.00,0.00
2024-12-08 16:58:52,60,10106,25,35,6903.88,11777.02,0.00
2024-12-08 16:58:52,59,10106,25,34,7008.95,11777.08,0.00
2024-12-08 16:58:52,58,10106,24,34,6958.30,11777.97,0.00
2024-12-08 16:58:52,58,10107,24,34,7157.33,11778.00,0.00
2024-12-08 16:58:52,59,10107,24,35,7036.01,11778.02,0.00
2024-12-08 16:58:52,59,10108,24,35,6997.86,11779.00,0.00
2024-12-08 16:58:52,60,10108,24,36,6881.23,11779.02,0.00
2024-12-08 16:58:52,59,10108,24,35,6947.98,11779.08,0.00
2024-12-08 16:58:52,59,10109,24,35,6942.88,11780.00,0.00
2024-12-08 16:58:52,60,10109,25,35,6827.17,11780.02,0.00
2024-12-08 16:58:52,60,10110,25,35,6786.37,11781.00,0.00
2024-12-08 16:58:52,61,10110,25,36,6675.12,11781.02,0.00
2024-12-08 16:58:52,60,10110,25,35,6737.31,11781.08,0.00
2024-12-08 16:58:52,60,10111,25,35,6727.17,11782.00,0.00
2024-12-08 16:58:52,61,10111,25,36,6616.89,11782.02,0.00
2024-12-08 16:58:52,60,10111,24,36,6615.60,11782.58,0.00
2024-12-08 16:58:52,60,10112,24,36,6742.55,11783.00,0.00
2024-12-08 16:58:52,61,10112,24,37,6632.02,11783.02,0.00
2024-12-08 16:58:52,60,10112,24,36,6693.49,11783.10,0.00
2024-12-08 16:58:52,60,10113,24,36,6688.40,11784.00,0.00
2024-12-08 16:58:52,61,10113,25,36,6578.75,11784.02,0.00
2024-12-08 16:58:53,61,10114,25,36,6544.81,11785.00,0.00
2024-12-08 16:58:53,62,10114,26,36,6439.25,11785.02,0.00
2024-12-08 16:58:53,61,10114,26,35,6498.48,11785.10,0.00
2024-12-08 16:58:53,61,10115,26,35,6504.66,11786.00,0.00
2024-12-08 16:58:53,62,10115,27,35,6399.75,11786.02,0.00
2024-12-08 16:58:53,62,10116,27,35,6379.85,11787.00,0.00
2024-12-08 16:58:53,63,10116,27,36,6278.58,11787.02,0.00
2024-12-08 16:58:53,62,10116,27,35,6332.36,11787.10,0.00
2024-12-08 16:58:53,62,10117,27,35,6339.55,11788.00,0.00
2024-12-08 16:58:53,63,10117,27,36,6238.93,11788.02,0.00
2024-12-08 16:58:53,63,10118,27,36,6215.56,11789.00,0.00
2024-12-08 16:58:53,64,10118,28,36,6118.44,11789.02,0.00
2024-12-08 16:58:53,63,10118,28,35,6168.82,11789.10,0.00
2024-12-08 16:58:53,63,10119,28,35,6165.25,11790.00,0.00
2024-12-08 16:58:53,64,10119,28,36,6068.92,11790.02,0.00
2024-12-08 16:58:53,63,10119,27,36,6155.93,11790.10,0.00
2024-12-08 16:58:53,63,10120,27,36,6135.16,11791.00,0.00
2024-12-08 16:58:53,64,10120,28,36,6039.29,11791.02,0.00
2024-12-08 16:58:53,63,10120,28,35,6088.40,11791.10,0.00
2024-12-08 16:58:53,62,10120,27,35,6086.23,11791.69,0.00
2024-12-08 16:58:53,62,10121,27,35,6228.48,11792.00,0.00
2024-12-08 16:58:53,63,10121,27,36,6129.62,11792.02,0.00
2024-12-08 16:58:53,64,10120,28,36,5958.54,11792.36,0.00
2024-12-08 16:58:53,63,10120,27,36,6103.68,11792.37,0.00
2024-12-08 16:58:53,63,10121,27,36,6201.70,11793.00,0.00
2024-12-08 16:58:53,64,10121,27,37,6104.80,11793.02,0.00
2024-12-08 16:58:53,63,10121,27,36,6165.90,11793.10,0.00
2024-12-08 16:58:53,62,10121,26,36,6265.34,11793.10,0.00
2024-12-08 16:58:53,61,10121,25,36,6320.67,11793.49,0.00
2024-12-08 16:58:53,60,10121,24,36,6415.14,11793.58,0.00
2024-12-08 16:58:53,60,10122,24,36,6740.94,11794.00,0.00
2024-12-08 16:58:53,61,10122,25,36,6630.44,11794.02,0.00
2024-12-08 16:58:53,60,10122,24,36,6642.75,11794.30,0.00
2024-12-08 16:58:53,60,10123,24,36,6737.82,11795.00,0.00
2024-12-08 16:58:53,61,10123,24,37,6627.37,11795.02,0.00
2024-12-08 16:58:53,60,10123,24,36,6690.68,11795.10,0.00
2024-12-08 16:58:53,60,10124,24,36,6683.17,11796.00,0.00
2024-12-08 16:58:53,61,10124,24,37,6573.61,11796.02,0.00
2024-12-08 16:58:53,60,10124,23,37,6632.08,11796.12,0.00
2024-12-08 16:58:53,60,10125,23,37,6705.18,11797.00,0.00
2024-12-08 16:58:53,61,10125,24,37,6595.26,11797.02,0.00
2024-12-08 16:58:53,60,10125,24,36,6659.99,11797.10,0.00
2024-12-08 16:58:53,60,10126,24,36,6652.86,11798.00,0.00
2024-12-08 16:58:53,61,10126,24,37,6543.80,11798.02,0.00
2024-12-08 16:58:53,61,10127,24,37,6503.75,11799.00,0.00
2024-12-08 16:58:53,62,10127,25,37,6398.85,11799.02,0.00
2024-12-08 16:58:53,61,10127,25,36,6459.29,11799.10,0.00
2024-12-08 16:58:53,60,10127,24,36,6510.09,11799.57,0.00
2024-12-08 16:58:53,60,10128,24,36,6559.56,11800.00,0.00
2024-12-08 16:58:53,61,10128,24,37,6452.03,11800.02,0.00
2024-12-08 16:58:53,60,10128,23,37,6506.50,11800.13,0.00
2024-12-08 16:58:53,59,10128,22,37,6575.78,11800.20,0.00
2024-12-08 16:58:53,58,10128,21,37,6627.92,11800.66,0.00
2024-12-08 16:58:53,58,10129,21,37,6775.07,11801.00,0.00
2024-12-08 16:58:53,59,10129,22,37,6660.23,11801.02,0.00
2024-12-08 16:58:53,58,10129,22,36,6730.33,11801.10,0.00
2024-12-08 16:58:53,57,10129,21,36,6779.50,11801.33,0.00
2024-12-08 16:58:53,56,10129,21,35,6847.78,11801.66,0.00
2024-12-08 16:58:53,56,10130,21,35,7018.75,11802.00,0.00
2024-12-08 16:58:53,57,10130,22,35,6895.61,11802.02,0.00
2024-12-08 16:58:53,57,10131,22,35,6851.88,11803.00,0.00
2024-12-08 16:58:53,58,10131,23,35,6733.74,11803.02,0.00
2024-12-08 16:58:53,57,10131,23,34,6808.41,11803.11,0.00
2024-12-08 16:58:53,58,10130,24,34,6656.57,11803.43,0.00
2024-12-08 16:58:53,58,10131,24,34,6841.78,11804.00,0.00
2024-12-08 16:58:53,59,10131,25,34,6725.82,11804.02,0.00
2024-12-08 16:58:53,58,10131,25,33,6811.68,11804.10,0.00
2024-12-08 16:58:53,58,10132,25,33,6995.04,11805.00,0.00
2024-12-08 16:58:53,59,10132,26,33,6876.48,11805.02,0.00
2024-12-08 16:58:53,59,10133,26,33,6809.91,11806.00,0.00
2024-12-08 16:58:53,60,10133,27,33,6696.41,11806.02,0.00
2024-12-08 16:58:53,59,10133,27,32,6765.91,11806.12,0.00
2024-12-08 16:58:53,58,10133,26,32,6807.07,11806.52,0.00
2024-12-08 16:58:53,58,10134,26,32,6857.90,11807.00,0.00
2024-12-08 16:58:53,59,10134,26,33,6741.66,11807.02,0.00
2024-12-08 16:58:53,59,10135,26,33,6672.52,11808.00,0.00
2024-12-08 16:58:53,60,10135,26,34,6561.31,11808.02,0.00
2024-12-08 16:58:53,59,10135,26,33,6626.51,11808.12,0.00
2024-12-08 16:58:53,58,10135,25,33,6701.61,11808.22,0.00
2024-12-08 16:58:53,58,10136,25,33,6767.97,11809.00,0.00
2024-12-08 16:58:53,59,10136,26,33,6653.26,11809.02,0.00
2024-12-08 16:58:53,58,10136,26,32,6643.22,11809.34,0.00
2024-12-08 16:58:53,58,10137,26,32,6750.89,11810.00,0.00
2024-12-08 16:58:53,59,10137,26,33,6636.47,11810.02,0.00
2024-12-08 16:58:53,59,10138,26,33,6614.46,11811.00,0.00
2024-12-08 16:58:53,60,10138,26,34,6504.22,11811.02,0.00
2024-12-08 16:58:54,60,10139,26,34,6452.31,11812.00,0.00
2024-12-08 16:58:54,61,10139,27,34,6346.54,11812.02,0.00
2024-12-08 16:58:54,60,10139,27,33,6399.18,11812.12,0.00
2024-12-08 16:58:54,60,10140,27,33,6378.57,11813.00,0.00
2024-12-08 16:58:54,61,10140,27,34,6274.00,11813.02,0.00
2024-12-08 16:58:54,60,10140,26,34,6323.46,11813.15,0.00
2024-12-08 16:58:54,59,10140,25,34,6275.14,11813.85,0.00
2024-12-08 16:58:54,59,10141,25,34,6457.46,11814.00,0.00
2024-12-08 16:58:54,60,10141,26,34,6349.84,11814.02,0.00
2024-12-08 16:58:54,59,10141,26,33,6435.06,11814.12,0.00
2024-12-08 16:58:54,58,10141,26,32,6517.30,11814.28,0.00
2024-12-08 16:58:54,58,10142,26,32,6539.26,11815.00,0.00
2024-12-08 16:58:54,59,10142,26,33,6428.42,11815.02,0.00
2024-12-08 16:58:54,59,10143,26,33,6395.28,11816.00,0.00
2024-12-08 16:58:54,60,10143,26,34,6288.69,11816.02,0.00
2024-12-08 16:58:54,59,10143,26,33,6351.23,11816.12,0.00
2024-12-08 16:58:54,59,10144,26,33,6356.12,11817.00,0.00
2024-12-08 16:58:54,60,10144,26,34,6250.19,11817.02,0.00
2024-12-08 16:58:54,59,10144,25,34,6354.12,11817.02,0.00
2024-12-08 16:58:54,58,10144,24,34,6457.57,11817.05,0.00
2024-12-08 16:58:54,59,10143,24,35,6164.28,11817.78,0.00
2024-12-08 16:58:54,59,10144,24,35,6353.70,11818.00,0.00
2024-12-08 16:58:54,60,10144,25,35,6247.80,11818.02,0.00
2024-12-08 16:58:54,59,10144,25,34,6313.64,11818.08,0.00
2024-12-08 16:58:54,58,10144,24,34,6374.50,11818.48,0.00
2024-12-08 16:58:54,58,10145,24,34,6629.06,11819.00,0.00
2024-12-08 16:58:54,59,10145,24,35,6516.70,11819.02,0.00
2024-12-08 16:58:54,59,10146,24,35,6483.31,11820.00,0.00
2024-12-08 16:58:54,60,10146,25,35,6375.26,11820.02,0.00
2024-12-08 16:58:54,59,10146,25,34,6445.26,11820.08,0.00
2024-12-08 16:58:54,59,10147,25,34,6443.76,11821.00,0.00
2024-12-08 16:58:54,60,10147,26,34,6336.37,11821.02,0.00
2024-12-08 16:58:54,59,10147,25,34,6441.76,11821.02,0.00
2024-12-08 16:58:54,58,10147,24,34,6453.99,11821.47,0.00
2024-12-08 16:58:54,57,10147,23,34,6516.03,11821.70,0.00
2024-12-08 16:58:54,57,10148,23,34,6675.34,11822.00,0.00
2024-12-08 16:58:54,58,10148,24,34,6560.25,11822.02,0.00
2024-12-08 16:58:54,57,10148,24,33,6629.73,11822.09,0.00
2024-12-08 16:58:54,56,10148,23,33,6675.38,11822.64,0.00
2024-12-08 16:58:54,56,10149,23,33,6744.94,11823.00,0.00
2024-12-08 16:58:54,57,10149,23,34,6626.60,11823.02,0.00
2024-12-08 16:58:54,57,10150,23,34,6575.83,11824.00,0.00
2024-12-08 16:58:54,58,10150,24,34,6462.46,11824.02,0.00
2024-12-08 16:58:54,57,10150,23,34,6563.70,11824.09,0.00
2024-12-08 16:58:54,56,10150,23,33,6651.59,11824.09,0.00
2024-12-08 16:58:54,55,10150,22,33,6681.26,11824.73,0.00
2024-12-08 16:58:54,55,10151,22,33,6846.15,11825.00,0.00
2024-12-08 16:58:54,56,10151,23,33,6723.90,11825.02,0.00
2024-12-08 16:58:54,56,10152,23,33,6668.48,11826.00,0.00
2024-12-08 16:58:54,57,10152,24,33,6551.49,11826.02,0.00
2024-12-08 16:58:54,56,10152,24,32,6622.03,11826.09,0.00
2024-12-08 16:58:54,55,10152,24,31,6620.26,11826.76,0.00
2024-12-08 16:58:54,55,10153,24,31,6721.52,11827.00,0.00
2024-12-08 16:58:54,56,10153,25,31,6601.49,11827.02,0.00
2024-12-08 16:58:54,55,10153,24,31,6638.32,11827.22,0.00
2024-12-08 16:58:54,55,10154,24,31,6689.35,11828.00,0.00
2024-12-08 16:58:54,56,10154,25,31,6569.90,11828.02,0.00
2024-12-08 16:58:54,55,10154,25,30,6644.20,11828.09,0.00
2024-12-08 16:58:54,54,10154,24,30,6692.35,11828.61,0.00
2024-12-08 16:58:54,54,10155,24,30,6865.70,11829.00,0.00
2024-12-08 16:58:54,55,10155,24,31,6740.87,11829.02,0.00
2024-12-08 16:58:54,55,10156,24,31,6725.51,11830.00,0.00
2024-12-08 16:58:54,56,10156,24,32,6605.41,11830.02,0.00
2024-12-08 16:58:54,55,10156,24,31,6676.04,11830.09,0.00
2024-12-08 16:58:54,55,10157,24,31,6692.26,11831.00,0.00
2024-12-08 16:58:54,56,10157,25,31,6572.76,11831.02,0.00
2024-12-08 16:58:54,55,10157,24,31,6687.69,11831.05,0.00
2024-12-08 16:58:54,55,10158,24,31,6671.43,11832.00,0.00
2024-12-08 16:58:54,56,10158,24,32,6552.29,11832.02,0.00
2024-12-08 16:58:54,55,10158,24,31,6626.26,11832.07,0.00
2024-12-08 16:58:54,55,10159,24,31,6634.00,11833.00,0.00
2024-12-08 16:58:54,56,10159,25,31,6515.53,11833.02,0.00
2024-12-08 16:58:54,55,10159,24,31,6447.89,11833.55,0.00
2024-12-08 16:58:54,55,10160,24,31,6606.05,11834.00,0.00
2024-12-08 16:58:54,56,10160,24,32,6488.09,11834.02,0.00
2024-12-08 16:58:54,57,10159,24,33,6368.04,11834.11,0.00
2024-12-08 16:58:54,57,10160,24,33,6535.35,11835.00,0.00
2024-12-08 16:58:54,58,10160,24,34,6422.67,11835.02,0.00
2024-12-08 16:58:54,58,10161,24,34,6640.80,11836.00,0.00
2024-12-08 16:58:54,59,10161,24,35,6528.24,11836.02,0.00
2024-12-08 16:58:54,58,10161,23,35,6637.95,11836.03,0.00
2024-12-08 16:58:54,58,10162,23,35,6646.13,11837.00,0.00
2024-12-08 16:58:54,59,10162,24,35,6533.49,11837.02,0.00
2024-12-08 16:58:54,59,10163,24,35,6519.23,11838.00,0.00
2024-12-08 16:58:54,60,10163,25,35,6410.58,11838.02,0.00
2024-12-08 16:58:54,59,10163,24,35,6517.22,11838.02,0.00
2024-12-08 16:58:55,59,10164,24,35,6480.39,11839.00,0.00
2024-12-08 16:58:55,60,10164,24,36,6372.38,11839.02,0.00
2024-12-08 16:58:55,59,10164,24,35,6454.30,11839.03,0.00
2024-12-08 16:58:55,59,10165,24,35,6450.91,11840.00,0.00
2024-12-08 16:58:55,60,10165,24,36,6343.39,11840.02,0.00
2024-12-08 16:58:55,59,10165,23,36,6308.02,11840.42,0.00
2024-12-08 16:58:55,59,10166,23,36,6438.50,11841.00,0.00
2024-12-08 16:58:55,60,10166,23,37,6331.19,11841.02,0.00
2024-12-08 16:58:55,59,10166,23,36,6414.42,11841.03,0.00
2024-12-08 16:58:55,58,10166,23,35,6496.36,11841.24,0.00
2024-12-08 16:58:55,57,10166,22,35,6497.13,11841.49,0.00
2024-12-08 16:58:55,57,10167,22,35,6639.87,11842.00,0.00
2024-12-08 16:58:55,58,10167,23,35,6525.39,11842.02,0.00
2024-12-08 16:58:55,57,10167,23,34,6622.67,11842.04,0.00
2024-12-08 16:58:55,57,10168,23,34,6625.61,11843.00,0.00
2024-12-08 16:58:55,58,10168,23,35,6511.37,11843.02,0.00
2024-12-08 16:58:55,57,10168,22,35,6529.56,11843.26,0.00
2024-12-08 16:58:55,57,10169,22,35,6639.38,11844.00,0.00
2024-12-08 16:58:55,58,10169,23,35,6524.91,11844.02,0.00
2024-12-08 16:58:55,57,10169,23,34,6612.37,11844.04,0.00
2024-12-08 16:58:55,58,10168,24,34,6490.09,11844.14,0.00
2024-12-08 16:58:55,58,10169,24,34,6699.52,11845.00,0.00
2024-12-08 16:58:55,59,10169,25,34,6585.97,11845.02,0.00
2024-12-08 16:58:55,58,10169,24,34,6506.26,11845.86,0.00
2024-12-08 16:58:55,58,10170,24,34,6898.51,11846.00,0.00
2024-12-08 16:58:55,59,10170,25,34,6781.58,11846.02,0.00
2024-12-08 16:58:55,58,10170,25,33,6869.92,11846.03,0.00
2024-12-08 16:58:55,58,10170,25,33,6861.19,11847.00,0.00
2024-12-08 16:58:55,59,10170,25,34,6744.90,11847.02,0.00
2024-12-08 16:58:55,58,10170,24,34,6808.12,11847.12,0.00
2024-12-08 16:58:55,58,10171,24,34,6815.57,11848.00,0.00
2024-12-08 16:58:55,59,10171,25,34,6700.05,11848.02,0.00
2024-12-08 16:58:55,58,10171,25,33,6789.01,11848.03,0.00
2024-12-08 16:58:55,58,10171,25,33,6775.95,11849.00,0.00
2024-12-08 16:58:55,59,10171,25,34,6661.10,11849.02,0.00
2024-12-08 16:58:55,59,10172,25,34,6616.56,11850.00,0.00
2024-12-08 16:58:55,60,10172,26,34,6506.29,11850.02,0.00
2024-12-08 16:58:55,59,10172,26,33,6570.39,11850.10,0.00
2024-12-08 16:58:55,59,10173,26,33,6552.04,11851.00,0.00
2024-12-08 16:58:55,60,10173,27,33,6442.84,11851.02,0.00
2024-12-08 16:58:55,59,10173,26,33,6471.30,11851.20,0.00
2024-12-08 16:58:55,58,10173,26,32,6515.03,11851.71,0.00
2024-12-08 16:58:55,58,10174,26,32,6675.71,11852.00,0.00
2024-12-08 16:58:55,59,10174,26,33,6562.56,11852.02,0.00
2024-12-08 16:58:55,58,10174,26,32,6630.78,11852.10,0.00
2024-12-08 16:58:55,58,10175,26,32,6629.95,11853.00,0.00
2024-12-08 16:58:55,59,10175,26,33,6517.58,11853.02,0.00
2024-12-08 16:58:55,58,10175,25,33,6620.80,11853.09,0.00
2024-12-08 16:58:55,58,10176,25,33,6594.09,11854.00,0.00
2024-12-08 16:58:55,59,10176,26,33,6482.33,11854.02,0.00
2024-12-08 16:58:55,58,10176,26,32,6551.19,11854.09,0.00
2024-12-08 16:58:55,57,10176,25,32,6592.25,11854.65,0.00
2024-12-08 16:58:55,56,10176,24,32,6630.54,11854.86,0.00
2024-12-08 16:58:55,56,10177,24,32,6825.40,11855.00,0.00
2024-12-08 16:58:55,57,10177,24,33,6705.65,11855.02,0.00
2024-12-08 16:58:55,56,10177,24,32,6771.95,11855.11,0.00
2024-12-08 16:58:55,56,10178,24,32,6777.50,11856.00,0.00
2024-12-08 16:58:55,57,10178,25,32,6658.60,11856.02,0.00
2024-12-08 16:58:55,56,10178,24,32,6600.80,11856.54,0.00
2024-12-08 16:58:55,56,10179,24,32,6748.25,11857.00,0.00
2024-12-08 16:58:55,57,10179,25,32,6629.85,11857.02,0.00
2024-12-08 16:58:55,56,10179,25,31,6746.13,11857.02,0.00
2024-12-08 16:58:55,55,10179,25,30,6867.08,11857.02,0.00
2024-12-08 16:58:55,54,10179,24,30,6989.10,11857.06,0.00
2024-12-08 16:58:55,53,10179,24,29,7078.46,11857.06,0.00
2024-12-08 16:58:55,52,10179,23,29,7136.30,11857.13,0.00
2024-12-08 16:58:55,51,10179,22,29,7223.79,11857.49,0.00
2024-12-08 16:58:55,51,10180,22,29,7388.85,11858.00,0.00
2024-12-08 16:58:55,52,10180,23,29,7246.75,11858.02,0.00
2024-12-08 16:58:55,51,10180,22,29,7207.62,11858.78,0.00
2024-12-08 16:58:55,51,10181,22,29,7414.75,11859.00,0.00
2024-12-08 16:58:55,52,10181,23,29,7272.15,11859.02,0.00
2024-12-08 16:58:55,51,10181,23,28,7368.26,11859.06,0.00
2024-12-08 16:58:55,51,10182,23,28,7384.19,11860.00,0.00
2024-12-08 16:58:55,52,10182,23,29,7242.19,11860.02,0.00
2024-12-08 16:58:55,52,10183,23,29,7212.74,11861.00,0.00
2024-12-08 16:58:55,53,10183,23,30,7076.65,11861.02,0.00
2024-12-08 16:58:55,52,10183,23,29,7167.14,11861.06,0.00
2024-12-08 16:58:55,52,10184,23,29,7179.66,11862.00,0.00
2024-12-08 16:58:55,53,10184,23,30,7044.19,11862.02,0.00
2024-12-08 16:58:55,52,10184,23,29,7116.81,11862.15,0.00
2024-12-08 16:58:55,52,10185,23,29,7166.49,11863.00,0.00
2024-12-08 16:58:55,53,10185,24,29,7031.28,11863.02,0.00
2024-12-08 16:58:55,52,10185,24,28,7116.48,11863.08,0.00
2024-12-08 16:58:55,52,10186,24,28,7144.43,11864.00,0.00
2024-12-08 16:58:55,53,10186,24,29,7009.63,11864.02,0.00
2024-12-08 16:58:55,52,10186,23,29,7057.85,11864.13,0.00
2024-12-08 16:58:55,51,10186,22,29,7148.65,11864.53,0.00
2024-12-08 16:58:55,51,10187,22,29,7325.82,11865.00,0.00
2024-12-08 16:58:55,52,10187,22,30,7184.94,11865.02,0.00
2024-12-08 16:58:56,52,10188,22,30,7158.60,11866.00,0.00
2024-12-08 16:58:56,53,10188,22,31,7023.53,11866.02,0.00
2024-12-08 16:58:56,52,10188,22,30,7146.54,11866.08,0.00
2024-12-08 16:58:56,52,10189,22,30,7174.50,11867.00,0.00
2024-12-08 16:58:56,53,10189,23,30,7039.13,11867.02,0.00
2024-12-08 16:58:56,53,10189,23,30,7031.17,11868.00,0.00
2024-12-08 16:58:56,54,10189,24,30,6900.96,11868.02,0.00
2024-12-08 16:58:56,53,10189,24,29,6977.45,11868.08,0.00
2024-12-08 16:58:56,53,10190,24,29,7001.01,11869.00,0.00
2024-12-08 16:58:56,54,10190,25,29,6871.36,11869.02,0.00
2024-12-08 16:58:56,54,10191,25,29,6858.31,11870.00,0.00
2024-12-08 16:58:56,55,10191,25,30,6733.61,11870.02,0.00
2024-12-08 16:58:56,54,10191,25,29,6805.57,11870.07,0.00
2024-12-08 16:58:56,54,10192,25,29,6816.50,11871.00,0.00
2024-12-08 16:58:56,55,10192,25,30,6692.56,11871.02,0.00
2024-12-08 16:58:56,54,10192,24,30,6708.86,11871.28,0.00
2024-12-08 16:58:56,54,10193,24,30,6826.47,11872.00,0.00
2024-12-08 16:58:56,55,10193,24,31,6702.35,11872.02,0.00
2024-12-08 16:58:56,54,10193,23,31,6718.82,11872.28,0.00
2024-12-08 16:58:56,54,10194,23,31,6830.64,11873.00,0.00
2024-12-08 16:58:56,55,10194,23,32,6706.45,11873.02,0.00
2024-12-08 16:58:56,54,10194,23,31,6829.81,11873.02,0.00
2024-12-08 16:58:56,53,10194,23,30,6947.49,11873.06,0.00
2024-12-08 16:58:56,52,10194,22,30,7025.37,11873.19,0.00
2024-12-08 16:58:56,52,10195,22,30,7105.92,11874.00,0.00
2024-12-08 16:58:56,53,10195,23,30,6971.85,11874.02,0.00
2024-12-08 16:58:56,52,10195,22,30,6910.84,11874.56,0.00
2024-12-08 16:58:56,52,10196,22,30,7087.01,11875.00,0.00
2024-12-08 16:58:56,53,10196,22,31,6953.29,11875.02,0.00
2024-12-08 16:58:56,52,10196,22,30,6965.24,11875.44,0.00
2024-12-08 16:58:56,52,10197,22,30,6971.25,11876.00,0.00
2024-12-08 16:58:56,53,10197,22,31,6839.72,11876.02,0.00
2024-12-08 16:58:56,52,10197,22,30,6964.41,11876.06,0.00
2024-12-08 16:58:56,51,10197,21,30,7027.80,11876.45,0.00
2024-12-08 16:58:56,51,10198,21,30,7102.73,11877.00,0.00
2024-12-08 16:58:56,52,10198,22,30,6966.14,11877.02,0.00
2024-12-08 16:58:56,51,10198,21,30,7034.87,11877.14,0.00
2024-12-08 16:58:56,51,10199,21,30,7165.84,11878.00,0.00
2024-12-08 16:58:56,52,10199,22,30,7028.04,11878.02,0.00
2024-12-08 16:58:56,51,10199,22,29,7114.62,11878.06,0.00
2024-12-08 16:58:56,52,10198,23,29,6977.80,11878.10,0.00
2024-12-08 16:58:56,51,10198,22,29,7252.06,11878.10,0.00
2024-12-08 16:58:56,51,10199,22,29,7285.24,11879.00,0.00
2024-12-08 16:58:56,52,10199,23,29,7145.14,11879.02,0.00
2024-12-08 16:58:56,52,10200,23,29,7421.40,11880.00,0.00
2024-12-08 16:58:56,53,10200,23,30,7281.37,11880.02,0.00
2024-12-08 16:58:56,54,10199,24,30,7146.53,11880.06,0.00
2024-12-08 16:58:56,54,10200,24,30,7261.25,11881.00,0.00
2024-12-08 16:58:56,55,10200,25,30,7129.23,11881.02,0.00
2024-12-08 16:58:56,55,10201,25,30,7355.79,11882.00,0.00
2024-12-08 16:58:56,56,10201,26,30,7224.44,11882.02,0.00
2024-12-08 16:58:56,55,10201,25,30,7303.97,11882.09,0.00
2024-12-08 16:58:56,55,10202,25,30,7332.58,11883.00,0.00
2024-12-08 16:58:56,56,10202,25,31,7201.64,11883.02,0.00
2024-12-08 16:58:56,55,10202,25,30,7293.71,11883.05,0.00
2024-12-08 16:58:56,54,10202,24,30,7263.76,11883.91,0.00
2024-12-08 16:58:56,54,10203,24,30,7472.90,11884.00,0.00
2024-12-08 16:58:56,55,10203,24,31,7337.03,11884.02,0.00
2024-12-08 16:58:56,54,10203,23,31,7340.78,11884.61,0.00
2024-12-08 16:58:56,54,10204,23,31,7514.96,11885.00,0.00
2024-12-08 16:58:56,55,10204,23,32,7378.32,11885.02,0.00
2024-12-08 16:58:56,54,10204,23,31,7477.56,11885.06,0.00
2024-12-08 16:58:56,54,10205,23,31,7497.33,11886.00,0.00
2024-12-08 16:58:56,55,10205,24,31,7361.02,11886.02,0.00
2024-12-08 16:58:56,55,10206,24,31,7333.05,11887.00,0.00
2024-12-08 16:58:56,56,10206,24,32,7202.10,11887.02,0.00
2024-12-08 16:58:56,55,10206,24,31,7276.50,11887.05,0.00
2024-12-08 16:58:56,54,10206,23,31,7410.10,11887.06,0.00
2024-12-08 16:58:56,54,10207,23,31,7511.42,11888.00,0.00
2024-12-08 16:58:56,55,10207,23,32,7374.85,11888.02,0.00
2024-12-08 16:58:56,55,10208,23,32,7278.22,11889.00,0.00
2024-12-08 16:58:56,56,10208,23,33,7148.25,11889.02,0.00
2024-12-08 16:58:56,55,10208,23,32,7134.90,11889.05,0.00
2024-12-08 16:58:56,55,10209,23,32,7138.58,11890.00,0.00
2024-12-08 16:58:56,56,10209,24,32,7011.10,11890.02,0.00
2024-12-08 16:58:56,55,10209,23,32,7118.62,11890.02,0.00
2024-12-08 16:58:56,54,10209,23,31,7190.15,11890.11,0.00
2024-12-08 16:58:56,53,10209,22,31,7268.20,11890.57,0.00
2024-12-08 16:58:56,53,10210,22,31,7439.07,11891.00,0.00
2024-12-08 16:58:56,54,10210,22,32,7301.31,11891.02,0.00
2024-12-08 16:58:56,53,10210,22,31,7391.96,11891.04,0.00
2024-12-08 16:58:56,53,10211,22,31,7412.77,11892.00,0.00
2024-12-08 16:58:56,54,10211,23,31,7275.50,11892.02,0.00
2024-12-08 16:58:56,53,10211,22,31,7410.53,11892.04,0.00
2024-12-08 16:58:57,53,10212,22,31,7398.57,11893.00,0.00
2024-12-08 16:58:57,54,10212,23,31,7261.56,11893.02,0.00
2024-12-08 16:58:57,53,10212,23,30,7351.45,11893.04,0.00
2024-12-08 16:58:57,53,10213,23,30,7372.26,11894.00,0.00
2024-12-08 16:58:57,54,10213,23,31,7235.74,11894.02,0.00
2024-12-08 16:58:57,53,10213,22,31,7219.07,11894.32,0.00
2024-12-08 16:58:57,52,10213,21,31,7321.49,11894.62,0.00
2024-12-08 16:58:57,52,10214,21,31,7504.79,11895.00,0.00
2024-12-08 16:58:57,53,10214,22,31,7363.19,11895.02,0.00
2024-12-08 16:58:57,52,10214,22,30,7456.75,11895.04,0.00
2024-12-08 16:58:57,52,10215,22,30,7480.26,11896.00,0.00
2024-12-08 16:58:57,53,10215,23,30,7339.12,11896.02,0.00
2024-12-08 16:58:57,53,10216,23,30,7312.80,11897.00,0.00
2024-12-08 16:58:57,54,10216,23,31,7177.38,11897.02,0.00
2024-12-08 16:58:57,53,10216,23,30,7293.32,11897.04,0.00
2024-12-08 16:58:57,53,10217,23,30,7314.14,11898.00,0.00
2024-12-08 16:58:57,54,10217,23,31,7178.69,11898.02,0.00
2024-12-08 16:58:57,54,10218,23,31,7165.50,11899.00,0.00
2024-12-08 16:58:57,55,10218,24,31,7035.22,11899.02,0.00
2024-12-08 16:58:57,54,10218,23,31,7163.30,11899.02,0.00
2024-12-08 16:58:57,53,10218,23,30,7251.31,11899.02,0.00
2024-12-08 16:58:57,52,10218,22,30,7222.61,11899.96,0.00
2024-12-08 16:58:57,52,10219,22,30,7446.90,11900.00,0.00
2024-12-08 16:58:57,53,10219,23,30,7306.39,11900.02,0.00
2024-12-08 16:58:57,54,10218,23,31,7054.60,11900.67,0.00
2024-12-08 16:58:57,54,10219,23,31,7200.59,11901.00,0.00
2024-12-08 16:58:57,55,10219,23,32,7069.67,11901.02,0.00
2024-12-08 16:58:57,54,10219,23,31,7156.51,11901.02,0.00
2024-12-08 16:58:57,53,10219,22,31,7154.80,11901.85,0.00
2024-12-08 16:58:57,53,10220,22,31,7586.08,11902.00,0.00
2024-12-08 16:58:57,54,10220,22,32,7445.59,11902.02,0.00
2024-12-08 16:58:57,54,10221,22,32,7436.11,11903.00,0.00
2024-12-08 16:58:57,55,10221,22,33,7300.91,11903.02,0.00
2024-12-08 16:58:57,55,10222,22,33,7271.22,11904.00,0.00
2024-12-08 16:58:57,56,10222,23,33,7141.38,11904.02,0.00
2024-12-08 16:58:57,55,10222,22,33,7146.40,11904.05,0.00
2024-12-08 16:58:57,55,10223,22,33,7250.90,11905.00,0.00
2024-12-08 16:58:57,56,10223,23,33,7121.42,11905.02,0.00
2024-12-08 16:58:57,55,10223,23,32,7214.10,11905.02,0.00
2024-12-08 16:58:57,54,10223,22,32,7340.36,11905.02,0.00
2024-12-08 16:58:57,54,10224,22,32,7444.60,11906.00,0.00
2024-12-08 16:58:57,55,10224,23,32,7309.24,11906.02,0.00
2024-12-08 16:58:57,54,10224,23,31,7440.19,11906.02,0.00
2024-12-08 16:58:57,54,10225,23,31,7454.30,11907.00,0.00
2024-12-08 16:58:57,55,10225,23,32,7318.77,11907.02,0.00
2024-12-08 16:58:57,55,10226,23,32,7300.51,11908.00,0.00
2024-12-08 16:58:57,56,10226,24,32,7170.15,11908.02,0.00
2024-12-08 16:58:57,55,10226,23,32,7298.35,11908.02,0.00
2024-12-08 16:58:57,54,10226,22,32,7293.76,11908.30,0.00
2024-12-08 16:58:57,54,10227,22,32,7421.30,11909.00,0.00
2024-12-08 16:58:57,55,10227,22,33,7286.37,11909.02,0.00
2024-12-08 16:58:57,54,10227,22,32,7419.10,11909.02,0.00
2024-12-08 16:58:57,53,10227,21,32,7466.98,11909.68,0.00
2024-12-08 16:58:57,53,10228,21,32,7563.87,11910.00,0.00
2024-12-08 16:58:57,54,10228,21,33,7423.80,11910.02,0.00
2024-12-08 16:58:57,53,10228,20,33,7559.38,11910.02,0.00
2024-12-08 16:58:57,53,10229,20,33,7610.43,11911.00,0.00
2024-12-08 16:58:57,54,10229,20,34,7469.49,11911.02,0.00
2024-12-08 16:58:57,53,10229,19,34,7536.29,11911.11,0.00
2024-12-08 16:58:57,53,10230,19,34,7631.03,11912.00,0.00
2024-12-08 16:58:57,54,10230,20,34,7489.71,11912.02,0.00
2024-12-08 16:58:57,53,10230,20,33,7628.78,11912.02,0.00
2024-12-08 16:58:57,53,10231,20,33,7619.86,11913.00,0.00
2024-12-08 16:58:57,54,10231,20,34,7478.75,11913.02,0.00
2024-12-08 16:58:57,53,10231,19,34,7568.17,11913.04,0.00
2024-12-08 16:58:57,53,10232,19,34,7652.48,11914.00,0.00
2024-12-08 16:58:57,54,10232,19,35,7510.76,11914.02,0.00
2024-12-08 16:58:57,53,10232,19,34,7607.52,11914.02,0.00
2024-12-08 16:58:57,53,10233,19,34,7604.18,11915.00,0.00
2024-12-08 16:58:57,54,10233,20,34,7463.36,11915.02,0.00
2024-12-08 16:58:57,55,10232,20,35,7269.21,11915.18,0.00
2024-12-08 16:58:57,54,10232,19,35,7430.10,11915.35,0.00
2024-12-08 16:58:57,54,10233,19,35,7568.01,11916.00,0.00
2024-12-08 16:58:57,55,10233,20,35,7430.41,11916.02,0.00
2024-12-08 16:58:57,55,10234,20,35,7620.82,11917.00,0.00
2024-12-08 16:58:57,56,10234,20,36,7484.74,11917.02,0.00
2024-12-08 16:58:57,55,10234,20,35,7579.66,11917.02,0.00
2024-12-08 16:58:57,55,10235,20,35,7591.05,11918.00,0.00
2024-12-08 16:58:57,56,10235,20,36,7455.50,11918.02,0.00
2024-12-08 16:58:57,56,10236,20,36,7416.05,11919.00,0.00
2024-12-08 16:58:57,57,10236,20,37,7285.95,11919.02,0.00
2024-12-08 16:58:57,56,10236,19,37,7411.80,11919.04,0.00
2024-12-08 16:58:57,55,10236,19,36,7542.23,11919.04,0.00
2024-12-08 16:58:57,54,10236,18,36,7512.63,11919.93,0.00
2024-12-08 16:58:58,54,10237,18,36,7724.58,11920.00,0.00
2024-12-08 16:58:58,55,10237,18,37,7584.14,11920.02,0.00
2024-12-08 16:58:58,56,10236,19,37,7372.20,11920.34,0.00
2024-12-08 16:58:58,56,10237,19,37,7447.00,11921.00,0.00
2024-12-08 16:58:58,57,10237,19,38,7316.35,11921.02,0.00
2024-12-08 16:58:58,56,10237,19,37,7400.17,11921.04,0.00
2024-12-08 16:58:58,55,10237,18,37,7358.22,11921.91,0.00
2024-12-08 16:58:58,55,10238,18,37,7780.96,11922.00,0.00
2024-12-08 16:58:58,56,10238,18,38,7642.02,11922.02,0.00
2024-12-08 16:58:58,55,10238,17,38,7667.21,11922.49,0.00
2024-12-08 16:58:58,55,10239,17,38,7721.84,11923.00,0.00
2024-12-08 16:58:58,56,10239,18,38,7583.95,11923.02,0.00
2024-12-08 16:58:58,55,10239,18,37,7676.32,11923.04,0.00
2024-12-08 16:58:58,54,10239,17,37,7668.76,11923.67,0.00
2024-12-08 16:58:58,54,10240,17,37,7781.58,11924.00,0.00
2024-12-08 16:58:58,55,10240,18,37,7640.10,11924.02,0.00
2024-12-08 16:58:58,54,10240,17,37,7702.47,11924.24,0.00
2024-12-08 16:58:58,54,10241,17,37,7710.99,11925.00,0.00
2024-12-08 16:58:58,55,10241,17,38,7570.79,11925.02,0.00
2024-12-08 16:58:58,54,10241,17,37,7664.62,11925.04,0.00
2024-12-08 16:58:58,53,10241,16,37,7664.77,11925.64,0.00
2024-12-08 16:58:58,53,10242,16,37,7733.63,11926.00,0.00
2024-12-08 16:58:58,54,10242,16,38,7590.41,11926.02,0.00
2024-12-08 16:58:58,54,10243,16,38,7591.32,11927.00,0.00
2024-12-08 16:58:58,55,10243,16,39,7453.29,11927.02,0.00
2024-12-08 16:58:58,55,10244,16,39,7440.77,11928.00,0.00
2024-12-08 16:58:58,56,10244,16,40,7307.90,11928.02,0.00
2024-12-08 16:58:58,56,10245,16,40,7267.70,11929.00,0.00
2024-12-08 16:58:58,57,10245,17,40,7140.20,11929.02,0.00
2024-12-08 16:58:58,56,10245,16,40,7084.83,11929.93,0.00
2024-12-08 16:58:58,56,10246,16,40,7289.40,11930.00,0.00
2024-12-08 16:58:58,57,10246,16,41,7161.51,11930.02,0.00
2024-12-08 16:58:58,56,10246,16,40,7274.49,11930.04,0.00
2024-12-08 16:58:58,55,10246,15,40,7404.59,11930.05,0.00
2024-12-08 16:58:58,55,10247,15,40,7382.23,11931.00,0.00
2024-12-08 16:58:58,56,10247,16,40,7250.40,11931.02,0.00
2024-12-08 16:58:58,56,10248,16,40,7181.67,11932.00,0.00
2024-12-08 16:58:58,57,10248,17,40,7055.68,11932.02,0.00
2024-12-08 16:58:58,56,10248,17,39,7147.59,11932.04,0.00
2024-12-08 16:58:58,55,10248,16,39,7083.24,11932.96,0.00
2024-12-08 16:58:58,55,10249,16,39,7295.88,11933.00,0.00
2024-12-08 16:58:58,56,10249,17,39,7165.60,11933.02,0.00
2024-12-08 16:58:58,55,10249,17,38,7239.77,11933.11,0.00
2024-12-08 16:58:58,55,10250,17,38,7217.28,11934.00,0.00
2024-12-08 16:58:58,56,10250,18,38,7088.40,11934.02,0.00
2024-12-08 16:58:58,55,10250,18,37,7178.23,11934.04,0.00
2024-12-08 16:58:58,54,10250,18,36,7273.90,11934.31,0.00
2024-12-08 16:58:58,53,10250,17,36,7379.05,11934.53,0.00
2024-12-08 16:58:58,53,10251,17,36,7430.97,11935.00,0.00
2024-12-08 16:58:58,54,10251,18,36,7293.36,11935.02,0.00
2024-12-08 16:58:58,54,10252,18,36,7231.89,11936.00,0.00
2024-12-08 16:58:58,55,10252,18,37,7100.40,11936.02,0.00
2024-12-08 16:58:58,54,10252,18,36,7194.32,11936.04,0.00
2024-12-08 16:58:58,54,10253,18,36,7166.18,11937.00,0.00
2024-12-08 16:58:58,55,10253,19,36,7035.89,11937.02,0.00
2024-12-08 16:58:58,54,10253,18,36,7047.68,11937.59,0.00
2024-12-08 16:58:58,54,10254,18,36,7098.41,11938.00,0.00
2024-12-08 16:58:58,55,10254,18,37,6969.35,11938.02,0.00
2024-12-08 16:58:58,54,10254,18,36,7063.05,11938.04,0.00
2024-12-08 16:58:58,53,10254,17,36,7191.82,11938.08,0.00
2024-12-08 16:58:58,52,10254,16,36,7323.04,11938.13,0.00
2024-12-08 16:58:58,51,10254,15,36,7369.23,11938.71,0.00
2024-12-08 16:58:58,51,10255,15,36,7474.81,11939.00,0.00
2024-12-08 16:58:58,52,10255,16,36,7331.06,11939.02,0.00
2024-12-08 16:58:58,52,10256,16,36,7294.00,11940.00,0.00
2024-12-08 16:58:58,53,10256,16,37,7156.38,11940.02,0.00
2024-12-08 16:58:58,52,10256,16,36,7259.57,11940.04,0.00
2024-12-08 16:58:58,51,10256,15,36,7235.09,11940.96,0.00
2024-12-08 16:58:58,51,10257,15,36,7464.57,11941.00,0.00
2024-12-08 16:58:58,52,10257,15,37,7321.02,11941.02,0.00
2024-12-08 16:58:58,52,10258,15,37,7278.79,11942.00,0.00
2024-12-08 16:58:58,53,10258,16,37,7141.45,11942.02,0.00
2024-12-08 16:58:58,52,10258,16,36,7242.05,11942.04,0.00
2024-12-08 16:58:58,52,10259,16,36,7251.88,11943.00,0.00
2024-12-08 16:58:58,53,10259,16,37,7115.05,11943.02,0.00
2024-12-08 16:58:58,52,10259,16,36,7180.95,11943.17,0.00
2024-12-08 16:58:58,52,10260,16,36,7229.35,11944.00,0.00
2024-12-08 16:58:58,53,10260,16,37,7092.95,11944.02,0.00
2024-12-08 16:58:58,52,10260,16,36,7188.01,11944.04,0.00
2024-12-08 16:58:58,51,10260,15,36,7199.68,11944.80,0.00
2024-12-08 16:58:58,51,10261,15,36,7410.63,11945.00,0.00
2024-12-08 16:58:58,52,10261,15,37,7268.11,11945.02,0.00
2024-12-08 16:58:58,52,10262,15,37,7251.45,11946.00,0.00
2024-12-08 16:58:58,53,10262,15,38,7114.63,11946.02,0.00
2024-12-08 16:58:58,52,10262,15,37,7203.23,11946.08,0.00
2024-12-08 16:58:58,52,10263,15,37,7231.38,11947.00,0.00
2024-12-08 16:58:58,53,10263,15,38,7094.94,11947.02,0.00
2024-12-08 16:58:59,53,10264,15,38,7078.10,11948.00,0.00
2024-12-08 16:58:59,54,10264,16,38,6947.03,11948.02,0.00
2024-12-08 16:58:59,53,10264,16,37,7033.04,11948.08,0.00
2024-12-08 16:58:59,52,10264,15,37,7163.72,11948.10,0.00
2024-12-08 16:58:59,51,10264,14,37,7247.39,11948.24,0.00
2024-12-08 16:58:59,51,10265,14,37,7390.83,11949.00,0.00
2024-12-08 16:58:59,52,10265,15,37,7248.69,11949.02,0.00
2024-12-08 16:58:59,51,10265,14,37,7300.06,11949.16,0.00
2024-12-08 16:58:59,51,10266,14,37,7434.18,11950.00,0.00
2024-12-08 16:58:59,52,10266,14,38,7291.22,11950.02,0.00
2024-12-08 16:58:59,51,10266,14,37,7389.69,11950.08,0.00
2024-12-08 16:58:59,51,10267,14,37,7415.70,11951.00,0.00
2024-12-08 16:58:59,52,10267,14,38,7273.09,11951.02,0.00
2024-12-08 16:58:59,51,10267,13,38,7293.97,11951.29,0.00
2024-12-08 16:58:59,50,10267,12,38,7380.57,11951.66,0.00
2024-12-08 16:58:59,50,10268,12,38,7579.22,11952.00,0.00
2024-12-08 16:58:59,51,10268,13,38,7430.61,11952.02,0.00
2024-12-08 16:58:59,50,10268,13,37,7535.58,11952.08,0.00
2024-12-08 16:58:59,50,10269,13,37,7544.37,11953.00,0.00
2024-12-08 16:58:59,51,10269,13,38,7396.44,11953.02,0.00
2024-12-08 16:58:59,51,10270,13,38,7335.80,11954.00,0.00
2024-12-08 16:58:59,52,10270,13,39,7194.73,11954.02,0.00
2024-12-08 16:58:59,51,10270,13,38,7286.60,11954.08,0.00
2024-12-08 16:58:59,51,10271,13,38,7258.80,11955.00,0.00
2024-12-08 16:58:59,52,10271,14,38,7119.21,11955.02,0.00
2024-12-08 16:58:59,51,10271,13,38,7251.77,11955.02,0.00
2024-12-08 16:58:59,50,10271,13,37,7289.75,11955.42,0.00
2024-12-08 16:58:59,50,10272,13,37,7459.94,11956.00,0.00
2024-12-08 16:58:59,51,10272,13,38,7313.66,11956.02,0.00
2024-12-08 16:58:59,50,10272,13,37,7409.74,11956.06,0.00
2024-12-08 16:58:59,50,10273,13,37,7441.43,11957.00,0.00
2024-12-08 16:58:59,51,10273,13,38,7295.52,11957.02,0.00
2024-12-08 16:58:59,51,10274,13,38,7279.40,11958.00,0.00
2024-12-08 16:58:59,52,10274,14,38,7139.41,11958.02,0.00
2024-12-08 16:58:59,51,10274,14,37,7227.83,11958.06,0.00
2024-12-08 16:58:59,50,10274,13,37,7357.23,11958.08,0.00
2024-12-08 16:58:59,50,10275,13,37,7482.89,11959.00,0.00
2024-12-08 16:58:59,51,10275,13,38,7336.16,11959.02,0.00
2024-12-08 16:58:59,50,10275,12,38,7291.81,11959.52,0.00
2024-12-08 16:58:59,50,10276,12,38,7468.75,11960.00,0.00
2024-12-08 16:58:59,51,10276,13,38,7322.31,11960.02,0.00
2024-12-08 16:58:59,50,10276,13,37,7418.54,11960.06,0.00
2024-12-08 16:58:59,50,10277,13,37,7443.93,11961.00,0.00
2024-12-08 16:58:59,51,10277,13,38,7297.97,11961.02,0.00
2024-12-08 16:58:59,51,10278,13,38,7275.53,11962.00,0.00
2024-12-08 16:58:59,52,10278,14,38,7135.61,11962.02,0.00
2024-12-08 16:58:59,51,10278,13,38,7223.68,11962.02,0.00
2024-12-08 16:58:59,50,10278,13,37,7320.30,11962.04,0.00
2024-12-08 16:58:59,49,10278,12,37,7371.70,11962.82,0.00
2024-12-08 16:58:59,49,10279,12,37,7594.01,11963.00,0.00
2024-12-08 16:58:59,50,10279,13,37,7442.13,11963.02,0.00
2024-12-08 16:58:59,49,10279,12,37,7480.81,11963.55,0.00
2024-12-08 16:58:59,49,10280,12,37,7576.70,11964.00,0.00
2024-12-08 16:58:59,50,10280,12,38,7425.17,11964.02,0.00
2024-12-08 16:58:59,49,10280,12,37,7530.31,11964.04,0.00
2024-12-08 16:58:59,49,10281,12,37,7562.05,11965.00,0.00
2024-12-08 16:58:59,50,10281,13,37,7410.80,11965.02,0.00
2024-12-08 16:58:59,50,10282,13,37,7388.75,11966.00,0.00
2024-12-08 16:58:59,51,10282,13,38,7243.88,11966.02,0.00
2024-12-08 16:58:59,50,10282,13,37,7345.68,11966.04,0.00
2024-12-08 16:58:59,50,10283,13,37,7372.16,11967.00,0.00
2024-12-08 16:58:59,51,10283,14,37,7227.61,11967.02,0.00
2024-12-08 16:58:59,51,10284,14,37,7202.91,11968.00,0.00
2024-12-08 16:58:59,52,10284,15,37,7064.39,11968.02,0.00
2024-12-08 16:58:59,51,10284,15,36,7163.02,11968.04,0.00
2024-12-08 16:58:59,51,10285,15,36,7185.92,11969.00,0.00
2024-12-08 16:58:59,52,10285,15,37,7047.73,11969.02,0.00
2024-12-08 16:58:59,51,10285,14,37,7066.56,11969.63,0.00
2024-12-08 16:58:59,51,10286,14,37,7168.90,11970.00,0.00
2024-12-08 16:58:59,52,10286,14,38,7031.03,11970.02,0.00
2024-12-08 16:58:59,51,10286,14,37,7124.30,11970.04,0.00
2024-12-08 16:58:59,51,10287,14,37,7147.92,11971.00,0.00
2024-12-08 16:58:59,52,10287,15,37,7010.46,11971.02,0.00
2024-12-08 16:58:59,53,10286,16,37,6738.78,11971.83,0.00
2024-12-08 16:58:59,53,10287,16,37,6883.68,11972.00,0.00
2024-12-08 16:58:59,54,10287,17,37,6756.21,11972.02,0.00
2024-12-08 16:58:59,53,10287,17,36,6840.77,11972.04,0.00
2024-12-08 16:58:59,52,10287,16,36,6820.86,11972.90,0.00
2024-12-08 16:58:59,52,10288,16,36,7269.90,11973.00,0.00
2024-12-08 16:58:59,53,10288,16,37,7132.74,11973.02,0.00
2024-12-08 16:58:59,52,10288,15,37,7095.77,11973.46,0.00
2024-12-08 16:58:59,52,10289,15,37,7259.76,11974.00,0.00
2024-12-08 16:58:59,53,10289,15,38,7122.78,11974.02,0.00
2024-12-08 16:58:59,52,10289,15,37,7218.31,11974.04,0.00
2024-12-08 16:59:00,52,10290,15,37,7228.27,11975.00,0.00
2024-12-08 16:59:00,53,10290,16,37,7091.89,11975.02,0.00
2024-12-08 16:59:00,52,10290,15,37,7212.15,11975.02,0.00
2024-12-08 16:59:00,52,10291,15,37,7263.85,11976.00,0.00
2024-12-08 16:59:00,53,10291,16,37,7126.79,11976.02,0.00
2024-12-08 16:59:00,52,10291,16,36,7227.00,11976.02,0.00
2024-12-08 16:59:00,52,10292,16,36,7235.46,11977.00,0.00
2024-12-08 16:59:00,53,10292,17,36,7098.94,11977.02,0.00
2024-12-08 16:59:00,52,10292,16,36,7047.20,11977.50,0.00
2024-12-08 16:59:00,52,10293,16,36,7218.00,11978.00,0.00
2024-12-08 16:59:00,53,10293,16,37,7081.81,11978.02,0.00
2024-12-08 16:59:00,52,10293,16,36,7181.15,11978.02,0.00
2024-12-08 16:59:00,52,10294,16,36,7200.13,11979.00,0.00
2024-12-08 16:59:00,53,10294,17,36,7064.28,11979.02,0.00
2024-12-08 16:59:00,53,10295,17,36,7044.40,11980.00,0.00
2024-12-08 16:59:00,54,10295,18,36,6913.94,11980.02,0.00
2024-12-08 16:59:00,53,10295,18,35,7010.49,11980.02,0.00
2024-12-08 16:59:00,53,10296,18,35,7029.16,11981.00,0.00
2024-12-08 16:59:00,54,10296,18,36,6898.99,11981.02,0.00
2024-12-08 16:59:00,53,10296,17,36,6898.38,11981.68,0.00
2024-12-08 16:59:00,53,10297,17,36,7086.26,11982.00,0.00
2024-12-08 16:59:00,54,10297,17,37,6955.04,11982.02,0.00
2024-12-08 16:59:00,53,10297,17,36,7054.61,11982.02,0.00
2024-12-08 16:59:00,53,10298,17,36,7073.29,11983.00,0.00
2024-12-08 16:59:00,54,10298,17,37,6942.30,11983.02,0.00
2024-12-08 16:59:00,54,10299,17,37,6922.48,11984.00,0.00
2024-12-08 16:59:00,55,10299,17,38,6796.62,11984.02,0.00
2024-12-08 16:59:00,54,10299,17,37,6891.41,11984.02,0.00
2024-12-08 16:59:00,54,10300,17,37,6907.52,11985.00,0.00
2024-12-08 16:59:00,55,10300,18,37,6781.93,11985.02,0.00
2024-12-08 16:59:00,54,10300,17,37,6732.64,11985.87,0.00
2024-12-08 16:59:00,54,10301,17,37,6939.17,11986.00,0.00
2024-12-08 16:59:00,55,10301,17,38,6813.01,11986.02,0.00
2024-12-08 16:59:00,54,10301,17,37,6910.32,11986.02,0.00
2024-12-08 16:59:00,53,10301,16,37,6964.67,11986.64,0.00
2024-12-08 16:59:00,53,10302,16,37,7057.69,11987.00,0.00
2024-12-08 16:59:00,54,10302,16,38,6926.99,11987.02,0.00
2024-12-08 16:59:00,53,10302,15,38,6942.59,11987.60,0.00
2024-12-08 16:59:00,53,10303,15,38,7036.02,11988.00,0.00
2024-12-08 16:59:00,54,10303,16,38,6905.72,11988.02,0.00
2024-12-08 16:59:00,53,10303,16,37,7008.87,11988.02,0.00
2024-12-08 16:59:00,52,10303,15,37,6984.76,11988.96,0.00
2024-12-08 16:59:00,52,10304,15,37,7210.73,11989.00,0.00
2024-12-08 16:59:00,53,10304,16,37,7074.67,11989.02,0.00
2024-12-08 16:59:00,54,10303,16,38,6894.83,11989.09,0.00
2024-12-08 16:59:00,53,10303,15,38,7112.35,11989.81,0.00
2024-12-08 16:59:00,53,10304,15,38,7316.12,11990.00,0.00
2024-12-08 16:59:00,54,10304,16,38,7180.63,11990.02,0.00
2024-12-08 16:59:00,53,10304,16,37,7288.97,11990.02,0.00
2024-12-08 16:59:00,53,10305,16,37,7533.92,11991.00,0.00
2024-12-08 16:59:00,54,10305,17,37,7394.40,11991.02,0.00
2024-12-08 16:59:00,53,10305,16,37,7457.18,11991.15,0.00
2024-12-08 16:59:00,53,10306,16,37,7580.33,11992.00,0.00
2024-12-08 16:59:00,54,10306,17,37,7439.96,11992.02,0.00
2024-12-08 16:59:00,53,10306,17,36,7555.44,11992.02,0.00
2024-12-08 16:59:00,53,10307,17,36,7558.63,11993.00,0.00
2024-12-08 16:59:00,54,10307,18,36,7418.66,11993.02,0.00
2024-12-08 16:59:00,54,10308,18,36,7378.24,11994.00,0.00
2024-12-08 16:59:00,55,10308,18,37,7244.09,11994.02,0.00
2024-12-08 16:59:00,54,10308,18,36,7349.38,11994.04,0.00
2024-12-08 16:59:00,54,10309,18,36,7358.60,11995.00,0.00
2024-12-08 16:59:00,55,10309,19,36,7224.81,11995.02,0.00
2024-12-08 16:59:00,55,10310,19,36,7185.24,11996.00,0.00
2024-12-08 16:59:00,56,10310,20,36,7056.94,11996.02,0.00
2024-12-08 16:59:00,55,10310,20,35,7159.09,11996.04,0.00
2024-12-08 16:59:00,54,10310,19,35,7285.02,11996.09,0.00
2024-12-08 16:59:00,54,10311,19,35,7297.51,11997.00,0.00
2024-12-08 16:59:00,55,10311,20,35,7164.83,11997.02,0.00
2024-12-08 16:59:00,55,10312,20,35,7121.63,11998.00,0.00
2024-12-08 16:59:00,56,10312,20,36,6994.45,11998.02,0.00
2024-12-08 16:59:00,55,10312,20,35,7097.65,11998.04,0.00
2024-12-08 16:59:00,55,10313,20,35,7099.04,11999.00,0.00
2024-12-08 16:59:00,56,10313,21,35,6972.27,11999.02,0.00
2024-12-08 16:59:00,56,10314,21,35,6925.02,12000.00,0.00
2024-12-08 16:59:00,57,10314,21,36,6803.53,12000.02,0.00
2024-12-08 16:59:00,56,10314,21,35,6903.61,12000.04,0.00
2024-12-08 16:59:00,56,10315,21,35,6892.96,12001.00,0.00
2024-12-08 16:59:00,57,10315,21,36,6772.03,12001.02,0.00
2024-12-08 16:59:00,57,10316,21,36,6697.95,12002.00,0.00
2024-12-08 16:59:00,58,10316,21,37,6582.47,12002.02,0.00
2024-12-08 16:59:00,57,10316,21,36,6676.91,12002.04,0.00
2024-12-08 16:59:00,56,10316,21,35,6695.44,12002.46,0.00
2024-12-08 16:59:00,55,10316,20,35,6725.43,12002.93,0.00
2024-12-08 16:59:01,55,10317,20,35,6934.98,12003.00,0.00
2024-12-08 16:59:01,56,10317,21,35,6811.14,12003.02,0.00
2024-12-08 16:59:01,56,10318,21,35,6734.12,12004.00,0.00
2024-12-08 16:59:01,57,10318,21,36,6615.98,12004.02,0.00
2024-12-08 16:59:01,56,10318,21,35,6704.12,12004.04,0.00
2024-12-08 16:59:01,55,10318,21,34,6683.34,12004.44,0.00
2024-12-08 16:59:01,55,10319,21,34,6747.00,12005.00,0.00
2024-12-08 16:59:01,56,10319,22,34,6626.52,12005.02,0.00
2024-12-08 16:59:01,55,10319,21,34,6600.88,12005.73,0.00
2024-12-08 16:59:01,55,10320,21,34,6786.60,12006.00,0.00
2024-12-08 16:59:01,56,10320,22,34,6665.42,12006.02,0.00
2024-12-08 16:59:01,55,10320,22,33,6756.06,12006.04,0.00
2024-12-08 16:59:01,55,10321,22,33,6763.61,12007.00,0.00
2024-12-08 16:59:01,56,10321,23,33,6642.83,12007.02,0.00
2024-12-08 16:59:01,56,10322,23,33,6610.00,12008.00,0.00
2024-12-08 16:59:01,57,10322,23,34,6494.03,12008.02,0.00
2024-12-08 16:59:01,56,10322,23,33,6579.99,12008.04,0.00
2024-12-08 16:59:01,56,10323,23,33,6581.09,12009.00,0.00
2024-12-08 16:59:01,57,10323,24,33,6465.63,12009.02,0.00
2024-12-08 16:59:01,57,10324,24,33,6429.74,12010.00,0.00
2024-12-08 16:59:01,58,10324,24,34,6318.89,12010.02,0.00
2024-12-08 16:59:01,57,10324,24,33,6402.37,12010.04,0.00
2024-12-08 16:59:01,56,10324,23,33,6493.18,12010.20,0.00
2024-12-08 16:59:01,56,10324,23,33,6518.31,12011.00,0.00
2024-12-08 16:59:01,57,10324,24,33,6403.96,12011.02,0.00
2024-12-08 16:59:01,57,10325,24,33,6371.68,12012.00,0.00
2024-12-08 16:59:01,58,10325,24,34,6261.82,12012.02,0.00
2024-12-08 16:59:01,57,10325,24,33,6344.30,12012.04,0.00
2024-12-08 16:59:01,57,10326,24,33,6345.15,12013.00,0.00
2024-12-08 16:59:01,58,10326,25,33,6235.75,12013.02,0.00
2024-12-08 16:59:01,57,10326,24,33,6217.21,12013.63,0.00
2024-12-08 16:59:01,57,10327,24,33,6311.35,12014.00,0.00
2024-12-08 16:59:01,58,10327,25,33,6202.54,12014.02,0.00
2024-12-08 16:59:01,57,10327,25,32,6286.08,12014.04,0.00
2024-12-08 16:59:01,56,10327,24,32,6311.56,12014.66,0.00
2024-12-08 16:59:01,56,10328,24,32,6399.74,12015.00,0.00
2024-12-08 16:59:01,57,10328,24,33,6287.47,12015.02,0.00
2024-12-08 16:59:01,57,10329,24,33,6253.76,12016.00,0.00
2024-12-08 16:59:01,58,10329,24,34,6145.94,12016.02,0.00
2024-12-08 16:59:01,57,10329,24,33,6230.58,12016.04,0.00
2024-12-08 16:59:01,56,10329,24,32,6281.16,12016.50,0.00
2024-12-08 16:59:01,55,10329,23,32,6292.52,12016.96,0.00
2024-12-08 16:59:01,55,10330,23,32,6506.66,12017.00,0.00
2024-12-08 16:59:01,56,10330,24,32,6390.47,12017.02,0.00
2024-12-08 16:59:01,56,10331,24,32,6356.66,12018.00,0.00
2024-12-08 16:59:01,57,10331,24,33,6245.14,12018.02,0.00
2024-12-08 16:59:01,56,10331,24,32,6335.21,12018.04,0.00
2024-12-08 16:59:01,56,10332,24,32,6283.96,12019.00,0.00
2024-12-08 16:59:01,57,10332,25,32,6173.72,12019.02,0.00
2024-12-08 16:59:01,56,10332,24,32,6223.91,12019.16,0.00
2024-12-08 16:59:01,55,10332,24,31,6133.08,12019.55,0.00
2024-12-08 16:59:01,55,10333,24,31,6297.27,12020.00,0.00
2024-12-08 16:59:01,56,10333,24,32,6184.82,12020.02,0.00
2024-12-08 16:59:01,55,10333,24,31,6277.62,12020.04,0.00
2024-12-08 16:59:01,54,10333,23,31,6376.10,12020.17,0.00
2024-12-08 16:59:01,53,10333,22,31,6444.82,12020.58,0.00
2024-12-08 16:59:01,53,10334,22,31,6530.74,12021.00,0.00
2024-12-08 16:59:01,54,10334,23,31,6409.80,12021.02,0.00
2024-12-08 16:59:01,53,10334,22,31,6353.59,12021.51,0.00
2024-12-08 16:59:01,52,10334,21,31,6468.86,12021.58,0.00
2024-12-08 16:59:01,52,10335,21,31,6647.62,12022.00,0.00
2024-12-08 16:59:01,53,10335,22,31,6522.19,12022.02,0.00
2024-12-08 16:59:01,52,10335,22,30,6624.51,12022.04,0.00
2024-12-08 16:59:01,52,10336,22,30,6646.67,12023.00,0.00
2024-12-08 16:59:01,53,10336,23,30,6521.26,12023.02,0.00
2024-12-08 16:59:01,53,10337,23,30,6493.87,12024.00,0.00
2024-12-08 16:59:01,54,10337,23,31,6373.61,12024.02,0.00
2024-12-08 16:59:01,53,10337,23,30,6484.23,12024.04,0.00
2024-12-08 16:59:01,53,10338,23,30,6505.18,12025.00,0.00
2024-12-08 16:59:01,54,10338,23,31,6384.71,12025.02,0.00
2024-12-08 16:59:01,53,10338,23,30,6476.63,12025.04,0.00
2024-12-08 16:59:01,53,10339,23,30,6494.98,12026.00,0.00
2024-12-08 16:59:01,54,10339,24,30,6374.70,12026.02,0.00
2024-12-08 16:59:01,53,10339,23,30,6415.62,12026.19,0.00
2024-12-08 16:59:01,54,10338,24,30,6221.69,12026.80,0.00
2024-12-08 16:59:01,54,10339,24,30,6444.57,12027.00,0.00
2024-12-08 16:59:01,55,10339,25,30,6327.40,12027.02,0.00
2024-12-08 16:59:01,54,10339,25,29,6439.19,12027.04,0.00
2024-12-08 16:59:01,54,10340,25,29,6675.65,12028.00,0.00
2024-12-08 16:59:01,55,10340,26,29,6554.28,12028.02,0.00
2024-12-08 16:59:01,54,10340,25,29,6470.47,12028.63,0.00
2024-12-08 16:59:01,54,10341,25,29,6648.94,12029.00,0.00
2024-12-08 16:59:01,55,10341,25,30,6528.05,12029.02,0.00
2024-12-08 16:59:01,54,10341,25,29,6628.90,12029.04,0.00
2024-12-08 16:59:01,53,10341,24,29,6697.81,12029.26,0.00
2024-12-08 16:59:01,52,10341,23,29,6789.19,12029.58,0.00
2024-12-08 16:59:02,52,10342,23,29,6969.95,12030.00,0.00
2024-12-08 16:59:02,53,10342,24,29,6838.44,12030.02,0.00
2024-12-08 16:59:02,52,10342,23,29,6828.97,12030.38,0.00
2024-12-08 16:59:02,52,10343,23,29,6986.72,12031.00,0.00
2024-12-08 16:59:02,53,10343,24,29,6854.90,12031.02,0.00
2024-12-08 16:59:02,52,10343,24,28,6968.22,12031.04,0.00
2024-12-08 16:59:02,52,10344,24,28,6991.93,12032.00,0.00
2024-12-08 16:59:02,53,10344,25,28,6860.01,12032.02,0.00
2024-12-08 16:59:02,52,10344,24,28,6927.19,12032.15,0.00
2024-12-08 16:59:02,52,10345,24,28,6964.74,12033.00,0.00
2024-12-08 16:59:02,53,10345,25,28,6833.33,12033.02,0.00
2024-12-08 16:59:02,52,10345,25,27,6946.24,12033.04,0.00
2024-12-08 16:59:02,51,10345,24,27,7042.39,12033.22,0.00
2024-12-08 16:59:02,51,10346,24,27,7184.48,12034.00,0.00
2024-12-08 16:59:02,52,10346,24,28,7046.32,12034.02,0.00
2024-12-08 16:59:02,52,10347,24,28,7031.67,12035.00,0.00
2024-12-08 16:59:02,53,10347,25,28,6899.00,12035.02,0.00
2024-12-08 16:59:02,52,10347,25,27,6990.02,12035.04,0.00
2024-12-08 16:59:02,51,10347,24,27,7116.16,12035.10,0.00
2024-12-08 16:59:02,51,10348,24,27,7242.22,12036.00,0.00
2024-12-08 16:59:02,52,10348,24,28,7102.95,12036.02,0.00
2024-12-08 16:59:02,51,10348,23,28,7180.90,12036.14,0.00
2024-12-08 16:59:02,51,10349,23,28,7216.61,12037.00,0.00
2024-12-08 16:59:02,52,10349,23,29,7077.83,12037.02,0.00
2024-12-08 16:59:02,51,10349,23,28,7195.38,12037.04,0.00
2024-12-08 16:59:02,50,10349,22,28,7282.80,12037.50,0.00
2024-12-08 16:59:02,50,10350,22,28,7364.94,12038.00,0.00
2024-12-08 16:59:02,51,10350,23,28,7220.53,12038.02,0.00
2024-12-08 16:59:02,51,10351,23,28,7188.52,12039.00,0.00
2024-12-08 16:59:02,52,10351,23,29,7050.28,12039.02,0.00
2024-12-08 16:59:02,51,10351,23,28,7142.08,12039.04,0.00
2024-12-08 16:59:02,50,10351,22,28,7215.39,12039.60,0.00
2024-12-08 16:59:02,50,10352,22,28,7408.27,12040.00,0.00
2024-12-08 16:59:02,51,10352,23,28,7263.01,12040.02,0.00
2024-12-08 16:59:02,51,10353,23,28,7207.52,12041.00,0.00
2024-12-08 16:59:02,52,10353,24,28,7068.92,12041.02,0.00
2024-12-08 16:59:02,51,10353,24,27,7139.31,12041.06,0.00
2024-12-08 16:59:02,51,10354,24,27,7167.38,12042.00,0.00
2024-12-08 16:59:02,52,10354,24,28,7029.54,12042.02,0.00
2024-12-08 16:59:02,51,10354,23,28,7153.75,12042.02,0.00
2024-12-08 16:59:02,50,10354,22,28,7176.69,12042.60,0.00
2024-12-08 16:59:02,50,10355,22,28,7274.23,12043.00,0.00
2024-12-08 16:59:02,51,10355,22,29,7131.60,12043.02,0.00
2024-12-08 16:59:02,50,10355,22,28,7242.92,12043.04,0.00
2024-12-08 16:59:02,49,10355,21,28,7225.01,12043.96,0.00
2024-12-08 16:59:02,49,10356,21,28,7465.91,12044.00,0.00
2024-12-08 16:59:02,50,10356,21,29,7316.59,12044.02,0.00
2024-12-08 16:59:02,50,10357,21,29,7288.62,12045.00,0.00
2024-12-08 16:59:02,51,10357,21,30,7145.71,12045.02,0.00
2024-12-08 16:59:02,50,10357,21,29,7252.49,12045.04,0.00
2024-12-08 16:59:02,50,10358,21,29,7272.47,12046.00,0.00
2024-12-08 16:59:02,51,10358,21,30,7129.87,12046.02,0.00
2024-12-08 16:59:02,50,10358,20,30,7136.17,12046.32,0.00
2024-12-08 16:59:02,50,10359,20,30,7288.32,12047.00,0.00
2024-12-08 16:59:02,51,10359,21,30,7145.42,12047.02,0.00
2024-12-08 16:59:02,50,10359,21,29,7249.78,12047.04,0.00
2024-12-08 16:59:02,50,10360,21,29,7275.04,12048.00,0.00
2024-12-08 16:59:02,51,10360,21,30,7132.39,12048.02,0.00
2024-12-08 16:59:02,51,10361,21,30,7113.21,12049.00,0.00
2024-12-08 16:59:02,52,10361,21,31,6976.41,12049.02,0.00
2024-12-08 16:59:02,51,10361,21,30,7077.77,12049.04,0.00
2024-12-08 16:59:02,51,10362,21,30,7102.16,12050.00,0.00
2024-12-08 16:59:02,52,10362,21,31,6965.58,12050.02,0.00
2024-12-08 16:59:02,51,10362,20,31,6936.65,12050.41,0.00
2024-12-08 16:59:02,51,10363,20,31,7100.50,12051.00,0.00
2024-12-08 16:59:02,52,10363,20,32,6963.95,12051.02,0.00
2024-12-08 16:59:02,51,10363,20,31,7065.06,12051.04,0.00
2024-12-08 16:59:02,50,10363,19,31,7104.95,12051.46,0.00
2024-12-08 16:59:02,50,10364,19,31,7279.50,12052.00,0.00
2024-12-08 16:59:02,51,10364,19,32,7136.76,12052.02,0.00
2024-12-08 16:59:02,50,10364,18,32,7214.71,12052.14,0.00
2024-12-08 16:59:02,49,10364,17,32,7244.66,12052.75,0.00
2024-12-08 16:59:02,49,10365,17,32,7461.30,12053.00,0.00
2024-12-08 16:59:02,50,10365,18,32,7312.08,12053.02,0.00
2024-12-08 16:59:02,49,10365,18,31,7424.41,12053.04,0.00
2024-12-08 16:59:02,49,10366,18,31,7421.75,12054.00,0.00
2024-12-08 16:59:02,50,10366,19,31,7273.31,12054.02,0.00
2024-12-08 16:59:02,50,10367,19,31,7207.98,12055.00,0.00
2024-12-08 16:59:02,51,10367,19,32,7066.64,12055.02,0.00
2024-12-08 16:59:02,50,10367,19,31,7174.22,12055.04,0.00
2024-12-08 16:59:02,49,10367,19,30,7282.33,12055.25,0.00
2024-12-08 16:59:02,49,10368,19,30,7339.44,12056.00,0.00
2024-12-08 16:59:02,50,10368,20,30,7192.66,12056.02,0.00
2024-12-08 16:59:02,50,10369,20,30,7183.50,12057.00,0.00
2024-12-08 16:59:02,51,10369,21,30,7042.65,12057.02,0.00
2024-12-08 16:59:02,50,10369,21,29,7135.29,12057.06,0.00
2024-12-08 16:59:02,49,10369,20,29,7118.15,12057.94,0.00
2024-12-08 16:59:03,49,10370,20,29,7356.89,12058.00,0.00
2024-12-08 16:59:03,50,10370,20,30,7209.75,12058.02,0.00
2024-12-08 16:59:03,49,10370,19,30,7181.08,12058.82,0.00
2024-12-08 16:59:03,49,10371,19,30,7405.18,12059.00,0.00
2024-12-08 16:59:03,50,10371,19,31,7257.07,12059.02,0.00
2024-12-08 16:59:03,49,10371,19,30,7351.04,12059.06,0.00
2024-12-08 16:59:03,49,10372,19,30,7386.10,12060.00,0.00
2024-12-08 16:59:03,50,10372,20,30,7238.38,12060.02,0.00
2024-12-08 16:59:03,50,10373,20,30,7232.38,12061.00,0.00
2024-12-08 16:59:03,51,10373,21,30,7090.57,12061.02,0.00
2024-12-08 16:59:03,50,10373,21,29,7179.32,12061.06,0.00
2024-12-08 16:59:03,49,10373,20,29,7252.31,12061.65,0.00
2024-12-08 16:59:03,49,10374,20,29,7358.44,12062.00,0.00
2024-12-08 16:59:03,50,10374,20,30,7211.27,12062.02,0.00
2024-12-08 16:59:03,49,10374,19,30,7272.32,12062.16,0.00
2024-12-08 16:59:03,49,10375,19,30,7418.13,12063.00,0.00
2024-12-08 16:59:03,50,10375,19,31,7269.77,12063.02,0.00
2024-12-08 16:59:03,49,10375,19,30,7366.44,12063.06,0.00
2024-12-08 16:59:03,48,10375,18,30,7501.49,12063.08,0.00
2024-12-08 16:59:03,48,10376,18,30,7642.84,12064.00,0.00
2024-12-08 16:59:03,49,10376,19,30,7486.87,12064.02,0.00
2024-12-08 16:59:03,49,10377,19,30,7469.46,12065.00,0.00
2024-12-08 16:59:03,50,10377,19,31,7320.07,12065.02,0.00
2024-12-08 16:59:03,49,10377,19,30,7425.16,12065.06,0.00
2024-12-08 16:59:03,49,10378,19,30,7460.24,12066.00,0.00
2024-12-08 16:59:03,50,10378,20,30,7311.04,12066.02,0.00
2024-12-08 16:59:03,50,10379,20,30,7298.94,12067.00,0.00
2024-12-08 16:59:03,51,10379,21,30,7155.82,12067.02,0.00
2024-12-08 16:59:03,50,10379,21,29,7250.67,12067.06,0.00
2024-12-08 16:59:03,50,10380,21,29,7282.65,12068.00,0.00
2024-12-08 16:59:03,51,10380,21,30,7139.85,12068.02,0.00
2024-12-08 16:59:03,50,10380,20,30,7280.23,12068.02,0.00
2024-12-08 16:59:03,50,10381,20,30,7274.88,12069.00,0.00
2024-12-08 16:59:03,51,10381,20,31,7132.24,12069.02,0.00
2024-12-08 16:59:03,50,10381,20,30,7224.20,12069.04,0.00
2024-12-08 16:59:03,49,10381,19,30,7293.56,12069.25,0.00
2024-12-08 16:59:03,49,10382,19,30,7449.25,12070.00,0.00
2024-12-08 16:59:03,50,10382,19,31,7300.27,12070.02,0.00
2024-12-08 16:59:03,50,10383,19,31,7294.51,12071.00,0.00
2024-12-08 16:59:03,51,10383,19,32,7151.48,12071.02,0.00
2024-12-08 16:59:03,50,10383,18,32,7063.54,12071.94,0.00
2024-12-08 16:59:03,50,10384,18,32,7297.77,12072.00,0.00
2024-12-08 16:59:03,51,10384,19,32,7154.68,12072.02,0.00
2024-12-08 16:59:03,50,10384,19,31,7292.95,12072.04,0.00
2024-12-08 16:59:03,50,10385,19,31,7322.52,12073.00,0.00
2024-12-08 16:59:03,51,10385,20,31,7178.94,12073.02,0.00
2024-12-08 16:59:03,51,10386,20,31,7174.82,12074.00,0.00
2024-12-08 16:59:03,52,10386,20,32,7036.84,12074.02,0.00
2024-12-08 16:59:03,52,10387,20,32,7011.89,12075.00,0.00
2024-12-08 16:59:03,53,10387,21,32,6879.59,12075.02,0.00
2024-12-08 16:59:03,52,10387,20,32,6963.11,12075.04,0.00
2024-12-08 16:59:03,51,10387,20,31,7097.27,12075.04,0.00
2024-12-08 16:59:03,51,10388,20,31,7218.62,12076.00,0.00
2024-12-08 16:59:03,52,10388,21,31,7079.80,12076.02,0.00
2024-12-08 16:59:03,52,10389,21,31,7072.00,12077.00,0.00
2024-12-08 16:59:03,53,10389,22,31,6938.57,12077.02,0.00
2024-12-08 16:59:03,52,10389,22,30,7023.23,12077.04,0.00
2024-12-08 16:59:03,51,10389,21,30,6994.79,12077.94,0.00
2024-12-08 16:59:03,51,10390,21,30,7224.55,12078.00,0.00
2024-12-08 16:59:03,52,10390,22,30,7085.61,12078.02,0.00
2024-12-08 16:59:03,51,10390,21,30,7059.20,12078.82,0.00
2024-12-08 16:59:03,51,10391,21,30,7274.88,12079.00,0.00
2024-12-08 16:59:03,52,10391,22,30,7134.98,12079.02,0.00
2024-12-08 16:59:03,51,10391,22,29,7225.15,12079.04,0.00
2024-12-08 16:59:03,51,10392,22,29,7251.66,12080.00,0.00
2024-12-08 16:59:03,52,10392,23,29,7112.21,12080.02,0.00
2024-12-08 16:59:03,52,10393,23,29,7102.50,12081.00,0.00
2024-12-08 16:59:03,53,10393,23,30,6968.49,12081.02,0.00
2024-12-08 16:59:03,52,10393,23,29,7053.71,12081.04,0.00
2024-12-08 16:59:03,51,10393,22,29,7112.34,12081.67,0.00
2024-12-08 16:59:03,51,10394,22,29,7214.47,12082.00,0.00
2024-12-08 16:59:03,52,10394,22,30,7075.73,12082.02,0.00
2024-12-08 16:59:03,51,10394,21,30,7212.11,12082.04,0.00
2024-12-08 16:59:03,50,10394,20,30,7244.57,12082.54,0.00
2024-12-08 16:59:03,50,10395,20,30,7356.06,12083.00,0.00
2024-12-08 16:59:03,51,10395,20,31,7211.83,12083.02,0.00
2024-12-08 16:59:03,51,10396,20,31,7186.36,12084.00,0.00
2024-12-08 16:59:03,52,10396,20,32,7048.16,12084.02,0.00
2024-12-08 16:59:03,51,10396,20,31,7181.62,12084.04,0.00
2024-12-08 16:59:03,50,10396,19,31,7259.63,12084.56,0.00
2024-12-08 16:59:03,50,10397,19,31,7349.25,12085.00,0.00
2024-12-08 16:59:03,51,10397,19,32,7205.15,12085.02,0.00
2024-12-08 16:59:04,51,10398,19,32,7176.80,12086.00,0.00
2024-12-08 16:59:04,52,10398,20,32,7038.79,12086.02,0.00
2024-12-08 16:59:04,51,10398,20,31,7160.82,12086.04,0.00
2024-12-08 16:59:04,50,10398,19,31,7258.18,12086.22,0.00
2024-12-08 16:59:04,50,10399,19,31,7403.83,12087.00,0.00
2024-12-08 16:59:04,51,10399,20,31,7258.66,12087.02,0.00
2024-12-08 16:59:04,50,10399,19,31,7401.42,12087.04,0.00
2024-12-08 16:59:04,49,10399,18,31,7485.89,12087.10,0.00
2024-12-08 16:59:04,49,10400,18,31,7620.71,12088.00,0.00
2024-12-08 16:59:04,50,10400,19,31,7468.29,12088.02,0.00
2024-12-08 16:59:04,50,10401,19,31,7444.31,12089.00,0.00
2024-12-08 16:59:04,51,10401,19,32,7298.34,12089.02,0.00
2024-12-08 16:59:04,50,10401,19,31,7434.65,12089.08,0.00
2024-12-08 16:59:04,49,10401,18,31,7465.95,12089.84,0.00
2024-12-08 16:59:04,49,10402,18,31,7691.99,12090.00,0.00
2024-12-08 16:59:04,50,10402,19,31,7538.15,12090.02,0.00
2024-12-08 16:59:04,50,10403,19,31,7531.86,12091.00,0.00
2024-12-08 16:59:04,51,10403,20,31,7384.17,12091.02,0.00
2024-12-08 16:59:04,50,10403,19,31,7521.85,12091.04,0.00
2024-12-08 16:59:04,50,10404,19,31,7599.86,12092.00,0.00
2024-12-08 16:59:04,51,10404,20,31,7450.84,12092.02,0.00
2024-12-08 16:59:04,50,10404,19,31,7597.44,12092.02,0.00
2024-12-08 16:59:04,49,10404,19,30,7735.25,12092.10,0.00
2024-12-08 16:59:04,49,10405,19,30,7775.34,12093.00,0.00
2024-12-08 16:59:04,50,10405,19,31,7619.83,12093.02,0.00
2024-12-08 16:59:04,50,10406,19,31,7608.51,12094.00,0.00
2024-12-08 16:59:04,51,10406,19,32,7459.32,12094.02,0.00
2024-12-08 16:59:04,50,10406,18,32,7453.97,12094.72,0.00
2024-12-08 16:59:04,50,10407,18,32,7662.22,12095.00,0.00
2024-12-08 16:59:04,51,10407,18,33,7511.98,12095.02,0.00
2024-12-08 16:59:04,50,10407,18,32,7647.73,12095.10,0.00
2024-12-08 16:59:04,50,10408,18,32,7684.21,12096.00,0.00
2024-12-08 16:59:04,51,10408,19,32,7533.54,12096.02,0.00
2024-12-08 16:59:04,50,10408,18,32,7544.05,12096.36,0.00
2024-12-08 16:59:04,50,10409,18,32,7704.72,12097.00,0.00
2024-12-08 16:59:04,51,10409,18,33,7553.65,12097.02,0.00
2024-12-08 16:59:04,50,10409,18,32,7644.26,12097.10,0.00
2024-12-08 16:59:04,50,10410,18,32,7673.54,12098.00,0.00
2024-12-08 16:59:04,51,10410,19,32,7523.08,12098.02,0.00
2024-12-08 16:59:04,51,10411,19,32,7500.08,12099.00,0.00
2024-12-08 16:59:04,52,10411,19,33,7355.85,12099.02,0.00
2024-12-08 16:59:04,51,10411,19,32,7440.79,12099.10,0.00
2024-12-08 16:59:04,50,10411,18,32,7521.39,12099.64,0.00
2024-12-08 16:59:04,50,10412,18,32,7614.93,12100.00,0.00
2024-12-08 16:59:04,51,10412,19,32,7465.62,12100.02,0.00
2024-12-08 16:59:04,51,10413,19,32,7444.85,12101.00,0.00
2024-12-08 16:59:04,52,10413,19,33,7301.68,12101.02,0.00
2024-12-08 16:59:04,52,10414,19,33,7266.02,12102.00,0.00
2024-12-08 16:59:04,53,10414,20,33,7128.92,12102.02,0.00
2024-12-08 16:59:04,52,10414,20,32,7254.40,12102.10,0.00
2024-12-08 16:59:04,51,10414,19,32,7281.88,12102.73,0.00
2024-12-08 16:59:04,51,10415,19,32,7486.18,12103.00,0.00
2024-12-08 16:59:04,52,10415,19,33,7342.21,12103.02,0.00
2024-12-08 16:59:04,52,10416,19,33,7310.88,12104.00,0.00
2024-12-08 16:59:04,53,10416,20,33,7172.94,12104.02,0.00
2024-12-08 16:59:04,52,10416,20,32,7255.04,12104.10,0.00
2024-12-08 16:59:04,51,10416,19,32,7344.41,12104.49,0.00
2024-12-08 16:59:04,51,10417,19,32,7501.35,12105.00,0.00
2024-12-08 16:59:04,52,10417,19,33,7357.09,12105.02,0.00
2024-12-08 16:59:04,52,10418,19,33,7321.55,12106.00,0.00
2024-12-08 16:59:04,53,10418,19,34,7183.41,12106.02,0.00
2024-12-08 16:59:04,52,10418,19,33,7268.02,12106.10,0.00
2024-12-08 16:59:04,52,10419,19,33,7279.54,12107.00,0.00
2024-12-08 16:59:04,53,10419,19,34,7142.19,12107.02,0.00
2024-12-08 16:59:04,52,10419,18,34,7087.01,12107.81,0.00
2024-12-08 16:59:04,52,10420,18,34,7296.73,12108.00,0.00
2024-12-08 16:59:04,53,10420,19,34,7159.06,12108.02,0.00
2024-12-08 16:59:04,52,10420,19,33,7245.52,12108.10,0.00
2024-12-08 16:59:04,52,10421,19,33,7259.35,12109.00,0.00
2024-12-08 16:59:04,53,10421,19,34,7122.38,12109.02,0.00
2024-12-08 16:59:04,52,10421,19,33,7136.39,12109.60,0.00
2024-12-08 16:59:04,52,10422,19,33,7237.43,12110.00,0.00
2024-12-08 16:59:04,53,10422,19,34,7100.88,12110.02,0.00
2024-12-08 16:59:04,52,10422,19,33,7188.54,12110.10,0.00
2024-12-08 16:59:04,52,10423,19,33,7215.39,12111.00,0.00
2024-12-08 16:59:04,53,10423,19,34,7079.25,12111.02,0.00
2024-12-08 16:59:04,52,10423,18,34,6996.50,12111.96,0.00
2024-12-08 16:59:04,52,10424,18,34,7224.78,12112.00,0.00
2024-12-08 16:59:04,53,10424,19,34,7088.46,12112.02,0.00
2024-12-08 16:59:04,52,10424,19,33,7175.88,12112.10,0.00
2024-12-08 16:59:04,51,10424,18,33,7250.93,12112.59,0.00
2024-12-08 16:59:04,50,10424,17,33,7391.13,12112.64,0.00
2024-12-08 16:59:04,50,10425,17,33,7590.09,12113.00,0.00
2024-12-08 16:59:04,51,10425,17,34,7441.26,12113.02,0.00
2024-12-08 16:59:05,51,10426,17,34,7416.32,12114.00,0.00
2024-12-08 16:59:05,52,10426,17,35,7273.70,12114.02,0.00
2024-12-08 16:59:05,51,10426,16,35,7380.69,12114.02,0.00
2024-12-08 16:59:05,50,10426,16,34,7482.28,12114.08,0.00
2024-12-08 16:59:05,50,10427,16,34,7607.69,12115.00,0.00
2024-12-08 16:59:05,51,10427,17,34,7458.52,12115.02,0.00
2024-12-08 16:59:05,51,10428,17,34,7431.17,12116.00,0.00
2024-12-08 16:59:05,52,10428,18,34,7288.26,12116.02,0.00
2024-12-08 16:59:05,51,10428,18,33,7388.41,12116.08,0.00
2024-12-08 16:59:05,50,10428,17,33,7508.48,12116.18,0.00
2024-12-08 16:59:05,50,10429,17,33,7647.28,12117.00,0.00
2024-12-08 16:59:05,51,10429,18,33,7497.34,12117.02,0.00
2024-12-08 16:59:05,51,10430,18,33,7469.29,12118.00,0.00
2024-12-08 16:59:05,52,10430,19,33,7325.65,12118.02,0.00
2024-12-08 16:59:05,51,10430,19,32,7428.90,12118.08,0.00
2024-12-08 16:59:05,51,10431,19,32,7455.11,12119.00,0.00
2024-12-08 16:59:05,52,10431,20,32,7311.74,12119.02,0.00
2024-12-08 16:59:05,51,10431,19,32,7233.82,12119.63,0.00
2024-12-08 16:59:05,51,10432,19,32,7426.61,12120.00,0.00
2024-12-08 16:59:05,52,10432,19,33,7283.79,12120.02,0.00
2024-12-08 16:59:05,51,10432,19,32,7388.59,12120.08,0.00
2024-12-08 16:59:05,51,10433,19,32,7415.52,12121.00,0.00
2024-12-08 16:59:05,52,10433,20,32,7272.91,12121.02,0.00
2024-12-08 16:59:05,52,10434,20,32,7245.12,12122.00,0.00
2024-12-08 16:59:05,53,10434,21,32,7108.42,12122.02,0.00
2024-12-08 16:59:05,52,10434,21,31,7205.50,12122.08,0.00
2024-12-08 16:59:05,52,10435,21,31,7228.12,12123.00,0.00
2024-12-08 16:59:05,53,10435,22,31,7091.74,12123.02,0.00
2024-12-08 16:59:05,53,10436,22,31,7067.72,12124.00,0.00
2024-12-08 16:59:05,54,10436,23,31,6936.83,12124.02,0.00
2024-12-08 16:59:05,53,10436,23,30,7026.54,12124.08,0.00
2024-12-08 16:59:05,53,10437,23,30,7050.46,12125.00,0.00
2024-12-08 16:59:05,54,10437,23,31,6919.89,12125.02,0.00
2024-12-08 16:59:05,53,10437,22,31,6991.00,12125.13,0.00
2024-12-08 16:59:05,53,10438,22,31,7028.35,12126.00,0.00
2024-12-08 16:59:05,54,10438,22,32,6898.20,12126.02,0.00
2024-12-08 16:59:05,53,10438,22,31,6989.46,12126.08,0.00
2024-12-08 16:59:05,53,10439,22,31,7015.12,12127.00,0.00
2024-12-08 16:59:05,54,10439,23,31,6885.21,12127.02,0.00
2024-12-08 16:59:05,54,10440,23,31,6864.12,12128.00,0.00
2024-12-08 16:59:05,55,10440,23,32,6739.31,12128.02,0.00
2024-12-08 16:59:05,54,10440,23,31,6823.69,12128.07,0.00
2024-12-08 16:59:05,54,10441,23,31,6846.71,12129.00,0.00
2024-12-08 16:59:05,55,10441,23,32,6722.23,12129.02,0.00
2024-12-08 16:59:05,55,10442,23,32,6701.03,12130.00,0.00
2024-12-08 16:59:05,56,10442,23,33,6581.37,12130.02,0.00
2024-12-08 16:59:05,55,10442,23,32,6663.54,12130.07,0.00
2024-12-08 16:59:05,55,10443,23,32,6683.94,12131.00,0.00
2024-12-08 16:59:05,56,10443,23,33,6564.58,12131.02,0.00
2024-12-08 16:59:05,55,10443,22,33,6681.73,12131.02,0.00
2024-12-08 16:59:05,55,10444,22,33,6664.03,12132.00,0.00
2024-12-08 16:59:05,56,10444,22,34,6545.03,12132.02,0.00
2024-12-08 16:59:05,55,10444,21,34,6661.83,12132.02,0.00
2024-12-08 16:59:05,54,10444,21,33,6751.50,12132.04,0.00
2024-12-08 16:59:05,53,10444,20,33,6740.31,12132.85,0.00
2024-12-08 16:59:05,53,10445,20,33,6951.04,12133.00,0.00
2024-12-08 16:59:05,54,10445,20,34,6822.32,12133.02,0.00
2024-12-08 16:59:05,53,10445,19,34,6948.75,12133.02,0.00
2024-12-08 16:59:05,52,10445,18,34,6923.38,12133.75,0.00
2024-12-08 16:59:05,52,10446,18,34,7126.57,12134.00,0.00
2024-12-08 16:59:05,53,10446,18,35,6992.11,12134.02,0.00
2024-12-08 16:59:05,52,10446,18,34,7091.57,12134.02,0.00
2024-12-08 16:59:05,51,10446,17,34,7130.84,12134.71,0.00
2024-12-08 16:59:05,51,10447,17,34,7333.29,12135.00,0.00
2024-12-08 16:59:05,52,10447,17,35,7192.27,12135.02,0.00
2024-12-08 16:59:05,52,10448,17,35,7165.34,12136.00,0.00
2024-12-08 16:59:05,53,10448,18,35,7030.14,12136.02,0.00
2024-12-08 16:59:05,52,10448,18,34,7151.82,12136.02,0.00
2024-12-08 16:59:05,51,10448,17,34,7206.75,12136.69,0.00
2024-12-08 16:59:05,51,10449,17,34,7405.00,12137.00,0.00
2024-12-08 16:59:05,52,10449,18,34,7262.59,12137.02,0.00
2024-12-08 16:59:05,52,10450,18,34,7234.60,12138.00,0.00
2024-12-08 16:59:05,53,10450,19,34,7098.10,12138.02,0.00
2024-12-08 16:59:05,52,10450,19,33,7204.61,12138.02,0.00
2024-12-08 16:59:05,52,10451,19,33,7222.77,12139.00,0.00
2024-12-08 16:59:05,53,10451,20,33,7086.49,12139.02,0.00
2024-12-08 16:59:05,53,10452,20,33,7056.97,12140.00,0.00
2024-12-08 16:59:05,54,10452,20,34,6926.28,12140.02,0.00
2024-12-08 16:59:05,53,10452,20,33,7029.48,12140.02,0.00
2024-12-08 16:59:05,53,10453,20,33,7046.56,12141.00,0.00
2024-12-08 16:59:05,54,10453,21,33,6916.07,12141.02,0.00
2024-12-08 16:59:05,54,10454,21,33,6891.28,12142.00,0.00
2024-12-08 16:59:05,55,10454,22,33,6765.99,12142.02,0.00
2024-12-08 16:59:05,54,10454,22,32,6862.05,12142.02,0.00
2024-12-08 16:59:06,54,10455,22,32,6878.29,12143.00,0.00
2024-12-08 16:59:06,55,10455,22,33,6753.23,12143.02,0.00
2024-12-08 16:59:06,55,10456,22,33,6738.31,12144.00,0.00
2024-12-08 16:59:06,56,10456,22,34,6617.99,12144.02,0.00
2024-12-08 16:59:06,55,10456,22,33,6691.96,12144.07,0.00
2024-12-08 16:59:06,54,10456,21,33,6773.21,12144.17,0.00
2024-12-08 16:59:06,54,10457,21,33,6897.42,12145.00,0.00
2024-12-08 16:59:06,55,10457,21,34,6772.01,12145.02,0.00
2024-12-08 16:59:06,54,10457,20,34,6777.82,12145.61,0.00
2024-12-08 16:59:06,54,10458,20,34,6880.76,12146.00,0.00
2024-12-08 16:59:06,55,10458,20,35,6755.66,12146.02,0.00
2024-12-08 16:59:06,54,10458,20,34,6835.79,12146.07,0.00
2024-12-08 16:59:06,53,10458,19,34,6824.58,12146.85,0.00
2024-12-08 16:59:06,53,10459,19,34,7035.54,12147.00,0.00
2024-12-08 16:59:06,54,10459,19,35,6905.25,12147.02,0.00
2024-12-08 16:59:06,54,10460,19,35,6884.19,12148.00,0.00
2024-12-08 16:59:06,55,10460,19,36,6759.02,12148.02,0.00
2024-12-08 16:59:06,54,10460,19,35,6841.46,12148.07,0.00
2024-12-08 16:59:06,53,10460,18,35,6897.87,12148.64,0.00
2024-12-08 16:59:06,52,10460,17,35,6967.16,12148.85,0.00
2024-12-08 16:59:06,52,10461,17,35,7182.22,12149.00,0.00
2024-12-08 16:59:06,53,10461,17,36,7046.71,12149.02,0.00
2024-12-08 16:59:06,52,10461,16,36,7123.70,12149.10,0.00
2024-12-08 16:59:06,52,10462,16,36,7163.21,12150.00,0.00
2024-12-08 16:59:06,53,10462,16,37,7028.06,12150.02,0.00
2024-12-08 16:59:06,52,10462,16,36,7121.17,12150.08,0.00
2024-12-08 16:59:06,51,10462,15,36,7109.34,12150.57,0.00
2024-12-08 16:59:06,51,10463,15,36,7295.53,12151.00,0.00
2024-12-08 16:59:06,52,10463,16,36,7155.23,12151.02,0.00
2024-12-08 16:59:06,51,10463,15,36,7181.27,12151.29,0.00
2024-12-08 16:59:06,51,10464,15,36,7334.25,12152.00,0.00
2024-12-08 16:59:06,52,10464,15,37,7193.21,12152.02,0.00
2024-12-08 16:59:06,51,10464,15,36,7284.23,12152.08,0.00
2024-12-08 16:59:06,51,10465,15,36,7315.79,12153.00,0.00
2024-12-08 16:59:06,52,10465,16,36,7175.10,12153.02,0.00
2024-12-08 16:59:06,51,10465,15,36,7155.22,12153.45,0.00
2024-12-08 16:59:06,51,10466,15,36,7327.21,12154.00,0.00
2024-12-08 16:59:06,52,10466,15,37,7186.30,12154.02,0.00
2024-12-08 16:59:06,51,10466,15,36,7270.04,12154.10,0.00
2024-12-08 16:59:06,51,10467,15,36,7303.98,12155.00,0.00
2024-12-08 16:59:06,52,10467,16,36,7163.52,12155.02,0.00
2024-12-08 16:59:06,52,10468,16,36,7151.18,12156.00,0.00
2024-12-08 16:59:06,53,10468,17,36,7016.25,12156.02,0.00
2024-12-08 16:59:06,52,10468,17,35,7097.43,12156.10,0.00
2024-12-08 16:59:06,52,10469,17,35,7125.52,12157.00,0.00
2024-12-08 16:59:06,53,10469,18,35,6991.07,12157.02,0.00
2024-12-08 16:59:06,53,10470,18,35,6970.26,12158.00,0.00
2024-12-08 16:59:06,54,10470,18,36,6841.18,12158.02,0.00
2024-12-08 16:59:06,53,10470,18,35,6919.81,12158.09,0.00
2024-12-08 16:59:06,53,10471,18,35,6934.13,12159.00,0.00
2024-12-08 16:59:06,54,10471,19,35,6805.72,12159.02,0.00
2024-12-08 16:59:06,53,10471,18,35,6817.74,12159.32,0.00
2024-12-08 16:59:06,53,10472,18,35,6948.55,12160.00,0.00
2024-12-08 16:59:06,54,10472,18,36,6819.87,12160.02,0.00
2024-12-08 16:59:06,53,10472,18,35,6898.09,12160.09,0.00
2024-12-08 16:59:06,53,10473,18,35,6907.99,12161.00,0.00
2024-12-08 16:59:06,54,10473,18,36,6780.06,12161.02,0.00
2024-12-08 16:59:06,53,10473,17,36,6770.44,12161.38,0.00
2024-12-08 16:59:06,53,10474,17,36,6911.38,12162.00,0.00
2024-12-08 16:59:06,54,10474,18,36,6783.39,12162.02,0.00
2024-12-08 16:59:06,53,10474,18,35,6860.91,12162.09,0.00
2024-12-08 16:59:06,53,10475,18,35,6880.97,12163.00,0.00
2024-12-08 16:59:06,54,10475,19,35,6753.55,12163.02,0.00
2024-12-08 16:59:06,53,10475,18,35,6759.44,12163.32,0.00
2024-12-08 16:59:06,53,10476,18,35,6902.09,12164.00,0.00
2024-12-08 16:59:06,54,10476,19,35,6774.28,12164.02,0.00
2024-12-08 16:59:06,53,10476,19,34,6849.33,12164.11,0.00
2024-12-08 16:59:06,52,10476,18,34,6979.66,12164.12,0.00
2024-12-08 16:59:06,52,10477,18,34,7011.45,12165.00,0.00
2024-12-08 16:59:06,53,10477,18,35,6879.16,12165.02,0.00
2024-12-08 16:59:06,53,10478,18,35,6868.15,12166.00,0.00
2024-12-08 16:59:06,54,10478,19,35,6740.96,12166.02,0.00
2024-12-08 16:59:06,53,10478,19,34,6815.37,12166.11,0.00
2024-12-08 16:59:06,52,10478,18,34,6888.27,12166.54,0.00
2024-12-08 16:59:06,52,10479,18,34,7066.42,12167.00,0.00
2024-12-08 16:59:06,53,10479,19,34,6933.09,12167.02,0.00
2024-12-08 16:59:06,53,10480,19,34,6922.27,12168.00,0.00
2024-12-08 16:59:06,54,10480,19,35,6794.08,12168.02,0.00
2024-12-08 16:59:06,53,10480,19,34,6869.48,12168.11,0.00
2024-12-08 16:59:06,53,10481,19,34,6899.88,12169.00,0.00
2024-12-08 16:59:06,54,10481,20,34,6772.10,12169.02,0.00
2024-12-08 16:59:07,54,10482,20,34,6760.25,12170.00,0.00
2024-12-08 16:59:07,55,10482,20,35,6637.33,12170.02,0.00
2024-12-08 16:59:07,54,10482,20,34,6710.68,12170.11,0.00
2024-12-08 16:59:07,54,10483,20,34,6737.65,12171.00,0.00
2024-12-08 16:59:07,55,10483,20,35,6615.15,12171.02,0.00
2024-12-08 16:59:07,55,10484,20,35,6600.94,12172.00,0.00
2024-12-08 16:59:07,56,10484,20,36,6483.07,12172.02,0.00
2024-12-08 16:59:07,55,10484,20,35,6554.48,12172.11,0.00
2024-12-08 16:59:07,54,10484,19,35,6576.34,12172.70,0.00
2024-12-08 16:59:07,54,10485,19,35,6765.89,12173.00,0.00
2024-12-08 16:59:07,55,10485,20,35,6642.87,12173.02,0.00
2024-12-08 16:59:07,54,10485,19,35,6583.04,12173.81,0.00
2024-12-08 16:59:07,54,10486,19,35,6786.08,12174.00,0.00
2024-12-08 16:59:07,55,10486,20,35,6662.70,12174.02,0.00
2024-12-08 16:59:07,54,10486,20,34,6738.75,12174.11,0.00
2024-12-08 16:59:07,54,10487,20,34,6763.51,12175.00,0.00
2024-12-08 16:59:07,55,10487,21,34,6640.54,12175.02,0.00
2024-12-08 16:59:07,54,10487,20,34,6761.26,12175.02,0.00
2024-12-08 16:59:07,53,10487,19,34,6740.95,12175.74,0.00
2024-12-08 16:59:07,53,10488,19,34,6938.72,12176.00,0.00
2024-12-08 16:59:07,54,10488,19,35,6810.22,12176.02,0.00
2024-12-08 16:59:07,53,10488,18,35,6936.42,12176.02,0.00
2024-12-08 16:59:07,52,10488,18,34,7027.67,12176.08,0.00
2024-12-08 16:59:07,52,10489,18,34,7053.11,12177.00,0.00
2024-12-08 16:59:07,53,10489,18,35,6920.04,12177.02,0.00
2024-12-08 16:59:07,52,10489,17,35,7050.77,12177.02,0.00
2024-12-08 16:59:07,52,10490,17,35,7032.50,12178.00,0.00
2024-12-08 16:59:07,53,10490,18,35,6899.81,12178.02,0.00
2024-12-08 16:59:07,52,10490,18,34,6995.03,12178.06,0.00
2024-12-08 16:59:07,51,10490,17,34,6978.56,12178.92,0.00
2024-12-08 16:59:07,51,10491,17,34,7207.87,12179.00,0.00
2024-12-08 16:59:07,52,10491,17,35,7069.25,12179.02,0.00
2024-12-08 16:59:07,51,10491,16,35,7089.63,12179.59,0.00
2024-12-08 16:59:07,51,10492,16,35,7189.92,12180.00,0.00
2024-12-08 16:59:07,52,10492,16,36,7051.65,12180.02,0.00
2024-12-08 16:59:07,51,10492,16,35,7151.72,12180.06,0.00
2024-12-08 16:59:07,50,10492,15,35,7144.56,12180.92,0.00
2024-12-08 16:59:07,50,10493,15,35,7378.49,12181.00,0.00
2024-12-08 16:59:07,51,10493,16,35,7233.82,12181.02,0.00
2024-12-08 16:59:07,51,10494,16,35,7212.89,12182.00,0.00
2024-12-08 16:59:07,52,10494,17,35,7074.18,12182.02,0.00
2024-12-08 16:59:07,51,10494,17,34,7177.07,12182.06,0.00
2024-12-08 16:59:07,50,10494,16,34,7164.97,12182.60,0.00
2024-12-08 16:59:07,50,10495,16,34,7360.21,12183.00,0.00
2024-12-08 16:59:07,51,10495,16,35,7215.89,12183.02,0.00
2024-12-08 16:59:07,50,10495,15,35,7243.40,12183.58,0.00
2024-12-08 16:59:07,50,10496,15,35,7349.69,12184.00,0.00
2024-12-08 16:59:07,51,10496,16,35,7205.58,12184.02,0.00
2024-12-08 16:59:07,50,10496,16,34,7303.39,12184.06,0.00
2024-12-08 16:59:07,49,10496,15,34,7333.37,12184.71,0.00
2024-12-08 16:59:07,49,10497,15,34,7547.46,12185.00,0.00
2024-12-08 16:59:07,50,10497,16,34,7396.51,12185.02,0.00
2024-12-08 16:59:07,50,10498,16,34,7388.39,12186.00,0.00
2024-12-08 16:59:07,51,10498,16,35,7243.52,12186.02,0.00
2024-12-08 16:59:07,50,10498,16,34,7334.78,12186.06,0.00
2024-12-08 16:59:07,50,10499,16,34,7367.06,12187.00,0.00
2024-12-08 16:59:07,51,10499,17,34,7222.61,12187.02,0.00
2024-12-08 16:59:07,51,10500,17,34,7212.48,12188.00,0.00
2024-12-08 16:59:07,52,10500,17,35,7073.78,12188.02,0.00
2024-12-08 16:59:07,51,10500,17,34,7162.30,12188.06,0.00
2024-12-08 16:59:07,51,10501,17,34,7191.56,12189.00,0.00
2024-12-08 16:59:07,52,10501,17,35,7053.26,12189.02,0.00
2024-12-08 16:59:07,52,10502,17,35,7044.42,12190.00,0.00
2024-12-08 16:59:07,53,10502,18,35,6911.51,12190.02,0.00
2024-12-08 16:59:07,52,10502,18,34,6995.20,12190.06,0.00
2024-12-08 16:59:07,52,10503,18,34,7021.56,12191.00,0.00
2024-12-08 16:59:07,53,10503,18,35,6889.08,12191.02,0.00
2024-12-08 16:59:07,53,10504,18,35,6879.51,12192.00,0.00
2024-12-08 16:59:07,54,10504,18,36,6752.11,12192.02,0.00
2024-12-08 16:59:07,53,10504,17,36,6877.21,12192.02,0.00
2024-12-08 16:59:07,52,10504,17,35,6964.91,12192.04,0.00
2024-12-08 16:59:07,51,10504,16,35,7085.21,12192.16,0.00
2024-12-08 16:59:07,52,10503,16,36,6916.27,12192.46,0.00
2024-12-08 16:59:07,52,10504,16,36,7069.06,12193.00,0.00
2024-12-08 16:59:07,53,10504,17,36,6935.69,12193.02,0.00
2024-12-08 16:59:07,52,10504,16,36,6893.65,12193.77,0.00
2024-12-08 16:59:07,52,10505,16,36,7334.67,12194.00,0.00
2024-12-08 16:59:07,53,10505,16,37,7196.28,12194.02,0.00
2024-12-08 16:59:07,52,10505,16,36,7292.46,12194.04,0.00
2024-12-08 16:59:07,52,10506,16,36,7316.51,12195.00,0.00
2024-12-08 16:59:07,53,10506,17,36,7178.46,12195.02,0.00
2024-12-08 16:59:07,52,10506,16,36,7203.00,12195.56,0.00
2024-12-08 16:59:07,52,10507,16,36,7300.27,12196.00,0.00
2024-12-08 16:59:07,53,10507,17,36,7162.53,12196.02,0.00
2024-12-08 16:59:07,52,10507,17,35,7260.40,12196.04,0.00
2024-12-08 16:59:07,52,10508,17,35,7281.31,12197.00,0.00
2024-12-08 16:59:07,53,10508,18,35,7143.93,12197.02,0.00
2024-12-08 16:59:08,53,10509,18,35,7120.33,12198.00,0.00
2024-12-08 16:59:08,54,10509,18,36,6988.47,12198.02,0.00
2024-12-08 16:59:08,53,10509,18,35,7083.51,12198.04,0.00
2024-12-08 16:59:08,53,10510,18,35,7095.31,12199.00,0.00
2024-12-08 16:59:08,54,10510,19,35,6963.91,12199.02,0.00
2024-12-08 16:59:08,53,10510,18,35,6968.07,12199.57,0.00
2024-12-08 16:59:08,53,10511,18,35,7063.47,12200.00,0.00
2024-12-08 16:59:08,54,10511,19,35,6932.67,12200.02,0.00
2024-12-08 16:59:08,53,10511,18,35,7061.17,12200.02,0.00
2024-12-08 16:59:08,52,10511,18,34,7164.12,12200.02,0.00
2024-12-08 16:59:08,52,10512,18,34,7164.80,12201.00,0.00
2024-12-08 16:59:08,53,10512,19,34,7029.61,12201.02,0.00
2024-12-08 16:59:08,52,10512,18,34,7109.73,12201.06,0.00
2024-12-08 16:59:08,52,10513,18,34,7119.56,12202.00,0.00
2024-12-08 16:59:08,53,10513,19,34,6985.23,12202.02,0.00
2024-12-08 16:59:08,52,10513,19,33,7089.06,12202.02,0.00
2024-12-08 16:59:08,51,10513,18,33,7093.44,12202.41,0.00
2024-12-08 16:59:08,51,10514,18,33,7261.34,12203.00,0.00
2024-12-08 16:59:08,52,10514,19,33,7121.70,12203.02,0.00
2024-12-08 16:59:08,52,10515,19,33,7075.53,12204.00,0.00
2024-12-08 16:59:08,53,10515,20,33,6942.03,12204.02,0.00
2024-12-08 16:59:08,52,10515,20,32,7071.10,12204.02,0.00
2024-12-08 16:59:08,52,10516,20,32,7073.67,12205.00,0.00
2024-12-08 16:59:08,53,10516,20,33,6940.21,12205.02,0.00
2024-12-08 16:59:08,52,10516,20,32,7063.46,12205.02,0.00
2024-12-08 16:59:08,52,10517,20,32,7078.10,12206.00,0.00
2024-12-08 16:59:08,53,10517,20,33,6944.55,12206.02,0.00
2024-12-08 16:59:08,52,10517,19,33,6947.37,12206.31,0.00
2024-12-08 16:59:08,52,10518,19,33,7090.12,12207.00,0.00
2024-12-08 16:59:08,53,10518,19,34,6956.34,12207.02,0.00
2024-12-08 16:59:08,52,10518,19,33,7047.87,12207.04,0.00
2024-12-08 16:59:08,52,10519,19,33,7057.88,12208.00,0.00
2024-12-08 16:59:08,53,10519,20,33,6924.71,12208.02,0.00
2024-12-08 16:59:08,53,10520,20,33,6898.09,12209.00,0.00
2024-12-08 16:59:08,54,10520,21,33,6770.35,12209.02,0.00
2024-12-08 16:59:08,53,10520,21,32,6858.94,12209.04,0.00
2024-12-08 16:59:08,53,10521,21,32,6871.61,12210.00,0.00
2024-12-08 16:59:08,54,10521,22,32,6744.36,12210.02,0.00
2024-12-08 16:59:08,53,10521,21,32,6768.11,12210.47,0.00
2024-12-08 16:59:08,53,10522,21,32,6858.26,12211.00,0.00
2024-12-08 16:59:08,54,10522,22,32,6731.26,12211.02,0.00
2024-12-08 16:59:08,53,10522,22,31,6812.20,12211.08,0.00
2024-12-08 16:59:08,53,10523,22,31,6837.34,12212.00,0.00
2024-12-08 16:59:08,54,10523,23,31,6710.72,12212.02,0.00
2024-12-08 16:59:08,53,10523,22,31,6777.46,12212.13,0.00
2024-12-08 16:59:08,52,10523,21,31,6839.97,12212.65,0.00
2024-12-08 16:59:08,52,10524,21,31,7032.02,12213.00,0.00
2024-12-08 16:59:08,53,10524,22,31,6899.34,12213.02,0.00
2024-12-08 16:59:08,52,10524,22,30,6987.42,12213.08,0.00
2024-12-08 16:59:08,52,10525,22,30,7015.43,12214.00,0.00
2024-12-08 16:59:08,53,10525,23,30,6883.06,12214.02,0.00
2024-12-08 16:59:08,52,10525,22,30,6909.39,12214.50,0.00
2024-12-08 16:59:08,52,10526,22,30,7000.77,12215.00,0.00
2024-12-08 16:59:08,53,10526,23,30,6868.68,12215.02,0.00
2024-12-08 16:59:08,52,10526,23,29,6958.51,12215.08,0.00
2024-12-08 16:59:08,51,10526,23,28,7092.36,12215.10,0.00
2024-12-08 16:59:08,51,10527,23,28,7124.00,12216.00,0.00
2024-12-08 16:59:08,52,10527,24,28,6987.00,12216.02,0.00
2024-12-08 16:59:08,51,10527,23,28,6985.43,12216.69,0.00
2024-12-08 16:59:08,51,10528,23,28,7178.21,12217.00,0.00
2024-12-08 16:59:08,52,10528,24,28,7040.17,12217.02,0.00
2024-12-08 16:59:08,51,10528,24,27,7137.50,12217.08,0.00
2024-12-08 16:59:08,51,10529,24,27,7151.92,12218.00,0.00
2024-12-08 16:59:08,52,10529,25,27,7014.38,12218.02,0.00
2024-12-08 16:59:08,52,10530,25,27,6966.16,12219.00,0.00
2024-12-08 16:59:08,53,10530,26,27,6834.72,12219.02,0.00
2024-12-08 16:59:08,52,10530,26,26,6921.53,12219.08,0.00
2024-12-08 16:59:08,52,10531,26,26,6906.17,12220.00,0.00
2024-12-08 16:59:08,53,10531,26,27,6775.87,12220.02,0.00
2024-12-08 16:59:08,53,10532,26,27,6757.47,12221.00,0.00
2024-12-08 16:59:08,54,10532,27,27,6632.33,12221.02,0.00
2024-12-08 16:59:08,53,10532,27,26,6619.97,12221.72,0.00
2024-12-08 16:59:08,53,10533,27,26,6765.83,12222.00,0.00
2024-12-08 16:59:08,54,10533,27,27,6640.54,12222.02,0.00
2024-12-08 16:59:08,54,10534,27,27,6614.25,12223.00,0.00
2024-12-08 16:59:08,55,10534,27,28,6493.99,12223.02,0.00
2024-12-08 16:59:08,54,10534,27,27,6584.83,12223.07,0.00
2024-12-08 16:59:09,54,10535,27,27,6608.00,12224.00,0.00
2024-12-08 16:59:09,55,10535,27,28,6487.85,12224.02,0.00
2024-12-08 16:59:09,54,10535,26,28,6549.16,12224.11,0.00
2024-12-08 16:59:09,54,10536,26,28,6593.41,12225.00,0.00
2024-12-08 16:59:09,55,10536,27,28,6473.53,12225.02,0.00
2024-12-08 16:59:09,54,10536,27,27,6550.41,12225.07,0.00
2024-12-08 16:59:09,53,10536,26,27,6535.07,12225.49,0.00
2024-12-08 16:59:09,53,10537,26,27,6703.79,12226.00,0.00
2024-12-08 16:59:09,54,10537,27,27,6579.64,12226.02,0.00
2024-12-08 16:59:09,53,10537,26,27,6589.86,12226.23,0.00
2024-12-08 16:59:09,53,10538,26,27,6726.44,12227.00,0.00
2024-12-08 16:59:09,54,10538,27,27,6601.88,12227.02,0.00
2024-12-08 16:59:09,53,10538,27,26,6684.92,12227.08,0.00
2024-12-08 16:59:09,53,10539,27,26,6710.84,12228.00,0.00
2024-12-08 16:59:09,54,10539,28,26,6586.57,12228.02,0.00
2024-12-08 16:59:09,54,10540,28,26,6580.29,12229.00,0.00
2024-12-08 16:59:09,55,10540,28,27,6460.64,12229.02,0.00
2024-12-08 16:59:09,54,10540,28,26,6525.95,12229.09,0.00
2024-12-08 16:59:09,54,10541,28,26,6551.38,12230.00,0.00
2024-12-08 16:59:09,55,10541,29,26,6432.26,12230.02,0.00
2024-12-08 16:59:09,54,10541,28,26,6435.70,12230.24,0.00
2024-12-08 16:59:09,54,10542,28,26,6569.78,12231.00,0.00
2024-12-08 16:59:09,55,10542,28,27,6450.33,12231.02,0.00
2024-12-08 16:59:09,54,10542,28,26,6515.44,12231.09,0.00
2024-12-08 16:59:09,54,10543,28,26,6540.87,12232.00,0.00
2024-12-08 16:59:09,55,10543,29,26,6421.95,12232.02,0.00
2024-12-08 16:59:09,55,10544,29,26,6407.06,12233.00,0.00
2024-12-08 16:59:09,56,10544,30,26,6292.65,12233.02,0.00
2024-12-08 16:59:09,55,10544,30,25,6355.91,12233.09,0.00
2024-12-08 16:59:09,55,10545,30,25,6364.20,12234.00,0.00
2024-12-08 16:59:09,56,10545,30,26,6250.56,12234.02,0.00
2024-12-08 16:59:09,56,10546,30,26,6225.69,12235.00,0.00
2024-12-08 16:59:09,57,10546,30,27,6116.47,12235.02,0.00
2024-12-08 16:59:09,56,10546,30,26,6177.63,12235.09,0.00
2024-12-08 16:59:10,56,10547,30,26,6182.70,12236.00,0.00
2024-12-08 16:59:10,57,10547,30,27,6074.23,12236.02,0.00
2024-12-08 16:59:10,57,10548,30,27,6055.41,12237.00,0.00
2024-12-08 16:59:10,58,10548,31,27,5951.00,12237.02,0.00
2024-12-08 16:59:10,57,10548,31,26,6003.89,12237.09,0.00
2024-12-08 16:59:10,56,10548,30,26,6056.93,12237.50,0.00
2024-12-08 16:59:10,55,10548,29,26,6077.26,12237.82,0.00
2024-12-08 16:59:10,55,10549,29,26,6277.64,12238.00,0.00
2024-12-08 16:59:10,56,10549,30,26,6165.54,12238.02,0.00
2024-12-08 16:59:10,55,10549,29,26,6148.70,12238.35,0.00
2024-12-08 16:59:10,55,10550,29,26,6291.50,12239.00,0.00
2024-12-08 16:59:10,56,10550,29,27,6179.15,12239.02,0.00
2024-12-08 16:59:10,55,10550,29,26,6240.33,12239.09,0.00
2024-12-08 16:59:10,55,10551,29,26,6262.54,12240.00,0.00
2024-12-08 16:59:10,56,10551,29,27,6150.71,12240.02,0.00
2024-12-08 16:59:10,56,10552,29,27,6143.44,12241.00,0.00
2024-12-08 16:59:10,57,10552,29,28,6035.66,12241.02,0.00
2024-12-08 16:59:10,56,10552,29,27,6093.17,12241.09,0.00
2024-12-08 16:59:10,56,10553,29,27,6112.73,12242.00,0.00
2024-12-08 16:59:10,57,10553,29,28,6005.49,12242.02,0.00
2024-12-08 16:59:10,56,10553,28,28,6110.54,12242.02,0.00
2024-12-08 16:59:10,56,10554,28,28,6106.47,12243.00,0.00
2024-12-08 16:59:10,57,10554,29,28,5999.33,12243.02,0.00
2024-12-08 16:59:10,56,10554,29,27,6060.56,12243.07,0.00
2024-12-08 16:59:10,55,10554,28,27,6101.68,12243.64,0.00
2024-12-08 16:59:10,54,10554,27,27,6181.91,12243.91,0.00
2024-12-08 16:59:10,54,10555,27,27,6397.38,12244.00,0.00
2024-12-08 16:59:10,55,10555,28,27,6281.06,12244.02,0.00
2024-12-08 16:59:10,55,10556,28,27,6277.27,12245.00,0.00
2024-12-08 16:59:10,56,10556,28,28,6165.17,12245.02,0.00
2024-12-08 16:59:10,55,10556,28,27,6275.04,12245.02,0.00
2024-12-08 16:59:10,54,10556,28,26,6343.63,12245.06,0.00
2024-12-08 16:59:10,54,10557,28,26,6364.50,12246.00,0.00
2024-12-08 16:59:10,55,10557,29,26,6248.78,12246.02,0.00
2024-12-08 16:59:10,54,10557,29,25,6362.23,12246.02,0.00
2024-12-08 16:59:10,53,10557,28,25,6479.97,12246.04,0.00
2024-12-08 16:59:10,53,10558,28,25,6484.52,12247.00,0.00
2024-12-08 16:59:10,54,10558,28,26,6364.44,12247.02,0.00
2024-12-08 16:59:10,53,10558,28,25,6436.00,12247.04,0.00
2024-12-08 16:59:10,53,10559,28,25,6457.32,12248.00,0.00
2024-12-08 16:59:10,54,10559,29,25,6337.74,12248.02,0.00
2024-12-08 16:59:10,54,10560,29,25,6336.03,12249.00,0.00
2024-12-08 16:59:10,55,10560,29,26,6220.83,12249.02,0.00
2024-12-08 16:59:10,54,10560,29,25,6288.40,12249.04,0.00
2024-12-08 16:59:10,53,10560,28,25,6224.42,12249.96,0.00
2024-12-08 16:59:10,53,10561,28,25,6450.94,12250.00,0.00
2024-12-08 16:59:10,54,10561,29,25,6331.48,12250.02,0.00
2024-12-08 16:59:10,54,10562,29,25,6328.52,12251.00,0.00
2024-12-08 16:59:10,55,10562,30,25,6213.45,12251.02,0.00
2024-12-08 16:59:10,54,10562,30,24,6283.14,12251.04,0.00
2024-12-08 16:59:10,54,10563,30,24,6301.42,12252.00,0.00
2024-12-08 16:59:10,55,10563,31,24,6186.85,12252.02,0.00
2024-12-08 16:59:10,55,10564,31,24,6184.44,12253.00,0.00
2024-12-08 16:59:11,56,10564,31,25,6074.00,12253.02,0.00
2024-12-08 16:59:11,55,10564,31,24,6137.66,12253.05,0.00
2024-12-08 16:59:11,55,10565,31,24,6155.98,12254.00,0.00
2024-12-08 16:59:11,56,10565,32,24,6046.05,12254.02,0.00
2024-12-08 16:59:11,55,10565,31,24,6014.30,12254.55,0.00
2024-12-08 16:59:11,55,10566,31,24,6181.71,12255.00,0.00
2024-12-08 16:59:11,56,10566,31,25,6071.32,12255.02,0.00
2024-12-08 16:59:11,55,10566,30,25,6178.78,12255.04,0.00
2024-12-08 16:59:11,54,10566,30,24,6252.35,12255.04,0.00
2024-12-08 16:59:11,54,10567,30,24,6271.02,12256.00,0.00
2024-12-08 16:59:11,55,10567,30,25,6157.00,12256.02,0.00
2024-12-08 16:59:11,55,10568,30,25,6150.64,12257.00,0.00
2024-12-08 16:59:11,56,10568,30,26,6040.80,12257.02,0.00
2024-12-08 16:59:11,55,10568,30,25,6112.75,12257.04,0.00
2024-12-08 16:59:11,54,10568,29,25,6182.56,12257.39,0.00
2024-12-08 16:59:11,53,10568,28,25,6183.84,12257.77,0.00
2024-12-08 16:59:11,53,10569,28,25,6387.54,12258.00,0.00
2024-12-08 16:59:11,54,10569,29,25,6269.25,12258.02,0.00
2024-12-08 16:59:11,54,10570,29,25,6264.17,12259.00,0.00
2024-12-08 16:59:11,55,10570,30,25,6150.27,12259.02,0.00
2024-12-08 16:59:11,54,10570,30,24,6225.58,12259.04,0.00
2024-12-08 16:59:11,54,10571,30,24,6244.25,12260.00,0.00
2024-12-08 16:59:11,55,10571,31,24,6130.71,12260.02,0.00
2024-12-08 16:59:11,55,10572,31,24,6128.43,12261.00,0.00
2024-12-08 16:59:11,56,10572,32,24,6019.00,12261.02,0.00
2024-12-08 16:59:11,55,10572,32,23,6083.85,12261.05,0.00
2024-12-08 16:59:11,54,10572,31,23,6077.02,12261.72,0.00
2024-12-08 16:59:11,54,10573,31,23,6270.24,12262.00,0.00
2024-12-08 16:59:11,55,10573,31,24,6156.24,12262.02,0.00
2024-12-08 16:59:11,54,10573,30,24,6258.90,12262.09,0.00
2024-12-08 16:59:11,54,10574,30,24,6276.90,12263.00,0.00
2024-12-08 16:59:11,55,10574,31,24,6162.78,12263.02,0.00
2024-12-08 16:59:11,54,10574,30,24,6270.44,12263.06,0.00
2024-12-08 16:59:11,53,10574,29,24,6386.14,12263.08,0.00
2024-12-08 16:59:11,53,10575,29,24,6373.23,12264.00,0.00
2024-12-08 16:59:11,54,10575,29,25,6255.20,12264.02,0.00
2024-12-08 16:59:11,53,10575,29,24,6357.04,12264.09,0.00
2024-12-08 16:59:11,52,10575,28,24,6428.72,12264.50,0.00
2024-12-08 16:59:11,51,10575,27,24,6413.44,12264.94,0.00
2024-12-08 16:59:11,51,10576,27,24,6646.75,12265.00,0.00
2024-12-08 16:59:11,52,10576,28,24,6518.93,12265.02,0.00
2024-12-08 16:59:11,51,10576,28,23,6644.35,12265.02,0.00
2024-12-08 16:59:11,51,10577,28,23,6652.95,12266.00,0.00
2024-12-08 16:59:11,52,10577,28,24,6525.01,12266.02,0.00
2024-12-08 16:59:11,51,10577,27,24,6548.27,12266.37,0.00
2024-12-08 16:59:11,51,10578,27,24,6712.25,12267.00,0.00
2024-12-08 16:59:11,52,10578,27,25,6583.17,12267.02,0.00
2024-12-08 16:59:11,51,10578,27,24,6702.65,12267.08,0.00
2024-12-08 16:59:11,51,10579,27,24,6734.45,12268.00,0.00
2024-12-08 16:59:11,52,10579,28,24,6604.94,12268.02,0.00
2024-12-08 16:59:11,52,10580,28,24,6625.42,12269.00,0.00
2024-12-08 16:59:11,53,10580,28,25,6500.41,12269.02,0.00
2024-12-08 16:59:11,53,10581,28,25,6488.56,12270.00,0.00
2024-12-08 16:59:11,54,10581,29,25,6368.40,12270.02,0.00
2024-12-08 16:59:11,53,10581,28,25,6485.58,12270.04,0.00
2024-12-08 16:59:11,52,10581,28,24,6558.44,12270.25,0.00
2024-12-08 16:59:12,52,10582,28,24,6608.48,12271.00,0.00
2024-12-08 16:59:12,53,10582,29,24,6483.79,12271.02,0.00
2024-12-08 16:59:12,52,10582,28,24,6601.42,12271.08,0.00
2024-12-08 16:59:12,51,10582,27,24,6585.94,12271.45,0.00
2024-12-08 16:59:12,51,10583,27,24,6759.59,12272.00,0.00
2024-12-08 16:59:12,52,10583,28,24,6629.60,12272.02,0.00
2024-12-08 16:59:12,51,10583,27,24,6667.13,12272.37,0.00
2024-12-08 16:59:12,51,10584,27,24,6747.38,12273.00,0.00
2024-12-08 16:59:12,52,10584,28,24,6617.62,12273.02,0.00
2024-12-08 16:59:12,51,10584,28,23,6696.88,12273.24,0.00
2024-12-08 16:59:12,51,10585,28,23,6747.93,12274.00,0.00
2024-12-08 16:59:12,52,10585,29,23,6618.16,12274.02,0.00
2024-12-08 16:59:12,52,10586,29,23,6633.92,12275.00,0.00
2024-12-08 16:59:12,53,10586,30,23,6508.75,12275.02,0.00
2024-12-08 16:59:12,52,10586,29,23,6619.78,12275.13,0.00
2024-12-08 16:59:12,51,10586,28,23,6549.12,12275.82,0.00
2024-12-08 16:59:12,51,10587,28,23,6768.28,12276.00,0.00
2024-12-08 16:59:12,52,10587,29,23,6638.12,12276.02,0.00
2024-12-08 16:59:12,51,10587,28,23,6767.20,12276.02,0.00
2024-12-08 16:59:12,50,10587,28,22,6860.30,12276.20,0.00
2024-12-08 16:59:12,50,10588,28,22,6909.93,12277.00,0.00
2024-12-08 16:59:12,51,10588,29,22,6774.44,12277.02,0.00
2024-12-08 16:59:12,50,10588,28,22,6902.11,12277.06,0.00
2024-12-08 16:59:12,49,10588,27,22,7035.46,12277.12,0.00
2024-12-08 16:59:12,49,10589,27,22,7066.69,12278.00,0.00
2024-12-08 16:59:12,50,10589,27,23,6925.36,12278.02,0.00
2024-12-08 16:59:12,50,10590,27,23,6902.88,12279.00,0.00
2024-12-08 16:59:12,51,10590,27,24,6767.53,12279.02,0.00
2024-12-08 16:59:12,50,10590,27,23,6870.99,12279.16,0.00
2024-12-08 16:59:12,50,10591,27,23,6915.73,12280.00,0.00
2024-12-08 16:59:12,51,10591,28,23,6780.12,12280.02,0.00
2024-12-08 16:59:12,50,10591,27,23,6900.60,12280.14,0.00
2024-12-08 16:59:12,50,10592,27,23,6934.22,12281.00,0.00
2024-12-08 16:59:12,51,10592,27,24,6798.25,12281.02,0.00
2024-12-08 16:59:12,51,10593,27,24,6779.21,12282.00,0.00
2024-12-08 16:59:12,52,10593,28,24,6648.84,12282.02,0.00
2024-12-08 16:59:12,51,10593,28,23,6743.11,12282.16,0.00
2024-12-08 16:59:12,50,10593,27,23,6776.70,12282.62,0.00
2024-12-08 16:59:12,50,10594,27,23,6975.95,12283.00,0.00
2024-12-08 16:59:12,51,10594,27,24,6839.17,12283.02,0.00
2024-12-08 16:59:12,50,10594,26,24,6969.73,12283.06,0.00
2024-12-08 16:59:12,49,10594,25,24,7081.91,12283.14,0.00
2024-12-08 16:59:12,49,10595,25,24,7177.72,12284.00,0.00
2024-12-08 16:59:12,50,10595,25,25,7034.17,12284.02,0.00
2024-12-08 16:59:12,50,10596,25,25,7012.63,12285.00,0.00
2024-12-08 16:59:12,51,10596,26,25,6875.12,12285.02,0.00
2024-12-08 16:59:12,50,10596,26,24,6980.71,12285.14,0.00
2024-12-08 16:59:12,50,10597,26,24,7023.02,12286.00,0.00
2024-12-08 16:59:12,51,10597,27,24,6885.32,12286.02,0.00
2024-12-08 16:59:12,50,10597,26,24,6871.13,12286.66,0.00
2024-12-08 16:59:13,50,10598,26,24,7075.33,12287.00,0.00
2024-12-08 16:59:13,51,10598,27,24,6936.60,12287.02,0.00
2024-12-08 16:59:13,51,10599,27,24,6914.31,12288.00,0.00
2024-12-08 16:59:13,52,10599,28,24,6781.34,12288.02,0.00
2024-12-08 16:59:13,51,10599,28,23,6882.37,12288.14,0.00
2024-12-08 16:59:13,51,10600,28,23,6921.46,12289.00,0.00
2024-12-08 16:59:13,52,10600,29,23,6788.35,12289.02,0.00
2024-12-08 16:59:13,51,10600,28,23,6909.43,12289.12,0.00
2024-12-08 16:59:13,51,10601,28,23,6932.40,12290.00,0.00
2024-12-08 16:59:13,52,10601,28,24,6799.09,12290.02,0.00
2024-12-08 16:59:13,52,10602,28,24,6773.64,12291.00,0.00
2024-12-08 16:59:13,53,10602,29,24,6645.84,12291.02,0.00
2024-12-08 16:59:13,52,10602,29,23,6750.02,12291.12,0.00
2024-12-08 16:59:13,51,10602,28,23,6847.38,12291.25,0.00
2024-12-08 16:59:13,51,10603,28,23,6997.28,12292.00,0.00
2024-12-08 16:59:13,52,10603,29,23,6862.71,12292.02,0.00
2024-12-08 16:59:13,52,10604,29,23,6866.74,12293.00,0.00
2024-12-08 16:59:13,53,10604,29,24,6737.17,12293.02,0.00
2024-12-08 16:59:13,52,10604,28,24,6649.09,12293.88,0.00
2024-12-08 16:59:13,52,10605,28,24,6871.40,12294.00,0.00
2024-12-08 16:59:13,53,10605,28,25,6741.75,12294.02,0.00
2024-12-08 16:59:13,52,10605,28,24,6852.51,12294.12,0.00
2024-12-08 16:59:13,52,10606,28,24,6886.15,12295.00,0.00
2024-12-08 16:59:13,53,10606,28,25,6756.22,12295.02,0.00
2024-12-08 16:59:13,53,10607,28,25,6759.88,12296.00,0.00
2024-12-08 16:59:13,54,10607,29,25,6634.70,12296.02,0.00
2024-12-08 16:59:13,53,10607,28,25,6543.77,12296.89,0.00
2024-12-08 16:59:13,53,10608,28,25,6761.96,12297.00,0.00
2024-12-08 16:59:13,54,10608,29,25,6636.74,12297.02,0.00
2024-12-08 16:59:13,53,10608,29,24,6743.41,12297.11,0.00
2024-12-08 16:59:13,52,10608,28,24,6818.55,12297.56,0.00
2024-12-08 16:59:13,51,10608,27,24,6937.84,12297.67,0.00
2024-12-08 16:59:13,51,10609,27,24,7041.79,12298.00,0.00
2024-12-08 16:59:13,52,10609,27,25,6906.37,12298.02,0.00
2024-12-08 16:59:13,52,10610,27,25,6906.92,12299.00,0.00
2024-12-08 16:59:13,53,10610,27,26,6776.60,12299.02,0.00
2024-12-08 16:59:13,52,10610,26,26,6906.35,12299.02,0.00
2024-12-08 16:59:13,51,10610,25,26,6902.18,12299.61,0.00
2024-12-08 16:59:13,51,10611,25,26,7095.41,12300.00,0.00
2024-12-08 16:59:13,52,10611,25,27,6958.96,12300.02,0.00
2024-12-08 16:59:13,51,10611,25,26,7083.36,12300.10,0.00
2024-12-08 16:59:13,51,10612,25,26,7117.69,12301.00,0.00
2024-12-08 16:59:13,52,10612,26,26,6980.81,12301.02,0.00
2024-12-08 16:59:13,52,10613,26,26,6977.88,12302.00,0.00
2024-12-08 16:59:13,53,10613,26,27,6846.22,12302.02,0.00
2024-12-08 16:59:13,52,10613,26,26,6921.11,12302.10,0.00
2024-12-08 16:59:13,51,10613,25,26,6984.75,12302.67,0.00
2024-12-08 16:59:13,51,10614,25,26,7088.74,12303.00,0.00
2024-12-08 16:59:13,52,10614,25,27,6952.42,12303.02,0.00
2024-12-08 16:59:13,51,10614,24,27,6921.16,12303.39,0.00
2024-12-08 16:59:13,51,10615,24,27,7088.07,12304.00,0.00
2024-12-08 16:59:13,52,10615,25,27,6951.76,12304.02,0.00
2024-12-08 16:59:13,51,10615,25,26,7032.58,12304.10,0.00
2024-12-08 16:59:13,51,10616,25,26,7066.93,12305.00,0.00
2024-12-08 16:59:13,52,10616,26,26,6931.02,12305.02,0.00
2024-12-08 16:59:13,52,10616,26,26,6929.10,12306.00,0.00
2024-12-08 16:59:13,53,10616,26,27,6798.37,12306.02,0.00
2024-12-08 16:59:13,52,10616,26,26,6872.31,12306.10,0.00
2024-12-08 16:59:13,52,10617,26,26,6903.63,12307.00,0.00
2024-12-08 16:59:13,53,10617,27,26,6773.38,12307.02,0.00
2024-12-08 16:59:13,53,10618,27,26,6770.91,12308.00,0.00
2024-12-08 16:59:13,54,10618,27,27,6645.53,12308.02,0.00
2024-12-08 16:59:13,53,10618,27,26,6715.18,12308.09,0.00
2024-12-08 16:59:13,53,10619,27,26,6743.59,12309.00,0.00
2024-12-08 16:59:13,54,10619,27,27,6618.71,12309.02,0.00
2024-12-08 16:59:13,53,10619,26,27,6741.27,12309.02,0.00
2024-12-08 16:59:13,53,10620,26,27,6740.80,12310.00,0.00
2024-12-08 16:59:13,54,10620,26,28,6615.97,12310.02,0.00
2024-12-08 16:59:13,53,10620,26,27,6687.38,12310.08,0.00
2024-12-08 16:59:13,52,10620,25,27,6637.63,12310.96,0.00
2024-12-08 16:59:13,52,10621,25,27,6869.66,12311.00,0.00
2024-12-08 16:59:13,53,10621,25,28,6740.04,12311.02,0.00
2024-12-08 16:59:13,52,10621,24,28,6862.56,12311.08,0.00
2024-12-08 16:59:13,51,10621,23,28,6989.89,12311.10,0.00
2024-12-08 16:59:13,51,10622,23,28,7072.52,12312.00,0.00
2024-12-08 16:59:13,52,10622,24,28,6936.51,12312.02,0.00
2024-12-08 16:59:13,52,10623,24,28,6911.03,12313.00,0.00
2024-12-08 16:59:13,53,10623,25,28,6780.63,12313.02,0.00
2024-12-08 16:59:13,52,10623,24,28,6908.66,12313.02,0.00
2024-12-08 16:59:13,51,10623,24,27,7034.48,12313.08,0.00
2024-12-08 16:59:13,50,10623,23,27,7091.54,12313.34,0.00
2024-12-08 16:59:13,50,10624,23,27,7257.01,12314.00,0.00
2024-12-08 16:59:14,51,10624,23,28,7114.72,12314.02,0.00
2024-12-08 16:59:14,51,10625,23,28,7113.86,12315.00,0.00
2024-12-08 16:59:14,52,10625,23,29,6977.05,12315.02,0.00
2024-12-08 16:59:14,51,10625,22,29,7111.44,12315.02,0.00
2024-12-08 16:59:14,50,10625,21,29,7248.75,12315.06,0.00
2024-12-08 16:59:14,49,10625,21,28,7343.91,12315.06,0.00
2024-12-08 16:59:14,49,10626,21,28,7379.68,12316.00,0.00
2024-12-08 16:59:14,50,10626,21,29,7232.09,12316.02,0.00
2024-12-08 16:59:14,50,10627,21,29,7229.07,12317.00,0.00
2024-12-08 16:59:14,51,10627,21,30,7087.32,12317.02,0.00
2024-12-08 16:59:14,50,10627,20,30,7226.60,12317.02,0.00
2024-12-08 16:59:14,49,10627,20,29,7321.31,12317.04,0.00
2024-12-08 16:59:14,48,10627,19,29,7404.85,12317.60,0.00
2024-12-08 16:59:14,48,10628,19,29,7510.36,12318.00,0.00
2024-12-08 16:59:14,49,10628,20,29,7357.09,12318.02,0.00
2024-12-08 16:59:14,48,10628,19,29,7347.67,12318.69,0.00
2024-12-08 16:59:14,48,10629,19,29,7566.06,12319.00,0.00
2024-12-08 16:59:14,49,10629,19,30,7411.65,12319.02,0.00
2024-12-08 16:59:14,48,10629,19,29,7514.74,12319.04,0.00
2024-12-08 16:59:14,47,10629,18,29,7674.62,12319.04,0.00
2024-12-08 16:59:14,47,10630,18,29,7714.56,12320.00,0.00
2024-12-08 16:59:14,48,10630,18,30,7553.84,12320.02,0.00
2024-12-08 16:59:14,47,10630,17,30,7560.30,12320.72,0.00
2024-12-08 16:59:14,47,10631,17,30,7788.59,12321.00,0.00
2024-12-08 16:59:14,48,10631,17,31,7626.33,12321.02,0.00
2024-12-08 16:59:14,48,10632,17,31,7608.98,12322.00,0.00
2024-12-08 16:59:14,49,10632,17,32,7453.69,12322.02,0.00
2024-12-08 16:59:14,48,10632,17,31,7601.29,12322.06,0.00
2024-12-08 16:59:14,47,10632,16,31,7611.52,12322.94,0.00
2024-12-08 16:59:14,47,10633,16,31,7865.89,12323.00,0.00
2024-12-08 16:59:14,48,10633,16,32,7702.01,12323.02,0.00
2024-12-08 16:59:14,47,10633,15,32,7706.83,12323.28,0.00
2024-12-08 16:59:14,47,10634,15,32,7880.42,12324.00,0.00
2024-12-08 16:59:14,48,10634,16,32,7716.24,12324.02,0.00
2024-12-08 16:59:14,47,10634,16,31,7820.12,12324.06,0.00
2024-12-08 16:59:14,47,10635,16,31,7862.70,12325.00,0.00
2024-12-08 16:59:14,48,10635,17,31,7698.90,12325.02,0.00
2024-12-08 16:59:14,48,10636,17,31,7694.07,12326.00,0.00
2024-12-08 16:59:14,49,10636,18,31,7537.04,12326.02,0.00
2024-12-08 16:59:14,48,10636,18,30,7635.02,12326.06,0.00
2024-12-08 16:59:14,48,10637,18,30,7674.14,12327.00,0.00
2024-12-08 16:59:14,49,10637,19,30,7517.53,12327.02,0.00
2024-12-08 16:59:14,49,10638,19,30,7510.29,12328.00,0.00
2024-12-08 16:59:14,50,10638,20,30,7360.09,12328.02,0.00
2024-12-08 16:59:14,49,10638,20,29,7454.95,12328.06,0.00
2024-12-08 16:59:14,49,10639,20,29,7490.77,12329.00,0.00
2024-12-08 16:59:14,50,10639,20,30,7340.96,12329.02,0.00
2024-12-08 16:59:14,49,10639,19,30,7330.17,12329.35,0.00
2024-12-08 16:59:14,49,10640,19,30,7501.74,12330.00,0.00
2024-12-08 16:59:14,50,10640,20,30,7351.71,12330.02,0.00
2024-12-08 16:59:14,49,10640,20,29,7446.40,12330.06,0.00
2024-12-08 16:59:14,49,10641,20,29,7482.22,12331.00,0.00
2024-12-08 16:59:14,50,10641,21,29,7332.58,12331.02,0.00
2024-12-08 16:59:14,50,10642,21,29,7339.98,12332.00,0.00
2024-12-08 16:59:14,51,10642,22,29,7196.06,12332.02,0.00
2024-12-08 16:59:14,50,10642,21,29,7330.14,12332.08,0.00
2024-12-08 16:59:14,50,10643,21,29,7315.92,12333.00,0.00
2024-12-08 16:59:14,51,10643,21,30,7172.47,12333.02,0.00
2024-12-08 16:59:14,50,10643,21,29,7288.81,12333.12,0.00
2024-12-08 16:59:14,49,10643,20,29,7260.00,12333.96,0.00
2024-12-08 16:59:14,49,10644,20,29,7506.70,12334.00,0.00
2024-12-08 16:59:14,50,10644,21,29,7356.56,12334.02,0.00
2024-12-08 16:59:14,50,10645,21,29,7359.76,12335.00,0.00
2024-12-08 16:59:14,51,10645,21,30,7215.45,12335.02,0.00
2024-12-08 16:59:14,50,10645,20,30,7209.22,12335.28,0.00
2024-12-08 16:59:14,50,10646,20,30,7367.62,12336.00,0.00
2024-12-08 16:59:14,51,10646,20,31,7223.16,12336.02,0.00
2024-12-08 16:59:14,50,10646,19,31,7355.31,12336.10,0.00
2024-12-08 16:59:14,49,10646,19,30,7495.35,12336.10,0.00
2024-12-08 16:59:14,49,10647,19,30,7536.22,12337.00,0.00
2024-12-08 16:59:14,50,10647,19,31,7385.49,12337.02,0.00
2024-12-08 16:59:14,50,10648,19,31,7386.07,12338.00,0.00
2024-12-08 16:59:14,51,10648,20,31,7241.24,12338.02,0.00
2024-12-08 16:59:14,50,10648,19,31,7277.56,12338.16,0.00
2024-12-08 16:59:14,50,10649,19,31,7421.24,12339.00,0.00
2024-12-08 16:59:14,51,10649,19,32,7275.73,12339.02,0.00
2024-12-08 16:59:14,50,10649,19,31,7403.99,12339.10,0.00
2024-12-08 16:59:14,50,10650,19,31,7441.58,12340.00,0.00
2024-12-08 16:59:14,51,10650,19,32,7295.67,12340.02,0.00
2024-12-08 16:59:14,51,10651,19,32,7293.81,12341.00,0.00
2024-12-08 16:59:14,52,10651,19,33,7153.54,12341.02,0.00
2024-12-08 16:59:14,51,10651,18,33,7115.17,12341.76,0.00
2024-12-08 16:59:15,51,10652,18,33,7328.31,12342.00,0.00
2024-12-08 16:59:15,52,10652,19,33,7187.38,12342.02,0.00
2024-12-08 16:59:15,51,10652,19,32,7313.81,12342.10,0.00
2024-12-08 16:59:15,50,10652,18,32,7371.34,12342.36,0.00
2024-12-08 16:59:15,50,10653,18,32,7539.67,12343.00,0.00
2024-12-08 16:59:15,51,10653,18,33,7391.83,12343.02,0.00
2024-12-08 16:59:15,50,10653,17,33,7432.73,12343.48,0.00
2024-12-08 16:59:15,50,10654,17,33,7535.21,12344.00,0.00
2024-12-08 16:59:15,51,10654,18,33,7387.46,12344.02,0.00
2024-12-08 16:59:15,50,10654,18,32,7473.51,12344.10,0.00
2024-12-08 16:59:15,50,10655,18,32,7511.13,12345.00,0.00
2024-12-08 16:59:15,51,10655,19,32,7363.86,12345.02,0.00
2024-12-08 16:59:15,51,10656,19,32,7364.78,12346.00,0.00
2024-12-08 16:59:15,52,10656,19,33,7223.15,12346.02,0.00
2024-12-08 16:59:15,52,10657,19,33,7197.61,12347.00,0.00
2024-12-08 16:59:15,53,10657,19,34,7061.81,12347.02,0.00
2024-12-08 16:59:15,52,10657,19,33,7173.88,12347.13,0.00
2024-12-08 16:59:15,52,10658,19,33,7210.07,12348.00,0.00
2024-12-08 16:59:15,53,10658,19,34,7074.03,12348.02,0.00
2024-12-08 16:59:15,52,10658,18,34,7200.58,12348.10,0.00
2024-12-08 16:59:15,51,10658,17,34,7339.35,12348.10,0.00
2024-12-08 16:59:15,51,10659,17,34,7422.26,12349.00,0.00
2024-12-08 16:59:15,52,10659,17,35,7279.52,12349.02,0.00
2024-12-08 16:59:15,51,10659,16,35,7311.02,12349.16,0.00
2024-12-08 16:59:15,51,10660,16,35,7449.62,12350.00,0.00
2024-12-08 16:59:15,52,10660,16,36,7306.36,12350.02,0.00
2024-12-08 16:59:15,51,10660,16,35,7430.26,12350.10,0.00
2024-12-08 16:59:15,50,10660,15,35,7433.40,12350.56,0.00
2024-12-08 16:59:15,50,10661,15,35,7626.40,12351.00,0.00
2024-12-08 16:59:15,51,10661,16,35,7476.86,12351.02,0.00
2024-12-08 16:59:15,50,10661,15,35,7623.93,12351.02,0.00
2024-12-08 16:59:15,49,10661,14,35,7713.99,12351.06,0.00
2024-12-08 16:59:15,49,10662,14,35,7800.00,12352.00,0.00
2024-12-08 16:59:15,50,10662,15,35,7644.00,12352.02,0.00
2024-12-08 16:59:15,50,10663,15,35,7622.38,12353.00,0.00
2024-12-08 16:59:15,51,10663,15,36,7472.93,12353.02,0.00
2024-12-08 16:59:15,50,10663,15,35,7612.51,12353.06,0.00
2024-12-08 16:59:15,50,10664,15,35,7645.24,12354.00,0.00
2024-12-08 16:59:15,51,10664,15,36,7495.33,12354.02,0.00
2024-12-08 16:59:15,51,10665,15,36,7484.29,12355.00,0.00
2024-12-08 16:59:15,52,10665,16,36,7340.36,12355.02,0.00
2024-12-08 16:59:15,51,10665,16,35,7428.58,12355.06,0.00
2024-12-08 16:59:15,50,10665,15,35,7478.21,12355.68,0.00
2024-12-08 16:59:15,50,10666,15,35,7686.02,12356.00,0.00
2024-12-08 16:59:15,51,10666,16,35,7535.31,12356.02,0.00
2024-12-08 16:59:15,51,10667,16,35,7526.52,12357.00,0.00
2024-12-08 16:59:15,52,10667,17,35,7381.78,12357.02,0.00
2024-12-08 16:59:15,51,10667,16,35,7335.03,12357.47,0.00
2024-12-08 16:59:15,51,10668,16,35,7512.30,12358.00,0.00
2024-12-08 16:59:15,52,10668,16,36,7367.83,12358.02,0.00
2024-12-08 16:59:15,51,10668,16,35,7505.03,12358.06,0.00
2024-12-08 16:59:15,51,10668,16,35,7534.67,12359.00,0.00
2024-12-08 16:59:15,52,10668,16,36,7389.77,12359.02,0.00
2024-12-08 16:59:15,51,10668,15,36,7532.25,12359.02,0.00
2024-12-08 16:59:15,51,10669,15,36,7522.51,12360.00,0.00
2024-12-08 16:59:15,52,10669,16,36,7377.84,12360.02,0.00
2024-12-08 16:59:15,51,10669,16,35,7471.61,12360.04,0.00
2024-12-08 16:59:15,50,10669,15,35,7473.89,12360.86,0.00
2024-12-08 16:59:15,50,10670,15,35,7703.91,12361.00,0.00
2024-12-08 16:59:15,51,10670,15,36,7552.86,12361.02,0.00
2024-12-08 16:59:15,50,10670,14,36,7555.97,12361.72,0.00
2024-12-08 16:59:15,50,10671,14,36,7768.82,12362.00,0.00
2024-12-08 16:59:15,51,10671,14,37,7616.49,12362.02,0.00
2024-12-08 16:59:15,50,10671,14,36,7719.37,12362.04,0.00
2024-12-08 16:59:15,49,10671,13,36,7738.00,12362.41,0.00
2024-12-08 16:59:15,49,10672,13,36,7917.57,12363.00,0.00
2024-12-08 16:59:15,50,10672,14,36,7759.22,12363.02,0.00
2024-12-08 16:59:15,49,10672,13,36,7897.39,12363.02,0.00
2024-12-08 16:59:15,49,10673,13,36,7978.77,12364.00,0.00
2024-12-08 16:59:15,50,10673,14,36,7819.20,12364.02,0.00
2024-12-08 16:59:15,49,10673,14,35,7930.83,12364.02,0.00
2024-12-08 16:59:15,49,10674,14,35,7961.75,12365.00,0.00
2024-12-08 16:59:15,50,10674,15,35,7802.52,12365.02,0.00
2024-12-08 16:59:15,49,10674,14,35,7827.44,12365.59,0.00
2024-12-08 16:59:16,49,10675,14,35,8029.65,12366.00,0.00
2024-12-08 16:59:16,50,10675,15,35,7869.06,12366.02,0.00
2024-12-08 16:59:16,49,10675,15,34,7984.23,12366.02,0.00
2024-12-08 16:59:16,49,10676,15,34,8015.16,12367.00,0.00
2024-12-08 16:59:16,50,10676,15,35,7854.85,12367.02,0.00
2024-12-08 16:59:16,49,10676,14,35,7869.23,12367.33,0.00
2024-12-08 16:59:16,49,10677,14,35,8038.84,12368.00,0.00
2024-12-08 16:59:16,50,10677,15,35,7878.06,12368.02,0.00
2024-12-08 16:59:16,49,10677,15,34,7990.88,12368.02,0.00
2024-12-08 16:59:16,49,10678,15,34,8021.82,12369.00,0.00
2024-12-08 16:59:16,50,10678,15,35,7861.38,12369.02,0.00
2024-12-08 16:59:16,50,10679,15,35,7840.44,12370.00,0.00
2024-12-08 16:59:16,51,10679,15,36,7686.71,12370.02,0.00
2024-12-08 16:59:16,50,10679,15,35,7793.44,12370.02,0.00
2024-12-08 16:59:16,49,10679,14,35,7800.58,12370.53,0.00
2024-12-08 16:59:16,49,10680,14,35,7995.34,12371.00,0.00
2024-12-08 16:59:16,50,10680,14,36,7835.43,12371.02,0.00
2024-12-08 16:59:16,49,10680,13,36,7839.23,12371.73,0.00
2024-12-08 16:59:16,49,10681,13,36,8059.11,12372.00,0.00
2024-12-08 16:59:16,50,10681,13,37,7897.93,12372.02,0.00
2024-12-08 16:59:16,49,10681,13,36,8013.66,12372.02,0.00
2024-12-08 16:59:16,49,10682,13,36,8044.61,12373.00,0.00
2024-12-08 16:59:16,50,10682,14,36,7883.72,12373.02,0.00
2024-12-08 16:59:16,50,10683,14,36,7862.08,12374.00,0.00
2024-12-08 16:59:16,51,10683,14,37,7707.92,12374.02,0.00
2024-12-08 16:59:16,50,10683,14,36,7820.01,12374.02,0.00
2024-12-08 16:59:16,50,10684,14,36,7847.87,12375.00,0.00
2024-12-08 16:59:16,51,10684,14,37,7693.99,12375.02,0.00
2024-12-08 16:59:16,51,10685,14,37,7671.19,12376.00,0.00
2024-12-08 16:59:16,52,10685,14,38,7523.66,12376.02,0.00
2024-12-08 16:59:16,51,10685,14,37,7632.36,12376.02,0.00
2024-12-08 16:59:16,50,10685,13,37,7717.41,12376.24,0.00
2024-12-08 16:59:16,50,10686,13,37,7871.41,12377.00,0.00
2024-12-08 16:59:16,51,10686,13,38,7717.07,12377.02,0.00
2024-12-08 16:59:16,51,10687,13,38,7698.71,12378.00,0.00
2024-12-08 16:59:16,52,10687,13,39,7550.66,12378.02,0.00
2024-12-08 16:59:16,51,10687,13,38,7650.18,12378.06,0.00
2024-12-08 16:59:16,50,10687,12,38,7740.93,12378.22,0.00
2024-12-08 16:59:16,50,10688,12,38,7892.49,12379.00,0.00
2024-12-08 16:59:16,51,10688,12,39,7737.74,12379.02,0.00
2024-12-08 16:59:16,51,10689,12,39,7718.23,12380.00,0.00
2024-12-08 16:59:16,52,10689,13,39,7569.81,12380.02,0.00
2024-12-08 16:59:16,51,10689,13,38,7672.13,12380.06,0.00
2024-12-08 16:59:16,51,10690,13,38,7701.86,12381.00,0.00
2024-12-08 16:59:16,52,10690,14,38,7553.75,12381.02,0.00
2024-12-08 16:59:16,51,10690,13,38,7556.58,12381.71,0.00
2024-12-08 16:59:16,51,10691,13,38,7763.18,12382.00,0.00
2024-12-08 16:59:16,52,10691,13,39,7613.89,12382.02,0.00
2024-12-08 16:59:16,51,10691,13,38,7719.49,12382.06,0.00
2024-12-08 16:59:16,51,10692,13,38,7749.24,12383.00,0.00
2024-12-08 16:59:16,52,10692,13,39,7600.22,12383.02,0.00
2024-12-08 16:59:16,52,10693,13,39,7579.25,12384.00,0.00
2024-12-08 16:59:16,53,10693,13,40,7436.24,12384.02,0.00
2024-12-08 16:59:16,52,10693,13,39,7536.39,12384.06,0.00
2024-12-08 16:59:16,52,10694,13,39,7563.19,12385.00,0.00
2024-12-08 16:59:16,53,10694,14,39,7420.49,12385.02,0.00
2024-12-08 16:59:16,52,10694,13,39,7418.39,12385.69,0.00
2024-12-08 16:59:16,52,10695,13,39,7618.73,12386.00,0.00
2024-12-08 16:59:16,53,10695,13,40,7474.98,12386.02,0.00
2024-12-08 16:59:16,52,10695,13,39,7578.25,12386.06,0.00
2024-12-08 16:59:16,51,10695,12,39,7655.00,12386.63,0.00
2024-12-08 16:59:16,50,10695,11,39,7805.63,12386.64,0.00
2024-12-08 16:59:16,50,10696,11,39,7909.98,12387.00,0.00
2024-12-08 16:59:16,51,10696,12,39,7754.88,12387.02,0.00
2024-12-08 16:59:16,51,10697,12,39,7731.22,12388.00,0.00
2024-12-08 16:59:16,52,10697,13,39,7582.54,12388.02,0.00
2024-12-08 16:59:16,51,10697,13,38,7692.36,12388.06,0.00
2024-12-08 16:59:17,51,10698,13,38,7722.13,12389.00,0.00
2024-12-08 16:59:17,52,10698,14,38,7573.62,12389.02,0.00
2024-12-08 16:59:17,51,10698,13,38,7518.65,12389.94,0.00
2024-12-08 16:59:17,51,10699,13,38,7754.33,12390.00,0.00
2024-12-08 16:59:17,52,10699,13,39,7605.21,12390.02,0.00
2024-12-08 16:59:17,51,10699,13,38,7717.90,12390.06,0.00
2024-12-08 16:59:17,51,10700,13,38,7747.67,12391.00,0.00
2024-12-08 16:59:17,52,10700,14,38,7598.67,12391.02,0.00
2024-12-08 16:59:17,52,10701,14,38,7573.08,12392.00,0.00
2024-12-08 16:59:17,53,10701,14,39,7430.19,12392.02,0.00
2024-12-08 16:59:17,52,10701,14,38,7539.72,12392.06,0.00
2024-12-08 16:59:17,52,10702,14,38,7566.53,12393.00,0.00
2024-12-08 16:59:17,53,10702,15,38,7423.77,12393.02,0.00
2024-12-08 16:59:17,53,10703,15,38,7400.42,12394.00,0.00
2024-12-08 16:59:17,54,10703,16,38,7263.38,12394.02,0.00
2024-12-08 16:59:17,53,10703,16,37,7358.34,12394.06,0.00
2024-12-08 16:59:17,53,10704,16,37,7382.31,12395.00,0.00
2024-12-08 16:59:17,54,10704,16,38,7245.60,12395.02,0.00
2024-12-08 16:59:17,53,10704,15,38,7328.53,12395.08,0.00
2024-12-08 16:59:17,53,10705,15,38,7365.99,12396.00,0.00
2024-12-08 16:59:17,54,10705,16,38,7229.59,12396.02,0.00
2024-12-08 16:59:17,53,10705,16,37,7319.22,12396.06,0.00
2024-12-08 16:59:17,53,10706,16,37,7343.20,12397.00,0.00
2024-12-08 16:59:17,54,10706,16,38,7207.21,12397.02,0.00
2024-12-08 16:59:17,53,10706,15,38,7208.22,12397.34,0.00
2024-12-08 16:59:17,53,10707,15,38,7360.73,12398.00,0.00
2024-12-08 16:59:17,54,10707,16,38,7224.42,12398.02,0.00
2024-12-08 16:59:17,53,10707,16,37,7313.95,12398.06,0.00
2024-12-08 16:59:17,52,10707,15,37,7395.09,12398.27,0.00
2024-12-08 16:59:17,52,10708,15,37,7543.42,12399.00,0.00
2024-12-08 16:59:17,53,10708,16,37,7401.09,12399.02,0.00
2024-12-08 16:59:17,53,10709,16,37,7379.54,12400.00,0.00
2024-12-08 16:59:17,54,10709,16,38,7242.88,12400.02,0.00
2024-12-08 16:59:17,53,10709,16,37,7335.09,12400.06,0.00
2024-12-08 16:59:17,53,10710,16,37,7359.08,12401.00,0.00
2024-12-08 16:59:17,54,10710,16,38,7222.80,12401.02,0.00
2024-12-08 16:59:17,53,10710,15,38,7165.90,12401.87,0.00
2024-12-08 16:59:17,53,10711,15,38,7383.61,12402.00,0.00
2024-12-08 16:59:17,54,10711,15,39,7246.88,12402.02,0.00
2024-12-08 16:59:17,53,10711,15,38,7341.49,12402.06,0.00
2024-12-08 16:59:17,53,10712,15,38,7365.48,12403.00,0.00
2024-12-08 16:59:17,54,10712,16,38,7229.08,12403.02,0.00
2024-12-08 16:59:17,53,10712,15,38,7188.10,12403.85,0.00
2024-12-08 16:59:17,53,10713,15,38,7403.52,12404.00,0.00
2024-12-08 16:59:17,54,10713,15,39,7266.42,12404.02,0.00
2024-12-08 16:59:17,53,10713,15,38,7361.40,12404.06,0.00
2024-12-08 16:59:17,53,10714,15,38,7385.40,12405.00,0.00
2024-12-08 16:59:17,54,10714,16,38,7248.63,12405.02,0.00
2024-12-08 16:59:17,54,10715,16,38,7223.55,12406.00,0.00
2024-12-08 16:59:17,55,10715,17,38,7092.22,12406.02,0.00
2024-12-08 16:59:17,54,10715,17,37,7184.50,12406.06,0.00
2024-12-08 16:59:17,53,10715,16,37,7201.26,12406.45,0.00
2024-12-08 16:59:17,53,10716,16,37,7367.86,12407.00,0.00
2024-12-08 16:59:17,54,10716,17,37,7231.42,12407.02,0.00
2024-12-08 16:59:17,54,10717,17,37,7206.18,12408.00,0.00
2024-12-08 16:59:17,55,10717,17,38,7075.16,12408.02,0.00
2024-12-08 16:59:17,54,10717,17,37,7169.42,12408.06,0.00
2024-12-08 16:59:17,54,10718,17,37,7190.67,12409.00,0.00
2024-12-08 16:59:17,55,10718,18,37,7059.93,12409.02,0.00
2024-12-08 16:59:17,55,10719,18,37,7034.47,12410.00,0.00
2024-12-08 16:59:17,56,10719,18,38,6908.85,12410.02,0.00
2024-12-08 16:59:17,55,10719,18,37,6998.37,12410.05,0.00
2024-12-08 16:59:17,55,10720,18,37,7016.99,12411.00,0.00
2024-12-08 16:59:17,56,10720,18,38,6891.68,12411.02,0.00
2024-12-08 16:59:18,56,10721,18,38,6869.40,12412.00,0.00
2024-12-08 16:59:18,57,10721,18,39,6748.88,12412.02,0.00
2024-12-08 16:59:18,56,10721,17,39,6867.18,12412.02,0.00
2024-12-08 16:59:18,55,10721,17,38,6955.94,12412.04,0.00
2024-12-08 16:59:18,54,10721,16,38,6927.36,12412.93,0.00
2024-12-08 16:59:18,54,10722,16,38,7148.08,12413.00,0.00
2024-12-08 16:59:18,55,10722,17,38,7018.12,12413.02,0.00
2024-12-08 16:59:18,54,10722,16,38,6954.95,12413.89,0.00
2024-12-08 16:59:18,54,10723,16,38,7171.13,12414.00,0.00
2024-12-08 16:59:18,55,10723,16,39,7040.75,12414.02,0.00
2024-12-08 16:59:18,54,10723,16,38,7169.16,12414.02,0.00
2024-12-08 16:59:18,53,10723,16,37,7271.63,12414.02,0.00
2024-12-08 16:59:18,53,10723,16,37,7290.96,12415.00,0.00
2024-12-08 16:59:18,54,10723,17,37,7155.94,12415.02,0.00
2024-12-08 16:59:18,54,10724,17,37,7128.16,12416.00,0.00
2024-12-08 16:59:18,55,10724,17,38,6998.55,12416.02,0.00
2024-12-08 16:59:18,54,10724,17,37,7098.27,12416.02,0.00
2024-12-08 16:59:18,53,10724,16,37,7220.51,12416.09,0.00
2024-12-08 16:59:18,53,10725,16,37,7249.18,12417.00,0.00
2024-12-08 16:59:18,54,10725,17,37,7114.93,12417.02,0.00
2024-12-08 16:59:18,53,10725,16,37,7177.37,12417.13,0.00
2024-12-08 16:59:18,53,10726,16,37,7304.44,12418.00,0.00
2024-12-08 16:59:18,54,10726,17,37,7169.17,12418.02,0.00
2024-12-08 16:59:18,53,10726,17,36,7276.32,12418.02,0.00
2024-12-08 16:59:18,53,10727,17,36,7295.65,12419.00,0.00
2024-12-08 16:59:18,54,10727,17,37,7160.55,12419.02,0.00
2024-12-08 16:59:18,54,10728,17,37,7131.22,12420.00,0.00
2024-12-08 16:59:18,55,10728,18,37,7001.56,12420.02,0.00
2024-12-08 16:59:18,54,10728,18,36,7105.92,12420.02,0.00
2024-12-08 16:59:18,53,10728,17,36,7090.54,12420.92,0.00
2024-12-08 16:59:18,53,10729,17,36,7315.57,12421.00,0.00
2024-12-08 16:59:18,54,10729,18,36,7180.10,12421.02,0.00
2024-12-08 16:59:18,54,10730,18,36,7150.77,12422.00,0.00
2024-12-08 16:59:18,55,10730,18,37,7020.76,12422.02,0.00
2024-12-08 16:59:18,54,10730,18,36,7123.17,12422.02,0.00
2024-12-08 16:59:18,53,10730,17,36,7166.52,12422.72,0.00
2024-12-08 16:59:18,53,10731,17,36,7365.98,12423.00,0.00
2024-12-08 16:59:18,54,10731,17,37,7229.57,12423.02,0.00
2024-12-08 16:59:18,53,10731,16,37,7155.32,12423.64,0.00
2024-12-08 16:59:18,53,10732,16,37,7345.47,12424.00,0.00
2024-12-08 16:59:18,54,10732,17,37,7209.44,12424.02,0.00
2024-12-08 16:59:18,53,10732,17,36,7319.69,12424.02,0.00
2024-12-08 16:59:18,52,10732,16,36,7450.92,12424.10,0.00
2024-12-08 16:59:18,52,10733,16,36,7482.56,12425.00,0.00
2024-12-08 16:59:18,53,10733,16,37,7341.38,12425.02,0.00
2024-12-08 16:59:18,53,10734,16,37,7313.83,12426.00,0.00
2024-12-08 16:59:18,54,10734,16,38,7178.39,12426.02,0.00
2024-12-08 16:59:18,53,10734,16,37,7283.35,12426.02,0.00
2024-12-08 16:59:18,52,10734,15,37,7244.52,12426.67,0.00
2024-12-08 16:59:18,52,10735,15,37,7443.13,12427.00,0.00
2024-12-08 16:59:18,53,10735,16,37,7302.69,12427.02,0.00
2024-12-08 16:59:18,53,10736,16,37,7275.14,12428.00,0.00
2024-12-08 16:59:18,54,10736,16,38,7140.42,12428.02,0.00
2024-12-08 16:59:18,53,10736,16,37,7247.00,12428.02,0.00
2024-12-08 16:59:18,53,10737,16,37,7266.35,12429.00,0.00
2024-12-08 16:59:18,54,10737,17,37,7131.79,12429.02,0.00
2024-12-08 16:59:18,53,10737,16,37,7093.03,12429.51,0.00
2024-12-08 16:59:18,53,10738,16,37,7266.93,12430.00,0.00
2024-12-08 16:59:18,54,10738,17,37,7132.36,12430.02,0.00
2024-12-08 16:59:18,53,10738,17,36,7238.79,12430.02,0.00
2024-12-08 16:59:18,53,10739,17,36,7258.14,12431.00,0.00
2024-12-08 16:59:18,54,10739,18,36,7123.73,12431.02,0.00
2024-12-08 16:59:18,54,10740,18,36,7095.99,12432.00,0.00
2024-12-08 16:59:18,55,10740,18,37,6966.98,12432.02,0.00
2024-12-08 16:59:18,54,10740,18,36,7070.67,12432.02,0.00
2024-12-08 16:59:18,54,10741,18,36,7087.36,12433.00,0.00
2024-12-08 16:59:18,55,10741,19,36,6958.50,12433.02,0.00
2024-12-08 16:59:18,54,10741,18,36,6957.11,12433.67,0.00
2024-12-08 16:59:18,54,10742,18,36,7146.17,12434.00,0.00
2024-12-08 16:59:18,55,10742,19,36,7016.24,12434.02,0.00
2024-12-08 16:59:18,54,10742,19,35,7113.93,12434.02,0.00
2024-12-08 16:59:18,54,10743,19,35,7130.63,12435.00,0.00
2024-12-08 16:59:18,55,10743,20,35,7000.98,12435.02,0.00
2024-12-08 16:59:18,55,10744,20,35,6978.65,12436.00,0.00
2024-12-08 16:59:18,56,10744,21,35,6854.03,12436.02,0.00
2024-12-08 16:59:18,55,10744,21,34,6946.99,12436.02,0.00
2024-12-08 16:59:18,54,10744,20,34,7034.54,12436.19,0.00
2024-12-08 16:59:18,54,10745,20,34,7163.42,12437.00,0.00
2024-12-08 16:59:18,55,10745,21,34,7033.17,12437.02,0.00
2024-12-08 16:59:18,55,10746,21,34,7006.92,12438.00,0.00
2024-12-08 16:59:18,56,10746,22,34,6881.79,12438.02,0.00
2024-12-08 16:59:18,55,10746,22,33,6977.52,12438.02,0.00
2024-12-08 16:59:18,54,10746,21,33,7031.01,12438.63,0.00
2024-12-08 16:59:18,54,10747,21,33,7117.93,12439.00,0.00
2024-12-08 16:59:18,55,10747,22,33,6988.51,12439.02,0.00
2024-12-08 16:59:19,55,10747,22,33,6956.30,12440.00,0.00
2024-12-08 16:59:19,56,10747,23,33,6832.08,12440.02,0.00
2024-12-08 16:59:19,55,10747,23,32,6929.16,12440.02,0.00
2024-12-08 16:59:19,55,10748,23,32,6936.99,12441.00,0.00
2024-12-08 16:59:19,56,10748,24,32,6813.11,12441.02,0.00
2024-12-08 16:59:19,56,10749,24,32,6783.36,12442.00,0.00
2024-12-08 16:59:19,57,10749,24,33,6664.35,12442.02,0.00
2024-12-08 16:59:19,56,10749,24,32,6758.92,12442.02,0.00
2024-12-08 16:59:19,55,10749,23,32,6868.28,12442.13,0.00
2024-12-08 16:59:19,55,10750,23,32,6893.18,12443.00,0.00
2024-12-08 16:59:19,56,10750,24,32,6770.09,12443.02,0.00
2024-12-08 16:59:19,56,10751,24,32,6743.90,12444.00,0.00
2024-12-08 16:59:19,57,10751,24,33,6625.59,12444.02,0.00
2024-12-08 16:59:19,56,10751,24,32,6719.46,12444.02,0.00
2024-12-08 16:59:19,56,10752,24,32,6730.52,12445.00,0.00
2024-12-08 16:59:19,57,10752,24,33,6612.44,12445.02,0.00
2024-12-08 16:59:19,56,10752,23,33,6611.65,12445.32,0.00
2024-12-08 16:59:19,56,10753,23,33,6749.81,12446.00,0.00
2024-12-08 16:59:19,57,10753,24,33,6631.39,12446.02,0.00
2024-12-08 16:59:19,56,10753,24,32,6727.59,12446.02,0.00
2024-12-08 16:59:19,56,10754,24,32,6739.24,12447.00,0.00
2024-12-08 16:59:19,57,10754,25,32,6621.01,12447.02,0.00
2024-12-08 16:59:19,57,10755,25,32,6594.19,12448.00,0.00
2024-12-08 16:59:19,58,10755,25,33,6480.50,12448.02,0.00
2024-12-08 16:59:19,57,10755,25,32,6574.54,12448.02,0.00
2024-12-08 16:59:19,56,10755,24,32,6676.42,12448.14,0.00
2024-12-08 16:59:19,56,10756,24,32,6703.59,12449.00,0.00
2024-12-08 16:59:19,57,10756,24,33,6585.98,12449.02,0.00
2024-12-08 16:59:19,57,10757,24,33,6556.43,12450.00,0.00
2024-12-08 16:59:19,58,10757,24,34,6443.39,12450.02,0.00
2024-12-08 16:59:19,57,10757,24,33,6538.96,12450.02,0.00
2024-12-08 16:59:19,56,10757,23,33,6640.20,12450.14,0.00
2024-12-08 16:59:19,56,10758,23,33,6667.38,12451.00,0.00
2024-12-08 16:59:19,57,10758,23,34,6550.40,12451.02,0.00
2024-12-08 16:59:19,57,10759,23,34,6520.78,12452.00,0.00
2024-12-08 16:59:19,58,10759,24,34,6408.36,12452.02,0.00
2024-12-08 16:59:19,57,10759,24,33,6505.49,12452.02,0.00
2024-12-08 16:59:19,56,10759,23,33,6606.14,12452.14,0.00
2024-12-08 16:59:19,55,10759,22,33,6606.19,12452.85,0.00
2024-12-08 16:59:19,55,10760,22,33,6814.60,12453.00,0.00
2024-12-08 16:59:19,56,10760,23,33,6692.91,12453.02,0.00
2024-12-08 16:59:19,56,10761,23,33,6662.10,12454.00,0.00
2024-12-08 16:59:19,57,10761,23,34,6545.22,12454.02,0.00
2024-12-08 16:59:19,56,10761,23,33,6648.75,12454.02,0.00
2024-12-08 16:59:19,55,10761,22,33,6693.54,12454.62,0.00
2024-12-08 16:59:19,54,10761,21,33,6815.21,12454.65,0.00
2024-12-08 16:59:19,54,10762,21,33,6910.01,12455.00,0.00
2024-12-08 16:59:19,55,10762,21,34,6784.37,12455.02,0.00
2024-12-08 16:59:19,55,10763,21,34,6753.21,12456.00,0.00
2024-12-08 16:59:19,56,10763,22,34,6632.61,12456.02,0.00
2024-12-08 16:59:19,55,10763,22,33,6737.35,12456.02,0.00
2024-12-08 16:59:19,54,10763,21,33,6696.34,12456.63,0.00
2024-12-08 16:59:19,54,10764,21,33,6881.13,12457.00,0.00
2024-12-08 16:59:19,55,10764,22,33,6756.02,12457.02,0.00
2024-12-08 16:59:19,54,10764,21,33,6754.26,12457.07,0.00
2024-12-08 16:59:19,54,10765,21,33,6870.14,12458.00,0.00
2024-12-08 16:59:19,55,10765,22,33,6745.23,12458.02,0.00
2024-12-08 16:59:19,54,10765,22,32,6856.30,12458.02,0.00
2024-12-08 16:59:19,54,10766,22,32,6873.00,12459.00,0.00
2024-12-08 16:59:19,55,10766,22,33,6748.04,12459.02,0.00
2024-12-08 16:59:19,55,10767,22,33,6716.86,12460.00,0.00
2024-12-08 16:59:19,56,10767,22,34,6596.92,12460.02,0.00
2024-12-08 16:59:19,55,10767,22,33,6705.54,12460.02,0.00
2024-12-08 16:59:19,54,10767,21,33,6757.34,12460.59,0.00
2024-12-08 16:59:19,53,10767,20,33,6798.11,12460.96,0.00
2024-12-08 16:59:19,53,10768,20,33,7028.54,12461.00,0.00
2024-12-08 16:59:19,54,10768,20,34,6898.38,12461.02,0.00
2024-12-08 16:59:19,54,10769,20,34,6868.93,12462.00,0.00
2024-12-08 16:59:19,55,10769,20,35,6744.04,12462.02,0.00
2024-12-08 16:59:19,54,10769,20,34,6857.39,12462.02,0.00
2024-12-08 16:59:19,54,10770,20,34,6874.10,12463.00,0.00
2024-12-08 16:59:19,55,10770,21,34,6749.12,12463.02,0.00
2024-12-08 16:59:19,54,10770,20,34,6753.50,12463.61,0.00
2024-12-08 16:59:19,53,10770,19,34,6805.90,12463.92,0.00
2024-12-08 16:59:19,53,10771,19,34,7031.72,12464.00,0.00
2024-12-08 16:59:19,54,10771,20,34,6901.50,12464.02,0.00
2024-12-08 16:59:19,53,10771,20,33,7015.26,12464.02,0.00
2024-12-08 16:59:19,53,10772,20,33,7034.63,12465.00,0.00
2024-12-08 16:59:19,54,10772,21,33,6904.36,12465.02,0.00
2024-12-08 16:59:19,54,10773,21,33,6874.91,12466.00,0.00
2024-12-08 16:59:19,55,10773,22,33,6749.91,12466.02,0.00
2024-12-08 16:59:19,54,10773,22,32,6858.75,12466.02,0.00
2024-12-08 16:59:19,54,10774,22,32,6874.54,12467.00,0.00
2024-12-08 16:59:19,55,10774,22,33,6749.54,12467.02,0.00
2024-12-08 16:59:20,54,10774,21,33,6770.21,12467.37,0.00
2024-12-08 16:59:20,54,10775,21,33,6921.66,12468.00,0.00
2024-12-08 16:59:20,55,10775,21,34,6795.81,12468.02,0.00
2024-12-08 16:59:20,54,10775,21,33,6903.19,12468.02,0.00
2024-12-08 16:59:20,53,10775,20,33,6930.11,12468.43,0.00
2024-12-08 16:59:20,53,10776,20,33,7094.40,12469.00,0.00
2024-12-08 16:59:20,54,10776,21,33,6963.02,12469.02,0.00
2024-12-08 16:59:20,53,10776,20,33,6881.07,12469.64,0.00
2024-12-08 16:59:20,53,10777,20,33,7070.73,12470.00,0.00
2024-12-08 16:59:20,54,10777,20,34,6939.79,12470.02,0.00
2024-12-08 16:59:20,53,10777,20,33,7051.91,12470.02,0.00
2024-12-08 16:59:20,52,10777,19,33,7175.56,12470.12,0.00
2024-12-08 16:59:20,51,10777,18,33,7254.22,12470.61,0.00
2024-12-08 16:59:20,51,10778,18,33,7351.27,12471.00,0.00
2024-12-08 16:59:20,52,10778,19,33,7209.90,12471.02,0.00
2024-12-08 16:59:20,52,10779,19,33,7184.10,12472.00,0.00
2024-12-08 16:59:20,53,10779,20,33,7048.55,12472.02,0.00
2024-12-08 16:59:20,52,10779,20,32,7162.51,12472.02,0.00
2024-12-08 16:59:20,52,10780,20,32,7184.67,12473.00,0.00
2024-12-08 16:59:20,53,10780,21,32,7049.11,12473.02,0.00
2024-12-08 16:59:20,52,10780,20,32,7039.86,12473.38,0.00
2024-12-08 16:59:20,53,10779,21,32,6841.51,12473.94,0.00
2024-12-08 16:59:20,53,10780,21,32,7265.19,12474.00,0.00
2024-12-08 16:59:20,54,10780,22,32,7130.65,12474.02,0.00
2024-12-08 16:59:20,53,10780,22,31,7246.36,12474.02,0.00
2024-12-08 16:59:20,52,10780,21,31,7309.27,12474.63,0.00
2024-12-08 16:59:20,52,10781,21,31,7647.81,12475.00,0.00
2024-12-08 16:59:20,53,10781,21,32,7503.51,12475.02,0.00
2024-12-08 16:59:20,53,10782,21,32,7475.86,12476.00,0.00
2024-12-08 16:59:20,54,10782,21,33,7337.42,12476.02,0.00
2024-12-08 16:59:20,53,10782,21,32,7459.38,12476.02,0.00
2024-12-08 16:59:20,53,10783,21,32,7478.81,12477.00,0.00
2024-12-08 16:59:20,54,10783,22,32,7340.32,12477.02,0.00
2024-12-08 16:59:20,54,10784,22,32,7310.87,12478.00,0.00
2024-12-08 16:59:20,55,10784,23,32,7177.94,12478.02,0.00
2024-12-08 16:59:20,54,10784,23,31,7294.69,12478.02,0.00
2024-12-08 16:59:20,54,10785,23,31,7311.45,12479.00,0.00
2024-12-08 16:59:20,55,10785,24,31,7178.52,12479.02,0.00
2024-12-08 16:59:20,55,10786,24,31,7147.32,12480.00,0.00
2024-12-08 16:59:20,56,10786,24,32,7019.69,12480.02,0.00
2024-12-08 16:59:20,55,10786,24,31,7126.90,12480.02,0.00
2024-12-08 16:59:20,55,10787,24,31,7141.09,12481.00,0.00
2024-12-08 16:59:20,56,10787,25,31,7013.57,12481.02,0.00
2024-12-08 16:59:20,56,10788,25,31,6982.82,12482.00,0.00
2024-12-08 16:59:20,57,10788,26,31,6860.32,12482.02,0.00
2024-12-08 16:59:20,56,10788,26,30,6962.76,12482.02,0.00
2024-12-08 16:59:20,56,10789,26,30,6974.47,12483.00,0.00
2024-12-08 16:59:20,57,10789,26,31,6852.11,12483.02,0.00
2024-12-08 16:59:20,57,10790,26,31,6819.81,12484.00,0.00
2024-12-08 16:59:20,58,10790,27,31,6702.23,12484.02,0.00
2024-12-08 16:59:20,57,10790,27,30,6802.29,12484.02,0.00
2024-12-08 16:59:20,56,10790,26,30,6772.66,12484.93,0.00
2024-12-08 16:59:20,56,10791,26,30,6986.73,12485.00,0.00
2024-12-08 16:59:20,57,10791,26,31,6864.16,12485.02,0.00
2024-12-08 16:59:20,57,10792,26,31,6831.47,12486.00,0.00
2024-12-08 16:59:20,58,10792,26,32,6713.69,12486.02,0.00
2024-12-08 16:59:20,57,10792,26,31,6816.14,12486.02,0.00
2024-12-08 16:59:20,57,10793,26,31,6825.45,12487.00,0.00
2024-12-08 16:59:20,58,10793,26,32,6707.77,12487.02,0.00
2024-12-08 16:59:20,57,10793,25,32,6670.08,12487.46,0.00
2024-12-08 16:59:20,57,10794,25,32,6821.61,12488.00,0.00
2024-12-08 16:59:20,58,10794,26,32,6704.00,12488.02,0.00
2024-12-08 16:59:20,57,10794,26,31,6806.28,12488.02,0.00
2024-12-08 16:59:20,56,10794,25,31,6907.80,12488.18,0.00
2024-12-08 16:59:20,56,10795,25,31,6939.44,12489.00,0.00
2024-12-08 16:59:20,57,10795,26,31,6817.70,12489.02,0.00
2024-12-08 16:59:20,56,10795,25,31,6825.70,12489.04,0.00
2024-12-08 16:59:20,56,10796,25,31,6922.49,12490.00,0.00
2024-12-08 16:59:20,57,10796,25,32,6801.05,12490.02,0.00
2024-12-08 16:59:20,56,10796,25,31,6906.88,12490.02,0.00
2024-12-08 16:59:20,56,10797,25,31,6907.94,12491.00,0.00
2024-12-08 16:59:20,57,10797,25,32,6786.75,12491.02,0.00
2024-12-08 16:59:20,56,10797,24,32,6794.18,12491.04,0.00
2024-12-08 16:59:20,56,10798,24,32,6885.78,12492.00,0.00
2024-12-08 16:59:20,57,10798,25,32,6764.98,12492.02,0.00
2024-12-08 16:59:20,56,10798,25,31,6867.93,12492.02,0.00
2024-12-08 16:59:20,55,10798,24,31,6906.11,12492.64,0.00
2024-12-08 16:59:20,55,10799,24,31,6997.22,12493.00,0.00
2024-12-08 16:59:20,56,10799,24,32,6872.27,12493.02,0.00
2024-12-08 16:59:20,55,10799,23,32,6931.35,12493.02,0.00
2024-12-08 16:59:20,55,10800,23,32,6982.76,12494.00,0.00
2024-12-08 16:59:20,56,10800,24,32,6858.07,12494.02,0.00
2024-12-08 16:59:20,55,10800,24,31,6962.32,12494.02,0.00
2024-12-08 16:59:20,54,10800,23,31,7007.09,12494.63,0.00
2024-12-08 16:59:20,53,10800,22,31,7134.60,12494.66,0.00
2024-12-08 16:59:21,53,10801,22,31,7233.87,12495.00,0.00
2024-12-08 16:59:21,54,10801,22,32,7099.91,12495.02,0.00
2024-12-08 16:59:21,54,10802,22,32,7062.58,12496.00,0.00
2024-12-08 16:59:21,55,10802,23,32,6934.17,12496.02,0.00
2024-12-08 16:59:21,54,10802,23,31,7044.07,12496.02,0.00
2024-12-08 16:59:21,53,10802,22,31,7165.44,12496.09,0.00
2024-12-08 16:59:21,52,10802,21,31,7143.31,12496.60,0.00
2024-12-08 16:59:21,52,10803,21,31,7333.47,12497.00,0.00
2024-12-08 16:59:21,53,10803,21,32,7195.10,12497.02,0.00
2024-12-08 16:59:21,53,10804,21,32,7159.75,12498.00,0.00
2024-12-08 16:59:21,54,10804,21,33,7027.16,12498.02,0.00
2024-12-08 16:59:21,53,10804,21,32,7140.88,12498.02,0.00
2024-12-08 16:59:21,52,10804,20,32,7094.78,12498.65,0.00
2024-12-08 16:59:21,52,10805,20,32,7292.13,12499.00,0.00
2024-12-08 16:59:21,53,10805,20,33,7154.55,12499.02,0.00
2024-12-08 16:59:21,52,10805,19,33,7222.46,12499.13,0.00
2024-12-08 16:59:21,52,10806,19,33,7351.90,12500.00,0.00
2024-12-08 16:59:21,53,10806,20,33,7213.19,12500.02,0.00
2024-12-08 16:59:21,52,10806,20,32,7335.08,12500.02,0.00
2024-12-08 16:59:21,51,10806,19,32,7466.67,12500.10,0.00
2024-12-08 16:59:21,50,10806,18,32,7503.79,12500.44,0.00
2024-12-08 16:59:21,50,10807,18,32,7684.21,12501.00,0.00
2024-12-08 16:59:21,51,10807,18,33,7533.54,12501.02,0.00
2024-12-08 16:59:21,51,10807,18,33,7509.63,12502.00,0.00
2024-12-08 16:59:21,52,10807,18,34,7365.21,12502.02,0.00
2024-12-08 16:59:21,51,10807,18,33,7492.47,12502.02,0.00
2024-12-08 16:59:21,51,10808,18,33,7517.58,12503.00,0.00
2024-12-08 16:59:21,52,10808,19,33,7373.02,12503.02,0.00
2024-12-08 16:59:21,51,10808,18,33,7383.49,12503.65,0.00
2024-12-08 16:59:21,51,10809,18,33,7584.80,12504.00,0.00
2024-12-08 16:59:21,52,10809,19,33,7438.94,12504.02,0.00
2024-12-08 16:59:21,51,10809,19,32,7562.74,12504.02,0.00
2024-12-08 16:59:21,51,10810,19,32,7587.86,12505.00,0.00
2024-12-08 16:59:21,52,10810,20,32,7441.94,12505.02,0.00
2024-12-08 16:59:21,52,10811,20,32,7425.52,12506.00,0.00
2024-12-08 16:59:21,53,10811,21,32,7285.42,12506.02,0.00
2024-12-08 16:59:21,52,10811,21,31,7379.84,12506.06,0.00
2024-12-08 16:59:21,52,10812,21,31,7406.88,12507.00,0.00
2024-12-08 16:59:21,53,10812,21,32,7267.12,12507.02,0.00
2024-12-08 16:59:21,53,10813,21,32,7250.48,12508.00,0.00
2024-12-08 16:59:21,54,10813,21,33,7116.22,12508.02,0.00
2024-12-08 16:59:21,53,10813,21,32,7205.65,12508.06,0.00
2024-12-08 16:59:21,52,10813,20,32,7191.64,12508.87,0.00
2024-12-08 16:59:21,52,10814,20,32,7415.45,12509.00,0.00
2024-12-08 16:59:21,53,10814,21,32,7275.54,12509.02,0.00
2024-12-08 16:59:21,52,10814,20,32,7285.88,12509.65,0.00
2024-12-08 16:59:21,52,10815,20,32,7397.82,12510.00,0.00
2024-12-08 16:59:21,53,10815,21,32,7258.24,12510.02,0.00
2024-12-08 16:59:21,52,10815,21,31,7354.52,12510.06,0.00
2024-12-08 16:59:21,52,10816,21,31,7381.57,12511.00,0.00
2024-12-08 16:59:21,53,10816,22,31,7242.29,12511.02,0.00
2024-12-08 16:59:21,53,10817,22,31,7223.69,12512.00,0.00
2024-12-08 16:59:21,54,10817,22,32,7089.92,12512.02,0.00
2024-12-08 16:59:21,53,10817,22,31,7181.29,12512.06,0.00
2024-12-08 16:59:21,53,10818,22,31,7205.47,12513.00,0.00
2024-12-08 16:59:21,54,10818,23,31,7072.03,12513.02,0.00
2024-12-08 16:59:21,53,10818,22,31,7080.64,12513.64,0.00
2024-12-08 16:59:21,53,10819,22,31,7189.82,12514.00,0.00
2024-12-08 16:59:21,54,10819,23,31,7056.68,12514.02,0.00
2024-12-08 16:59:21,53,10819,23,30,7147.33,12514.06,0.00
2024-12-08 16:59:21,53,10820,23,30,7171.51,12515.00,0.00
2024-12-08 16:59:21,54,10820,23,31,7038.70,12515.02,0.00
2024-12-08 16:59:21,54,10821,23,31,7017.87,12516.00,0.00
2024-12-08 16:59:21,55,10821,23,32,6890.27,12516.02,0.00
2024-12-08 16:59:21,54,10821,23,31,6978.48,12516.06,0.00
2024-12-08 16:59:21,53,10821,22,31,6991.11,12516.77,0.00
2024-12-08 16:59:21,53,10822,22,31,7197.31,12517.00,0.00
2024-12-08 16:59:21,54,10822,23,31,7064.02,12517.02,0.00
2024-12-08 16:59:21,53,10822,22,31,7024.99,12517.77,0.00
2024-12-08 16:59:21,53,10823,22,31,7232.38,12518.00,0.00
2024-12-08 16:59:21,54,10823,22,32,7098.44,12518.02,0.00
2024-12-08 16:59:21,53,10823,22,31,7194.59,12518.06,0.00
2024-12-08 16:59:21,53,10824,22,31,7218.78,12519.00,0.00
2024-12-08 16:59:21,54,10824,23,31,7085.10,12519.02,0.00
2024-12-08 16:59:21,54,10825,23,31,7068.05,12520.00,0.00
2024-12-08 16:59:21,55,10825,23,32,6939.54,12520.02,0.00
2024-12-08 16:59:21,54,10825,23,31,7028.65,12520.06,0.00
2024-12-08 16:59:21,54,10826,23,31,7050.07,12521.00,0.00
2024-12-08 16:59:21,55,10826,24,31,6921.89,12521.02,0.00
2024-12-08 16:59:21,54,10826,23,31,6968.96,12521.20,0.00
2024-12-08 16:59:22,54,10827,23,31,7101.65,12522.00,0.00
2024-12-08 16:59:22,55,10827,24,31,6972.53,12522.02,0.00
2024-12-08 16:59:22,54,10827,24,30,7064.55,12522.06,0.00
2024-12-08 16:59:22,53,10827,23,30,7196.89,12522.06,0.00
2024-12-08 16:59:22,53,10828,23,30,7221.09,12523.00,0.00
2024-12-08 16:59:22,54,10828,24,30,7087.36,12523.02,0.00
2024-12-08 16:59:22,54,10829,24,30,7071.44,12524.00,0.00
2024-12-08 16:59:22,55,10829,24,31,6942.87,12524.02,0.00
2024-12-08 16:59:22,54,10829,24,30,7029.70,12524.06,0.00
2024-12-08 16:59:22,53,10829,23,30,7155.27,12524.11,0.00
2024-12-08 16:59:22,53,10830,23,30,7186.53,12525.00,0.00
2024-12-08 16:59:22,54,10830,24,30,7053.45,12525.02,0.00
2024-12-08 16:59:22,54,10831,24,30,7036.31,12526.00,0.00
2024-12-08 16:59:22,55,10831,25,30,6908.38,12526.02,0.00
2024-12-08 16:59:22,54,10831,25,29,6996.88,12526.06,0.00
2024-12-08 16:59:22,53,10831,24,29,7058.28,12526.62,0.00
2024-12-08 16:59:22,53,10832,24,29,7153.10,12527.00,0.00
2024-12-08 16:59:22,54,10832,25,29,7020.63,12527.02,0.00
2024-12-08 16:59:22,54,10833,25,29,7001.78,12528.00,0.00
2024-12-08 16:59:22,55,10833,26,29,6874.48,12528.02,0.00
2024-12-08 16:59:22,54,10833,26,28,6964.66,12528.06,0.00
2024-12-08 16:59:22,53,10833,26,27,7087.45,12528.09,0.00
2024-12-08 16:59:22,53,10834,26,27,7116.37,12529.00,0.00
2024-12-08 16:59:22,54,10834,27,27,6984.59,12529.02,0.00
2024-12-08 16:59:22,54,10835,27,27,6963.41,12530.00,0.00
2024-12-08 16:59:22,55,10835,27,28,6836.80,12530.02,0.00
2024-12-08 16:59:22,54,10835,27,27,6928.61,12530.06,0.00
2024-12-08 16:59:22,53,10835,26,27,7057.23,12530.06,0.00
2024-12-08 16:59:22,53,10836,26,27,7081.43,12531.00,0.00
2024-12-08 16:59:22,54,10836,27,27,6950.30,12531.02,0.00
2024-12-08 16:59:22,54,10837,27,27,6934.97,12532.00,0.00
2024-12-08 16:59:22,55,10837,27,28,6808.88,12532.02,0.00
2024-12-08 16:59:22,54,10837,27,27,6890.88,12532.06,0.00
2024-12-08 16:59:22,54,10838,27,27,6912.32,12533.00,0.00
2024-12-08 16:59:22,55,10838,27,28,6786.64,12533.02,0.00
2024-12-08 16:59:22,55,10839,27,28,6772.33,12534.00,0.00
2024-12-08 16:59:22,56,10839,28,28,6651.39,12534.02,0.00
2024-12-08 16:59:22,55,10839,27,28,6750.72,12534.05,0.00
2024-12-08 16:59:22,54,10839,27,27,6836.28,12534.06,0.00
2024-12-08 16:59:22,54,10840,27,27,6950.56,12535.00,0.00
2024-12-08 16:59:22,55,10840,28,27,6824.19,12535.02,0.00
2024-12-08 16:59:22,55,10841,28,27,6815.62,12536.00,0.00
2024-12-08 16:59:22,56,10841,29,27,6693.91,12536.02,0.00
2024-12-08 16:59:22,55,10841,29,26,6763.21,12536.07,0.00
2024-12-08 16:59:22,55,10842,29,26,6784.25,12537.00,0.00
2024-12-08 16:59:22,56,10842,29,27,6663.11,12537.02,0.00
2024-12-08 16:59:22,55,10842,28,27,6781.97,12537.02,0.00
2024-12-08 16:59:22,55,10843,28,27,6773.95,12538.00,0.00
2024-12-08 16:59:22,56,10843,29,27,6652.98,12538.02,0.00
2024-12-08 16:59:22,55,10843,28,27,6771.67,12538.02,0.00
2024-12-08 16:59:22,54,10843,28,26,6850.64,12538.04,0.00
2024-12-08 16:59:22,53,10843,27,26,6863.74,12538.70,0.00
2024-12-08 16:59:22,53,10844,27,26,7062.68,12539.00,0.00
2024-12-08 16:59:22,54,10844,27,27,6931.89,12539.02,0.00
2024-12-08 16:59:22,54,10845,27,27,6925.51,12540.00,0.00
2024-12-08 16:59:22,55,10845,28,27,6799.60,12540.02,0.00
2024-12-08 16:59:22,54,10845,28,26,6872.11,12540.06,0.00
2024-12-08 16:59:22,54,10846,28,26,6893.55,12541.00,0.00
2024-12-08 16:59:22,55,10846,28,27,6768.22,12541.02,0.00
2024-12-08 16:59:22,54,10846,27,27,6889.21,12541.04,0.00
2024-12-08 16:59:22,54,10847,27,27,6890.03,12542.00,0.00
2024-12-08 16:59:22,55,10847,28,27,6764.76,12542.02,0.00
2024-12-08 16:59:22,54,10847,27,27,6887.71,12542.04,0.00
2024-12-08 16:59:22,53,10847,26,27,6880.33,12542.49,0.00
2024-12-08 16:59:22,53,10848,26,27,7053.43,12543.00,0.00
2024-12-08 16:59:22,54,10848,26,28,6922.81,12543.02,0.00
2024-12-08 16:59:22,53,10848,26,27,7046.35,12543.06,0.00
2024-12-08 16:59:22,53,10849,26,27,7070.56,12544.00,0.00
2024-12-08 16:59:22,54,10849,26,28,6939.63,12544.02,0.00
2024-12-08 16:59:22,54,10850,26,28,6933.56,12545.00,0.00
2024-12-08 16:59:22,55,10850,26,29,6807.49,12545.02,0.00
2024-12-08 16:59:22,54,10850,26,28,6880.14,12545.06,0.00
2024-12-08 16:59:22,54,10851,26,28,6901.58,12546.00,0.00
2024-12-08 16:59:22,55,10851,27,28,6776.10,12546.02,0.00
2024-12-08 16:59:22,54,10851,26,28,6758.50,12546.31,0.00
2024-12-08 16:59:22,54,10852,26,28,6905.31,12547.00,0.00
2024-12-08 16:59:22,55,10852,27,28,6779.76,12547.02,0.00
2024-12-08 16:59:22,54,10852,27,27,6854.21,12547.06,0.00
2024-12-08 16:59:22,54,10853,27,27,6875.65,12548.00,0.00
2024-12-08 16:59:22,55,10853,27,28,6750.64,12548.02,0.00
2024-12-08 16:59:22,54,10853,26,28,6773.56,12548.46,0.00
2024-12-08 16:59:23,54,10854,26,28,6870.42,12549.00,0.00
2024-12-08 16:59:23,55,10854,27,28,6745.51,12549.02,0.00
2024-12-08 16:59:23,54,10854,26,28,6789.09,12549.04,0.00
2024-12-08 16:59:23,53,10854,26,27,6872.20,12549.04,0.00
2024-12-08 16:59:23,52,10854,25,27,6943.36,12549.52,0.00
2024-12-08 16:59:23,52,10855,25,27,7124.70,12550.00,0.00
2024-12-08 16:59:23,53,10855,25,28,6990.27,12550.02,0.00
2024-12-08 16:59:23,52,10855,24,28,7052.32,12550.12,0.00
2024-12-08 16:59:23,52,10856,24,28,7183.19,12551.00,0.00
2024-12-08 16:59:23,53,10856,25,28,7047.66,12551.02,0.00
2024-12-08 16:59:23,52,10856,25,27,7130.10,12551.06,0.00
2024-12-08 16:59:23,52,10857,25,27,7157.21,12552.00,0.00
2024-12-08 16:59:23,53,10857,25,28,7022.17,12552.02,0.00
2024-12-08 16:59:23,53,10858,25,28,7015.18,12553.00,0.00
2024-12-08 16:59:23,54,10858,26,28,6885.27,12553.02,0.00
2024-12-08 16:59:23,53,10858,26,27,6965.45,12553.06,0.00
2024-12-08 16:59:23,52,10858,25,27,6940.98,12553.88,0.00
2024-12-08 16:59:23,52,10859,25,27,7168.01,12554.00,0.00
2024-12-08 16:59:23,53,10859,26,27,7032.77,12554.02,0.00
2024-12-08 16:59:23,53,10860,26,27,7026.55,12555.00,0.00
2024-12-08 16:59:23,54,10860,26,28,6896.42,12555.02,0.00
2024-12-08 16:59:23,53,10860,25,28,7023.80,12555.04,0.00
2024-12-08 16:59:23,52,10860,25,27,7113.00,12555.04,0.00
2024-12-08 16:59:23,52,10861,25,27,7137.71,12556.00,0.00
2024-12-08 16:59:23,53,10861,26,27,7003.04,12556.02,0.00
2024-12-08 16:59:23,52,10861,25,27,7012.42,12556.63,0.00
2024-12-08 16:59:23,52,10862,25,27,7134.25,12557.00,0.00
2024-12-08 16:59:23,53,10862,26,27,6999.64,12557.02,0.00
2024-12-08 16:59:23,52,10862,26,26,7085.96,12557.04,0.00
2024-12-08 16:59:23,52,10863,26,26,7110.67,12558.00,0.00
2024-12-08 16:59:23,53,10863,26,27,6976.51,12558.02,0.00
2024-12-08 16:59:23,53,10864,26,27,6971.33,12559.00,0.00
2024-12-08 16:59:23,54,10864,27,27,6842.23,12559.02,0.00
2024-12-08 16:59:23,53,10864,27,26,6921.57,12559.06,0.00
2024-12-08 16:59:23,52,10864,26,26,7007.09,12559.42,0.00
2024-12-08 16:59:23,52,10865,26,26,7079.95,12560.00,0.00
2024-12-08 16:59:23,53,10865,27,26,6946.36,12560.02,0.00
2024-12-08 16:59:23,53,10866,27,26,6940.44,12561.00,0.00
2024-12-08 16:59:23,54,10866,27,27,6811.92,12561.02,0.00
2024-12-08 16:59:23,53,10866,26,27,6937.07,12561.04,0.00
2024-12-08 16:59:23,52,10866,26,26,7027.00,12561.04,0.00
2024-12-08 16:59:23,52,10867,26,26,7051.71,12562.00,0.00
2024-12-08 16:59:23,53,10867,27,26,6918.66,12562.02,0.00
2024-12-08 16:59:23,52,10867,26,26,6917.68,12562.58,0.00
2024-12-08 16:59:23,52,10868,26,26,7106.44,12563.00,0.00
2024-12-08 16:59:23,53,10868,26,27,6972.35,12563.02,0.00
2024-12-08 16:59:23,52,10868,26,26,7062.95,12563.04,0.00
2024-12-08 16:59:23,52,10869,26,26,7087.67,12564.00,0.00
2024-12-08 16:59:23,53,10869,26,27,6953.94,12564.02,0.00
2024-12-08 16:59:23,53,10870,26,27,6945.06,12565.00,0.00
2024-12-08 16:59:23,54,10870,27,27,6816.45,12565.02,0.00
2024-12-08 16:59:23,53,10870,27,26,6902.39,12565.04,0.00
2024-12-08 16:59:23,52,10870,26,26,6895.33,12565.81,0.00
2024-12-08 16:59:23,52,10871,26,26,7112.97,12566.00,0.00
2024-12-08 16:59:23,53,10871,27,26,6978.76,12566.02,0.00
2024-12-08 16:59:23,53,10872,27,26,6968.93,12567.00,0.00
2024-12-08 16:59:23,54,10872,28,26,6839.88,12567.02,0.00
2024-12-08 16:59:23,53,10872,28,25,6928.62,12567.04,0.00
2024-12-08 16:59:23,53,10872,28,25,6950.52,12568.00,0.00
2024-12-08 16:59:23,54,10872,28,26,6821.80,12568.02,0.00
2024-12-08 16:59:23,54,10873,28,26,6816.75,12569.00,0.00
2024-12-08 16:59:23,55,10873,29,26,6692.81,12569.02,0.00
2024-12-08 16:59:23,54,10873,29,25,6770.20,12569.04,0.00
2024-12-08 16:59:23,54,10874,29,25,6789.36,12570.00,0.00
2024-12-08 16:59:23,55,10874,29,26,6665.92,12570.02,0.00
2024-12-08 16:59:23,54,10874,28,26,6738.15,12570.06,0.00
2024-12-08 16:59:23,53,10874,27,26,6862.51,12570.08,0.00
2024-12-08 16:59:23,52,10874,26,26,6926.87,12570.27,0.00
2024-12-08 16:59:23,51,10874,25,26,7037.33,12570.47,0.00
2024-12-08 16:59:23,51,10875,25,26,7217.64,12571.00,0.00
2024-12-08 16:59:23,52,10875,25,27,7078.84,12571.02,0.00
2024-12-08 16:59:23,51,10875,25,26,7170.81,12571.04,0.00
2024-12-08 16:59:23,50,10875,24,26,7276.56,12571.16,0.00
2024-12-08 16:59:23,50,10876,24,26,7422.68,12572.00,0.00
2024-12-08 16:59:23,51,10876,25,26,7277.14,12572.02,0.00
2024-12-08 16:59:23,51,10877,25,26,7272.59,12573.00,0.00
2024-12-08 16:59:23,52,10877,25,27,7132.73,12573.02,0.00
2024-12-08 16:59:23,51,10877,24,27,7270.12,12573.02,0.00
2024-12-08 16:59:23,50,10877,24,26,7362.72,12573.04,0.00
2024-12-08 16:59:23,49,10877,23,26,7464.02,12573.43,0.00
2024-12-08 16:59:23,49,10878,23,26,7541.80,12574.00,0.00
2024-12-08 16:59:23,50,10878,24,26,7390.96,12574.02,0.00
2024-12-08 16:59:23,50,10879,24,26,7382.91,12575.00,0.00
2024-12-08 16:59:23,51,10879,24,27,7238.15,12575.02,0.00
2024-12-08 16:59:23,50,10879,24,26,7325.07,12575.06,0.00
2024-12-08 16:59:23,50,10880,24,26,7351.68,12576.00,0.00
2024-12-08 16:59:23,51,10880,25,26,7207.53,12576.02,0.00
2024-12-08 16:59:24,51,10880,25,26,7199.33,12577.00,0.00
2024-12-08 16:59:24,52,10880,25,27,7060.88,12577.02,0.00
2024-12-08 16:59:24,51,10880,25,26,7145.08,12577.06,0.00
2024-12-08 16:59:24,51,10881,25,26,7172.07,12578.00,0.00
2024-12-08 16:59:24,52,10881,25,27,7034.15,12578.02,0.00
2024-12-08 16:59:24,52,10882,25,27,7029.26,12579.00,0.00
2024-12-08 16:59:24,53,10882,25,28,6896.63,12579.02,0.00
2024-12-08 16:59:24,52,10882,24,28,7028.35,12579.02,0.00
2024-12-08 16:59:24,51,10882,24,27,7114.38,12579.04,0.00
2024-12-08 16:59:24,50,10882,23,27,7141.96,12579.68,0.00
2024-12-08 16:59:24,50,10883,23,27,7353.54,12580.00,0.00
2024-12-08 16:59:24,51,10883,23,28,7209.35,12580.02,0.00
2024-12-08 16:59:24,51,10883,23,28,7205.08,12581.00,0.00
2024-12-08 16:59:24,52,10883,24,28,7066.52,12581.02,0.00
2024-12-08 16:59:24,51,10883,24,27,7153.29,12581.04,0.00
2024-12-08 16:59:24,51,10883,24,27,7180.98,12582.00,0.00
2024-12-08 16:59:24,52,10883,24,28,7042.89,12582.02,0.00
2024-12-08 16:59:24,52,10884,24,28,7044.01,12583.00,0.00
2024-12-08 16:59:24,53,10884,24,29,6911.10,12583.02,0.00
2024-12-08 16:59:24,53,10885,24,29,6883.16,12584.00,0.00
2024-12-08 16:59:24,54,10885,25,29,6755.69,12584.02,0.00
2024-12-08 16:59:24,53,10885,25,28,6876.04,12584.06,0.00
2024-12-08 16:59:24,52,10885,24,28,6901.52,12584.65,0.00
2024-12-08 16:59:24,52,10886,24,28,7100.23,12585.00,0.00
2024-12-08 16:59:24,53,10886,25,28,6966.27,12585.02,0.00
2024-12-08 16:59:24,52,10886,24,28,7092.98,12585.06,0.00
2024-12-08 16:59:24,52,10887,24,28,7168.57,12586.00,0.00
2024-12-08 16:59:24,53,10887,24,29,7033.31,12586.02,0.00
2024-12-08 16:59:24,53,10888,24,29,7005.37,12587.00,0.00
2024-12-08 16:59:24,54,10888,24,30,6875.64,12587.02,0.00
2024-12-08 16:59:24,53,10888,24,29,6986.38,12587.09,0.00
2024-12-08 16:59:24,53,10889,24,29,7015.43,12588.00,0.00
2024-12-08 16:59:24,54,10889,24,30,6885.51,12588.02,0.00
2024-12-08 16:59:24,53,10889,23,30,6900.21,12588.51,0.00
2024-12-08 16:59:24,52,10889,22,30,7031.40,12588.52,0.00
2024-12-08 16:59:24,52,10890,22,30,7213.33,12589.00,0.00
2024-12-08 16:59:24,53,10890,23,30,7077.23,12589.02,0.00
2024-12-08 16:59:24,53,10891,23,30,7049.28,12590.00,0.00
2024-12-08 16:59:24,54,10891,23,31,6918.74,12590.02,0.00
2024-12-08 16:59:24,53,10891,22,31,7042.16,12590.08,0.00
2024-12-08 16:59:24,52,10891,22,30,7167.90,12590.10,0.00
2024-12-08 16:59:24,51,10891,21,30,7145.79,12590.61,0.00
2024-12-08 16:59:24,51,10892,21,30,7343.59,12591.00,0.00
2024-12-08 16:59:24,52,10892,21,31,7202.37,12591.02,0.00
2024-12-08 16:59:24,52,10893,21,31,7201.62,12592.00,0.00
2024-12-08 16:59:24,53,10893,22,31,7065.74,12592.02,0.00
2024-12-08 16:59:24,52,10893,21,31,7194.36,12592.08,0.00
2024-12-08 16:59:24,51,10893,20,31,7244.88,12592.37,0.00
2024-12-08 16:59:24,51,10894,20,31,7413.23,12593.00,0.00
2024-12-08 16:59:24,52,10894,20,32,7270.67,12593.02,0.00
2024-12-08 16:59:24,51,10894,19,32,7409.46,12593.04,0.00
2024-12-08 16:59:24,50,10894,19,31,7552.61,12593.06,0.00
2024-12-08 16:59:24,50,10895,19,31,7585.95,12594.00,0.00
2024-12-08 16:59:24,51,10895,19,32,7437.20,12594.02,0.00
2024-12-08 16:59:24,50,10895,18,32,7578.40,12594.06,0.00
2024-12-08 16:59:24,50,10896,18,32,7584.99,12595.00,0.00
2024-12-08 16:59:24,51,10896,19,32,7436.26,12595.02,0.00
2024-12-08 16:59:24,51,10897,19,32,7412.15,12596.00,0.00
2024-12-08 16:59:24,52,10897,20,32,7269.61,12596.02,0.00
2024-12-08 16:59:24,51,10897,20,31,7399.81,12596.08,0.00
2024-12-08 16:59:24,51,10898,20,31,7432.50,12597.00,0.00
2024-12-08 16:59:24,52,10898,21,31,7289.57,12597.02,0.00
2024-12-08 16:59:24,51,10898,20,31,7429.06,12597.04,0.00
2024-12-08 16:59:24,51,10899,20,31,7430.25,12598.00,0.00
2024-12-08 16:59:24,52,10899,21,31,7287.36,12598.02,0.00
2024-12-08 16:59:24,52,10900,21,31,7261.28,12599.00,0.00
2024-12-08 16:59:24,53,10900,21,32,7124.28,12599.02,0.00
2024-12-08 16:59:24,52,10900,21,31,7254.02,12599.06,0.00
2024-12-08 16:59:24,52,10901,21,31,7281.25,12600.00,0.00
2024-12-08 16:59:24,53,10901,22,31,7143.86,12600.02,0.00
2024-12-08 16:59:24,53,10902,22,31,7138.55,12601.00,0.00
2024-12-08 16:59:24,54,10902,23,31,7006.35,12601.02,0.00
2024-12-08 16:59:24,53,10902,23,30,7083.87,12601.06,0.00
2024-12-08 16:59:24,53,10903,23,30,7108.20,12602.00,0.00
2024-12-08 16:59:24,54,10903,24,30,6976.57,12602.02,0.00
2024-12-08 16:59:24,54,10904,24,30,6971.59,12603.00,0.00
2024-12-08 16:59:24,55,10904,24,31,6844.84,12603.02,0.00
2024-12-08 16:59:24,54,10904,24,30,6917.92,12603.06,0.00
2024-12-08 16:59:24,54,10905,24,30,6939.47,12604.00,0.00
2024-12-08 16:59:24,55,10905,25,30,6813.30,12604.02,0.00
2024-12-08 16:59:25,55,10906,25,30,6806.32,12605.00,0.00
2024-12-08 16:59:25,56,10906,25,31,6684.78,12605.02,0.00
2024-12-08 16:59:25,55,10906,24,31,6803.93,12605.04,0.00
2024-12-08 16:59:25,54,10906,24,30,6883.24,12605.04,0.00
2024-12-08 16:59:25,53,10906,23,30,6934.96,12605.64,0.00
2024-12-08 16:59:25,53,10907,23,30,7032.70,12606.00,0.00
2024-12-08 16:59:25,54,10907,23,31,6902.46,12606.02,0.00
2024-12-08 16:59:25,54,10908,23,31,6893.26,12607.00,0.00
2024-12-08 16:59:25,55,10908,23,32,6767.93,12607.02,0.00
2024-12-08 16:59:25,54,10908,23,31,6846.57,12607.04,0.00
2024-12-08 16:59:25,53,10908,22,31,6973.37,12607.04,0.00
2024-12-08 16:59:25,52,10908,21,31,6935.90,12607.92,0.00
2024-12-08 16:59:25,52,10909,21,31,7168.71,12608.00,0.00
2024-12-08 16:59:25,53,10909,21,32,7033.45,12608.02,0.00
2024-12-08 16:59:25,53,10910,21,32,7025.88,12609.00,0.00
2024-12-08 16:59:25,54,10910,22,32,6895.77,12609.02,0.00
2024-12-08 16:59:25,53,10910,22,31,6975.92,12609.04,0.00
2024-12-08 16:59:25,52,10910,21,31,7085.96,12609.04,0.00
2024-12-08 16:59:25,52,10911,21,31,7203.34,12610.00,0.00
2024-12-08 16:59:25,53,10911,22,31,7067.42,12610.02,0.00
2024-12-08 16:59:25,52,10911,21,31,7081.03,12610.23,0.00
2024-12-08 16:59:25,52,10912,21,31,7227.01,12611.00,0.00
2024-12-08 16:59:25,53,10912,22,31,7090.65,12611.02,0.00
2024-12-08 16:59:25,52,10912,22,30,7176.09,12611.04,0.00
2024-12-08 16:59:25,52,10913,22,30,7194.47,12612.00,0.00
2024-12-08 16:59:25,53,10913,22,31,7058.73,12612.02,0.00
2024-12-08 16:59:25,53,10914,22,31,7047.71,12613.00,0.00
2024-12-08 16:59:25,54,10914,23,31,6917.19,12613.02,0.00
2024-12-08 16:59:25,53,10914,23,30,6995.36,12613.06,0.00
2024-12-08 16:59:25,52,10914,22,30,7054.25,12613.63,0.00
2024-12-08 16:59:25,51,10914,21,30,7116.17,12613.75,0.00
2024-12-08 16:59:25,51,10915,21,30,7331.54,12614.00,0.00
2024-12-08 16:59:25,52,10915,21,31,7190.55,12614.02,0.00
2024-12-08 16:59:25,51,10915,20,31,7329.06,12614.02,0.00
2024-12-08 16:59:25,51,10916,20,31,7326.36,12615.00,0.00
2024-12-08 16:59:25,52,10916,20,32,7185.47,12615.02,0.00
2024-12-08 16:59:25,51,10916,20,31,7271.95,12615.04,0.00
2024-12-08 16:59:25,50,10916,19,31,7242.16,12615.92,0.00
2024-12-08 16:59:25,50,10917,19,31,7484.45,12616.00,0.00
2024-12-08 16:59:25,51,10917,20,31,7337.69,12616.02,0.00
2024-12-08 16:59:25,51,10918,20,31,7335.44,12617.00,0.00
2024-12-08 16:59:25,52,10918,20,32,7194.38,12617.02,0.00
2024-12-08 16:59:25,52,10919,20,32,7168.26,12618.00,0.00
2024-12-08 16:59:25,53,10919,20,33,7033.01,12618.02,0.00
2024-12-08 16:59:25,52,10919,20,32,7158.57,12618.08,0.00
2024-12-08 16:59:25,52,10920,20,32,7186.44,12619.00,0.00
2024-12-08 16:59:25,53,10920,21,32,7050.84,12619.02,0.00
2024-12-08 16:59:25,52,10920,20,32,7080.96,12619.13,0.00
2024-12-08 16:59:25,51,10920,19,32,7172.05,12619.51,0.00
2024-12-08 16:59:25,51,10921,19,32,7354.34,12620.00,0.00
2024-12-08 16:59:25,52,10921,20,32,7212.92,12620.02,0.00
2024-12-08 16:59:25,52,10922,20,32,7183.26,12621.00,0.00
2024-12-08 16:59:25,53,10922,20,33,7047.72,12621.02,0.00
2024-12-08 16:59:25,52,10922,20,32,7173.56,12621.08,0.00
2024-12-08 16:59:25,52,10923,20,32,7201.33,12622.00,0.00
2024-12-08 16:59:25,53,10923,20,33,7065.46,12622.02,0.00
2024-12-08 16:59:25,52,10923,19,33,7004.63,12622.90,0.00
2024-12-08 16:59:25,52,10924,19,33,7235.30,12623.00,0.00
2024-12-08 16:59:25,53,10924,20,33,7098.79,12623.02,0.00
2024-12-08 16:59:25,52,10924,20,32,7177.06,12623.08,0.00
2024-12-08 16:59:25,52,10925,20,32,7206.67,12624.00,0.00
2024-12-08 16:59:25,53,10925,21,32,7070.69,12624.02,0.00
2024-12-08 16:59:25,52,10925,20,32,7075.68,12624.33,0.00
2024-12-08 16:59:25,52,10926,20,32,7233.94,12625.00,0.00
2024-12-08 16:59:25,53,10926,20,33,7097.45,12625.02,0.00
2024-12-08 16:59:25,52,10926,20,32,7178.12,12625.08,0.00
2024-12-08 16:59:25,51,10926,19,32,7263.32,12625.51,0.00
2024-12-08 16:59:25,51,10927,19,32,7350.31,12626.00,0.00
2024-12-08 16:59:25,52,10927,19,33,7208.96,12626.02,0.00
2024-12-08 16:59:25,51,10927,18,33,7238.52,12626.51,0.00
2024-12-08 16:59:25,51,10928,18,33,7424.57,12627.00,0.00
2024-12-08 16:59:25,52,10928,19,33,7281.79,12627.02,0.00
2024-12-08 16:59:25,52,10929,19,33,7255.65,12628.00,0.00
2024-12-08 16:59:25,53,10929,19,34,7118.75,12628.02,0.00
2024-12-08 16:59:25,52,10929,19,33,7245.95,12628.08,0.00
2024-12-08 16:59:25,52,10930,19,33,7275.65,12629.00,0.00
2024-12-08 16:59:25,53,10930,20,33,7138.38,12629.02,0.00
2024-12-08 16:59:25,52,10930,19,33,7185.83,12629.19,0.00
2024-12-08 16:59:25,52,10931,19,33,7327.24,12630.00,0.00
2024-12-08 16:59:25,53,10931,19,34,7188.99,12630.02,0.00
2024-12-08 16:59:25,52,10931,19,33,7268.95,12630.08,0.00
2024-12-08 16:59:25,52,10932,19,33,7298.67,12631.00,0.00
2024-12-08 16:59:25,53,10932,19,34,7160.96,12631.02,0.00
2024-12-08 16:59:25,53,10933,19,34,7152.91,12632.00,0.00
2024-12-08 16:59:25,54,10933,20,34,7020.45,12632.02,0.00
2024-12-08 16:59:25,53,10933,20,33,7098.10,12632.08,0.00
2024-12-08 16:59:25,52,10933,19,33,7182.25,12632.48,0.00
2024-12-08 16:59:26,52,10934,19,33,7262.79,12633.00,0.00
2024-12-08 16:59:26,53,10934,20,33,7125.75,12633.02,0.00
2024-12-08 16:59:26,52,10934,19,33,7216.63,12633.02,0.00
2024-12-08 16:59:26,51,10934,18,33,7353.18,12633.06,0.00
2024-12-08 16:59:26,51,10935,18,33,7433.03,12634.00,0.00
2024-12-08 16:59:26,52,10935,18,34,7290.09,12634.02,0.00
2024-12-08 16:59:26,51,10935,17,34,7431.69,12634.02,0.00
2024-12-08 16:59:26,50,10935,17,33,7527.26,12634.04,0.00
2024-12-08 16:59:26,50,10936,17,33,7558.18,12635.00,0.00
2024-12-08 16:59:26,51,10936,18,33,7409.98,12635.02,0.00
2024-12-08 16:59:26,50,10936,17,33,7555.66,12635.04,0.00
2024-12-08 16:59:26,49,10936,16,33,7559.76,12635.39,0.00
2024-12-08 16:59:26,49,10937,16,33,7740.70,12636.00,0.00
2024-12-08 16:59:26,50,10937,17,33,7585.88,12636.02,0.00
2024-12-08 16:59:26,49,10937,17,32,7686.55,12636.04,0.00
2024-12-08 16:59:26,49,10938,17,32,7720.68,12637.00,0.00
2024-12-08 16:59:26,50,10938,18,32,7566.26,12637.02,0.00
2024-12-08 16:59:26,50,10939,18,32,7556.44,12638.00,0.00
2024-12-08 16:59:26,51,10939,18,33,7408.28,12638.02,0.00
2024-12-08 16:59:26,50,10939,18,32,7503.37,12638.04,0.00
2024-12-08 16:59:26,50,10940,18,32,7534.29,12639.00,0.00
2024-12-08 16:59:26,51,10940,19,32,7386.56,12639.02,0.00
2024-12-08 16:59:26,51,10941,19,32,7375.49,12640.00,0.00
2024-12-08 16:59:26,52,10941,19,33,7233.65,12640.02,0.00
2024-12-08 16:59:26,51,10941,19,32,7325.92,12640.04,0.00
2024-12-08 16:59:26,51,10942,19,32,7353.76,12641.00,0.00
2024-12-08 16:59:26,52,10942,20,32,7212.34,12641.02,0.00
2024-12-08 16:59:26,51,10942,19,32,7230.14,12641.61,0.00
2024-12-08 16:59:26,50,10942,18,32,7340.93,12641.66,0.00
2024-12-08 16:59:26,50,10943,18,32,7551.02,12642.00,0.00
2024-12-08 16:59:26,51,10943,19,32,7402.97,12642.02,0.00
2024-12-08 16:59:26,50,10943,19,31,7502.99,12642.04,0.00
2024-12-08 16:59:26,50,10944,19,31,7533.92,12643.00,0.00
2024-12-08 16:59:26,51,10944,19,32,7386.20,12643.02,0.00
2024-12-08 16:59:26,51,10945,19,32,7366.89,12644.00,0.00
2024-12-08 16:59:26,52,10945,20,32,7225.22,12644.02,0.00
2024-12-08 16:59:26,51,10945,20,31,7321.60,12644.04,0.00
2024-12-08 16:59:26,50,10945,19,31,7387.10,12644.62,0.00
2024-12-08 16:59:26,50,10946,19,31,7592.22,12645.00,0.00
2024-12-08 16:59:26,51,10946,20,31,7443.35,12645.02,0.00
2024-12-08 16:59:26,51,10947,20,31,7424.11,12646.00,0.00
2024-12-08 16:59:26,52,10947,20,32,7281.33,12646.02,0.00
2024-12-08 16:59:26,51,10947,20,31,7379.11,12646.04,0.00
2024-12-08 16:59:26,51,10948,20,31,7406.97,12647.00,0.00
2024-12-08 16:59:26,52,10948,20,32,7264.53,12647.02,0.00
2024-12-08 16:59:26,51,10948,19,32,7351.35,12647.06,0.00
2024-12-08 16:59:26,51,10949,19,32,7390.69,12648.00,0.00
2024-12-08 16:59:26,52,10949,19,33,7248.56,12648.02,0.00
2024-12-08 16:59:26,51,10949,19,32,7348.53,12648.04,0.00
2024-12-08 16:59:26,50,10949,18,32,7324.99,12648.96,0.00
2024-12-08 16:59:26,50,10950,18,32,7572.93,12649.00,0.00
2024-12-08 16:59:26,51,10950,19,32,7424.44,12649.02,0.00
2024-12-08 16:59:26,51,10951,19,32,7408.50,12650.00,0.00
2024-12-08 16:59:26,52,10951,20,32,7266.03,12650.02,0.00
2024-12-08 16:59:26,51,10951,20,31,7363.86,12650.04,0.00
2024-12-08 16:59:26,51,10952,20,31,7391.72,12651.00,0.00
2024-12-08 16:59:26,52,10952,21,31,7249.58,12651.02,0.00
2024-12-08 16:59:26,52,10953,21,31,7232.07,12652.00,0.00
2024-12-08 16:59:26,53,10953,21,32,7095.62,12652.02,0.00
2024-12-08 16:59:26,52,10953,21,31,7190.71,12652.04,0.00
2024-12-08 16:59:26,52,10954,21,31,7215.61,12653.00,0.00
2024-12-08 16:59:26,53,10954,21,32,7079.47,12653.02,0.00
2024-12-08 16:59:26,53,10955,21,32,7059.69,12654.00,0.00
2024-12-08 16:59:26,54,10955,21,33,6928.96,12654.02,0.00
2024-12-08 16:59:26,53,10955,21,32,7021.49,12654.04,0.00
2024-12-08 16:59:26,52,10955,20,32,7112.77,12654.17,0.00
2024-12-08 16:59:26,52,10956,20,32,7252.00,12655.00,0.00
2024-12-08 16:59:26,53,10956,20,33,7115.17,12655.02,0.00
2024-12-08 16:59:26,52,10956,19,33,7251.72,12655.02,0.00
2024-12-08 16:59:26,51,10956,18,33,7203.08,12655.49,0.00
2024-12-08 16:59:26,51,10957,18,33,7387.05,12656.00,0.00
2024-12-08 16:59:26,52,10957,18,34,7244.99,12656.02,0.00
2024-12-08 16:59:26,51,10957,18,33,7349.83,12656.02,0.00
2024-12-08 16:59:26,51,10958,18,33,7375.23,12657.00,0.00
2024-12-08 16:59:26,52,10958,18,34,7233.40,12657.02,0.00
2024-12-08 16:59:26,51,10958,17,34,7315.68,12657.08,0.00
2024-12-08 16:59:26,51,10959,17,34,7355.93,12658.00,0.00
2024-12-08 16:59:26,52,10959,18,34,7214.47,12658.02,0.00
2024-12-08 16:59:26,51,10959,18,33,7321.19,12658.02,0.00
2024-12-08 16:59:26,50,10959,17,33,7384.38,12658.62,0.00
2024-12-08 16:59:26,50,10960,17,33,7589.75,12659.00,0.00
2024-12-08 16:59:26,51,10960,18,33,7440.93,12659.02,0.00
2024-12-08 16:59:26,50,10960,17,33,7405.13,12659.46,0.00
2024-12-08 16:59:26,50,10961,17,33,7590.35,12660.00,0.00
2024-12-08 16:59:26,51,10961,17,34,7441.52,12660.02,0.00
2024-12-08 16:59:26,50,10961,17,33,7554.90,12660.02,0.00
2024-12-08 16:59:26,50,10962,17,33,7583.35,12661.00,0.00
2024-12-08 16:59:26,51,10962,17,34,7434.66,12661.02,0.00
2024-12-08 16:59:27,51,10963,17,34,7412.33,12662.00,0.00
2024-12-08 16:59:27,52,10963,18,34,7269.79,12662.02,0.00
2024-12-08 16:59:27,51,10963,18,33,7380.06,12662.02,0.00
2024-12-08 16:59:27,51,10964,18,33,7405.47,12663.00,0.00
2024-12-08 16:59:27,52,10964,18,34,7263.06,12663.02,0.00
2024-12-08 16:59:27,51,10964,17,34,7284.59,12663.53,0.00
2024-12-08 16:59:27,50,10964,16,34,7418.24,12663.62,0.00
2024-12-08 16:59:27,50,10965,16,34,7623.70,12664.00,0.00
2024-12-08 16:59:27,51,10965,17,34,7474.21,12664.02,0.00
2024-12-08 16:59:27,50,10965,17,33,7583.17,12664.02,0.00
2024-12-08 16:59:27,49,10965,16,33,7593.44,12664.51,0.00
2024-12-08 16:59:27,49,10966,16,33,7790.23,12665.00,0.00
2024-12-08 16:59:27,50,10966,16,34,7634.43,12665.02,0.00
2024-12-08 16:59:27,49,10966,15,34,7670.87,12665.18,0.00
2024-12-08 16:59:27,49,10967,15,34,7826.52,12666.00,0.00
2024-12-08 16:59:27,50,10967,15,35,7669.98,12666.02,0.00
2024-12-08 16:59:27,49,10967,15,34,7779.99,12666.02,0.00
2024-12-08 16:59:27,48,10967,14,34,7791.90,12666.50,0.00
2024-12-08 16:59:27,48,10968,14,34,7992.84,12667.00,0.00
2024-12-08 16:59:27,49,10968,14,35,7829.72,12667.02,0.00
2024-12-08 16:59:27,48,10968,13,35,7784.60,12667.52,0.00
2024-12-08 16:59:27,48,10969,13,35,7988.19,12668.00,0.00
2024-12-08 16:59:27,49,10969,14,35,7825.17,12668.02,0.00
2024-12-08 16:59:27,48,10969,14,34,7940.68,12668.02,0.00
2024-12-08 16:59:27,47,10969,13,34,7984.91,12668.40,0.00
2024-12-08 16:59:27,47,10970,13,34,8179.45,12669.00,0.00
2024-12-08 16:59:27,48,10970,13,35,8009.04,12669.02,0.00
2024-12-08 16:59:27,48,10971,13,35,7992.85,12670.00,0.00
2024-12-08 16:59:27,49,10971,14,35,7829.73,12670.02,0.00
2024-12-08 16:59:27,48,10971,14,34,7947.97,12670.02,0.00
2024-12-08 16:59:27,48,10972,14,34,7982.92,12671.00,0.00
2024-12-08 16:59:27,49,10972,14,35,7820.00,12671.02,0.00
2024-12-08 16:59:27,50,10971,15,35,7600.27,12671.16,0.00
2024-12-08 16:59:27,50,10972,15,35,7792.58,12672.00,0.00
2024-12-08 16:59:27,51,10972,16,35,7639.79,12672.02,0.00
2024-12-08 16:59:27,50,10972,16,34,7752.03,12672.02,0.00
2024-12-08 16:59:27,50,10973,16,34,8033.99,12673.00,0.00
2024-12-08 16:59:27,51,10973,17,34,7876.46,12673.02,0.00
2024-12-08 16:59:27,50,10973,16,34,7860.49,12673.78,0.00
2024-12-08 16:59:27,50,10974,16,34,8086.27,12674.00,0.00
2024-12-08 16:59:27,51,10974,17,34,7927.71,12674.02,0.00
2024-12-08 16:59:27,50,10974,17,33,8048.24,12674.02,0.00
2024-12-08 16:59:27,50,10975,17,33,8076.76,12675.00,0.00
2024-12-08 16:59:27,51,10975,18,33,7918.40,12675.02,0.00
2024-12-08 16:59:27,51,10976,18,33,7899.52,12676.00,0.00
2024-12-08 16:59:27,52,10976,19,33,7747.61,12676.02,0.00
2024-12-08 16:59:27,51,10976,18,33,7894.86,12676.04,0.00
2024-12-08 16:59:27,50,10976,18,32,8009.66,12676.04,0.00
2024-12-08 16:59:27,50,10977,18,32,8040.71,12677.00,0.00
2024-12-08 16:59:27,51,10977,18,33,7883.05,12677.02,0.00
2024-12-08 16:59:27,51,10978,18,33,7936.37,12678.00,0.00
2024-12-08 16:59:27,52,10978,18,34,7783.75,12678.02,0.00
2024-12-08 16:59:27,52,10979,18,34,7822.46,12679.00,0.00
2024-12-08 16:59:27,53,10979,18,35,7674.87,12679.02,0.00
2024-12-08 16:59:27,53,10980,18,35,7680.46,12680.00,0.00
2024-12-08 16:59:27,54,10980,19,35,7538.23,12680.02,0.00
2024-12-08 16:59:27,53,10980,18,35,7620.67,12680.11,0.00
2024-12-08 16:59:27,53,10981,18,35,7652.35,12681.00,0.00
2024-12-08 16:59:27,54,10981,19,35,7510.64,12681.02,0.00
2024-12-08 16:59:27,53,10981,19,34,7623.64,12681.04,0.00
2024-12-08 16:59:27,53,10982,19,34,7645.77,12682.00,0.00
2024-12-08 16:59:27,54,10982,20,34,7504.19,12682.02,0.00
2024-12-08 16:59:27,53,10982,19,34,7493.31,12682.81,0.00
2024-12-08 16:59:27,53,10983,19,34,7708.82,12683.00,0.00
2024-12-08 16:59:27,54,10983,20,34,7566.06,12683.02,0.00
2024-12-08 16:59:27,53,10983,20,33,7675.32,12683.04,0.00
2024-12-08 16:59:27,53,10984,20,33,7697.46,12684.00,0.00
2024-12-08 16:59:27,54,10984,21,33,7554.91,12684.02,0.00
2024-12-08 16:59:27,54,10985,21,33,7524.97,12685.00,0.00
2024-12-08 16:59:27,55,10985,22,33,7388.15,12685.02,0.00
2024-12-08 16:59:27,54,10985,22,32,7492.09,12685.04,0.00
2024-12-08 16:59:27,54,10986,22,32,7511.47,12686.00,0.00
2024-12-08 16:59:27,55,10986,23,32,7374.90,12686.02,0.00
2024-12-08 16:59:27,54,10986,22,32,7388.07,12686.61,0.00
2024-12-08 16:59:27,54,10987,22,32,7573.96,12687.00,0.00
2024-12-08 16:59:27,55,10987,23,32,7436.25,12687.02,0.00
2024-12-08 16:59:27,54,10987,23,31,7543.42,12687.04,0.00
2024-12-08 16:59:27,54,10988,23,31,7562.81,12688.00,0.00
2024-12-08 16:59:27,55,10988,23,32,7425.30,12688.02,0.00
2024-12-08 16:59:27,55,10989,23,32,7393.59,12689.00,0.00
2024-12-08 16:59:27,56,10989,24,32,7261.56,12689.02,0.00
2024-12-08 16:59:27,55,10989,24,31,7361.29,12689.04,0.00
2024-12-08 16:59:28,55,10990,24,31,7378.02,12690.00,0.00
2024-12-08 16:59:28,56,10990,24,32,7246.27,12690.02,0.00
2024-12-08 16:59:28,56,10991,24,32,7213.31,12691.00,0.00
2024-12-08 16:59:28,57,10991,25,32,7086.76,12691.02,0.00
2024-12-08 16:59:28,56,10991,25,31,7183.85,12691.04,0.00
2024-12-08 16:59:28,55,10991,24,31,7258.69,12691.22,0.00
2024-12-08 16:59:28,55,10992,24,31,7390.72,12692.00,0.00
2024-12-08 16:59:28,56,10992,24,32,7258.74,12692.02,0.00
2024-12-08 16:59:28,55,10992,23,32,7182.95,12692.58,0.00
2024-12-08 16:59:28,55,10993,23,32,7360.94,12693.00,0.00
2024-12-08 16:59:28,56,10993,24,32,7229.50,12693.02,0.00
2024-12-08 16:59:28,55,10993,24,31,7328.64,12693.04,0.00
2024-12-08 16:59:28,55,10994,24,31,7345.37,12694.00,0.00
2024-12-08 16:59:28,56,10994,25,31,7214.20,12694.02,0.00
2024-12-08 16:59:28,56,10995,25,31,7184.27,12695.00,0.00
2024-12-08 16:59:28,57,10995,26,31,7058.23,12695.02,0.00
2024-12-08 16:59:28,56,10995,26,30,7154.80,12695.04,0.00
2024-12-08 16:59:28,56,10996,26,30,7168.96,12696.00,0.00
2024-12-08 16:59:28,57,10996,26,31,7043.19,12696.02,0.00
2024-12-08 16:59:28,57,10997,26,31,7013.34,12697.00,0.00
2024-12-08 16:59:28,58,10997,27,31,6892.42,12697.02,0.00
2024-12-08 16:59:28,57,10997,27,30,6984.39,12697.04,0.00
2024-12-08 16:59:28,56,10997,26,30,6982.77,12697.80,0.00
2024-12-08 16:59:28,56,10998,26,30,7184.73,12698.00,0.00
2024-12-08 16:59:28,57,10998,27,30,7058.68,12698.02,0.00
2024-12-08 16:59:28,57,10999,27,30,7030.07,12699.00,0.00
2024-12-08 16:59:28,58,10999,28,30,6908.86,12699.02,0.00
2024-12-08 16:59:28,57,10999,28,29,7001.10,12699.04,0.00
2024-12-08 16:59:28,57,11000,28,29,7012.79,12700.00,0.00
2024-12-08 16:59:28,58,11000,28,30,6891.88,12700.02,0.00
2024-12-08 16:59:28,57,11000,27,30,6810.31,12700.61,0.00
2024-12-08 16:59:28,57,11001,27,30,6984.38,12701.00,0.00
2024-12-08 16:59:28,58,11001,27,31,6863.96,12701.02,0.00
2024-12-08 16:59:28,57,11001,27,30,6957.64,12701.04,0.00
2024-12-08 16:59:28,56,11001,26,30,6955.09,12701.50,0.00
2024-12-08 16:59:28,55,11001,25,30,7058.55,12701.67,0.00
2024-12-08 16:59:28,55,11002,25,30,7248.17,12702.00,0.00
2024-12-08 16:59:28,56,11002,25,31,7118.73,12702.02,0.00
2024-12-08 16:59:28,56,11003,25,31,7092.52,12703.00,0.00
2024-12-08 16:59:28,57,11003,25,32,6968.09,12703.02,0.00
2024-12-08 16:59:28,56,11003,25,31,7060.77,12703.05,0.00
2024-12-08 16:59:28,55,11003,24,31,7113.43,12703.64,0.00
2024-12-08 16:59:28,55,11004,24,31,7206.09,12704.00,0.00
2024-12-08 16:59:28,56,11004,24,32,7077.41,12704.02,0.00
2024-12-08 16:59:28,55,11004,23,32,7071.96,12704.65,0.00
2024-12-08 16:59:28,55,11005,23,32,7259.33,12705.00,0.00
2024-12-08 16:59:28,56,11005,23,33,7129.70,12705.02,0.00
2024-12-08 16:59:28,55,11005,22,33,7190.03,12705.04,0.00
2024-12-08 16:59:28,54,11005,22,32,7290.24,12705.04,0.00
2024-12-08 16:59:28,54,11006,22,32,7403.76,12706.00,0.00
2024-12-08 16:59:28,55,11006,23,32,7269.15,12706.02,0.00
2024-12-08 16:59:28,55,11007,23,32,7246.87,12707.00,0.00
2024-12-08 16:59:28,56,11007,23,33,7117.47,12707.02,0.00
2024-12-08 16:59:28,55,11007,23,32,7212.22,12707.04,0.00
2024-12-08 16:59:28,55,11008,23,32,7228.96,12708.00,0.00
2024-12-08 16:59:28,56,11008,24,32,7099.87,12708.02,0.00
2024-12-08 16:59:28,55,11008,23,32,7055.87,12708.51,0.00
2024-12-08 16:59:28,55,11009,23,32,7224.91,12709.00,0.00
2024-12-08 16:59:28,56,11009,24,32,7095.89,12709.02,0.00
2024-12-08 16:59:28,55,11009,23,32,7222.60,12709.02,0.00
2024-12-08 16:59:28,54,11009,23,31,7321.05,12709.02,0.00
2024-12-08 16:59:28,53,11009,22,31,7389.61,12709.57,0.00
2024-12-08 16:59:28,53,11010,22,31,7478.24,12710.00,0.00
2024-12-08 16:59:28,54,11010,23,31,7339.76,12710.02,0.00
2024-12-08 16:59:28,53,11010,22,31,7423.10,12710.08,0.00
2024-12-08 16:59:28,52,11010,21,31,7519.47,12710.25,0.00
2024-12-08 16:59:28,52,11011,21,31,7667.05,12711.00,0.00
2024-12-08 16:59:28,53,11011,21,32,7522.39,12711.02,0.00
2024-12-08 16:59:28,52,11011,21,31,7627.94,12711.02,0.00
2024-12-08 16:59:28,52,11012,21,31,7648.01,12712.00,0.00
2024-12-08 16:59:28,53,11012,22,31,7503.71,12712.02,0.00
2024-12-08 16:59:28,52,11012,21,31,7591.80,12712.08,0.00
2024-12-08 16:59:28,52,11013,21,31,7623.71,12713.00,0.00
2024-12-08 16:59:28,53,11013,22,31,7479.86,12713.02,0.00
2024-12-08 16:59:28,52,11013,22,30,7587.03,12713.02,0.00
2024-12-08 16:59:28,52,11014,22,30,7605.40,12714.00,0.00
2024-12-08 16:59:28,53,11014,22,31,7461.90,12714.02,0.00
2024-12-08 16:59:28,52,11014,21,31,7552.66,12714.04,0.00
2024-12-08 16:59:28,52,11015,21,31,7574.97,12715.00,0.00
2024-12-08 16:59:28,53,11015,21,32,7432.04,12715.02,0.00
2024-12-08 16:59:28,52,11015,21,31,7540.73,12715.02,0.00
2024-12-08 16:59:28,52,11016,21,31,7558.32,12716.00,0.00
2024-12-08 16:59:28,53,11016,21,32,7415.71,12716.02,0.00
2024-12-08 16:59:29,53,11017,21,32,7389.32,12717.00,0.00
2024-12-08 16:59:29,54,11017,21,33,7252.48,12717.02,0.00
2024-12-08 16:59:29,53,11017,21,32,7350.92,12717.02,0.00
2024-12-08 16:59:29,52,11017,20,32,7329.31,12717.92,0.00
2024-12-08 16:59:29,52,11018,20,32,7564.14,12718.00,0.00
2024-12-08 16:59:29,53,11018,21,32,7421.42,12718.02,0.00
2024-12-08 16:59:29,53,11019,21,32,7394.77,12719.00,0.00
2024-12-08 16:59:29,54,11019,22,32,7257.83,12719.02,0.00
2024-12-08 16:59:29,53,11019,22,31,7358.77,12719.02,0.00
2024-12-08 16:59:29,53,11020,22,31,7373.97,12720.00,0.00
2024-12-08 16:59:29,54,11020,22,32,7237.42,12720.02,0.00
2024-12-08 16:59:29,54,11021,22,32,7209.95,12721.00,0.00
2024-12-08 16:59:29,55,11021,23,32,7078.86,12721.02,0.00
2024-12-08 16:59:29,54,11021,23,31,7176.97,12721.02,0.00
2024-12-08 16:59:29,53,11021,22,31,7194.46,12721.75,0.00
2024-12-08 16:59:29,53,11022,22,31,7403.45,12722.00,0.00
2024-12-08 16:59:29,54,11022,22,32,7266.35,12722.02,0.00
2024-12-08 16:59:29,54,11023,22,32,7238.13,12723.00,0.00
2024-12-08 16:59:29,55,11023,22,33,7106.53,12723.02,0.00
2024-12-08 16:59:29,54,11023,22,32,7207.50,12723.02,0.00
2024-12-08 16:59:29,54,11024,22,32,7219.34,12724.00,0.00
2024-12-08 16:59:29,55,11024,23,32,7088.08,12724.02,0.00
2024-12-08 16:59:29,54,11024,22,32,7033.41,12724.52,0.00
2024-12-08 16:59:29,54,11025,22,32,7202.57,12725.00,0.00
2024-12-08 16:59:29,55,11025,22,33,7071.61,12725.02,0.00
2024-12-08 16:59:29,54,11025,22,32,7174.29,12725.02,0.00
2024-12-08 16:59:29,54,11026,22,32,7186.32,12726.00,0.00
2024-12-08 16:59:29,55,11026,23,32,7055.66,12726.02,0.00
2024-12-08 16:59:29,54,11026,22,32,7059.06,12726.04,0.00
2024-12-08 16:59:29,54,11027,22,32,7169.87,12727.00,0.00
2024-12-08 16:59:29,55,11027,23,32,7039.51,12727.02,0.00
2024-12-08 16:59:29,54,11027,23,31,7143.94,12727.02,0.00
2024-12-08 16:59:29,54,11028,23,31,7159.91,12728.00,0.00
2024-12-08 16:59:29,55,11028,23,32,7029.73,12728.02,0.00
2024-12-08 16:59:29,55,11029,23,32,7007.22,12729.00,0.00
2024-12-08 16:59:29,56,11029,23,33,6882.09,12729.02,0.00
2024-12-08 16:59:29,55,11029,23,32,6979.45,12729.02,0.00
2024-12-08 16:59:29,54,11029,22,32,6990.51,12729.41,0.00
2024-12-08 16:59:29,54,11030,22,32,7151.21,12730.00,0.00
2024-12-08 16:59:29,55,11030,23,32,7021.18,12730.02,0.00
2024-12-08 16:59:29,55,11031,23,32,6998.73,12731.00,0.00
2024-12-08 16:59:29,56,11031,23,33,6873.75,12731.02,0.00
2024-12-08 16:59:29,55,11031,23,32,6973.27,12731.02,0.00
2024-12-08 16:59:29,54,11031,22,32,7026.04,12731.61,0.00
2024-12-08 16:59:29,54,11032,22,32,7118.26,12732.00,0.00
2024-12-08 16:59:29,55,11032,22,33,6988.84,12732.02,0.00
2024-12-08 16:59:29,55,11033,22,33,6966.53,12733.00,0.00
2024-12-08 16:59:29,56,11033,23,33,6842.13,12733.02,0.00
2024-12-08 16:59:29,55,11033,23,32,6941.07,12733.02,0.00
2024-12-08 16:59:29,54,11033,22,32,6994.41,12733.61,0.00
2024-12-08 16:59:29,54,11034,22,32,7086.65,12734.00,0.00
2024-12-08 16:59:29,55,11034,23,32,6957.80,12734.02,0.00
2024-12-08 16:59:29,54,11034,22,32,7025.37,12734.13,0.00
2024-12-08 16:59:29,53,11034,21,32,7078.73,12734.36,0.00
2024-12-08 16:59:29,53,11035,21,32,7237.75,12735.00,0.00
2024-12-08 16:59:29,54,11035,21,33,7103.72,12735.02,0.00
2024-12-08 16:59:29,53,11035,21,32,7211.32,12735.02,0.00
2024-12-08 16:59:29,52,11035,20,32,7276.70,12735.60,0.00
2024-12-08 16:59:29,52,11036,20,32,7372.52,12736.00,0.00
2024-12-08 16:59:29,53,11036,21,32,7233.41,12736.02,0.00
2024-12-08 16:59:29,53,11037,21,32,7207.84,12737.00,0.00
2024-12-08 16:59:29,54,11037,21,33,7074.36,12737.02,0.00
2024-12-08 16:59:29,53,11037,21,32,7183.80,12737.02,0.00
2024-12-08 16:59:29,53,11038,21,32,7203.59,12738.00,0.00
2024-12-08 16:59:29,54,11038,22,32,7070.19,12738.02,0.00
2024-12-08 16:59:29,54,11039,22,32,7043.92,12739.00,0.00
2024-12-08 16:59:29,55,11039,22,33,6915.85,12739.02,0.00
2024-12-08 16:59:29,54,11039,22,32,7022.69,12739.02,0.00
2024-12-08 16:59:29,54,11040,22,32,7039.75,12740.00,0.00
2024-12-08 16:59:29,55,11040,23,32,6911.76,12740.02,0.00
2024-12-08 16:59:29,55,11041,23,32,6885.88,12741.00,0.00
2024-12-08 16:59:29,56,11041,23,33,6762.92,12741.02,0.00
2024-12-08 16:59:29,55,11041,23,32,6865.03,12741.02,0.00
2024-12-08 16:59:29,54,11041,22,32,6839.13,12741.89,0.00
2024-12-08 16:59:29,54,11042,22,32,7061.01,12742.00,0.00
2024-12-08 16:59:29,55,11042,23,32,6932.62,12742.02,0.00
2024-12-08 16:59:29,54,11042,22,32,6931.23,12742.06,0.00
2024-12-08 16:59:29,54,11043,22,32,7039.73,12743.00,0.00
2024-12-08 16:59:29,55,11043,22,33,6911.74,12743.02,0.00
2024-12-08 16:59:29,54,11043,22,32,7018.49,12743.02,0.00
2024-12-08 16:59:29,53,11043,21,32,7141.33,12743.09,0.00
2024-12-08 16:59:30,53,11044,21,32,7159.54,12744.00,0.00
2024-12-08 16:59:30,54,11044,21,33,7026.96,12744.02,0.00
2024-12-08 16:59:30,54,11045,21,33,6993.54,12745.00,0.00
2024-12-08 16:59:30,55,11045,22,33,6866.39,12745.02,0.00
2024-12-08 16:59:30,54,11045,22,32,6960.50,12745.04,0.00
2024-12-08 16:59:30,53,11045,21,32,7055.81,12745.13,0.00
2024-12-08 16:59:30,53,11046,21,32,7166.78,12746.00,0.00
2024-12-08 16:59:30,54,11046,22,32,7034.07,12746.02,0.00
2024-12-08 16:59:30,53,11046,21,32,7021.27,12746.57,0.00
2024-12-08 16:59:30,53,11047,21,32,7122.03,12747.00,0.00
2024-12-08 16:59:30,54,11047,22,32,6990.14,12747.02,0.00
2024-12-08 16:59:30,53,11047,22,31,7090.77,12747.04,0.00
2024-12-08 16:59:30,52,11047,21,31,7224.68,12747.06,0.00
2024-12-08 16:59:30,52,11048,21,31,7217.01,12748.00,0.00
2024-12-08 16:59:30,53,11048,22,31,7080.84,12748.02,0.00
2024-12-08 16:59:30,53,11049,22,31,7018.68,12749.00,0.00
2024-12-08 16:59:30,54,11049,22,32,6888.70,12749.02,0.00
2024-12-08 16:59:30,53,11049,22,31,6989.82,12749.04,0.00
2024-12-08 16:59:30,52,11049,22,30,7069.36,12749.38,0.00
2024-12-08 16:59:30,51,11049,21,30,7187.93,12749.55,0.00
2024-12-08 16:59:30,51,11050,21,30,7280.75,12750.00,0.00
2024-12-08 16:59:30,52,11050,21,31,7140.73,12750.02,0.00
2024-12-08 16:59:30,51,11050,20,31,7277.40,12750.04,0.00
2024-12-08 16:59:30,51,11051,20,31,7268.42,12751.00,0.00
2024-12-08 16:59:30,52,11051,20,32,7128.65,12751.02,0.00
2024-12-08 16:59:30,51,11051,20,31,7220.92,12751.04,0.00
2024-12-08 16:59:30,51,11052,20,31,7242.85,12752.00,0.00
2024-12-08 16:59:30,52,11052,20,32,7103.56,12752.02,0.00
2024-12-08 16:59:30,52,11053,20,32,7089.44,12753.00,0.00
2024-12-08 16:59:30,53,11053,21,32,6955.68,12753.02,0.00
2024-12-08 16:59:30,52,11053,21,31,7042.85,12753.04,0.00
2024-12-08 16:59:30,51,11053,20,31,7163.52,12753.04,0.00
2024-12-08 16:59:30,51,11054,20,31,7284.07,12754.00,0.00
2024-12-08 16:59:30,52,11054,21,31,7143.99,12754.02,0.00
2024-12-08 16:59:30,51,11054,20,31,7153.17,12754.27,0.00
2024-12-08 16:59:30,51,11055,20,31,7306.23,12755.00,0.00
2024-12-08 16:59:30,52,11055,21,31,7165.73,12755.02,0.00
2024-12-08 16:59:30,51,11055,21,30,7258.72,12755.04,0.00
2024-12-08 16:59:30,50,11055,21,29,7401.72,12755.04,0.00
2024-12-08 16:59:30,49,11055,20,29,7497.37,12755.47,0.00
2024-12-08 16:59:30,49,11056,20,29,7580.97,12756.00,0.00
2024-12-08 16:59:30,50,11056,20,30,7429.35,12756.02,0.00
2024-12-08 16:59:30,49,11056,19,30,7576.50,12756.04,0.00
2024-12-08 16:59:30,49,11057,19,30,7580.95,12757.00,0.00
2024-12-08 16:59:30,50,11057,20,30,7429.33,12757.02,0.00
2024-12-08 16:59:30,49,11057,19,30,7458.40,12757.49,0.00
2024-12-08 16:59:30,49,11058,19,30,7651.27,12758.00,0.00
2024-12-08 16:59:30,50,11058,19,31,7498.25,12758.02,0.00
2024-12-08 16:59:30,49,11058,19,30,7635.66,12758.08,0.00
2024-12-08 16:59:30,49,11059,19,30,7674.17,12759.00,0.00
2024-12-08 16:59:30,50,11059,20,30,7520.69,12759.02,0.00
2024-12-08 16:59:30,49,11059,19,30,7671.57,12759.04,0.00
2024-12-08 16:59:30,49,11060,19,30,7673.07,12760.00,0.00
2024-12-08 16:59:30,50,11060,19,31,7519.61,12760.02,0.00
2024-12-08 16:59:30,50,11060,19,31,7492.93,12761.00,0.00
2024-12-08 16:59:30,51,11060,19,32,7346.01,12761.02,0.00
2024-12-08 16:59:30,50,11060,19,31,7485.28,12761.06,0.00
2024-12-08 16:59:30,50,11061,19,31,7512.48,12762.00,0.00
2024-12-08 16:59:30,51,11061,20,31,7365.18,12762.02,0.00
2024-12-08 16:59:30,51,11062,20,31,7352.75,12763.00,0.00
2024-12-08 16:59:30,52,11062,20,32,7211.35,12763.02,0.00
2024-12-08 16:59:30,51,11062,20,31,7297.70,12763.06,0.00
2024-12-08 16:59:30,50,11062,19,31,7319.47,12763.72,0.00
2024-12-08 16:59:30,50,11063,19,31,7539.22,12764.00,0.00
2024-12-08 16:59:30,51,11063,20,31,7391.40,12764.02,0.00
2024-12-08 16:59:30,51,11064,20,31,7382.46,12765.00,0.00
2024-12-08 16:59:30,52,11064,21,31,7240.49,12765.02,0.00
2024-12-08 16:59:30,51,11064,21,30,7329.91,12765.06,0.00
2024-12-08 16:59:30,51,11065,21,30,7360.13,12766.00,0.00
2024-12-08 16:59:30,52,11065,22,30,7218.59,12766.02,0.00
2024-12-08 16:59:30,52,11066,22,30,7209.72,12767.00,0.00
2024-12-08 16:59:30,53,11066,23,30,7073.69,12767.02,0.00
2024-12-08 16:59:30,52,11066,23,29,7160.63,12767.06,0.00
2024-12-08 16:59:30,52,11067,23,29,7188.19,12768.00,0.00
2024-12-08 16:59:30,53,11067,23,30,7052.56,12768.02,0.00
2024-12-08 16:59:30,53,11068,23,30,7042.48,12769.00,0.00
2024-12-08 16:59:30,54,11068,23,31,6912.07,12769.02,0.00
2024-12-08 16:59:30,53,11068,23,30,6996.71,12769.06,0.00
2024-12-08 16:59:30,52,11068,22,30,7060.72,12769.60,0.00
2024-12-08 16:59:30,52,11069,22,30,7156.77,12770.00,0.00
2024-12-08 16:59:30,53,11069,22,31,7021.74,12770.02,0.00
2024-12-08 16:59:30,52,11069,21,31,7068.41,12770.15,0.00
2024-12-08 16:59:30,51,11069,20,31,7159.99,12770.51,0.00
2024-12-08 16:59:30,51,11070,20,31,7348.13,12771.00,0.00
2024-12-08 16:59:30,52,11070,21,31,7206.82,12771.02,0.00
2024-12-08 16:59:30,51,11070,21,30,7300.56,12771.06,0.00
2024-12-08 16:59:31,51,11071,21,30,7331.18,12772.00,0.00
2024-12-08 16:59:31,52,11071,21,31,7190.19,12772.02,0.00
2024-12-08 16:59:31,51,11071,20,31,7328.67,12772.02,0.00
2024-12-08 16:59:31,51,11072,20,31,7323.77,12773.00,0.00
2024-12-08 16:59:31,52,11072,20,32,7182.93,12773.02,0.00
2024-12-08 16:59:31,51,11072,20,31,7273.69,12773.04,0.00
2024-12-08 16:59:31,51,11073,20,31,7301.80,12774.00,0.00
2024-12-08 16:59:31,52,11073,21,31,7161.38,12774.02,0.00
2024-12-08 16:59:31,51,11073,20,31,7157.30,12774.61,0.00
2024-12-08 16:59:31,51,11074,20,31,7357.95,12775.00,0.00
2024-12-08 16:59:31,52,11074,21,31,7216.45,12775.02,0.00
2024-12-08 16:59:31,51,11074,21,30,7302.84,12775.04,0.00
2024-12-08 16:59:31,51,11075,21,30,7330.97,12776.00,0.00
2024-12-08 16:59:31,52,11075,22,30,7189.99,12776.02,0.00
2024-12-08 16:59:31,52,11076,22,30,7184.68,12777.00,0.00
2024-12-08 16:59:31,53,11076,22,31,7049.12,12777.02,0.00
2024-12-08 16:59:31,52,11076,22,30,7133.08,12777.04,0.00
2024-12-08 16:59:31,52,11077,22,30,7158.21,12778.00,0.00
2024-12-08 16:59:31,53,11077,23,30,7023.15,12778.02,0.00
2024-12-08 16:59:31,53,11078,23,30,7016.54,12779.00,0.00
2024-12-08 16:59:31,54,11078,24,30,6886.61,12779.02,0.00
2024-12-08 16:59:31,53,11078,24,29,6968.32,12779.04,0.00
2024-12-08 16:59:31,52,11078,23,29,7023.99,12779.63,0.00
2024-12-08 16:59:31,52,11079,23,29,7125.00,12780.00,0.00
2024-12-08 16:59:31,53,11079,24,29,6990.57,12780.02,0.00
2024-12-08 16:59:31,52,11079,23,29,7024.45,12780.27,0.00
2024-12-08 16:59:31,52,11080,23,29,7177.29,12781.00,0.00
2024-12-08 16:59:31,53,11080,24,29,7041.87,12781.02,0.00
2024-12-08 16:59:31,52,11080,24,28,7123.23,12781.06,0.00
2024-12-08 16:59:31,52,11081,24,28,7150.81,12782.00,0.00
2024-12-08 16:59:31,53,11081,24,29,7015.89,12782.02,0.00
2024-12-08 16:59:31,53,11082,24,29,7010.60,12783.00,0.00
2024-12-08 16:59:31,54,11082,25,29,6880.78,12783.02,0.00
2024-12-08 16:59:31,53,11082,25,28,6957.55,12783.06,0.00
2024-12-08 16:59:31,52,11082,24,28,6908.53,12783.96,0.00
2024-12-08 16:59:31,52,11083,24,28,7149.48,12784.00,0.00
2024-12-08 16:59:31,53,11083,24,29,7014.58,12784.02,0.00
2024-12-08 16:59:31,53,11084,24,29,7008.62,12785.00,0.00
2024-12-08 16:59:31,54,11084,25,29,6878.83,12785.02,0.00
2024-12-08 16:59:31,53,11084,25,28,6957.97,12785.06,0.00
2024-12-08 16:59:31,52,11084,24,28,7002.61,12785.27,0.00
2024-12-08 16:59:31,52,11085,24,28,7155.51,12786.00,0.00
2024-12-08 16:59:31,53,11085,25,28,7020.50,12786.02,0.00
2024-12-08 16:59:31,53,11086,25,28,7015.46,12787.00,0.00
2024-12-08 16:59:31,54,11086,26,28,6885.54,12787.02,0.00
2024-12-08 16:59:31,53,11086,26,27,6964.80,12787.06,0.00
2024-12-08 16:59:31,52,11086,25,27,7098.74,12787.06,0.00
2024-12-08 16:59:31,52,11087,25,27,7125.62,12788.00,0.00
2024-12-08 16:59:31,53,11087,26,27,6991.17,12788.02,0.00
2024-12-08 16:59:31,52,11087,25,27,6941.03,12788.77,0.00
2024-12-08 16:59:31,52,11088,25,27,7157.63,12789.00,0.00
2024-12-08 16:59:31,53,11088,26,27,7022.58,12789.02,0.00
2024-12-08 16:59:31,52,11088,26,26,7103.53,12789.06,0.00
2024-12-08 16:59:31,52,11089,26,26,7128.99,12790.00,0.00
2024-12-08 16:59:31,53,11089,26,27,6994.48,12790.02,0.00
2024-12-08 16:59:31,53,11090,26,27,6986.60,12791.00,0.00
2024-12-08 16:59:31,54,11090,26,28,6857.22,12791.02,0.00
2024-12-08 16:59:31,53,11090,26,27,6935.93,12791.06,0.00
2024-12-08 16:59:31,52,11090,25,27,6930.66,12791.79,0.00
2024-12-08 16:59:31,52,11091,25,27,7149.77,12792.00,0.00
2024-12-08 16:59:31,53,11091,25,28,7014.87,12792.02,0.00
2024-12-08 16:59:31,52,11091,24,28,6993.10,12792.38,0.00
2024-12-08 16:59:31,51,11091,23,28,7112.35,12792.53,0.00
2024-12-08 16:59:31,51,11092,23,28,7303.32,12793.00,0.00
2024-12-08 16:59:31,52,11092,23,29,7162.87,12793.02,0.00
2024-12-08 16:59:31,51,11092,23,28,7250.65,12793.06,0.00
2024-12-08 16:59:31,50,11092,22,28,7369.24,12793.14,0.00
2024-12-08 16:59:31,49,11092,21,28,7471.30,12793.51,0.00
2024-12-08 16:59:31,49,11093,21,28,7670.10,12794.00,0.00
2024-12-08 16:59:31,50,11093,21,29,7516.69,12794.02,0.00
2024-12-08 16:59:31,50,11094,21,29,7508.64,12795.00,0.00
2024-12-08 16:59:31,51,11094,22,29,7361.41,12795.02,0.00
2024-12-08 16:59:31,50,11094,22,28,7457.46,12795.06,0.00
2024-12-08 16:59:31,50,11095,22,28,7490.94,12796.00,0.00
2024-12-08 16:59:31,51,11095,23,28,7344.06,12796.02,0.00
2024-12-08 16:59:31,50,11095,22,28,7318.25,12796.72,0.00
2024-12-08 16:59:31,50,11096,22,28,7538.59,12797.00,0.00
2024-12-08 16:59:31,51,11096,23,28,7390.77,12797.02,0.00
2024-12-08 16:59:31,50,11096,23,27,7482.29,12797.08,0.00
2024-12-08 16:59:31,50,11097,23,27,7514.74,12798.00,0.00
2024-12-08 16:59:31,51,11097,23,28,7367.39,12798.02,0.00
2024-12-08 16:59:31,50,11097,23,27,7455.11,12798.08,0.00
2024-12-08 16:59:32,50,11098,23,27,7491.52,12799.00,0.00
2024-12-08 16:59:32,51,11098,23,28,7344.62,12799.02,0.00
2024-12-08 16:59:32,50,11098,22,28,7488.96,12799.02,0.00
2024-12-08 16:59:32,50,11099,22,28,7488.78,12800.00,0.00
2024-12-08 16:59:32,51,11099,23,28,7341.94,12800.02,0.00
2024-12-08 16:59:32,50,11099,23,27,7432.47,12800.06,0.00
2024-12-08 16:59:32,50,11100,23,27,7464.16,12801.00,0.00
2024-12-08 16:59:32,51,11100,24,27,7317.80,12801.02,0.00
2024-12-08 16:59:32,51,11101,24,27,7307.63,12802.00,0.00
2024-12-08 16:59:32,52,11101,25,27,7167.10,12802.02,0.00
2024-12-08 16:59:32,51,11101,25,26,7252.42,12802.06,0.00
2024-12-08 16:59:32,51,11102,25,26,7272.95,12803.00,0.00
2024-12-08 16:59:32,52,11102,25,27,7133.08,12803.02,0.00
2024-12-08 16:59:32,52,11103,25,27,7117.79,12804.00,0.00
2024-12-08 16:59:32,53,11103,26,27,6983.49,12804.02,0.00
2024-12-08 16:59:32,52,11103,26,26,7063.63,12804.06,0.00
2024-12-08 16:59:32,51,11103,25,26,7065.80,12804.65,0.00
2024-12-08 16:59:32,51,11104,25,26,7267.52,12805.00,0.00
2024-12-08 16:59:32,52,11104,25,27,7127.76,12805.02,0.00
2024-12-08 16:59:32,51,11104,24,27,7076.91,12805.51,0.00
2024-12-08 16:59:32,51,11105,24,27,7255.58,12806.00,0.00
2024-12-08 16:59:32,52,11105,25,27,7116.05,12806.02,0.00
2024-12-08 16:59:32,51,11105,25,26,7202.86,12806.06,0.00
2024-12-08 16:59:32,50,11105,24,26,7188.23,12806.50,0.00
2024-12-08 16:59:32,50,11106,24,26,7369.23,12807.00,0.00
2024-12-08 16:59:32,51,11106,25,26,7224.73,12807.02,0.00
2024-12-08 16:59:32,50,11106,24,26,7358.99,12807.08,0.00
2024-12-08 16:59:32,49,11106,23,26,7373.35,12807.33,0.00
2024-12-08 16:59:32,48,11106,22,26,7492.03,12807.58,0.00
2024-12-08 16:59:32,48,11107,22,26,7694.23,12808.00,0.00
2024-12-08 16:59:32,49,11107,22,27,7537.20,12808.02,0.00
2024-12-08 16:59:32,49,11108,22,27,7499.05,12809.00,0.00
2024-12-08 16:59:32,50,11108,22,28,7349.06,12809.02,0.00
2024-12-08 16:59:32,49,11108,22,27,7488.60,12809.08,0.00
2024-12-08 16:59:32,49,11109,22,27,7508.61,12810.00,0.00
2024-12-08 16:59:32,50,11109,22,28,7358.44,12810.02,0.00
2024-12-08 16:59:32,49,11109,21,28,7501.39,12810.06,0.00
2024-12-08 16:59:32,48,11109,20,28,7422.78,12810.96,0.00
2024-12-08 16:59:32,48,11110,20,28,7684.36,12811.00,0.00
2024-12-08 16:59:32,49,11110,21,28,7527.53,12811.02,0.00
2024-12-08 16:59:32,48,11110,21,27,7625.65,12811.06,0.00
2024-12-08 16:59:32,47,11110,20,27,7714.02,12811.23,0.00
2024-12-08 16:59:32,47,11111,20,27,7867.41,12812.00,0.00
2024-12-08 16:59:32,48,11111,21,27,7703.50,12812.02,0.00
2024-12-08 16:59:32,48,11112,21,27,7682.43,12813.00,0.00
2024-12-08 16:59:32,49,11112,22,27,7525.64,12813.02,0.00
2024-12-08 16:59:32,48,11112,22,26,7626.38,12813.06,0.00
2024-12-08 16:59:32,48,11113,22,26,7652.23,12814.00,0.00
2024-12-08 16:59:32,49,11113,22,27,7496.06,12814.02,0.00
2024-12-08 16:59:32,49,11114,22,27,7480.74,12815.00,0.00
2024-12-08 16:59:32,50,11114,23,27,7331.13,12815.02,0.00
2024-12-08 16:59:32,49,11114,23,26,7428.44,12815.06,0.00
2024-12-08 16:59:32,48,11114,22,26,7583.20,12815.06,0.00
2024-12-08 16:59:32,48,11115,22,26,7612.72,12816.00,0.00
2024-12-08 16:59:32,49,11115,22,27,7457.36,12816.02,0.00
2024-12-08 16:59:32,49,11116,22,27,7449.04,12817.00,0.00
2024-12-08 16:59:32,50,11116,23,27,7300.05,12817.02,0.00
2024-12-08 16:59:32,49,11116,23,26,7391.49,12817.06,0.00
2024-12-08 16:59:32,48,11116,22,26,7459.44,12817.25,0.00
2024-12-08 16:59:32,48,11117,22,26,7622.24,12818.00,0.00
2024-12-08 16:59:32,49,11117,22,27,7466.68,12818.02,0.00
2024-12-08 16:59:32,48,11117,21,27,7616.90,12818.06,0.00
2024-12-08 16:59:32,47,11117,20,27,7676.33,12818.43,0.00
2024-12-08 16:59:32,46,11117,19,27,7748.68,12818.78,0.00
2024-12-08 16:59:32,46,11118,19,27,7999.67,12819.00,0.00
2024-12-08 16:59:32,47,11118,20,27,7829.46,12819.02,0.00
2024-12-08 16:59:32,46,11118,19,27,7996.88,12819.02,0.00
2024-12-08 16:59:32,45,11118,19,26,8114.77,12819.04,0.00
2024-12-08 16:59:32,45,11119,19,26,8157.84,12820.00,0.00
2024-12-08 16:59:32,46,11119,19,27,7980.49,12820.02,0.00
2024-12-08 16:59:32,46,11120,19,27,7971.09,12821.00,0.00
2024-12-08 16:59:32,47,11120,20,27,7801.49,12821.02,0.00
2024-12-08 16:59:32,46,11120,20,26,7912.56,12821.04,0.00
2024-12-08 16:59:32,46,11121,20,26,7947.89,12822.00,0.00
2024-12-08 16:59:32,47,11121,20,27,7778.79,12822.02,0.00
2024-12-08 16:59:32,46,11121,19,27,7797.62,12822.61,0.00
2024-12-08 16:59:32,46,11122,19,27,8026.52,12823.00,0.00
2024-12-08 16:59:32,47,11122,20,27,7855.75,12823.02,0.00
2024-12-08 16:59:32,46,11122,20,26,7970.77,12823.04,0.00
2024-12-08 16:59:32,45,11122,19,26,8009.79,12823.27,0.00
2024-12-08 16:59:32,45,11123,19,26,8198.59,12824.00,0.00
2024-12-08 16:59:32,46,11123,19,27,8020.36,12824.02,0.00
2024-12-08 16:59:32,45,11123,18,27,8085.26,12824.44,0.00
2024-12-08 16:59:32,45,11124,18,27,8197.82,12825.00,0.00
2024-12-08 16:59:32,46,11124,19,27,8019.60,12825.02,0.00
2024-12-08 16:59:32,45,11124,19,26,8140.82,12825.04,0.00
2024-12-08 16:59:32,45,11125,19,26,8189.91,12826.00,0.00
2024-12-08 16:59:32,46,11125,19,27,8011.86,12826.02,0.00
2024-12-08 16:59:33,45,11125,18,27,8164.03,12826.04,0.00
2024-12-08 16:59:33,45,11126,18,27,8270.13,12827.00,0.00
2024-12-08 16:59:33,46,11126,19,27,8090.34,12827.02,0.00
2024-12-08 16:59:33,46,11127,19,27,8077.03,12828.00,0.00
2024-12-08 16:59:33,47,11127,20,27,7905.18,12828.02,0.00
2024-12-08 16:59:33,46,11127,20,26,8071.45,12828.04,0.00
2024-12-08 16:59:33,46,11128,20,26,8116.71,12829.00,0.00
2024-12-08 16:59:33,47,11128,21,26,7944.01,12829.02,0.00
2024-12-08 16:59:33,46,11128,20,26,7969.22,12829.65,0.00
2024-12-08 16:59:33,46,11129,20,26,8203.80,12830.00,0.00
2024-12-08 16:59:33,47,11129,20,27,8029.25,12830.02,0.00
2024-12-08 16:59:33,46,11129,20,26,8145.23,12830.04,0.00
2024-12-08 16:59:33,46,11130,20,26,8190.49,12831.00,0.00
2024-12-08 16:59:33,47,11130,20,27,8016.23,12831.02,0.00
2024-12-08 16:59:33,47,11131,20,27,8010.83,12832.00,0.00
2024-12-08 16:59:33,48,11131,20,28,7843.94,12832.02,0.00
2024-12-08 16:59:33,47,11131,20,27,7956.22,12832.04,0.00
2024-12-08 16:59:33,46,11131,19,27,7982.10,12832.43,0.00
2024-12-08 16:59:33,46,11132,19,27,8188.98,12833.00,0.00
2024-12-08 16:59:33,47,11132,19,28,8014.75,12833.02,0.00
2024-12-08 16:59:33,46,11132,18,28,8186.19,12833.02,0.00
2024-12-08 16:59:33,46,11133,18,28,8184.49,12834.00,0.00
2024-12-08 16:59:33,47,11133,18,29,8010.35,12834.02,0.00
2024-12-08 16:59:33,46,11133,18,28,8131.48,12834.02,0.00
2024-12-08 16:59:33,45,11133,17,28,8277.51,12834.07,0.00
2024-12-08 16:59:33,45,11134,17,28,8443.57,12835.00,0.00
2024-12-08 16:59:33,46,11134,18,28,8260.01,12835.02,0.00
2024-12-08 16:59:33,45,11134,17,28,8332.38,12835.13,0.00
2024-12-08 16:59:33,45,11135,17,28,8506.98,12836.00,0.00
2024-12-08 16:59:33,46,11135,18,28,8322.04,12836.02,0.00
2024-12-08 16:59:33,45,11135,18,27,8455.63,12836.02,0.00
2024-12-08 16:59:33,44,11135,17,27,8588.71,12836.48,0.00
2024-12-08 16:59:33,44,11136,17,27,8697.08,12837.00,0.00
2024-12-08 16:59:33,45,11136,18,27,8503.81,12837.02,0.00
2024-12-08 16:59:33,45,11137,18,27,8493.06,12838.00,0.00
2024-12-08 16:59:33,46,11137,18,28,8308.43,12838.02,0.00
2024-12-08 16:59:33,45,11137,18,27,8436.00,12838.02,0.00
2024-12-08 16:59:33,45,11138,18,27,8482.05,12839.00,0.00
2024-12-08 16:59:33,46,11138,19,27,8297.65,12839.02,0.00
2024-12-08 16:59:33,46,11139,19,27,8291.17,12840.00,0.00
2024-12-08 16:59:33,47,11139,19,28,8114.76,12840.02,0.00
2024-12-08 16:59:33,46,11139,18,28,8198.32,12840.07,0.00
2024-12-08 16:59:33,45,11139,18,27,8358.01,12840.22,0.00
2024-12-08 16:59:33,45,11140,18,27,8544.06,12841.00,0.00
2024-12-08 16:59:33,46,11140,19,27,8358.32,12841.02,0.00
2024-12-08 16:59:33,45,11140,19,26,8538.35,12841.02,0.00
2024-12-08 16:59:33,45,11141,19,26,8582.02,12842.00,0.00
2024-12-08 16:59:33,46,11141,19,27,8395.46,12842.02,0.00
2024-12-08 16:59:33,46,11142,19,27,8381.28,12843.00,0.00
2024-12-08 16:59:33,47,11142,19,28,8202.96,12843.02,0.00
2024-12-08 16:59:33,46,11142,18,28,8154.59,12843.93,0.00
2024-12-08 16:59:33,46,11143,18,28,8425.47,12844.00,0.00
2024-12-08 16:59:33,47,11143,18,29,8246.21,12844.02,0.00
2024-12-08 16:59:33,46,11143,18,28,8422.68,12844.02,0.00
2024-12-08 16:59:33,46,11144,18,28,8460.91,12845.00,0.00
2024-12-08 16:59:33,47,11144,18,29,8280.90,12845.02,0.00
2024-12-08 16:59:33,47,11145,18,29,8275.44,12846.00,0.00
2024-12-08 16:59:33,48,11145,18,30,8103.04,12846.02,0.00
2024-12-08 16:59:33,47,11145,17,30,8078.18,12846.81,0.00
2024-12-08 16:59:33,47,11146,17,30,8327.07,12847.00,0.00
2024-12-08 16:59:33,48,11146,18,30,8153.59,12847.02,0.00
2024-12-08 16:59:33,47,11146,18,29,8316.14,12847.02,0.00
2024-12-08 16:59:33,46,11146,17,29,8369.09,12847.37,0.00
2024-12-08 16:59:33,46,11147,17,29,8567.87,12848.00,0.00
2024-12-08 16:59:33,47,11147,18,29,8385.58,12848.02,0.00
2024-12-08 16:59:33,47,11148,18,29,8374.08,12849.00,0.00
2024-12-08 16:59:33,48,11148,18,30,8199.62,12849.02,0.00
2024-12-08 16:59:33,48,11149,18,30,8177.80,12850.00,0.00
2024-12-08 16:59:33,49,11149,19,30,8010.91,12850.02,0.00
2024-12-08 16:59:33,48,11149,19,29,8172.45,12850.02,0.00
2024-12-08 16:59:33,48,11150,19,29,8203.14,12851.00,0.00
2024-12-08 16:59:33,49,11150,20,29,8035.73,12851.02,0.00
2024-12-08 16:59:33,49,11151,20,29,8020.02,12852.00,0.00
2024-12-08 16:59:33,50,11151,20,30,7859.62,12852.02,0.00
2024-12-08 16:59:33,49,11151,20,29,7964.94,12852.02,0.00
2024-12-08 16:59:33,48,11151,19,29,8004.44,12852.33,0.00
2024-12-08 16:59:33,48,11152,19,29,8187.00,12853.00,0.00
2024-12-08 16:59:33,49,11152,19,30,8019.91,12853.02,0.00
2024-12-08 16:59:33,48,11152,18,30,8117.39,12853.06,0.00
2024-12-08 16:59:33,47,11152,17,30,8280.50,12853.06,0.00
2024-12-08 16:59:33,47,11153,17,30,8434.29,12854.00,0.00
2024-12-08 16:59:33,48,11153,17,31,8258.57,12854.02,0.00
2024-12-08 16:59:33,47,11153,17,30,8379.59,12854.02,0.00
2024-12-08 16:59:34,47,11154,17,30,8418.53,12855.00,0.00
2024-12-08 16:59:34,48,11154,17,31,8243.15,12855.02,0.00
2024-12-08 16:59:34,48,11155,17,31,8227.70,12856.00,0.00
2024-12-08 16:59:34,49,11155,18,31,8059.79,12856.02,0.00
2024-12-08 16:59:34,48,11155,18,30,8176.81,12856.02,0.00
2024-12-08 16:59:34,48,11156,18,30,8212.27,12857.00,0.00
2024-12-08 16:59:34,49,11156,18,31,8044.67,12857.02,0.00
2024-12-08 16:59:34,49,11157,18,31,8038.42,12858.00,0.00
2024-12-08 16:59:34,50,11157,18,32,7877.65,12858.02,0.00
2024-12-08 16:59:34,49,11157,17,32,7882.71,12858.27,0.00
2024-12-08 16:59:34,49,11158,17,32,8051.17,12859.00,0.00
2024-12-08 16:59:34,50,11158,18,32,7890.15,12859.02,0.00
2024-12-08 16:59:34,49,11158,18,31,8048.55,12859.02,0.00
2024-12-08 16:59:34,49,11159,18,31,8080.67,12860.00,0.00
2024-12-08 16:59:34,50,11159,18,32,7919.06,12860.02,0.00
2024-12-08 16:59:34,49,11159,17,32,8078.05,12860.02,0.00
2024-12-08 16:59:34,48,11159,16,32,8176.68,12860.04,0.00
2024-12-08 16:59:34,48,11160,16,32,8319.19,12861.00,0.00
2024-12-08 16:59:34,49,11160,16,33,8149.42,12861.02,0.00
2024-12-08 16:59:34,49,11161,16,33,8118.18,12862.00,0.00
2024-12-08 16:59:34,50,11161,16,34,7955.81,12862.02,0.00
2024-12-08 16:59:34,49,11161,16,33,8112.93,12862.02,0.00
2024-12-08 16:59:34,48,11161,15,33,8193.30,12862.58,0.00
2024-12-08 16:59:34,48,11162,15,33,8300.81,12863.00,0.00
2024-12-08 16:59:34,49,11162,15,34,8131.41,12863.02,0.00
2024-12-08 16:59:34,48,11162,14,34,8111.30,12863.77,0.00
2024-12-08 16:59:34,48,11163,14,34,8350.02,12864.00,0.00
2024-12-08 16:59:34,49,11163,15,34,8179.61,12864.02,0.00
2024-12-08 16:59:34,49,11164,15,34,8147.67,12865.00,0.00
2024-12-08 16:59:34,50,11164,15,35,7984.72,12865.02,0.00
2024-12-08 16:59:34,49,11164,15,34,8145.04,12865.02,0.00
2024-12-08 16:59:34,49,11165,15,34,8168.99,12866.00,0.00
2024-12-08 16:59:34,50,11165,15,35,8005.61,12866.02,0.00
2024-12-08 16:59:34,50,11166,15,35,7984.28,12867.00,0.00
2024-12-08 16:59:34,51,11166,15,36,7827.73,12867.02,0.00
2024-12-08 16:59:34,50,11166,14,36,7894.13,12867.08,0.00
2024-12-08 16:59:34,50,11167,14,36,8011.00,12868.00,0.00
2024-12-08 16:59:34,51,11167,14,37,7853.93,12868.02,0.00
2024-12-08 16:59:34,50,11167,14,36,8008.43,12868.02,0.00
2024-12-08 16:59:34,49,11167,13,36,7947.19,12868.63,0.00
2024-12-08 16:59:34,49,11168,13,36,8162.85,12869.00,0.00
2024-12-08 16:59:34,50,11168,13,37,7999.59,12869.02,0.00
2024-12-08 16:59:34,49,11168,12,37,8029.01,12869.27,0.00
2024-12-08 16:59:34,48,11168,11,37,8159.99,12869.44,0.00
2024-12-08 16:59:34,48,11169,11,37,8352.76,12870.00,0.00
2024-12-08 16:59:34,49,11169,12,37,8182.29,12870.02,0.00
2024-12-08 16:59:34,48,11169,12,36,8299.13,12870.02,0.00
2024-12-08 16:59:34,47,11169,11,36,8388.20,12870.28,0.00
2024-12-08 16:59:34,47,11170,11,36,8566.53,12871.00,0.00
2024-12-08 16:59:34,48,11170,12,36,8388.06,12871.02,0.00
2024-12-08 16:59:34,47,11170,11,36,8432.45,12871.25,0.00
2024-12-08 16:59:34,47,11171,11,36,8608.97,12872.00,0.00
2024-12-08 16:59:34,48,11171,11,37,8429.61,12872.02,0.00
2024-12-08 16:59:34,47,11171,11,36,8556.93,12872.02,0.00
2024-12-08 16:59:34,47,11172,11,36,8594.94,12873.00,0.00
2024-12-08 16:59:34,48,11172,11,37,8415.88,12873.02,0.00
2024-12-08 16:59:34,47,11172,10,37,8367.90,12873.55,0.00
2024-12-08 16:59:34,47,11173,10,37,8584.65,12874.00,0.00
2024-12-08 16:59:34,48,11173,11,37,8405.80,12874.02,0.00
2024-12-08 16:59:34,47,11173,11,36,8527.13,12874.02,0.00
2024-12-08 16:59:34,47,11174,11,36,8566.14,12875.00,0.00
2024-12-08 16:59:34,48,11174,11,37,8387.68,12875.02,0.00
2024-12-08 16:59:34,48,11175,11,37,8373.48,12876.00,0.00
2024-12-08 16:59:34,49,11175,12,37,8202.59,12876.02,0.00
2024-12-08 16:59:34,48,11175,12,36,8317.14,12876.02,0.00
2024-12-08 16:59:34,47,11175,11,36,8370.02,12876.77,0.00
2024-12-08 16:59:34,47,11176,11,36,8614.05,12877.00,0.00
2024-12-08 16:59:34,48,11176,12,36,8434.59,12877.02,0.00
2024-12-08 16:59:34,47,11176,11,36,8468.96,12877.30,0.00
2024-12-08 16:59:34,47,11177,11,36,8653.08,12878.00,0.00
2024-12-08 16:59:34,48,11177,12,36,8472.80,12878.02,0.00
2024-12-08 16:59:34,47,11177,12,35,8595.54,12878.02,0.00
2024-12-08 16:59:34,47,11178,12,35,8634.57,12879.00,0.00
2024-12-08 16:59:34,48,11178,13,35,8454.68,12879.02,0.00
2024-12-08 16:59:34,47,11178,12,35,8557.86,12879.08,0.00
2024-12-08 16:59:34,47,11179,12,35,8714.71,12880.00,0.00
2024-12-08 16:59:34,48,11179,13,35,8533.15,12880.02,0.00
2024-12-08 16:59:34,47,11179,13,34,8657.16,12880.02,0.00
2024-12-08 16:59:34,47,11180,13,34,8696.20,12881.00,0.00
2024-12-08 16:59:34,48,11180,13,35,8515.03,12881.02,0.00
2024-12-08 16:59:35,48,11181,13,35,8496.91,12882.00,0.00
2024-12-08 16:59:35,49,11181,13,36,8323.50,12882.02,0.00
2024-12-08 16:59:35,48,11181,13,35,8437.87,12882.04,0.00
2024-12-08 16:59:35,47,11181,12,35,8464.16,12882.49,0.00
2024-12-08 16:59:35,47,11182,12,35,8672.88,12883.00,0.00
2024-12-08 16:59:35,48,11182,12,36,8492.20,12883.02,0.00
2024-12-08 16:59:35,48,11183,12,36,8474.07,12884.00,0.00
2024-12-08 16:59:35,49,11183,13,36,8301.13,12884.02,0.00
2024-12-08 16:59:35,48,11183,13,35,8415.02,12884.04,0.00
2024-12-08 16:59:35,48,11184,13,35,8453.25,12885.00,0.00
2024-12-08 16:59:35,49,11184,14,35,8280.74,12885.02,0.00
2024-12-08 16:59:35,49,11185,14,35,8265.66,12886.00,0.00
2024-12-08 16:59:35,50,11185,15,35,8100.34,12886.02,0.00
2024-12-08 16:59:35,49,11185,15,34,8205.19,12886.06,0.00
2024-12-08 16:59:35,49,11186,15,34,8242.63,12887.00,0.00
2024-12-08 16:59:35,50,11186,16,34,8077.78,12887.02,0.00
2024-12-08 16:59:35,50,11187,16,34,8066.82,12888.00,0.00
2024-12-08 16:59:35,51,11187,17,34,7908.64,12888.02,0.00
2024-12-08 16:59:35,51,11188,17,34,7883.99,12889.00,0.00
2024-12-08 16:59:35,52,11188,17,35,7732.37,12889.02,0.00
2024-12-08 16:59:35,51,11188,17,34,7873.88,12889.06,0.00
2024-12-08 16:59:35,51,11189,17,34,7904.82,12890.00,0.00
2024-12-08 16:59:35,52,11189,17,35,7752.80,12890.02,0.00
2024-12-08 16:59:35,51,11189,16,35,7901.02,12890.04,0.00
2024-12-08 16:59:35,50,11189,15,35,7930.48,12890.62,0.00
2024-12-08 16:59:35,50,11190,15,35,8050.48,12891.00,0.00
2024-12-08 16:59:35,51,11190,16,35,7892.63,12891.02,0.00
2024-12-08 16:59:35,50,11190,16,34,7993.77,12891.04,0.00
2024-12-08 16:59:35,50,11191,16,34,8025.33,12892.00,0.00
2024-12-08 16:59:35,51,11191,16,35,7867.97,12892.02,0.00
2024-12-08 16:59:35,52,11190,17,35,7610.28,12892.50,0.00
2024-12-08 16:59:35,52,11191,17,35,7772.19,12893.00,0.00
2024-12-08 16:59:35,53,11191,18,35,7625.55,12893.02,0.00
2024-12-08 16:59:35,52,11191,18,34,7720.13,12893.04,0.00
2024-12-08 16:59:35,51,11191,17,34,7767.84,12893.69,0.00
2024-12-08 16:59:35,51,11192,17,34,8233.25,12894.00,0.00
2024-12-08 16:59:35,52,11192,17,35,8074.92,12894.02,0.00
2024-12-08 16:59:35,52,11193,17,35,8053.49,12895.00,0.00
2024-12-08 16:59:35,53,11193,17,36,7901.54,12895.02,0.00
2024-12-08 16:59:35,52,11193,17,35,8003.90,12895.04,0.00
2024-12-08 16:59:35,51,11193,16,35,8052.00,12895.35,0.00
2024-12-08 16:59:35,51,11194,16,35,8221.89,12896.00,0.00
2024-12-08 16:59:35,52,11194,16,36,8063.77,12896.02,0.00
2024-12-08 16:59:35,51,11194,15,36,8108.56,12896.20,0.00
2024-12-08 16:59:35,51,11195,15,36,8258.32,12897.00,0.00
2024-12-08 16:59:35,52,11195,16,36,8099.51,12897.02,0.00
2024-12-08 16:59:35,51,11195,16,35,8210.28,12897.04,0.00
2024-12-08 16:59:35,51,11196,16,35,8228.77,12898.00,0.00
2024-12-08 16:59:35,52,11196,16,36,8070.52,12898.02,0.00
2024-12-08 16:59:35,52,11197,16,36,8038.70,12899.00,0.00
2024-12-08 16:59:35,53,11197,16,37,7887.02,12899.02,0.00
2024-12-08 16:59:35,52,11197,16,36,7986.61,12899.04,0.00
2024-12-08 16:59:35,51,11197,16,35,8142.75,12899.04,0.00
2024-12-08 16:59:35,51,11198,16,35,8171.20,12900.00,0.00
2024-12-08 16:59:35,52,11198,17,35,8014.06,12900.02,0.00
2024-12-08 16:59:35,52,11199,17,35,7999.91,12901.00,0.00
2024-12-08 16:59:35,53,11199,17,36,7848.97,12901.02,0.00
2024-12-08 16:59:35,53,11200,17,36,7820.37,12902.00,0.00
2024-12-08 16:59:35,54,11200,18,36,7675.55,12902.02,0.00
2024-12-08 16:59:35,53,11200,18,35,7815.50,12902.04,0.00
2024-12-08 16:59:35,52,11200,17,35,7902.95,12902.52,0.00
2024-12-08 16:59:35,52,11201,17,35,7990.13,12903.00,0.00
2024-12-08 16:59:35,53,11201,18,35,7839.37,12903.02,0.00
2024-12-08 16:59:35,52,11201,17,35,7942.99,12903.02,0.00
2024-12-08 16:59:35,52,11202,17,35,8015.57,12904.00,0.00
2024-12-08 16:59:35,53,11202,18,35,7864.33,12904.02,0.00
2024-12-08 16:59:35,52,11202,18,34,7965.94,12904.02,0.00
2024-12-08 16:59:35,52,11203,18,34,7988.89,12905.00,0.00
2024-12-08 16:59:35,53,11203,19,34,7838.16,12905.02,0.00
2024-12-08 16:59:35,52,11203,18,34,7877.36,12905.50,0.00
2024-12-08 16:59:35,51,11203,17,34,7938.49,12905.92,0.00
2024-12-08 16:59:35,51,11204,17,34,8181.47,12906.00,0.00
2024-12-08 16:59:35,52,11204,17,35,8024.14,12906.02,0.00
2024-12-08 16:59:35,51,11204,17,34,8133.39,12906.02,0.00
2024-12-08 16:59:35,51,11205,17,34,8159.33,12907.00,0.00
2024-12-08 16:59:35,52,11205,17,35,8002.42,12907.02,0.00
2024-12-08 16:59:35,52,11206,17,35,7977.70,12908.00,0.00
2024-12-08 16:59:35,53,11206,17,36,7827.18,12908.02,0.00
2024-12-08 16:59:35,52,11206,17,35,7933.02,12908.02,0.00
2024-12-08 16:59:35,52,11207,17,35,7955.98,12909.00,0.00
2024-12-08 16:59:35,53,11207,17,36,7805.87,12909.02,0.00
2024-12-08 16:59:35,53,11208,17,36,7782.38,12910.00,0.00
2024-12-08 16:59:35,54,11208,17,37,7638.27,12910.02,0.00
2024-12-08 16:59:35,53,11208,17,36,7740.98,12910.02,0.00
2024-12-08 16:59:35,52,11208,16,36,7775.55,12910.38,0.00
2024-12-08 16:59:36,51,11208,15,36,7907.82,12910.55,0.00
2024-12-08 16:59:36,51,11209,15,36,8103.08,12911.00,0.00
2024-12-08 16:59:36,52,11209,15,37,7947.25,12911.02,0.00
2024-12-08 16:59:36,52,11210,15,37,7924.78,12912.00,0.00
2024-12-08 16:59:36,53,11210,15,38,7775.26,12912.02,0.00
2024-12-08 16:59:36,52,11210,15,37,7880.09,12912.02,0.00
2024-12-08 16:59:36,51,11210,14,37,7914.01,12912.39,0.00
2024-12-08 16:59:36,51,11211,14,37,8089.14,12913.00,0.00
2024-12-08 16:59:36,52,11211,15,37,7933.58,12913.02,0.00
2024-12-08 16:59:36,52,11212,15,37,7914.55,12914.00,0.00
2024-12-08 16:59:36,53,11212,15,38,7765.22,12914.02,0.00
2024-12-08 16:59:36,52,11212,15,37,7867.36,12914.02,0.00
2024-12-08 16:59:36,51,11212,14,37,7935.64,12914.63,0.00
2024-12-08 16:59:36,51,11213,14,37,8141.04,12915.00,0.00
2024-12-08 16:59:36,52,11213,14,38,7984.48,12915.02,0.00
2024-12-08 16:59:36,52,11214,14,38,7963.64,12916.00,0.00
2024-12-08 16:59:36,53,11214,15,38,7813.38,12916.02,0.00
2024-12-08 16:59:36,52,11214,15,37,7918.93,12916.02,0.00
2024-12-08 16:59:36,51,11214,14,37,7962.02,12916.35,0.00
2024-12-08 16:59:36,51,11215,14,37,8132.17,12917.00,0.00
2024-12-08 16:59:36,52,11215,14,38,7975.78,12917.02,0.00
2024-12-08 16:59:36,52,11216,14,38,7954.28,12918.00,0.00
2024-12-08 16:59:36,53,11216,15,38,7804.20,12918.02,0.00
2024-12-08 16:59:36,52,11216,15,37,7912.05,12918.02,0.00
2024-12-08 16:59:36,51,11216,14,37,7986.98,12918.63,0.00
2024-12-08 16:59:36,51,11217,14,37,8091.14,12919.00,0.00
2024-12-08 16:59:36,52,11217,14,38,7935.54,12919.02,0.00
2024-12-08 16:59:36,52,11218,14,38,7900.71,12920.00,0.00
2024-12-08 16:59:36,53,11218,15,38,7751.64,12920.02,0.00
2024-12-08 16:59:36,52,11218,15,37,7860.96,12920.02,0.00
2024-12-08 16:59:36,52,11219,15,37,7855.82,12921.00,0.00
2024-12-08 16:59:36,53,11219,16,37,7707.60,12921.02,0.00
2024-12-08 16:59:36,53,11220,16,37,7649.93,12922.00,0.00
2024-12-08 16:59:36,54,11220,17,37,7508.26,12922.02,0.00
2024-12-08 16:59:36,53,11220,17,36,7610.92,12922.02,0.00
2024-12-08 16:59:36,53,11221,17,36,7599.62,12923.00,0.00
2024-12-08 16:59:36,54,11221,18,36,7458.89,12923.02,0.00
2024-12-08 16:59:36,53,11221,17,36,7448.33,12923.68,0.00
2024-12-08 16:59:36,53,11222,17,36,7562.58,12924.00,0.00
2024-12-08 16:59:36,54,11222,18,36,7422.53,12924.02,0.00
2024-12-08 16:59:36,53,11222,18,35,7526.00,12924.02,0.00
2024-12-08 16:59:36,53,11223,18,35,7546.09,12925.00,0.00
2024-12-08 16:59:36,54,11223,18,36,7406.35,12925.02,0.00
2024-12-08 16:59:36,54,11224,18,36,7385.43,12926.00,0.00
2024-12-08 16:59:36,55,11224,18,37,7251.15,12926.02,0.00
2024-12-08 16:59:36,54,11224,18,36,7349.52,12926.02,0.00
2024-12-08 16:59:36,53,11224,17,36,7356.63,12926.45,0.00
2024-12-08 16:59:36,53,11225,17,36,7530.18,12927.00,0.00
2024-12-08 16:59:36,54,11225,18,36,7390.74,12927.02,0.00
2024-12-08 16:59:36,54,11226,18,36,7369.49,12928.00,0.00
2024-12-08 16:59:36,55,11226,18,37,7235.50,12928.02,0.00
2024-12-08 16:59:36,54,11226,18,36,7335.98,12928.02,0.00
2024-12-08 16:59:36,53,11226,17,36,7357.73,12928.40,0.00
2024-12-08 16:59:36,53,11227,17,36,7524.03,12929.00,0.00
2024-12-08 16:59:36,54,11227,17,37,7384.70,12929.02,0.00
2024-12-08 16:59:36,54,11228,17,37,7363.01,12930.00,0.00
2024-12-08 16:59:36,55,11228,18,37,7229.13,12930.02,0.00
2024-12-08 16:59:36,54,11228,18,36,7331.88,12930.02,0.00
2024-12-08 16:59:36,54,11229,18,36,7349.21,12931.00,0.00
2024-12-08 16:59:36,55,11229,19,36,7215.59,12931.02,0.00
2024-12-08 16:59:36,55,11230,19,36,7238.54,12932.00,0.00
2024-12-08 16:59:36,56,11230,19,37,7109.29,12932.02,0.00
2024-12-08 16:59:36,55,11230,18,37,7177.45,12932.13,0.00
2024-12-08 16:59:36,55,11231,18,37,7230.50,12933.00,0.00
2024-12-08 16:59:36,56,11231,19,37,7101.39,12933.02,0.00
2024-12-08 16:59:36,55,11231,19,36,7183.48,12933.02,0.00
2024-12-08 16:59:36,55,11232,19,36,7198.14,12934.00,0.00
2024-12-08 16:59:36,56,11232,19,37,7069.60,12934.02,0.00
2024-12-08 16:59:36,56,11233,19,37,7045.10,12935.00,0.00
2024-12-08 16:59:36,57,11233,19,38,6921.50,12935.02,0.00
2024-12-08 16:59:36,56,11233,19,37,7019.69,12935.02,0.00
2024-12-08 16:59:36,55,11233,18,37,7015.65,12935.80,0.00
2024-12-08 16:59:36,55,11234,18,37,7225.12,12936.00,0.00
2024-12-08 16:59:36,56,11234,19,37,7096.10,12936.02,0.00
2024-12-08 16:59:36,55,11234,18,37,7128.76,12936.22,0.00
2024-12-08 16:59:36,55,11235,18,37,7263.32,12937.00,0.00
2024-12-08 16:59:36,56,11235,19,37,7133.61,12937.02,0.00
2024-12-08 16:59:36,55,11235,19,36,7239.80,12937.02,0.00
2024-12-08 16:59:37,55,11236,19,36,7254.47,12938.00,0.00
2024-12-08 16:59:37,56,11236,20,36,7124.93,12938.02,0.00
2024-12-08 16:59:37,56,11237,20,36,7097.28,12939.00,0.00
2024-12-08 16:59:37,57,11237,21,36,6972.77,12939.02,0.00
2024-12-08 16:59:37,56,11237,21,35,7076.49,12939.02,0.00
2024-12-08 16:59:37,55,11237,20,35,7127.58,12939.62,0.00
2024-12-08 16:59:37,55,11238,20,35,7219.60,12940.00,0.00
2024-12-08 16:59:37,56,11238,21,35,7090.68,12940.02,0.00
2024-12-08 16:59:37,55,11238,20,35,7100.63,12940.56,0.00
2024-12-08 16:59:37,54,11238,19,35,7224.62,12940.63,0.00
2024-12-08 16:59:37,54,11239,19,35,7324.32,12941.00,0.00
2024-12-08 16:59:37,55,11239,20,35,7191.15,12941.02,0.00
2024-12-08 16:59:37,54,11239,20,34,7305.15,12941.02,0.00
2024-12-08 16:59:37,54,11240,20,34,7322.49,12942.00,0.00
2024-12-08 16:59:37,55,11240,20,35,7189.35,12942.02,0.00
2024-12-08 16:59:37,55,11241,20,35,7156.96,12943.00,0.00
2024-12-08 16:59:37,56,11241,21,35,7029.16,12943.02,0.00
2024-12-08 16:59:37,55,11241,21,34,7140.49,12943.02,0.00
2024-12-08 16:59:37,54,11241,20,34,7109.07,12943.94,0.00
2024-12-08 16:59:37,54,11242,20,34,7341.61,12944.00,0.00
2024-12-08 16:59:37,55,11242,21,34,7208.13,12944.02,0.00
2024-12-08 16:59:37,55,11243,21,34,7175.73,12945.00,0.00
2024-12-08 16:59:37,56,11243,22,34,7047.60,12945.02,0.00
2024-12-08 16:59:37,55,11243,22,33,7156.91,12945.02,0.00
2024-12-08 16:59:37,55,11244,22,33,7171.58,12946.00,0.00
2024-12-08 16:59:37,56,11244,23,33,7043.52,12946.02,0.00
2024-12-08 16:59:37,55,11244,22,33,7110.36,12946.11,0.00
2024-12-08 16:59:37,55,11245,22,33,7230.93,12947.00,0.00
2024-12-08 16:59:37,56,11245,22,34,7101.81,12947.02,0.00
2024-12-08 16:59:37,55,11245,22,33,7214.45,12947.02,0.00
2024-12-08 16:59:37,55,11246,22,33,7229.14,12948.00,0.00
2024-12-08 16:59:37,56,11246,23,33,7100.04,12948.02,0.00
2024-12-08 16:59:37,55,11246,22,33,7172.66,12948.09,0.00
2024-12-08 16:59:37,54,11246,21,33,7239.32,12948.59,0.00
2024-12-08 16:59:37,54,11247,21,33,7330.72,12949.00,0.00
2024-12-08 16:59:37,55,11247,21,34,7197.43,12949.02,0.00
2024-12-08 16:59:37,54,11247,21,33,7313.93,12949.02,0.00
2024-12-08 16:59:37,53,11247,20,33,7444.62,12949.08,0.00
2024-12-08 16:59:37,52,11247,19,33,7462.26,12949.62,0.00
2024-12-08 16:59:37,52,11248,19,33,7661.75,12950.00,0.00
2024-12-08 16:59:37,53,11248,20,33,7517.19,12950.02,0.00
2024-12-08 16:59:37,53,11249,20,33,7488.45,12951.00,0.00
2024-12-08 16:59:37,54,11249,20,34,7349.78,12951.02,0.00
2024-12-08 16:59:37,53,11249,20,33,7461.57,12951.02,0.00
2024-12-08 16:59:37,53,11250,20,33,7481.70,12952.00,0.00
2024-12-08 16:59:37,54,11250,20,34,7343.15,12952.02,0.00
2024-12-08 16:59:37,54,11251,20,34,7312.53,12953.00,0.00
2024-12-08 16:59:37,55,11251,20,35,7179.58,12953.02,0.00
2024-12-08 16:59:37,54,11251,20,34,7288.54,12953.02,0.00
2024-12-08 16:59:37,53,11251,19,34,7260.42,12953.96,0.00
2024-12-08 16:59:37,53,11252,19,34,7499.96,12954.00,0.00
2024-12-08 16:59:37,54,11252,19,35,7361.07,12954.02,0.00
2024-12-08 16:59:37,54,11253,19,35,7330.45,12955.00,0.00
2024-12-08 16:59:37,55,11253,19,36,7197.17,12955.02,0.00
2024-12-08 16:59:37,54,11253,19,35,7308.86,12955.02,0.00
2024-12-08 16:59:37,54,11254,19,35,7321.59,12956.00,0.00
2024-12-08 16:59:37,55,11254,20,35,7188.47,12956.02,0.00
2024-12-08 16:59:37,55,11255,20,35,7158.57,12957.00,0.00
2024-12-08 16:59:37,56,11255,21,35,7030.74,12957.02,0.00
2024-12-08 16:59:37,55,11255,21,34,7127.95,12957.02,0.00
2024-12-08 16:59:37,54,11255,20,34,7170.77,12957.67,0.00
2024-12-08 16:59:37,54,11256,20,34,7271.79,12958.00,0.00
2024-12-08 16:59:37,55,11256,21,34,7139.57,12958.02,0.00
2024-12-08 16:59:37,55,11257,21,34,7112.13,12959.00,0.00
2024-12-08 16:59:37,56,11257,22,34,6985.13,12959.02,0.00
2024-12-08 16:59:37,55,11257,22,33,7083.85,12959.02,0.00
2024-12-08 16:59:37,55,11258,22,33,7098.54,12960.00,0.00
2024-12-08 16:59:37,56,11258,23,33,6971.78,12960.02,0.00
2024-12-08 16:59:37,56,11259,23,33,6946.27,12961.00,0.00
2024-12-08 16:59:37,57,11259,24,33,6824.40,12961.02,0.00
2024-12-08 16:59:37,56,11259,24,32,6918.49,12961.02,0.00
2024-12-08 16:59:37,55,11259,23,32,6901.35,12961.51,0.00
2024-12-08 16:59:37,55,11260,23,32,7073.71,12962.00,0.00
2024-12-08 16:59:37,56,11260,23,33,6947.39,12962.02,0.00
2024-12-08 16:59:37,55,11260,22,33,6930.10,12962.40,0.00
2024-12-08 16:59:37,54,11260,21,33,7045.67,12962.50,0.00
2024-12-08 16:59:37,54,11261,21,33,7221.24,12963.00,0.00
2024-12-08 16:59:37,55,11261,21,34,7089.95,12963.02,0.00
2024-12-08 16:59:37,54,11261,21,33,7192.44,12963.02,0.00
2024-12-08 16:59:37,54,11262,21,33,7209.80,12964.00,0.00
2024-12-08 16:59:37,55,11262,21,34,7078.71,12964.02,0.00
2024-12-08 16:59:37,54,11262,20,34,7147.41,12964.13,0.00
2024-12-08 16:59:37,53,11262,19,34,7204.10,12964.38,0.00
2024-12-08 16:59:38,53,11263,19,34,7368.41,12965.00,0.00
2024-12-08 16:59:38,54,11263,20,34,7231.96,12965.02,0.00
2024-12-08 16:59:38,53,11263,20,33,7341.50,12965.02,0.00
2024-12-08 16:59:38,52,11263,19,33,7398.22,12965.65,0.00
2024-12-08 16:59:38,52,11264,19,33,7503.21,12966.00,0.00
2024-12-08 16:59:38,53,11264,19,34,7361.64,12966.02,0.00
2024-12-08 16:59:38,53,11265,19,34,7332.85,12967.00,0.00
2024-12-08 16:59:38,54,11265,20,34,7197.06,12967.02,0.00
2024-12-08 16:59:38,53,11265,20,33,7308.38,12967.02,0.00
2024-12-08 16:59:38,54,11264,20,34,7113.22,12967.52,0.00
2024-12-08 16:59:38,53,11264,19,34,7394.80,12967.64,0.00
2024-12-08 16:59:38,53,11265,19,34,7593.27,12968.00,0.00
2024-12-08 16:59:38,54,11265,20,34,7452.65,12968.02,0.00
2024-12-08 16:59:38,53,11265,19,34,7378.23,12968.60,0.00
2024-12-08 16:59:38,53,11265,19,34,7816.53,12969.00,0.00
2024-12-08 16:59:38,54,11265,20,34,7671.78,12969.02,0.00
2024-12-08 16:59:38,53,11265,20,33,7792.06,12969.02,0.00
2024-12-08 16:59:38,53,11266,20,33,7812.24,12970.00,0.00
2024-12-08 16:59:38,54,11266,20,34,7667.57,12970.02,0.00
2024-12-08 16:59:38,54,11267,20,34,7636.93,12971.00,0.00
2024-12-08 16:59:38,55,11267,20,35,7498.08,12971.02,0.00
2024-12-08 16:59:38,54,11267,20,34,7615.31,12971.02,0.00
2024-12-08 16:59:38,53,11267,19,34,7593.15,12971.96,0.00
2024-12-08 16:59:38,53,11268,19,34,7833.02,12972.00,0.00
2024-12-08 16:59:38,54,11268,20,34,7687.97,12972.02,0.00
2024-12-08 16:59:38,53,11268,19,34,7743.46,12972.04,0.00
2024-12-08 16:59:38,53,11269,19,34,7863.99,12973.00,0.00
2024-12-08 16:59:38,54,11269,19,35,7718.36,12973.02,0.00
2024-12-08 16:59:38,53,11269,19,34,7841.96,12973.02,0.00
2024-12-08 16:59:38,53,11270,19,34,7862.15,12974.00,0.00
2024-12-08 16:59:38,54,11270,20,34,7716.55,12974.02,0.00
2024-12-08 16:59:38,54,11271,20,34,7686.03,12975.00,0.00
2024-12-08 16:59:38,55,11271,21,34,7546.28,12975.02,0.00
2024-12-08 16:59:38,54,11271,21,33,7654.80,12975.04,0.00
2024-12-08 16:59:38,54,11272,21,33,7674.60,12976.00,0.00
2024-12-08 16:59:38,55,11272,22,33,7535.07,12976.02,0.00
2024-12-08 16:59:38,55,11273,22,33,7504.26,12977.00,0.00
2024-12-08 16:59:38,56,11273,23,33,7370.26,12977.02,0.00
2024-12-08 16:59:38,55,11273,23,32,7475.95,12977.04,0.00
2024-12-08 16:59:38,55,11274,23,32,7493.04,12978.00,0.00
2024-12-08 16:59:38,56,11274,24,32,7359.24,12978.02,0.00
2024-12-08 16:59:38,56,11275,24,32,7326.59,12979.00,0.00
2024-12-08 16:59:38,57,11275,24,33,7198.06,12979.02,0.00
2024-12-08 16:59:38,56,11275,24,32,7301.10,12979.04,0.00
2024-12-08 16:59:38,56,11276,24,32,7315.57,12980.00,0.00
2024-12-08 16:59:38,57,11276,24,33,7187.23,12980.02,0.00
2024-12-08 16:59:38,56,11276,23,33,7246.08,12980.18,0.00
2024-12-08 16:59:38,56,11277,23,33,7280.16,12981.00,0.00
2024-12-08 16:59:38,57,11277,23,34,7152.43,12981.02,0.00
2024-12-08 16:59:38,56,11277,23,33,7256.98,12981.04,0.00
2024-12-08 16:59:38,55,11277,22,33,7225.47,12981.96,0.00
2024-12-08 16:59:38,55,11278,22,33,7456.81,12982.00,0.00
2024-12-08 16:59:38,56,11278,23,33,7323.65,12982.02,0.00
2024-12-08 16:59:38,56,11279,23,33,7289.44,12983.00,0.00
2024-12-08 16:59:38,57,11279,24,33,7161.55,12983.02,0.00
2024-12-08 16:59:38,56,11279,24,32,7268.58,12983.04,0.00
2024-12-08 16:59:38,56,11280,24,32,7283.04,12984.00,0.00
2024-12-08 16:59:38,57,11280,25,32,7155.27,12984.02,0.00
2024-12-08 16:59:38,57,11281,25,32,7119.37,12985.00,0.00
2024-12-08 16:59:38,58,11281,25,33,6996.63,12985.02,0.00
2024-12-08 16:59:38,57,11281,25,32,7101.15,12985.04,0.00
2024-12-08 16:59:38,57,11282,25,32,7113.09,12986.00,0.00
2024-12-08 16:59:38,58,11282,25,33,6990.45,12986.02,0.00
2024-12-08 16:59:38,58,11283,25,33,6953.29,12987.00,0.00
2024-12-08 16:59:38,59,11283,26,33,6835.43,12987.02,0.00
2024-12-08 16:59:38,58,11283,26,32,6937.62,12987.03,0.00
2024-12-08 16:59:38,58,11284,26,32,6942.34,12988.00,0.00
2024-12-08 16:59:38,59,11284,26,33,6824.67,12988.02,0.00
2024-12-08 16:59:38,58,11284,25,33,6754.71,12988.84,0.00
2024-12-08 16:59:38,58,11285,25,33,6958.61,12989.00,0.00
2024-12-08 16:59:38,59,11285,25,34,6840.67,12989.02,0.00
2024-12-08 16:59:38,58,11285,25,33,6942.94,12989.03,0.00
2024-12-08 16:59:38,58,11286,25,33,6930.62,12990.00,0.00
2024-12-08 16:59:38,59,11286,26,33,6813.15,12990.02,0.00
2024-12-08 16:59:38,58,11286,25,33,6897.02,12990.02,0.00
2024-12-08 16:59:38,57,11286,24,33,6848.06,12990.68,0.00
2024-12-08 16:59:38,57,11287,24,33,7035.16,12991.00,0.00
2024-12-08 16:59:38,58,11287,24,34,6913.86,12991.02,0.00
2024-12-08 16:59:38,57,11287,24,33,7023.76,12991.02,0.00
2024-12-08 16:59:38,57,11288,24,33,6980.24,12992.00,0.00
2024-12-08 16:59:39,58,11288,25,33,6859.89,12992.02,0.00
2024-12-08 16:59:39,57,11288,25,32,6809.71,12992.65,0.00
2024-12-08 16:59:39,57,11289,25,32,6903.88,12993.00,0.00
2024-12-08 16:59:39,58,11289,26,32,6784.85,12993.02,0.00
2024-12-08 16:59:39,57,11289,26,31,6892.48,12993.02,0.00
2024-12-08 16:59:39,56,11289,25,31,6929.92,12993.68,0.00
2024-12-08 16:59:39,55,11289,24,31,6975.30,12993.96,0.00
2024-12-08 16:59:39,55,11290,24,31,7206.85,12994.00,0.00
2024-12-08 16:59:39,56,11290,25,31,7078.15,12994.02,0.00
2024-12-08 16:59:39,56,11291,25,31,7044.19,12995.00,0.00
2024-12-08 16:59:39,57,11291,25,32,6920.61,12995.02,0.00
2024-12-08 16:59:39,56,11291,25,31,7032.59,12995.02,0.00
2024-12-08 16:59:39,56,11292,25,31,7044.73,12996.00,0.00
2024-12-08 16:59:39,57,11292,26,31,6921.14,12996.02,0.00
2024-12-08 16:59:39,56,11292,25,31,6926.66,12996.29,0.00
2024-12-08 16:59:39,56,11293,25,31,7066.36,12997.00,0.00
2024-12-08 16:59:39,57,11293,26,31,6942.39,12997.02,0.00
2024-12-08 16:59:39,56,11293,26,30,7045.47,12997.02,0.00
2024-12-08 16:59:39,55,11293,25,30,7162.14,12997.09,0.00
2024-12-08 16:59:39,55,11294,25,30,7186.30,12998.00,0.00
2024-12-08 16:59:39,56,11294,26,30,7057.98,12998.02,0.00
2024-12-08 16:59:39,56,11295,26,30,7027.03,12999.00,0.00
2024-12-08 16:59:39,57,11295,26,31,6903.75,12999.02,0.00
2024-12-08 16:59:39,56,11295,26,30,7008.46,12999.02,0.00
2024-12-08 16:59:39,55,11295,25,30,7121.75,12999.13,0.00
2024-12-08 16:59:39,55,11296,25,30,7150.62,13000.00,0.00
2024-12-08 16:59:39,56,11296,25,31,7022.93,13000.02,0.00
2024-12-08 16:59:39,55,11296,24,31,7023.11,13000.33,0.00
2024-12-08 16:59:39,55,11297,24,31,7172.44,13001.00,0.00
2024-12-08 16:59:39,56,11297,24,32,7044.36,13001.02,0.00
2024-12-08 16:59:39,55,11297,24,31,7153.53,13001.02,0.00
2024-12-08 16:59:39,55,11298,24,31,7168.27,13002.00,0.00
2024-12-08 16:59:39,56,11298,24,32,7040.26,13002.02,0.00
2024-12-08 16:59:39,55,11298,23,32,7106.84,13002.13,0.00
2024-12-08 16:59:39,55,11299,23,32,7137.04,13003.00,0.00
2024-12-08 16:59:39,56,11299,23,33,7009.59,13003.02,0.00
2024-12-08 16:59:39,55,11299,23,32,7120.49,13003.02,0.00
2024-12-08 16:59:39,54,11299,22,32,7142.83,13003.43,0.00
2024-12-08 16:59:39,53,11299,21,32,7250.74,13003.64,0.00
2024-12-08 16:59:39,52,11299,20,32,7387.68,13003.65,0.00
2024-12-08 16:59:39,52,11300,20,32,7592.99,13004.00,0.00
2024-12-08 16:59:39,53,11300,21,32,7449.73,13004.02,0.00
2024-12-08 16:59:39,53,11301,21,32,7420.85,13005.00,0.00
2024-12-08 16:59:39,54,11301,21,33,7283.43,13005.02,0.00
2024-12-08 16:59:39,53,11301,21,32,7401.22,13005.02,0.00
2024-12-08 16:59:39,53,11302,21,32,7421.42,13006.00,0.00
2024-12-08 16:59:39,54,11302,22,32,7283.99,13006.02,0.00
2024-12-08 16:59:39,53,11302,21,32,7306.20,13006.28,0.00
2024-12-08 16:59:39,53,11303,21,32,7458.81,13007.00,0.00
2024-12-08 16:59:39,54,11303,22,32,7320.68,13007.02,0.00
2024-12-08 16:59:39,53,11303,22,31,7439.17,13007.02,0.00
2024-12-08 16:59:39,53,11304,22,31,7459.38,13008.00,0.00
2024-12-08 16:59:39,54,11304,23,31,7321.24,13008.02,0.00
2024-12-08 16:59:39,54,11305,23,31,7290.49,13009.00,0.00
2024-12-08 16:59:39,55,11305,23,32,7157.93,13009.02,0.00
2024-12-08 16:59:39,54,11305,23,31,7273.63,13009.02,0.00
2024-12-08 16:59:39,54,11306,23,31,7283.84,13010.00,0.00
2024-12-08 16:59:39,55,11306,23,32,7151.40,13010.02,0.00
2024-12-08 16:59:39,54,11306,22,32,7206.75,13010.04,0.00
2024-12-08 16:59:39,54,11307,22,32,7263.27,13011.00,0.00
2024-12-08 16:59:39,55,11307,23,32,7131.21,13011.02,0.00
2024-12-08 16:59:39,54,11307,23,31,7231.96,13011.04,0.00
2024-12-08 16:59:39,53,11307,22,31,7287.40,13011.04,0.00
2024-12-08 16:59:39,53,11308,22,31,7396.02,13012.00,0.00
2024-12-08 16:59:39,54,11308,23,31,7259.06,13012.02,0.00
2024-12-08 16:59:39,54,11309,23,31,7229.48,13013.00,0.00
2024-12-08 16:59:39,55,11309,23,32,7098.03,13013.02,0.00
2024-12-08 16:59:39,54,11309,23,31,7190.93,13013.04,0.00
2024-12-08 16:59:39,54,11310,23,31,7205.88,13014.00,0.00
2024-12-08 16:59:39,55,11310,23,32,7074.86,13014.02,0.00
2024-12-08 16:59:39,55,11311,23,32,7056.16,13015.00,0.00
2024-12-08 16:59:39,56,11311,23,33,6930.15,13015.02,0.00
2024-12-08 16:59:39,55,11311,23,32,7018.30,13015.04,0.00
2024-12-08 16:59:39,54,11311,22,32,7058.36,13015.67,0.00
2024-12-08 16:59:39,54,11312,22,32,7256.23,13016.00,0.00
2024-12-08 16:59:39,55,11312,23,32,7124.30,13016.02,0.00
2024-12-08 16:59:39,55,11313,23,32,7106.00,13017.00,0.00
2024-12-08 16:59:39,56,11313,23,33,6979.11,13017.02,0.00
2024-12-08 16:59:39,55,11313,23,32,7068.15,13017.04,0.00
2024-12-08 16:59:39,54,11313,22,32,7114.85,13017.61,0.00
2024-12-08 16:59:39,53,11313,21,32,7244.20,13017.64,0.00
2024-12-08 16:59:39,53,11314,21,32,7443.40,13018.00,0.00
2024-12-08 16:59:39,54,11314,22,32,7305.56,13018.02,0.00
2024-12-08 16:59:39,53,11314,21,32,7369.76,13018.15,0.00
2024-12-08 16:59:40,53,11315,21,32,7505.38,13019.00,0.00
2024-12-08 16:59:40,54,11315,21,33,7366.39,13019.02,0.00
2024-12-08 16:59:40,53,11315,21,32,7468.54,13019.04,0.00
2024-12-08 16:59:40,53,11316,21,32,7491.22,13020.00,0.00
2024-12-08 16:59:40,54,11316,21,33,7352.49,13020.02,0.00
2024-12-08 16:59:40,54,11317,21,33,7328.72,13021.00,0.00
2024-12-08 16:59:40,55,11317,21,34,7195.47,13021.02,0.00
2024-12-08 16:59:40,54,11317,21,33,7294.97,13021.04,0.00
2024-12-08 16:59:40,53,11317,20,33,7261.39,13021.96,0.00
2024-12-08 16:59:40,53,11318,20,33,7502.20,13022.00,0.00
2024-12-08 16:59:40,54,11318,20,34,7363.27,13022.02,0.00
2024-12-08 16:59:40,53,11318,19,34,7357.25,13022.08,0.00
2024-12-08 16:59:40,53,11319,19,34,7483.12,13023.00,0.00
2024-12-08 16:59:40,54,11319,19,35,7344.54,13023.02,0.00
2024-12-08 16:59:40,53,11319,19,34,7451.18,13023.04,0.00
2024-12-08 16:59:40,53,11320,19,34,7473.86,13024.00,0.00
2024-12-08 16:59:40,54,11320,20,34,7335.45,13024.02,0.00
2024-12-08 16:59:40,53,11320,19,34,7314.29,13024.42,0.00
2024-12-08 16:59:40,52,11320,18,34,7437.83,13024.54,0.00
2024-12-08 16:59:40,52,11321,18,34,7628.53,13025.00,0.00
2024-12-08 16:59:40,53,11321,19,34,7484.60,13025.02,0.00
2024-12-08 16:59:40,52,11321,19,33,7598.48,13025.04,0.00
2024-12-08 16:59:40,52,11322,19,33,7624.11,13026.00,0.00
2024-12-08 16:59:40,53,11322,19,34,7480.26,13026.02,0.00
2024-12-08 16:59:40,52,11322,18,34,7549.76,13026.15,0.00
2024-12-08 16:59:40,52,11323,18,34,7690.58,13027.00,0.00
2024-12-08 16:59:40,53,11323,19,34,7545.48,13027.02,0.00
2024-12-08 16:59:40,52,11323,19,33,7643.01,13027.08,0.00
2024-12-08 16:59:40,51,11323,18,33,7705.24,13027.65,0.00
2024-12-08 16:59:40,51,11324,18,33,7914.99,13028.00,0.00
2024-12-08 16:59:40,52,11324,19,33,7762.78,13028.02,0.00
2024-12-08 16:59:40,52,11325,19,33,7740.84,13029.00,0.00
2024-12-08 16:59:40,53,11325,20,33,7594.79,13029.02,0.00
2024-12-08 16:59:40,52,11325,20,32,7695.76,13029.08,0.00
2024-12-08 16:59:40,52,11326,20,32,7726.40,13030.00,0.00
2024-12-08 16:59:40,53,11326,21,32,7580.62,13030.02,0.00
2024-12-08 16:59:40,53,11327,21,32,7555.99,13031.00,0.00
2024-12-08 16:59:40,54,11327,22,32,7416.06,13031.02,0.00
2024-12-08 16:59:40,53,11327,22,31,7514.21,13031.08,0.00
2024-12-08 16:59:40,53,11328,22,31,7541.27,13032.00,0.00
2024-12-08 16:59:40,54,11328,23,31,7401.61,13032.02,0.00
2024-12-08 16:59:40,53,11328,22,31,7457.72,13032.19,0.00
2024-12-08 16:59:40,53,11329,22,31,7597.43,13033.00,0.00
2024-12-08 16:59:40,54,11329,23,31,7456.74,13033.02,0.00
2024-12-08 16:59:40,53,11329,23,30,7555.65,13033.08,0.00
2024-12-08 16:59:40,53,11330,23,30,7580.30,13034.00,0.00
2024-12-08 16:59:40,54,11330,24,30,7439.93,13034.02,0.00
2024-12-08 16:59:40,53,11330,23,30,7376.42,13034.55,0.00
2024-12-08 16:59:40,53,11331,23,30,7558.61,13035.00,0.00
2024-12-08 16:59:40,54,11331,23,31,7418.63,13035.02,0.00
2024-12-08 16:59:40,53,11331,23,30,7511.89,13035.08,0.00
2024-12-08 16:59:40,52,11331,22,30,7651.35,13035.12,0.00
2024-12-08 16:59:40,52,11332,22,30,7682.85,13036.00,0.00
2024-12-08 16:59:40,53,11332,22,31,7537.89,13036.02,0.00
2024-12-08 16:59:40,53,11333,22,31,7509.66,13037.00,0.00
2024-12-08 16:59:40,54,11333,22,32,7370.59,13037.02,0.00
2024-12-08 16:59:40,53,11333,22,31,7465.40,13037.08,0.00
2024-12-08 16:59:40,53,11334,22,31,7493.01,13038.00,0.00
2024-12-08 16:59:40,54,11334,22,32,7354.25,13038.02,0.00
2024-12-08 16:59:40,54,11335,22,32,7330.58,13039.00,0.00
2024-12-08 16:59:40,55,11335,22,33,7197.30,13039.02,0.00
2024-12-08 16:59:40,54,11335,22,32,7287.13,13039.07,0.00
2024-12-08 16:59:40,53,11335,21,32,7353.45,13039.28,0.00
2024-12-08 16:59:40,53,11336,21,32,7502.47,13040.00,0.00
2024-12-08 16:59:40,54,11336,22,32,7363.54,13040.02,0.00
2024-12-08 16:59:40,54,11337,22,32,7341.71,13041.00,0.00
2024-12-08 16:59:40,55,11337,23,32,7208.23,13041.02,0.00
2024-12-08 16:59:40,54,11337,23,31,7286.19,13041.09,0.00
2024-12-08 16:59:40,53,11337,22,31,7273.26,13041.85,0.00
2024-12-08 16:59:40,53,11338,22,31,7499.76,13042.00,0.00
2024-12-08 16:59:40,54,11338,22,32,7360.87,13042.02,0.00
2024-12-08 16:59:40,54,11339,22,32,7343.02,13043.00,0.00
2024-12-08 16:59:40,55,11339,22,33,7209.52,13043.02,0.00
2024-12-08 16:59:40,54,11339,22,32,7289.90,13043.09,0.00
2024-12-08 16:59:40,54,11340,22,32,7317.02,13044.00,0.00
2024-12-08 16:59:40,55,11340,22,33,7183.98,13044.02,0.00
2024-12-08 16:59:41,55,11341,22,33,7168.22,13045.00,0.00
2024-12-08 16:59:41,56,11341,23,33,7040.22,13045.02,0.00
2024-12-08 16:59:41,55,11341,23,32,7118.43,13045.09,0.00
2024-12-08 16:59:41,54,11341,22,32,7133.80,13045.70,0.00
2024-12-08 16:59:41,54,11342,22,32,7336.93,13046.00,0.00
2024-12-08 16:59:41,55,11342,23,32,7203.53,13046.02,0.00
2024-12-08 16:59:41,55,11343,23,32,7180.16,13047.00,0.00
2024-12-08 16:59:41,56,11343,23,33,7051.94,13047.02,0.00
2024-12-08 16:59:41,55,11343,23,32,7122.01,13047.11,0.00
2024-12-08 16:59:41,55,11344,23,32,7132.53,13048.00,0.00
2024-12-08 16:59:41,56,11344,24,32,7005.16,13048.02,0.00
2024-12-08 16:59:41,55,11344,23,32,7099.13,13048.04,0.00
2024-12-08 16:59:41,55,11345,23,32,7139.83,13049.00,0.00
2024-12-08 16:59:41,56,11345,24,32,7012.34,13049.02,0.00
2024-12-08 16:59:41,55,11345,24,31,7086.23,13049.09,0.00
2024-12-08 16:59:41,55,11346,24,31,7086.44,13050.00,0.00
2024-12-08 16:59:41,56,11346,25,31,6959.90,13050.02,0.00
2024-12-08 16:59:41,56,11347,25,31,6926.69,13051.00,0.00
2024-12-08 16:59:41,57,11347,25,32,6805.17,13051.02,0.00
2024-12-08 16:59:41,56,11347,25,31,6875.43,13051.09,0.00
2024-12-08 16:59:41,55,11347,24,31,6812.15,13051.93,0.00
2024-12-08 16:59:41,55,11348,24,31,7040.01,13052.00,0.00
2024-12-08 16:59:41,56,11348,24,32,6914.29,13052.02,0.00
2024-12-08 16:59:41,56,11349,24,32,6889.65,13053.00,0.00
2024-12-08 16:59:41,57,11349,24,33,6768.78,13053.02,0.00
2024-12-08 16:59:41,56,11349,24,32,6840.71,13053.09,0.00
2024-12-08 16:59:41,55,11349,23,32,6962.41,13053.11,0.00
2024-12-08 16:59:41,55,11350,23,32,6980.70,13054.00,0.00
2024-12-08 16:59:41,56,11350,24,32,6856.05,13054.02,0.00
2024-12-08 16:59:41,55,11350,24,31,6970.79,13054.09,0.00
2024-12-08 16:59:41,55,11351,24,31,6989.02,13055.00,0.00
2024-12-08 16:59:41,56,11351,24,32,6864.21,13055.02,0.00
2024-12-08 16:59:41,55,11351,23,32,6794.11,13055.64,0.00
2024-12-08 16:59:41,55,11352,23,32,6979.20,13056.00,0.00
2024-12-08 16:59:41,56,11352,23,33,6854.57,13056.02,0.00
2024-12-08 16:59:41,55,11352,23,32,6922.24,13056.09,0.00
2024-12-08 16:59:41,54,11352,22,32,6968.90,13056.57,0.00
2024-12-08 16:59:41,54,11353,22,32,7150.72,13057.00,0.00
2024-12-08 16:59:41,55,11353,23,32,7020.71,13057.02,0.00
2024-12-08 16:59:41,55,11354,23,32,7014.13,13058.00,0.00
2024-12-08 16:59:41,56,11354,24,32,6888.88,13058.02,0.00
2024-12-08 16:59:41,56,11355,24,32,6851.30,13059.00,0.00
2024-12-08 16:59:41,57,11355,25,32,6731.10,13059.02,0.00
2024-12-08 16:59:41,56,11355,25,31,6839.65,13059.09,0.00
2024-12-08 16:59:41,56,11356,25,31,6858.84,13060.00,0.00
2024-12-08 16:59:41,57,11356,25,32,6738.51,13060.02,0.00
2024-12-08 16:59:41,57,11357,25,32,6728.30,13061.00,0.00
2024-12-08 16:59:41,58,11357,26,32,6612.30,13061.02,0.00
2024-12-08 16:59:41,57,11357,25,32,6723.68,13061.04,0.00
2024-12-08 16:59:41,56,11357,25,31,6792.44,13061.07,0.00
2024-12-08 16:59:41,55,11357,24,31,6899.34,13061.13,0.00
2024-12-08 16:59:41,55,11358,24,31,7015.07,13062.00,0.00
2024-12-08 16:59:41,56,11358,24,32,6889.80,13062.02,0.00
2024-12-08 16:59:41,57,11357,24,33,6601.17,13062.89,0.00
2024-12-08 16:59:41,57,11358,24,33,6765.43,13063.00,0.00
2024-12-08 16:59:41,58,11358,24,34,6648.78,13063.02,0.00
2024-12-08 16:59:41,57,11358,24,33,6714.80,13063.07,0.00
2024-12-08 16:59:41,57,11359,24,33,6946.93,13064.00,0.00
2024-12-08 16:59:41,58,11359,24,34,6827.15,13064.02,0.00
2024-12-08 16:59:41,57,11359,23,34,6944.46,13064.02,0.00
2024-12-08 16:59:41,56,11359,22,34,7003.17,13064.11,0.00
2024-12-08 16:59:41,56,11360,22,34,7109.79,13065.00,0.00
2024-12-08 16:59:41,57,11360,22,35,6985.05,13065.02,0.00
2024-12-08 16:59:41,56,11360,22,34,7063.13,13065.05,0.00
2024-12-08 16:59:41,56,11361,22,34,7072.17,13066.00,0.00
2024-12-08 16:59:41,57,11361,23,34,6948.09,13066.02,0.00
2024-12-08 16:59:41,56,11361,22,34,6922.51,13066.39,0.00
2024-12-08 16:59:41,56,11362,22,34,7069.72,13067.00,0.00
2024-12-08 16:59:41,57,11362,23,34,6945.69,13067.02,0.00
2024-12-08 16:59:41,56,11362,23,33,7025.39,13067.05,0.00
2024-12-08 16:59:41,55,11362,22,33,7102.85,13067.42,0.00
2024-12-08 16:59:41,54,11362,21,33,7220.94,13067.52,0.00
2024-12-08 16:59:41,54,11363,21,33,7296.39,13068.00,0.00
2024-12-08 16:59:41,55,11363,22,33,7163.73,13068.02,0.00
2024-12-08 16:59:41,55,11364,22,33,7143.29,13069.00,0.00
2024-12-08 16:59:41,56,11364,22,34,7015.74,13069.02,0.00
2024-12-08 16:59:41,55,11364,22,33,7098.15,13069.05,0.00
2024-12-08 16:59:41,55,11364,22,33,7108.05,13070.00,0.00
2024-12-08 16:59:41,56,11364,23,33,6981.12,13070.02,0.00
2024-12-08 16:59:41,55,11364,22,33,6971.43,13070.56,0.00
2024-12-08 16:59:41,55,11365,22,33,7146.53,13071.00,0.00
2024-12-08 16:59:41,56,11365,22,34,7018.92,13071.02,0.00
2024-12-08 16:59:41,55,11365,22,33,7096.63,13071.05,0.00
2024-12-08 16:59:41,55,11366,22,33,7106.41,13072.00,0.00
2024-12-08 16:59:41,56,11366,23,33,6979.50,13072.02,0.00
2024-12-08 16:59:42,56,11367,23,33,6960.98,13073.00,0.00
2024-12-08 16:59:42,57,11367,23,34,6838.86,13073.02,0.00
2024-12-08 16:59:42,56,11367,23,33,6914.30,13073.05,0.00
2024-12-08 16:59:42,55,11367,22,33,7018.38,13073.05,0.00
2024-12-08 16:59:42,54,11367,21,33,7148.35,13073.06,0.00
2024-12-08 16:59:42,54,11368,21,33,7262.08,13074.00,0.00
2024-12-08 16:59:42,55,11368,22,33,7130.04,13074.02,0.00
2024-12-08 16:59:42,54,11368,21,33,7158.04,13074.24,0.00
2024-12-08 16:59:42,54,11368,21,33,7296.54,13075.00,0.00
2024-12-08 16:59:42,55,11368,21,34,7163.88,13075.02,0.00
2024-12-08 16:59:42,54,11368,20,34,7294.12,13075.02,0.00
2024-12-08 16:59:42,53,11368,20,33,7382.40,13075.04,0.00
2024-12-08 16:59:42,53,11369,20,33,7397.42,13076.00,0.00
2024-12-08 16:59:42,54,11369,20,34,7260.43,13076.02,0.00
2024-12-08 16:59:42,53,11369,19,34,7338.22,13076.08,0.00
2024-12-08 16:59:42,52,11369,18,34,7391.07,13076.63,0.00
2024-12-08 16:59:42,52,11370,18,34,7595.04,13077.00,0.00
2024-12-08 16:59:42,53,11370,19,34,7451.73,13077.02,0.00
2024-12-08 16:59:42,52,11370,19,33,7580.79,13077.04,0.00
2024-12-08 16:59:42,52,11371,19,33,7598.05,13078.00,0.00
2024-12-08 16:59:42,53,11371,20,33,7454.69,13078.02,0.00
2024-12-08 16:59:42,52,11371,19,33,7436.30,13078.63,0.00
2024-12-08 16:59:42,52,11372,19,33,7640.30,13079.00,0.00
2024-12-08 16:59:42,53,11372,19,34,7496.14,13079.02,0.00
2024-12-08 16:59:42,52,11372,19,33,7595.02,13079.04,0.00
2024-12-08 16:59:42,52,11373,19,33,7620.18,13080.00,0.00
2024-12-08 16:59:42,53,11373,19,34,7476.41,13080.02,0.00
2024-12-08 16:59:42,52,11373,18,34,7442.29,13080.54,0.00
2024-12-08 16:59:42,52,11374,18,34,7633.81,13081.00,0.00
2024-12-08 16:59:42,53,11374,18,35,7489.77,13081.02,0.00
2024-12-08 16:59:42,52,11374,18,34,7630.77,13081.04,0.00
2024-12-08 16:59:42,52,11375,18,34,7656.51,13082.00,0.00
2024-12-08 16:59:42,53,11375,18,35,7512.05,13082.02,0.00
2024-12-08 16:59:42,53,11376,18,35,7497.71,13083.00,0.00
2024-12-08 16:59:42,54,11376,19,35,7358.86,13083.02,0.00
2024-12-08 16:59:42,53,11376,19,34,7453.27,13083.04,0.00
2024-12-08 16:59:42,53,11377,19,34,7474.95,13084.00,0.00
2024-12-08 16:59:42,54,11377,19,35,7336.53,13084.02,0.00
2024-12-08 16:59:42,53,11377,18,35,7472.49,13084.02,0.00
2024-12-08 16:59:42,53,11378,18,35,7459.65,13085.00,0.00
2024-12-08 16:59:42,54,11378,19,35,7321.51,13085.02,0.00
2024-12-08 16:59:42,53,11378,19,34,7420.15,13085.02,0.00
2024-12-08 16:59:42,52,11378,18,34,7446.65,13085.69,0.00
2024-12-08 16:59:42,52,11379,18,34,7656.22,13086.00,0.00
2024-12-08 16:59:42,53,11379,19,34,7511.76,13086.02,0.00
2024-12-08 16:59:42,52,11379,19,33,7580.32,13086.21,0.00
2024-12-08 16:59:42,52,11380,19,33,7640.87,13087.00,0.00
2024-12-08 16:59:42,53,11380,20,33,7496.70,13087.02,0.00
2024-12-08 16:59:42,52,11380,20,32,7603.12,13087.02,0.00
2024-12-08 16:59:42,51,11380,19,32,7667.83,13087.65,0.00
2024-12-08 16:59:42,51,11381,19,32,7773.71,13088.00,0.00
2024-12-08 16:59:42,52,11381,19,33,7624.22,13088.02,0.00
2024-12-08 16:59:42,52,11382,19,33,7603.47,13089.00,0.00
2024-12-08 16:59:42,53,11382,19,34,7460.01,13089.02,0.00
2024-12-08 16:59:42,52,11382,19,33,7568.23,13089.02,0.00
2024-12-08 16:59:42,52,11383,19,33,7589.18,13090.00,0.00
2024-12-08 16:59:42,53,11383,20,33,7445.99,13090.02,0.00
2024-12-08 16:59:42,53,11384,20,33,7424.96,13091.00,0.00
2024-12-08 16:59:42,54,11384,20,34,7287.46,13091.02,0.00
2024-12-08 16:59:42,53,11384,20,33,7392.85,13091.02,0.00
2024-12-08 16:59:42,52,11384,19,33,7529.99,13091.06,0.00
2024-12-08 16:59:42,52,11385,19,33,7555.89,13092.00,0.00
2024-12-08 16:59:42,53,11385,20,33,7413.33,13092.02,0.00
2024-12-08 16:59:42,52,11385,19,33,7477.90,13092.06,0.00
2024-12-08 16:59:42,52,11386,19,33,7605.61,13093.00,0.00
2024-12-08 16:59:42,53,11386,20,33,7462.11,13093.02,0.00
2024-12-08 16:59:42,52,11386,20,32,7567.84,13093.04,0.00
2024-12-08 16:59:42,51,11386,19,32,7666.01,13093.41,0.00
2024-12-08 16:59:42,50,11386,18,32,7806.03,13093.52,0.00
2024-12-08 16:59:42,50,11387,18,32,7900.65,13094.00,0.00
2024-12-08 16:59:42,51,11387,19,32,7745.73,13094.02,0.00
2024-12-08 16:59:42,51,11388,19,32,7738.20,13095.00,0.00
2024-12-08 16:59:42,52,11388,20,32,7589.39,13095.02,0.00
2024-12-08 16:59:42,51,11388,20,31,7681.71,13095.04,0.00
2024-12-08 16:59:42,51,11389,20,31,7710.55,13096.00,0.00
2024-12-08 16:59:42,52,11389,21,31,7562.27,13096.02,0.00
2024-12-08 16:59:42,51,11389,20,31,7506.12,13096.55,0.00
2024-12-08 16:59:42,51,11390,20,31,7704.18,13097.00,0.00
2024-12-08 16:59:42,52,11390,20,32,7556.02,13097.02,0.00
2024-12-08 16:59:42,51,11390,20,31,7650.25,13097.04,0.00
2024-12-08 16:59:42,51,11391,20,31,7679.09,13098.00,0.00
2024-12-08 16:59:42,52,11391,21,31,7531.41,13098.02,0.00
2024-12-08 16:59:42,51,11391,20,31,7677.51,13098.02,0.00
2024-12-08 16:59:42,50,11391,19,31,7717.11,13098.48,0.00
2024-12-08 16:59:43,50,11392,19,31,7911.34,13099.00,0.00
2024-12-08 16:59:43,51,11392,20,31,7756.21,13099.02,0.00
2024-12-08 16:59:43,50,11392,20,30,7861.56,13099.02,0.00
2024-12-08 16:59:43,50,11393,20,30,7890.98,13100.00,0.00
2024-12-08 16:59:43,51,11393,20,31,7736.25,13100.02,0.00
2024-12-08 16:59:43,51,11394,20,31,7723.40,13101.00,0.00
2024-12-08 16:59:43,52,11394,20,32,7574.87,13101.02,0.00
2024-12-08 16:59:43,51,11394,20,31,7674.59,13101.02,0.00
2024-12-08 16:59:43,50,11394,19,31,7765.85,13101.48,0.00
2024-12-08 16:59:43,49,11394,18,31,7856.19,13101.69,0.00
2024-12-08 16:59:43,49,11395,18,31,8083.69,13102.00,0.00
2024-12-08 16:59:43,50,11395,19,31,7922.01,13102.02,0.00
2024-12-08 16:59:43,50,11396,19,31,7910.22,13103.00,0.00
2024-12-08 16:59:43,51,11396,19,32,7755.12,13103.02,0.00
2024-12-08 16:59:43,50,11396,19,31,7855.19,13103.04,0.00
2024-12-08 16:59:43,50,11397,19,31,7887.23,13104.00,0.00
2024-12-08 16:59:43,51,11397,20,31,7732.58,13104.02,0.00
2024-12-08 16:59:43,51,11398,20,31,7721.06,13105.00,0.00
2024-12-08 16:59:43,52,11398,20,32,7572.58,13105.02,0.00
2024-12-08 16:59:43,51,11398,20,31,7669.67,13105.04,0.00
2024-12-08 16:59:43,51,11399,20,31,7698.52,13106.00,0.00
2024-12-08 16:59:43,52,11399,21,31,7550.47,13106.02,0.00
2024-12-08 16:59:43,51,11399,20,31,7697.83,13106.02,0.00
2024-12-08 16:59:43,51,11400,20,31,7689.63,13107.00,0.00
2024-12-08 16:59:43,52,11400,21,31,7541.76,13107.02,0.00
2024-12-08 16:59:43,51,11400,21,30,7643.37,13107.02,0.00
2024-12-08 16:59:43,51,11401,21,30,7669.66,13108.00,0.00
2024-12-08 16:59:43,52,11401,21,31,7522.17,13108.02,0.00
2024-12-08 16:59:43,52,11402,21,31,7513.47,13109.00,0.00
2024-12-08 16:59:43,53,11402,22,31,7371.71,13109.02,0.00
2024-12-08 16:59:43,52,11402,22,30,7465.57,13109.02,0.00
2024-12-08 16:59:43,51,11402,21,30,7611.96,13109.02,0.00
2024-12-08 16:59:43,51,11403,21,30,7638.24,13110.00,0.00
2024-12-08 16:59:43,52,11403,21,31,7491.35,13110.02,0.00
2024-12-08 16:59:43,51,11403,20,31,7633.10,13110.04,0.00
2024-12-08 16:59:43,50,11403,19,31,7620.10,13110.68,0.00
2024-12-08 16:59:43,50,11404,19,31,7840.58,13111.00,0.00
2024-12-08 16:59:43,51,11404,19,32,7686.84,13111.02,0.00
2024-12-08 16:59:43,50,11404,19,31,7782.89,13111.04,0.00
2024-12-08 16:59:43,50,11405,19,31,7808.62,13112.00,0.00
2024-12-08 16:59:43,51,11405,19,32,7655.51,13112.02,0.00
2024-12-08 16:59:43,51,11406,19,32,7632.69,13113.00,0.00
2024-12-08 16:59:43,52,11406,20,32,7485.91,13113.02,0.00
2024-12-08 16:59:43,51,11406,20,31,7578.70,13113.04,0.00
2024-12-08 16:59:43,50,11406,19,31,7533.48,13113.88,0.00
2024-12-08 16:59:43,50,11407,19,31,7780.11,13114.00,0.00
2024-12-08 16:59:43,51,11407,20,31,7627.56,13114.02,0.00
2024-12-08 16:59:43,50,11407,19,31,7779.56,13114.02,0.00
2024-12-08 16:59:43,50,11408,19,31,7718.90,13115.00,0.00
2024-12-08 16:59:43,51,11408,20,31,7567.55,13115.02,0.00
2024-12-08 16:59:43,50,11408,20,30,7669.07,13115.02,0.00
2024-12-08 16:59:43,49,11408,19,30,7722.08,13115.78,0.00
2024-12-08 16:59:43,49,11409,19,30,7797.26,13116.00,0.00
2024-12-08 16:59:43,50,11409,19,31,7641.32,13116.02,0.00
2024-12-08 16:59:43,50,11410,19,31,7583.50,13117.00,0.00
2024-12-08 16:59:43,51,11410,19,32,7434.81,13117.02,0.00
2024-12-08 16:59:43,50,11410,18,32,7378.22,13117.42,0.00
2024-12-08 16:59:43,49,11410,18,31,7470.00,13117.75,0.00
2024-12-08 16:59:43,49,11411,18,31,7705.77,13118.00,0.00
2024-12-08 16:59:43,50,11411,19,31,7551.65,13118.02,0.00
2024-12-08 16:59:43,49,11411,19,30,7692.38,13118.02,0.00
2024-12-08 16:59:43,48,11411,18,30,7718.49,13118.44,0.00
2024-12-08 16:59:43,48,11412,18,30,7918.38,13119.00,0.00
2024-12-08 16:59:43,49,11412,19,30,7756.79,13119.02,0.00
2024-12-08 16:59:43,49,11413,19,30,7746.57,13120.00,0.00
2024-12-08 16:59:43,50,11413,20,30,7591.64,13120.02,0.00
2024-12-08 16:59:43,49,11413,20,29,7701.05,13120.02,0.00
2024-12-08 16:59:43,48,11413,19,29,7790.59,13120.54,0.00
2024-12-08 16:59:43,48,11414,19,29,7894.80,13121.00,0.00
2024-12-08 16:59:43,49,11414,19,30,7733.68,13121.02,0.00
2024-12-08 16:59:43,49,11415,19,30,7726.04,13122.00,0.00
2024-12-08 16:59:43,50,11415,20,30,7571.52,13122.02,0.00
2024-12-08 16:59:43,49,11415,20,29,7672.49,13122.04,0.00
2024-12-08 16:59:43,48,11415,19,29,7751.45,13122.58,0.00
2024-12-08 16:59:43,48,11416,19,29,7970.48,13123.00,0.00
2024-12-08 16:59:43,49,11416,19,30,7807.81,13123.02,0.00
2024-12-08 16:59:43,48,11416,18,30,7839.36,13123.27,0.00
2024-12-08 16:59:43,47,11416,17,30,7968.84,13123.53,0.00
2024-12-08 16:59:43,47,11417,17,30,8187.00,13124.00,0.00
2024-12-08 16:59:43,48,11417,18,30,8016.44,13124.02,0.00
2024-12-08 16:59:43,47,11417,17,30,8089.27,13124.02,0.00
2024-12-08 16:59:43,46,11417,17,29,8210.91,13124.02,0.00
2024-12-08 16:59:44,46,11418,17,29,8366.28,13125.00,0.00
2024-12-08 16:59:44,47,11418,17,30,8188.27,13125.02,0.00
2024-12-08 16:59:44,47,11419,17,30,8173.29,13126.00,0.00
2024-12-08 16:59:44,48,11419,17,31,8003.02,13126.02,0.00
2024-12-08 16:59:44,47,11419,17,30,8125.82,13126.02,0.00
2024-12-08 16:59:44,47,11420,17,30,8162.78,13127.00,0.00
2024-12-08 16:59:44,48,11420,18,30,7992.72,13127.02,0.00
2024-12-08 16:59:44,48,11421,18,30,7978.51,13128.00,0.00
2024-12-08 16:59:44,49,11421,18,31,7815.68,13128.02,0.00
2024-12-08 16:59:44,48,11421,18,30,7934.75,13128.02,0.00
2024-12-08 16:59:44,48,11422,18,30,7969.53,13129.00,0.00
2024-12-08 16:59:44,49,11422,18,31,7806.89,13129.02,0.00
2024-12-08 16:59:44,48,11422,17,31,7810.36,13129.69,0.00
2024-12-08 16:59:44,48,11423,17,31,8043.10,13130.00,0.00
2024-12-08 16:59:44,49,11423,18,31,7878.95,13130.02,0.00
2024-12-08 16:59:44,48,11423,18,30,8002.07,13130.02,0.00
2024-12-08 16:59:44,47,11423,17,30,8037.46,13130.77,0.00
2024-12-08 16:59:44,47,11424,17,30,8286.29,13131.00,0.00
2024-12-08 16:59:44,48,11424,17,31,8113.66,13131.02,0.00
2024-12-08 16:59:44,48,11425,17,31,8095.13,13132.00,0.00
2024-12-08 16:59:44,49,11425,18,31,7929.92,13132.02,0.00
2024-12-08 16:59:44,48,11425,18,30,8056.82,13132.02,0.00
2024-12-08 16:59:44,47,11425,17,30,8097.11,13132.43,0.00
2024-12-08 16:59:44,47,11426,17,30,8301.52,13133.00,0.00
2024-12-08 16:59:44,48,11426,18,30,8128.58,13133.02,0.00
2024-12-08 16:59:44,48,11427,18,30,8112.99,13134.00,0.00
2024-12-08 16:59:44,49,11427,19,30,7947.42,13134.02,0.00
2024-12-08 16:59:44,48,11427,19,29,8069.21,13134.02,0.00
2024-12-08 16:59:44,48,11428,19,29,8105.40,13135.00,0.00
2024-12-08 16:59:44,49,11428,19,30,7939.98,13135.02,0.00
2024-12-08 16:59:44,49,11429,19,30,7924.23,13136.00,0.00
2024-12-08 16:59:44,50,11429,19,31,7765.75,13136.02,0.00
2024-12-08 16:59:44,49,11429,19,30,7881.34,13136.02,0.00
2024-12-08 16:59:44,48,11429,18,30,7895.50,13136.46,0.00
2024-12-08 16:59:44,47,11429,17,30,8059.20,13136.49,0.00
2024-12-08 16:59:44,47,11430,17,30,8272.01,13137.00,0.00
2024-12-08 16:59:44,48,11430,17,31,8099.68,13137.02,0.00
2024-12-08 16:59:44,48,11431,17,31,8082.73,13138.00,0.00
2024-12-08 16:59:44,49,11431,18,31,7917.78,13138.02,0.00
2024-12-08 16:59:44,48,11431,18,30,8038.94,13138.02,0.00
2024-12-08 16:59:44,47,11431,17,30,8119.02,13138.32,0.00
2024-12-08 16:59:44,47,11432,17,30,8309.62,13139.00,0.00
2024-12-08 16:59:44,48,11432,17,31,8136.50,13139.02,0.00
2024-12-08 16:59:44,47,11432,16,31,8189.50,13139.25,0.00
2024-12-08 16:59:44,47,11433,16,31,8371.75,13140.00,0.00
2024-12-08 16:59:44,48,11433,17,31,8197.34,13140.02,0.00
2024-12-08 16:59:44,47,11433,17,30,8327.02,13140.02,0.00
2024-12-08 16:59:44,47,11434,17,30,8366.80,13141.00,0.00
2024-12-08 16:59:44,48,11434,17,31,8192.49,13141.02,0.00
2024-12-08 16:59:44,47,11434,16,31,8204.64,13141.04,0.00
2024-12-08 16:59:44,47,11435,16,31,8359.05,13142.00,0.00
2024-12-08 16:59:44,48,11435,17,31,8184.90,13142.02,0.00
2024-12-08 16:59:44,47,11435,17,30,8317.10,13142.02,0.00
2024-12-08 16:59:44,47,11436,17,30,8356.89,13143.00,0.00
2024-12-08 16:59:44,48,11436,18,30,8182.79,13143.02,0.00
2024-12-08 16:59:44,48,11437,18,30,8167.03,13144.00,0.00
2024-12-08 16:59:44,49,11437,19,30,8000.36,13144.02,0.00
2024-12-08 16:59:44,48,11437,19,29,8123.22,13144.02,0.00
2024-12-08 16:59:44,48,11438,19,29,8159.44,13145.00,0.00
2024-12-08 16:59:44,49,11438,20,29,7992.92,13145.02,0.00
2024-12-08 16:59:44,48,11438,20,28,8104.97,13145.02,0.00
2024-12-08 16:59:44,48,11439,20,28,8141.19,13146.00,0.00
2024-12-08 16:59:44,49,11439,21,28,7975.04,13146.02,0.00
2024-12-08 16:59:44,49,11440,21,28,7961.32,13147.00,0.00
2024-12-08 16:59:44,50,11440,22,28,7802.09,13147.02,0.00
2024-12-08 16:59:44,49,11440,22,27,7921.20,13147.02,0.00
2024-12-08 16:59:44,48,11440,21,27,8078.02,13147.06,0.00
2024-12-08 16:59:44,48,11441,21,27,8119.71,13148.00,0.00
2024-12-08 16:59:44,49,11441,22,27,7954.00,13148.02,0.00
2024-12-08 16:59:44,48,11441,21,27,7997.89,13148.52,0.00
2024-12-08 16:59:44,47,11441,20,27,8162.50,13148.57,0.00
2024-12-08 16:59:44,47,11442,20,27,8278.76,13149.00,0.00
2024-12-08 16:59:44,48,11442,21,27,8106.28,13149.02,0.00
2024-12-08 16:59:44,47,11442,21,26,8239.59,13149.02,0.00
2024-12-08 16:59:44,47,11443,21,26,8279.39,13150.00,0.00
2024-12-08 16:59:44,48,11443,22,26,8106.90,13150.02,0.00
2024-12-08 16:59:44,47,11443,21,26,8069.55,13150.47,0.00
2024-12-08 16:59:44,47,11444,21,26,8279.80,13151.00,0.00
2024-12-08 16:59:44,48,11444,21,27,8107.30,13151.02,0.00
2024-12-08 16:59:44,47,11444,21,26,8240.63,13151.02,0.00
2024-12-08 16:59:45,47,11445,21,26,8280.43,13152.00,0.00
2024-12-08 16:59:45,48,11445,22,26,8107.92,13152.02,0.00
2024-12-08 16:59:45,48,11446,22,26,8089.36,13153.00,0.00
2024-12-08 16:59:45,49,11446,22,27,7924.27,13153.02,0.00
2024-12-08 16:59:45,48,11446,22,26,8045.51,13153.02,0.00
2024-12-08 16:59:45,47,11446,21,26,8211.11,13153.06,0.00
2024-12-08 16:59:45,47,11447,21,26,8256.50,13154.00,0.00
2024-12-08 16:59:45,48,11447,22,26,8084.49,13154.02,0.00
2024-12-08 16:59:45,48,11448,22,26,8065.92,13155.00,0.00
2024-12-08 16:59:45,49,11448,23,26,7901.31,13155.02,0.00
2024-12-08 16:59:45,48,11448,23,25,8024.81,13155.02,0.00
2024-12-08 16:59:45,47,11448,22,25,8022.61,13155.96,0.00
2024-12-08 16:59:45,47,11449,22,25,8296.94,13156.00,0.00
2024-12-08 16:59:45,48,11449,23,25,8124.09,13156.02,0.00
2024-12-08 16:59:45,48,11450,23,25,8105.52,13157.00,0.00
2024-12-08 16:59:45,49,11450,24,25,7940.10,13157.02,0.00
2024-12-08 16:59:45,48,11450,24,24,8064.40,13157.02,0.00
2024-12-08 16:59:45,47,11450,23,24,8059.91,13157.55,0.00
2024-12-08 16:59:45,47,11451,23,24,8281.41,13158.00,0.00
2024-12-08 16:59:45,48,11451,23,25,8108.88,13158.02,0.00
2024-12-08 16:59:45,48,11452,23,25,8098.56,13159.00,0.00
2024-12-08 16:59:45,49,11452,24,25,7933.29,13159.02,0.00
2024-12-08 16:59:45,48,11452,24,24,8046.48,13159.02,0.00
2024-12-08 16:59:45,47,11452,23,24,8142.40,13159.60,0.00
2024-12-08 16:59:45,47,11453,23,24,8257.50,13160.00,0.00
2024-12-08 16:59:45,48,11453,23,25,8085.47,13160.02,0.00
2024-12-08 16:59:45,48,11454,23,25,8078.31,13161.00,0.00
2024-12-08 16:59:45,49,11454,24,25,7913.45,13161.02,0.00
2024-12-08 16:59:45,48,11454,24,24,8023.48,13161.02,0.00
2024-12-08 16:59:45,48,11455,24,24,8059.73,13162.00,0.00
2024-12-08 16:59:45,49,11455,25,24,7895.25,13162.02,0.00
2024-12-08 16:59:45,49,11456,25,24,7889.97,13163.00,0.00
2024-12-08 16:59:45,50,11456,26,24,7732.17,13163.02,0.00
2024-12-08 16:59:45,49,11456,26,23,7838.93,13163.02,0.00
2024-12-08 16:59:45,49,11457,26,23,7871.76,13164.00,0.00
2024-12-08 16:59:45,50,11457,27,23,7714.33,13164.02,0.00
2024-12-08 16:59:45,49,11457,26,23,7664.13,13164.55,0.00
2024-12-08 16:59:45,49,11458,26,23,7874.01,13165.00,0.00
2024-12-08 16:59:45,50,11458,27,23,7716.53,13165.02,0.00
2024-12-08 16:59:45,49,11458,27,22,7814.91,13165.04,0.00
2024-12-08 16:59:45,48,11458,26,22,7910.22,13165.15,0.00
2024-12-08 16:59:45,48,11459,26,22,8072.60,13166.00,0.00
2024-12-08 16:59:45,49,11459,27,22,7907.85,13166.02,0.00
2024-12-08 16:59:45,48,11459,26,22,7912.95,13166.71,0.00
2024-12-08 16:59:45,48,11460,26,22,8149.11,13167.00,0.00
2024-12-08 16:59:45,49,11460,27,22,7982.80,13167.02,0.00
2024-12-08 16:59:45,49,11461,27,22,7960.09,13168.00,0.00
2024-12-08 16:59:45,50,11461,27,23,7800.88,13168.02,0.00
2024-12-08 16:59:45,49,11461,27,22,7954.72,13168.04,0.00
2024-12-08 16:59:45,49,11462,27,22,7987.31,13169.00,0.00
2024-12-08 16:59:45,50,11462,28,22,7827.56,13169.02,0.00
2024-12-08 16:59:45,50,11463,28,22,7820.47,13170.00,0.00
2024-12-08 16:59:45,51,11463,29,22,7667.13,13170.02,0.00
2024-12-08 16:59:45,50,11463,29,21,7762.53,13170.04,0.00
2024-12-08 16:59:45,49,11463,28,21,7713.26,13170.96,0.00
2024-12-08 16:59:45,49,11464,28,21,7976.70,13171.00,0.00
2024-12-08 16:59:45,50,11464,29,21,7817.17,13171.02,0.00
2024-12-08 16:59:45,49,11464,28,21,7850.19,13171.57,0.00
2024-12-08 16:59:45,49,11465,28,21,7939.70,13172.00,0.00
2024-12-08 16:59:45,50,11465,28,22,7780.90,13172.02,0.00
2024-12-08 16:59:45,49,11465,28,21,7883.25,13172.04,0.00
2024-12-08 16:59:45,49,11466,28,21,7871.90,13173.00,0.00
2024-12-08 16:59:45,50,11466,28,22,7714.46,13173.02,0.00
2024-12-08 16:59:45,50,11467,28,22,7657.81,13174.00,0.00
2024-12-08 16:59:45,51,11467,29,22,7507.66,13174.02,0.00
2024-12-08 16:59:45,50,11467,29,21,7605.12,13174.04,0.00
2024-12-08 16:59:45,49,11467,28,21,7660.15,13174.53,0.00
2024-12-08 16:59:45,49,11468,28,21,7759.97,13175.00,0.00
2024-12-08 16:59:45,50,11468,29,21,7604.77,13175.02,0.00
2024-12-08 16:59:45,49,11468,28,21,7757.29,13175.04,0.00
2024-12-08 16:59:45,48,11468,27,21,7796.14,13175.54,0.00
2024-12-08 16:59:45,48,11469,27,21,8010.60,13176.00,0.00
2024-12-08 16:59:45,49,11469,27,22,7847.12,13176.02,0.00
2024-12-08 16:59:45,48,11469,27,21,7950.21,13176.04,0.00
2024-12-08 16:59:45,48,11470,27,21,7989.24,13177.00,0.00
2024-12-08 16:59:45,49,11470,27,22,7826.20,13177.02,0.00
2024-12-08 16:59:45,48,11470,26,22,7783.57,13177.50,0.00
2024-12-08 16:59:45,48,11471,26,22,7992.59,13178.00,0.00
2024-12-08 16:59:45,49,11471,26,23,7829.48,13178.02,0.00
2024-12-08 16:59:45,48,11471,26,22,7934.95,13178.04,0.00
2024-12-08 16:59:46,48,11472,26,22,7973.98,13179.00,0.00
2024-12-08 16:59:46,49,11472,27,22,7811.25,13179.02,0.00
2024-12-08 16:59:46,49,11473,27,22,7812.21,13180.00,0.00
2024-12-08 16:59:46,50,11473,28,22,7655.96,13180.02,0.00
2024-12-08 16:59:46,50,11474,28,22,7632.82,13181.00,0.00
2024-12-08 16:59:46,51,11474,29,22,7483.15,13181.02,0.00
2024-12-08 16:59:46,50,11474,29,21,7622.28,13181.08,0.00
2024-12-08 16:59:46,50,11475,29,21,7659.76,13182.00,0.00
2024-12-08 16:59:46,51,11475,30,21,7509.57,13182.02,0.00
2024-12-08 16:59:46,51,11476,30,21,7507.15,13183.00,0.00
2024-12-08 16:59:46,52,11476,30,22,7362.79,13183.02,0.00
2024-12-08 16:59:46,51,11476,29,22,7500.29,13183.06,0.00
2024-12-08 16:59:46,50,11476,29,21,7594.93,13183.06,0.00
2024-12-08 16:59:46,49,11476,28,21,7621.35,13183.39,0.00
2024-12-08 16:59:46,49,11477,28,21,7810.12,13184.00,0.00
2024-12-08 16:59:46,50,11477,28,22,7653.91,13184.02,0.00
2024-12-08 16:59:46,50,11478,28,22,7652.06,13185.00,0.00
2024-12-08 16:59:46,51,11478,29,22,7502.02,13185.02,0.00
2024-12-08 16:59:46,50,11478,29,21,7591.42,13185.06,0.00
2024-12-08 16:59:46,50,11479,29,21,7626.27,13186.00,0.00
2024-12-08 16:59:46,51,11479,29,22,7476.74,13186.02,0.00
2024-12-08 16:59:46,50,11479,28,22,7457.23,13186.68,0.00
2024-12-08 16:59:46,50,11480,28,22,7678.99,13187.00,0.00
2024-12-08 16:59:46,51,11480,29,22,7528.42,13187.02,0.00
2024-12-08 16:59:46,50,11480,29,21,7620.98,13187.06,0.00
2024-12-08 16:59:46,49,11480,28,21,7661.33,13187.69,0.00
2024-12-08 16:59:46,49,11481,28,21,7890.33,13188.00,0.00
2024-12-08 16:59:46,50,11481,29,21,7732.52,13188.02,0.00
2024-12-08 16:59:46,50,11482,29,21,7727.91,13189.00,0.00
2024-12-08 16:59:46,51,11482,29,22,7576.38,13189.02,0.00
2024-12-08 16:59:46,50,11482,29,21,7669.88,13189.06,0.00
2024-12-08 16:59:46,50,11483,29,21,7704.75,13190.00,0.00
2024-12-08 16:59:46,51,11483,29,22,7553.67,13190.02,0.00
2024-12-08 16:59:46,50,11483,28,22,7622.97,13190.04,0.00
2024-12-08 16:59:46,50,11484,28,22,7707.97,13191.00,0.00
2024-12-08 16:59:46,51,11484,29,22,7556.83,13191.02,0.00
2024-12-08 16:59:46,50,11484,29,21,7655.21,13191.04,0.00
2024-12-08 16:59:46,51,11483,29,22,7290.91,13191.92,0.00
2024-12-08 16:59:46,51,11484,29,22,7549.65,13192.00,0.00
2024-12-08 16:59:46,52,11484,29,23,7404.46,13192.02,0.00
2024-12-08 16:59:46,51,11484,28,23,7545.93,13192.04,0.00
2024-12-08 16:59:46,51,11485,28,23,7805.31,13193.00,0.00
2024-12-08 16:59:46,52,11485,28,24,7655.20,13193.02,0.00
2024-12-08 16:59:46,51,11485,28,23,7753.57,13193.04,0.00
2024-12-08 16:59:46,50,11485,27,23,7816.04,13193.52,0.00
2024-12-08 16:59:46,50,11486,27,23,8016.95,13194.00,0.00
2024-12-08 16:59:46,51,11486,27,24,7859.75,13194.02,0.00
2024-12-08 16:59:46,50,11486,26,24,8011.68,13194.06,0.00
2024-12-08 16:59:46,50,11487,26,24,8014.40,13195.00,0.00
2024-12-08 16:59:46,51,11487,27,24,7857.25,13195.02,0.00
2024-12-08 16:59:46,50,11487,27,23,7953.71,13195.06,0.00
2024-12-08 16:59:46,50,11488,27,23,7988.61,13196.00,0.00
2024-12-08 16:59:46,51,11488,28,23,7831.97,13196.02,0.00
2024-12-08 16:59:46,51,11489,28,23,7825.24,13197.00,0.00
2024-12-08 16:59:46,52,11489,29,23,7674.75,13197.02,0.00
2024-12-08 16:59:46,51,11489,29,22,7768.32,13197.06,0.00
2024-12-08 16:59:46,50,11489,28,22,7815.35,13197.66,0.00
2024-12-08 16:59:46,50,11490,28,22,8034.69,13198.00,0.00
2024-12-08 16:59:46,51,11490,29,22,7877.15,13198.02,0.00
2024-12-08 16:59:46,51,11491,29,22,7868.87,13199.00,0.00
2024-12-08 16:59:46,52,11491,30,22,7717.54,13199.02,0.00
2024-12-08 16:59:46,51,11491,30,21,7814.53,13199.06,0.00
2024-12-08 16:59:46,51,11492,30,21,7846.17,13200.00,0.00
2024-12-08 16:59:46,52,11492,31,21,7695.28,13200.02,0.00
2024-12-08 16:59:46,51,11492,30,21,7706.50,13200.29,0.00
2024-12-08 16:59:46,51,11493,30,21,7872.65,13201.00,0.00
2024-12-08 16:59:46,52,11493,31,21,7721.25,13201.02,0.00
2024-12-08 16:59:46,51,11493,31,20,7818.30,13201.06,0.00
2024-12-08 16:59:46,51,11494,31,20,7849.95,13202.00,0.00
2024-12-08 16:59:46,52,11494,32,20,7698.99,13202.02,0.00
2024-12-08 16:59:46,52,11495,32,20,7690.83,13203.00,0.00
2024-12-08 16:59:46,53,11495,32,21,7545.72,13203.02,0.00
2024-12-08 16:59:46,52,11495,32,20,7637.52,13203.06,0.00
2024-12-08 16:59:46,52,11496,32,20,7666.02,13204.00,0.00
2024-12-08 16:59:46,53,11496,33,20,7521.38,13204.02,0.00
2024-12-08 16:59:46,52,11496,32,20,7663.48,13204.02,0.00
2024-12-08 16:59:46,51,11496,31,20,7808.58,13204.06,0.00
2024-12-08 16:59:46,51,11497,31,20,7824.69,13205.00,0.00
2024-12-08 16:59:46,52,11497,32,20,7674.21,13205.02,0.00
2024-12-08 16:59:46,52,11498,32,20,7646.86,13206.00,0.00
2024-12-08 16:59:46,53,11498,33,20,7502.58,13206.02,0.00
2024-12-08 16:59:47,52,11498,33,19,7624.01,13206.08,0.00
2024-12-08 16:59:47,51,11498,32,19,7610.81,13206.82,0.00
2024-12-08 16:59:47,51,11499,32,19,7846.59,13207.00,0.00
2024-12-08 16:59:47,52,11499,33,19,7695.70,13207.02,0.00
2024-12-08 16:59:47,51,11499,32,19,7741.56,13207.12,0.00
2024-12-08 16:59:47,51,11500,32,19,7884.56,13208.00,0.00
2024-12-08 16:59:47,52,11500,33,19,7732.94,13208.02,0.00
2024-12-08 16:59:47,52,11501,33,19,7705.58,13209.00,0.00
2024-12-08 16:59:47,53,11501,34,19,7560.19,13209.02,0.00
2024-12-08 16:59:47,52,11501,34,18,7685.27,13209.08,0.00
2024-12-08 16:59:47,52,11502,34,18,7716.32,13210.00,0.00
2024-12-08 16:59:47,53,11502,35,18,7570.73,13210.02,0.00
2024-12-08 16:59:47,52,11502,34,18,7541.38,13210.46,0.00
2024-12-08 16:59:47,52,11503,34,18,7724.68,13211.00,0.00
2024-12-08 16:59:47,53,11503,35,18,7578.93,13211.02,0.00
2024-12-08 16:59:47,53,11504,35,18,7549.59,13212.00,0.00
2024-12-08 16:59:47,54,11504,35,19,7409.79,13212.02,0.00
2024-12-08 16:59:47,53,11504,34,19,7544.55,13212.06,0.00
2024-12-08 16:59:47,52,11504,34,18,7664.25,13212.12,0.00
2024-12-08 16:59:47,52,11505,34,18,7700.37,13213.00,0.00
2024-12-08 16:59:47,53,11505,34,19,7555.08,13213.02,0.00
2024-12-08 16:59:47,52,11505,33,19,7519.14,13213.48,0.00
2024-12-08 16:59:47,52,11506,33,19,7705.01,13214.00,0.00
2024-12-08 16:59:47,53,11506,33,20,7559.63,13214.02,0.00
2024-12-08 16:59:47,53,11507,33,20,7530.29,13215.00,0.00
2024-12-08 16:59:47,54,11507,34,20,7390.84,13215.02,0.00
2024-12-08 16:59:47,53,11507,34,19,7502.88,13215.11,0.00
2024-12-08 16:59:47,53,11508,34,19,7535.84,13216.00,0.00
2024-12-08 16:59:47,54,11508,35,19,7396.29,13216.02,0.00
2024-12-08 16:59:47,53,11508,34,19,7435.25,13216.40,0.00
2024-12-08 16:59:47,53,11509,34,19,7550.26,13217.00,0.00
2024-12-08 16:59:47,54,11509,34,20,7410.44,13217.02,0.00
2024-12-08 16:59:47,54,11510,34,20,7386.55,13218.00,0.00
2024-12-08 16:59:47,55,11510,35,20,7252.25,13218.02,0.00
2024-12-08 16:59:47,54,11510,35,19,7335.19,13218.20,0.00
2024-12-08 16:59:47,54,11511,35,19,7377.31,13219.00,0.00
2024-12-08 16:59:47,55,11511,35,20,7243.18,13219.02,0.00
2024-12-08 16:59:47,55,11512,35,20,7256.82,13220.00,0.00
2024-12-08 16:59:47,56,11512,36,20,7127.24,13220.02,0.00
2024-12-08 16:59:47,55,11512,35,20,7038.57,13220.95,0.00
2024-12-08 16:59:47,55,11513,35,20,7271.77,13221.00,0.00
2024-12-08 16:59:47,56,11513,35,21,7141.92,13221.02,0.00
2024-12-08 16:59:47,55,11513,34,21,7257.37,13221.11,0.00
2024-12-08 16:59:47,54,11513,34,20,7350.17,13221.20,0.00
2024-12-08 16:59:47,54,11514,34,20,7392.30,13222.00,0.00
2024-12-08 16:59:47,55,11514,35,20,7257.90,13222.02,0.00
2024-12-08 16:59:47,54,11514,34,20,7377.63,13222.11,0.00
2024-12-08 16:59:47,54,11515,34,20,7402.57,13223.00,0.00
2024-12-08 16:59:47,55,11515,35,20,7267.98,13223.02,0.00
2024-12-08 16:59:47,55,11516,35,20,7242.49,13224.00,0.00
2024-12-08 16:59:47,56,11516,35,21,7113.16,13224.02,0.00
2024-12-08 16:59:47,55,11516,34,21,7233.94,13224.07,0.00
2024-12-08 16:59:47,54,11516,34,20,7331.20,13224.17,0.00
2024-12-08 16:59:47,54,11517,34,20,7368.45,13225.00,0.00
2024-12-08 16:59:47,55,11517,34,21,7234.48,13225.02,0.00
2024-12-08 16:59:47,55,11518,34,21,7244.67,13226.00,0.00
2024-12-08 16:59:47,56,11518,35,21,7115.30,13226.02,0.00
2024-12-08 16:59:47,55,11518,34,21,7136.57,13226.40,0.00
2024-12-08 16:59:47,55,11519,34,21,7298.10,13227.00,0.00
2024-12-08 16:59:47,56,11519,35,21,7167.78,13227.02,0.00
2024-12-08 16:59:47,55,11519,35,20,7250.04,13227.20,0.00
2024-12-08 16:59:47,55,11520,35,20,7289.03,13228.00,0.00
2024-12-08 16:59:47,56,11520,36,20,7158.87,13228.02,0.00
2024-12-08 16:59:47,56,11521,36,20,7164.21,13229.00,0.00
2024-12-08 16:59:47,57,11521,37,20,7038.53,13229.02,0.00
2024-12-08 16:59:47,57,11522,37,20,7008.76,13230.00,0.00
2024-12-08 16:59:47,58,11522,38,20,6887.92,13230.02,0.00
2024-12-08 16:59:47,57,11522,38,19,6967.02,13230.19,0.00
2024-12-08 16:59:47,56,11522,37,19,7025.54,13230.68,0.00
2024-12-08 16:59:47,56,11523,37,19,7125.00,13231.00,0.00
2024-12-08 16:59:47,57,11523,37,20,7000.00,13231.02,0.00
2024-12-08 16:59:47,57,11524,37,20,7001.74,13232.00,0.00
2024-12-08 16:59:47,58,11524,37,21,6881.02,13232.02,0.00
2024-12-08 16:59:47,57,11524,36,21,6999.42,13232.02,0.00
2024-12-08 16:59:47,56,11524,35,21,7015.86,13232.27,0.00
2024-12-08 16:59:47,56,11525,35,21,7155.74,13233.00,0.00
2024-12-08 16:59:47,57,11525,35,22,7030.21,13233.02,0.00
2024-12-08 16:59:47,56,11525,35,21,7120.33,13233.18,0.00
2024-12-08 16:59:47,55,11525,34,21,7106.01,13233.93,0.00
2024-12-08 16:59:48,55,11526,34,21,7337.06,13234.00,0.00
2024-12-08 16:59:48,56,11526,35,21,7206.04,13234.02,0.00
2024-12-08 16:59:48,55,11526,34,21,7221.62,13234.25,0.00
2024-12-08 16:59:48,55,11527,34,21,7364.08,13235.00,0.00
2024-12-08 16:59:48,56,11527,34,22,7232.58,13235.02,0.00
2024-12-08 16:59:48,56,11528,34,22,7203.27,13236.00,0.00
2024-12-08 16:59:48,57,11528,35,22,7076.90,13236.02,0.00
2024-12-08 16:59:48,56,11528,34,22,7184.39,13236.16,0.00
2024-12-08 16:59:48,55,11528,34,21,7293.36,13236.18,0.00
2024-12-08 16:59:48,55,11529,34,21,7329.98,13237.00,0.00
2024-12-08 16:59:48,56,11529,34,22,7199.09,13237.02,0.00
2024-12-08 16:59:48,56,11530,34,22,7200.97,13238.00,0.00
2024-12-08 16:59:48,57,11530,35,22,7074.64,13238.02,0.00
2024-12-08 16:59:48,56,11530,34,22,7046.25,13238.46,0.00
2024-12-08 16:59:48,56,11531,34,22,7212.12,13239.00,0.00
2024-12-08 16:59:48,57,11531,35,22,7085.59,13239.02,0.00
2024-12-08 16:59:48,56,11531,35,21,7176.68,13239.18,0.00
2024-12-08 16:59:48,56,11532,35,21,7210.30,13240.00,0.00
2024-12-08 16:59:48,57,11532,36,21,7083.80,13240.02,0.00
2024-12-08 16:59:48,56,11532,35,21,7198.16,13240.11,0.00
2024-12-08 16:59:48,55,11532,34,21,7324.23,13240.15,0.00
2024-12-08 16:59:48,55,11533,34,21,7353.61,13241.00,0.00
2024-12-08 16:59:48,56,11533,34,22,7222.29,13241.02,0.00
2024-12-08 16:59:48,56,11534,34,22,7195.43,13242.00,0.00
2024-12-08 16:59:48,57,11534,34,23,7069.19,13242.02,0.00
2024-12-08 16:59:48,56,11534,33,23,7193.06,13242.02,0.00
2024-12-08 16:59:48,55,11534,33,22,7285.34,13242.13,0.00
2024-12-08 16:59:48,55,11535,33,22,7314.77,13243.00,0.00
2024-12-08 16:59:48,56,11535,33,23,7184.15,13243.02,0.00
2024-12-08 16:59:48,55,11535,32,23,7175.23,13243.35,0.00
2024-12-08 16:59:48,55,11536,32,23,7329.77,13244.00,0.00
2024-12-08 16:59:48,56,11536,32,24,7198.88,13244.02,0.00
2024-12-08 16:59:48,55,11536,31,24,7243.09,13244.11,0.00
2024-12-08 16:59:48,55,11537,31,24,7318.28,13245.00,0.00
2024-12-08 16:59:48,56,11537,32,24,7187.60,13245.02,0.00
2024-12-08 16:59:48,55,11537,32,23,7294.21,13245.11,0.00
2024-12-08 16:59:48,54,11537,31,23,7306.14,13245.81,0.00
2024-12-08 16:59:48,54,11538,31,23,7527.05,13246.00,0.00
2024-12-08 16:59:48,55,11538,31,24,7390.19,13246.02,0.00
2024-12-08 16:59:48,55,11539,31,24,7387.19,13247.00,0.00
2024-12-08 16:59:48,56,11539,32,24,7255.27,13247.02,0.00
2024-12-08 16:59:48,56,11540,32,24,7220.34,13248.00,0.00
2024-12-08 16:59:48,57,11540,32,25,7093.66,13248.02,0.00
2024-12-08 16:59:48,56,11540,31,25,7208.60,13248.09,0.00
2024-12-08 16:59:48,55,11540,31,24,7332.44,13248.09,0.00
2024-12-08 16:59:48,55,11541,31,24,7357.07,13249.00,0.00
2024-12-08 16:59:48,56,11541,31,25,7225.69,13249.02,0.00
2024-12-08 16:59:48,55,11541,30,25,7161.39,13249.85,0.00
2024-12-08 16:59:48,55,11542,30,25,7383.15,13250.00,0.00
2024-12-08 16:59:48,56,11542,30,26,7251.30,13250.02,0.00
2024-12-08 16:59:48,56,11543,30,26,7216.36,13251.00,0.00
2024-12-08 16:59:48,57,11543,31,26,7089.75,13251.02,0.00
2024-12-08 16:59:48,56,11543,31,25,7204.53,13251.09,0.00
2024-12-08 16:59:48,55,11543,30,25,7212.96,13251.67,0.00
2024-12-08 16:59:48,55,11544,30,25,7410.80,13252.00,0.00
2024-12-08 16:59:48,56,11544,30,26,7278.47,13252.02,0.00
2024-12-08 16:59:48,56,11545,30,26,7268.87,13253.00,0.00
2024-12-08 16:59:48,57,11545,30,27,7141.35,13253.02,0.00
2024-12-08 16:59:48,56,11545,30,26,7212.08,13253.09,0.00
2024-12-08 16:59:48,55,11545,29,26,7208.47,13253.55,0.00
2024-12-08 16:59:48,55,11546,29,26,7389.54,13254.00,0.00
2024-12-08 16:59:48,56,11546,29,27,7257.59,13254.02,0.00
2024-12-08 16:59:48,55,11546,28,27,7387.13,13254.02,0.00
2024-12-08 16:59:48,55,11547,28,27,7379.23,13255.00,0.00
2024-12-08 16:59:48,56,11547,28,28,7247.46,13255.02,0.00
2024-12-08 16:59:48,55,11547,28,27,7326.22,13255.07,0.00
2024-12-08 16:59:48,54,11547,27,27,7401.55,13255.50,0.00
2024-12-08 16:59:48,54,11548,27,27,7581.12,13256.00,0.00
2024-12-08 16:59:48,55,11548,28,27,7443.28,13256.02,0.00
2024-12-08 16:59:48,55,11549,28,27,7430.18,13257.00,0.00
2024-12-08 16:59:48,56,11549,28,28,7297.49,13257.02,0.00
2024-12-08 16:59:48,55,11549,27,28,7427.77,13257.02,0.00
2024-12-08 16:59:48,54,11549,27,27,7516.22,13257.06,0.00
2024-12-08 16:59:48,54,11550,27,27,7535.57,13258.00,0.00
2024-12-08 16:59:48,55,11550,27,28,7398.56,13258.02,0.00
2024-12-08 16:59:48,55,11551,27,28,7393.15,13259.00,0.00
2024-12-08 16:59:48,56,11551,27,29,7261.13,13259.02,0.00
2024-12-08 16:59:48,55,11551,26,29,7383.52,13259.09,0.00
2024-12-08 16:59:48,54,11551,25,29,7364.00,13259.33,0.00
2024-12-08 16:59:48,54,11552,25,29,7514.86,13260.00,0.00
2024-12-08 16:59:48,55,11552,25,30,7378.23,13260.02,0.00
2024-12-08 16:59:48,54,11552,24,30,7505.04,13260.02,0.00
2024-12-08 16:59:48,53,11552,24,29,7621.66,13260.13,0.00
2024-12-08 16:59:48,53,11553,24,29,7748.98,13261.00,0.00
2024-12-08 16:59:48,54,11553,25,29,7605.48,13261.02,0.00
2024-12-08 16:59:48,53,11553,24,29,7739.00,13261.09,0.00
2024-12-08 16:59:49,53,11554,24,29,7751.03,13262.00,0.00
2024-12-08 16:59:49,54,11554,25,29,7607.49,13262.02,0.00
2024-12-08 16:59:49,53,11554,24,29,7643.50,13262.42,0.00
2024-12-08 16:59:49,52,11554,23,29,7786.63,13262.44,0.00
2024-12-08 16:59:49,52,11555,23,29,7862.82,13263.00,0.00
2024-12-08 16:59:49,53,11555,23,30,7714.47,13263.02,0.00
2024-12-08 16:59:49,52,11555,23,29,7809.32,13263.23,0.00
2024-12-08 16:59:49,52,11556,23,29,7851.20,13264.00,0.00
2024-12-08 16:59:49,53,11556,24,29,7703.07,13264.02,0.00
2024-12-08 16:59:49,52,11556,23,29,7848.65,13264.02,0.00
2024-12-08 16:59:49,52,11557,23,29,7849.20,13265.00,0.00
2024-12-08 16:59:49,53,11557,23,30,7701.10,13265.02,0.00
2024-12-08 16:59:49,53,11558,23,30,7655.89,13266.00,0.00
2024-12-08 16:59:49,54,11558,23,31,7514.12,13266.02,0.00
2024-12-08 16:59:49,53,11558,23,30,7610.89,13266.21,0.00
2024-12-08 16:59:49,53,11559,23,30,7633.72,13267.00,0.00
2024-12-08 16:59:49,54,11559,24,30,7492.36,13267.02,0.00
2024-12-08 16:59:49,53,11559,23,30,7492.98,13267.45,0.00
2024-12-08 16:59:49,53,11560,23,30,7658.49,13268.00,0.00
2024-12-08 16:59:49,54,11560,24,30,7516.66,13268.02,0.00
2024-12-08 16:59:49,53,11560,23,30,7643.50,13268.13,0.00
2024-12-08 16:59:49,53,11561,23,30,7613.01,13269.00,0.00
2024-12-08 16:59:49,54,11561,23,31,7472.03,13269.02,0.00
2024-12-08 16:59:49,53,11561,22,31,7598.02,13269.13,0.00
2024-12-08 16:59:49,52,11561,22,30,7723.74,13269.17,0.00
2024-12-08 16:59:49,52,11562,22,30,7753.69,13270.00,0.00
2024-12-08 16:59:49,53,11562,23,30,7607.40,13270.02,0.00
2024-12-08 16:59:49,52,11562,22,30,7515.98,13270.90,0.00
2024-12-08 16:59:49,52,11563,22,30,7749.90,13271.00,0.00
2024-12-08 16:59:49,53,11563,22,31,7603.68,13271.02,0.00
2024-12-08 16:59:49,52,11563,21,31,7622.06,13271.19,0.00
2024-12-08 16:59:49,52,11564,21,31,7762.92,13272.00,0.00
2024-12-08 16:59:49,53,11564,21,32,7616.45,13272.02,0.00
2024-12-08 16:59:49,52,11564,21,31,7727.23,13272.17,0.00
2024-12-08 16:59:49,51,11564,20,31,7852.73,13272.20,0.00
2024-12-08 16:59:49,51,11565,20,31,8004.82,13273.00,0.00
2024-12-08 16:59:49,52,11565,20,32,7850.88,13273.02,0.00
2024-12-08 16:59:49,52,11566,20,32,7851.28,13274.00,0.00
2024-12-08 16:59:49,53,11566,21,32,7703.14,13274.02,0.00
2024-12-08 16:59:49,53,11567,21,32,7673.51,13275.00,0.00
2024-12-08 16:59:49,54,11567,22,32,7531.41,13275.02,0.00
2024-12-08 16:59:49,53,11567,21,32,7658.51,13275.11,0.00
2024-12-08 16:59:49,52,11567,21,31,7787.94,13275.15,0.00
2024-12-08 16:59:49,52,11568,21,31,7828.61,13276.00,0.00
2024-12-08 16:59:49,53,11568,21,32,7680.90,13276.02,0.00
2024-12-08 16:59:49,53,11569,21,32,7677.12,13277.00,0.00
2024-12-08 16:59:49,54,11569,21,33,7534.95,13277.02,0.00
2024-12-08 16:59:49,53,11569,20,33,7498.85,13277.34,0.00
2024-12-08 16:59:49,53,11570,20,33,7656.75,13278.00,0.00
2024-12-08 16:59:49,54,11570,21,33,7514.96,13278.02,0.00
2024-12-08 16:59:49,53,11570,20,33,7576.60,13278.09,0.00
2024-12-08 16:59:49,52,11570,20,32,7707.00,13278.13,0.00
2024-12-08 16:59:49,51,11570,19,32,7817.37,13278.43,0.00
2024-12-08 16:59:49,51,11571,19,32,7997.44,13279.00,0.00
2024-12-08 16:59:49,52,11571,20,32,7843.64,13279.02,0.00
2024-12-08 16:59:49,51,11571,19,32,7832.31,13279.59,0.00
2024-12-08 16:59:49,51,11572,19,32,8034.60,13280.00,0.00
2024-12-08 16:59:49,52,11572,20,32,7880.09,13280.02,0.00
2024-12-08 16:59:49,52,11573,20,32,7846.91,13281.00,0.00
2024-12-08 16:59:49,53,11573,20,33,7698.86,13281.02,0.00
2024-12-08 16:59:49,52,11573,20,32,7821.40,13281.13,0.00
2024-12-08 16:59:49,52,11574,20,32,7852.19,13282.00,0.00
2024-12-08 16:59:49,53,11574,21,32,7704.04,13282.02,0.00
2024-12-08 16:59:49,52,11574,20,32,7740.20,13282.46,0.00
2024-12-08 16:59:49,52,11575,20,32,7837.46,13283.00,0.00
2024-12-08 16:59:49,53,11575,21,32,7689.59,13283.02,0.00
2024-12-08 16:59:49,53,11576,21,32,7651.23,13284.00,0.00
2024-12-08 16:59:49,54,11576,22,32,7509.54,13284.02,0.00
2024-12-08 16:59:49,53,11576,22,31,7631.20,13284.13,0.00
2024-12-08 16:59:49,53,11577,22,31,7657.39,13285.00,0.00
2024-12-08 16:59:49,54,11577,23,31,7515.58,13285.02,0.00
2024-12-08 16:59:49,54,11578,23,31,7505.77,13286.00,0.00
2024-12-08 16:59:49,55,11578,24,31,7369.30,13286.02,0.00
2024-12-08 16:59:49,55,11579,24,31,7320.15,13287.00,0.00
2024-12-08 16:59:49,56,11579,25,31,7189.43,13287.02,0.00
2024-12-08 16:59:49,55,11579,25,30,7291.18,13287.15,0.00
2024-12-08 16:59:49,55,11580,25,30,7295.90,13288.00,0.00
2024-12-08 16:59:49,56,11580,25,31,7165.62,13288.02,0.00
2024-12-08 16:59:49,56,11581,25,31,7126.41,13289.00,0.00
2024-12-08 16:59:49,57,11581,25,32,7001.38,13289.02,0.00
2024-12-08 16:59:50,56,11581,24,32,6836.49,13289.96,0.00
2024-12-08 16:59:50,56,11582,24,32,7069.08,13290.00,0.00
2024-12-08 16:59:50,57,11582,25,32,6945.06,13290.02,0.00
2024-12-08 16:59:50,56,11582,25,31,7045.37,13290.14,0.00
2024-12-08 16:59:50,56,11583,25,31,7025.29,13291.00,0.00
2024-12-08 16:59:50,57,11583,25,32,6902.03,13291.02,0.00
2024-12-08 16:59:50,56,11583,25,31,6868.08,13291.59,0.00
2024-12-08 16:59:50,56,11584,25,31,6988.43,13292.00,0.00
2024-12-08 16:59:50,57,11584,25,32,6865.83,13292.02,0.00
2024-12-08 16:59:50,56,11584,24,32,6733.92,13292.91,0.00
2024-12-08 16:59:50,56,11585,24,32,6959.48,13293.00,0.00
2024-12-08 16:59:50,57,11585,25,32,6837.39,13293.02,0.00
2024-12-08 16:59:50,56,11585,25,31,6940.51,13293.14,0.00
2024-12-08 16:59:50,56,11586,25,31,6946.38,13294.00,0.00
2024-12-08 16:59:50,57,11586,25,32,6824.52,13294.02,0.00
2024-12-08 16:59:50,57,11586,25,32,6800.86,13295.00,0.00
2024-12-08 16:59:50,58,11586,25,33,6683.60,13295.02,0.00
2024-12-08 16:59:50,57,11586,24,33,6798.52,13295.02,0.00
2024-12-08 16:59:50,56,11586,24,32,6855.84,13295.13,0.00
2024-12-08 16:59:50,55,11586,24,31,6921.47,13295.53,0.00
2024-12-08 16:59:50,54,11586,23,31,6969.17,13295.78,0.00
2024-12-08 16:59:50,54,11587,23,31,7186.00,13296.00,0.00
2024-12-08 16:59:50,55,11587,23,32,7055.35,13296.02,0.00
2024-12-08 16:59:50,54,11587,22,32,7112.15,13296.15,0.00
2024-12-08 16:59:50,54,11588,22,32,7245.64,13297.00,0.00
2024-12-08 16:59:50,55,11588,23,32,7113.90,13297.02,0.00
2024-12-08 16:59:50,54,11588,22,32,7243.18,13297.02,0.00
2024-12-08 16:59:50,53,11588,22,31,7314.63,13297.11,0.00
2024-12-08 16:59:50,53,11589,22,31,7448.14,13298.00,0.00
2024-12-08 16:59:50,54,11589,22,32,7310.21,13298.02,0.00
2024-12-08 16:59:50,54,11590,22,32,7309.95,13299.00,0.00
2024-12-08 16:59:50,55,11590,22,33,7177.04,13299.02,0.00
2024-12-08 16:59:50,54,11590,21,33,7307.48,13299.02,0.00
2024-12-08 16:59:50,53,11590,20,33,7258.67,13299.62,0.00
2024-12-08 16:59:50,53,11591,20,33,7459.71,13300.00,0.00
2024-12-08 16:59:50,54,11591,21,33,7321.56,13300.02,0.00
2024-12-08 16:59:50,53,11591,21,32,7444.66,13300.09,0.00
2024-12-08 16:59:50,53,11592,21,32,7475.23,13301.00,0.00
2024-12-08 16:59:50,54,11592,21,33,7336.80,13301.02,0.00
2024-12-08 16:59:50,53,11592,20,33,7472.72,13301.02,0.00
2024-12-08 16:59:50,53,11593,20,33,7470.37,13302.00,0.00
2024-12-08 16:59:50,54,11593,21,33,7332.03,13302.02,0.00
2024-12-08 16:59:50,53,11593,21,32,7410.14,13302.08,0.00
2024-12-08 16:59:50,52,11593,20,32,7470.90,13302.67,0.00
2024-12-08 16:59:50,52,11594,20,32,7578.49,13303.00,0.00
2024-12-08 16:59:50,53,11594,21,32,7435.50,13303.02,0.00
2024-12-08 16:59:50,53,11595,21,32,7422.44,13304.00,0.00
2024-12-08 16:59:50,54,11595,22,32,7284.99,13304.02,0.00
2024-12-08 16:59:50,53,11595,22,31,7364.72,13304.08,0.00
2024-12-08 16:59:50,52,11595,21,31,7437.45,13304.54,0.00
2024-12-08 16:59:50,52,11596,21,31,7524.02,13305.00,0.00
2024-12-08 16:59:50,53,11596,21,32,7382.06,13305.02,0.00
2024-12-08 16:59:50,52,11596,20,32,7413.94,13305.40,0.00
2024-12-08 16:59:50,52,11597,20,32,7506.48,13306.00,0.00
2024-12-08 16:59:50,53,11597,21,32,7364.84,13306.02,0.00
2024-12-08 16:59:50,52,11597,21,31,7450.19,13306.08,0.00
2024-12-08 16:59:50,51,11597,20,31,7399.15,13306.96,0.00
2024-12-08 16:59:50,51,11598,20,31,7654.87,13307.00,0.00
2024-12-08 16:59:50,52,11598,20,32,7507.66,13307.02,0.00
2024-12-08 16:59:50,51,11598,19,32,7436.34,13307.65,0.00
2024-12-08 16:59:50,51,11599,19,32,7643.08,13308.00,0.00
2024-12-08 16:59:50,52,11599,19,33,7496.10,13308.02,0.00
2024-12-08 16:59:50,51,11599,19,32,7583.07,13308.10,0.00
2024-12-08 16:59:50,50,11599,18,32,7670.69,13308.56,0.00
2024-12-08 16:59:50,50,11600,18,32,7872.14,13309.00,0.00
2024-12-08 16:59:50,51,11600,19,32,7717.78,13309.02,0.00
2024-12-08 16:59:50,50,11600,18,32,7869.47,13309.02,0.00
2024-12-08 16:59:50,50,11601,18,32,7861.86,13310.00,0.00
2024-12-08 16:59:50,51,11601,18,33,7707.71,13310.02,0.00
2024-12-08 16:59:50,50,11601,18,32,7803.30,13310.08,0.00
2024-12-08 16:59:50,49,11601,17,32,7894.72,13310.55,0.00
2024-12-08 16:59:50,49,11602,17,32,8102.27,13311.00,0.00
2024-12-08 16:59:50,50,11602,17,33,7940.23,13311.02,0.00
2024-12-08 16:59:50,49,11602,16,33,8099.56,13311.02,0.00
2024-12-08 16:59:50,48,11602,15,33,8128.97,13311.54,0.00
2024-12-08 16:59:50,48,11603,15,33,8342.03,13312.00,0.00
2024-12-08 16:59:50,49,11603,15,34,8171.78,13312.02,0.00
2024-12-08 16:59:50,48,11603,15,33,8286.56,13312.06,0.00
2024-12-08 16:59:50,48,11604,15,33,8327.02,13313.00,0.00
2024-12-08 16:59:50,49,11604,15,34,8157.09,13313.02,0.00
2024-12-08 16:59:50,48,11604,14,34,8285.42,13313.02,0.00
2024-12-08 16:59:50,48,11605,14,34,8377.58,13314.00,0.00
2024-12-08 16:59:50,49,11605,14,35,8206.61,13314.02,0.00
2024-12-08 16:59:50,48,11605,14,34,8327.65,13314.04,0.00
2024-12-08 16:59:50,48,11606,14,34,8367.11,13315.00,0.00
2024-12-08 16:59:50,49,11606,14,35,8196.35,13315.02,0.00
2024-12-08 16:59:51,49,11606,14,35,8184.15,13316.00,0.00
2024-12-08 16:59:51,50,11606,15,35,8020.47,13316.02,0.00
2024-12-08 16:59:51,49,11606,14,35,8183.96,13316.02,0.00
2024-12-08 16:59:51,48,11606,14,34,8307.30,13316.02,0.00
2024-12-08 16:59:51,48,11607,14,34,8343.99,13317.00,0.00
2024-12-08 16:59:51,49,11607,14,35,8173.70,13317.02,0.00
2024-12-08 16:59:51,49,11608,14,35,8159.25,13318.00,0.00
2024-12-08 16:59:51,50,11608,14,36,7996.06,13318.02,0.00
2024-12-08 16:59:51,49,11608,14,35,8115.76,13318.02,0.00
2024-12-08 16:59:51,49,11609,14,35,8148.99,13319.00,0.00
2024-12-08 16:59:51,50,11609,14,36,7986.01,13319.02,0.00
2024-12-08 16:59:51,49,11609,13,36,7998.58,13319.65,0.00
2024-12-08 16:59:51,49,11610,13,36,8224.47,13320.00,0.00
2024-12-08 16:59:51,50,11610,13,37,8059.98,13320.02,0.00
2024-12-08 16:59:51,49,11610,13,36,8183.70,13320.02,0.00
2024-12-08 16:59:51,49,11611,13,36,8216.93,13321.00,0.00
2024-12-08 16:59:51,50,11611,13,37,8052.60,13321.02,0.00
2024-12-08 16:59:51,50,11612,13,37,8034.40,13322.00,0.00
2024-12-08 16:59:51,51,11612,13,38,7876.86,13322.02,0.00
2024-12-08 16:59:51,50,11612,13,37,7997.10,13322.02,0.00
2024-12-08 16:59:51,49,11612,12,37,7997.85,13322.90,0.00
2024-12-08 16:59:51,49,11613,12,37,8256.23,13323.00,0.00
2024-12-08 16:59:51,50,11613,13,37,8091.11,13323.02,0.00
2024-12-08 16:59:51,49,11613,12,37,8188.28,13323.12,0.00
2024-12-08 16:59:51,49,11614,12,37,8343.87,13324.00,0.00
2024-12-08 16:59:51,50,11614,12,38,8176.99,13324.02,0.00
2024-12-08 16:59:51,49,11614,12,37,8305.80,13324.02,0.00
2024-12-08 16:59:51,48,11614,11,37,8468.33,13324.08,0.00
2024-12-08 16:59:51,48,11615,11,37,8513.36,13325.00,0.00
2024-12-08 16:59:51,49,11615,12,37,8339.62,13325.02,0.00
2024-12-08 16:59:51,48,11615,11,37,8435.66,13325.10,0.00
2024-12-08 16:59:51,48,11616,11,37,8594.51,13326.00,0.00
2024-12-08 16:59:51,49,11616,12,37,8419.12,13326.02,0.00
2024-12-08 16:59:51,48,11616,12,36,8558.42,13326.02,0.00
2024-12-08 16:59:51,48,11617,12,36,8595.16,13327.00,0.00
2024-12-08 16:59:51,49,11617,13,36,8419.75,13327.02,0.00
2024-12-08 16:59:51,49,11618,13,36,8398.62,13328.00,0.00
2024-12-08 16:59:51,50,11618,13,37,8230.65,13328.02,0.00
2024-12-08 16:59:51,49,11618,13,36,8365.98,13328.02,0.00
2024-12-08 16:59:51,49,11619,13,36,8399.25,13329.00,0.00
2024-12-08 16:59:51,50,11619,14,36,8231.26,13329.02,0.00
2024-12-08 16:59:51,50,11620,14,36,8207.89,13330.00,0.00
2024-12-08 16:59:51,51,11620,15,36,8046.95,13330.02,0.00
2024-12-08 16:59:51,50,11620,15,35,8178.56,13330.02,0.00
2024-12-08 16:59:51,50,11621,15,35,8208.50,13331.00,0.00
2024-12-08 16:59:51,51,11621,15,36,8047.55,13331.02,0.00
2024-12-08 16:59:51,51,11622,15,36,8022.01,13332.00,0.00
2024-12-08 16:59:51,52,11622,16,36,7867.74,13332.02,0.00
2024-12-08 16:59:51,51,11622,16,35,7990.64,13332.02,0.00
2024-12-08 16:59:51,50,11622,15,35,8009.64,13332.84,0.00
2024-12-08 16:59:51,50,11623,15,35,8255.06,13333.00,0.00
2024-12-08 16:59:51,51,11623,16,35,8093.20,13333.02,0.00
2024-12-08 16:59:51,50,11623,15,35,8126.61,13333.58,0.00
2024-12-08 16:59:51,50,11624,15,35,8234.21,13334.00,0.00
2024-12-08 16:59:51,51,11624,15,36,8072.75,13334.02,0.00
2024-12-08 16:59:51,50,11624,15,35,8191.54,13334.02,0.00
2024-12-08 16:59:51,50,11625,15,35,8221.49,13335.00,0.00
2024-12-08 16:59:51,51,11625,16,35,8060.29,13335.02,0.00
2024-12-08 16:59:51,51,11626,16,35,8037.51,13336.00,0.00
2024-12-08 16:59:51,52,11626,17,35,7882.94,13336.02,0.00
2024-12-08 16:59:51,51,11626,16,35,7945.98,13336.02,0.00
2024-12-08 16:59:51,50,11626,16,34,8062.23,13336.02,0.00
2024-12-08 16:59:51,50,11627,16,34,8198.74,13337.00,0.00
2024-12-08 16:59:51,51,11627,16,35,8037.98,13337.02,0.00
2024-12-08 16:59:51,51,11628,16,35,8014.21,13338.00,0.00
2024-12-08 16:59:51,52,11628,17,35,7860.09,13338.02,0.00
2024-12-08 16:59:51,51,11628,17,34,7974.98,13338.02,0.00
2024-12-08 16:59:51,51,11629,17,34,7998.90,13339.00,0.00
2024-12-08 16:59:51,52,11629,17,35,7845.08,13339.02,0.00
2024-12-08 16:59:51,51,11629,16,35,7832.11,13339.37,0.00
2024-12-08 16:59:51,51,11630,16,35,8010.21,13340.00,0.00
2024-12-08 16:59:51,52,11630,17,35,7856.16,13340.02,0.00
2024-12-08 16:59:51,51,11630,17,34,7973.59,13340.02,0.00
2024-12-08 16:59:51,50,11630,16,34,8023.68,13340.06,0.00
2024-12-08 16:59:51,50,11631,16,34,8157.84,13341.00,0.00
2024-12-08 16:59:51,51,11631,16,35,7997.88,13341.02,0.00
2024-12-08 16:59:52,51,11632,16,35,7968.42,13342.00,0.00
2024-12-08 16:59:52,52,11632,16,36,7815.18,13342.02,0.00
2024-12-08 16:59:52,51,11632,16,35,7929.17,13342.02,0.00
2024-12-08 16:59:52,51,11633,16,35,7945.44,13343.00,0.00
2024-12-08 16:59:52,52,11633,16,36,7792.64,13343.02,0.00
2024-12-08 16:59:52,52,11634,16,36,7764.04,13344.00,0.00
2024-12-08 16:59:52,53,11634,17,36,7617.55,13344.02,0.00
2024-12-08 16:59:52,52,11634,17,35,7728.11,13344.02,0.00
2024-12-08 16:59:52,52,11635,17,35,7745.08,13345.00,0.00
2024-12-08 16:59:52,53,11635,18,35,7598.95,13345.02,0.00
2024-12-08 16:59:52,54,11634,18,36,7332.06,13345.59,0.00
2024-12-08 16:59:52,54,11635,18,36,7497.82,13346.00,0.00
2024-12-08 16:59:52,55,11635,19,36,7361.50,13346.02,0.00
2024-12-08 16:59:52,54,11635,19,35,7458.28,13346.02,0.00
2024-12-08 16:59:52,54,11636,19,35,7719.01,13347.00,0.00
2024-12-08 16:59:52,55,11636,20,35,7578.66,13347.02,0.00
2024-12-08 16:59:52,54,11636,19,35,7654.76,13347.06,0.00
2024-12-08 16:59:52,53,11636,18,35,7718.16,13347.62,0.00
2024-12-08 16:59:52,53,11637,18,35,7919.90,13348.00,0.00
2024-12-08 16:59:52,54,11637,19,35,7773.23,13348.02,0.00
2024-12-08 16:59:52,53,11637,19,34,7867.01,13348.02,0.00
2024-12-08 16:59:52,52,11637,18,34,7939.45,13348.60,0.00
2024-12-08 16:59:52,52,11638,18,34,8039.84,13349.00,0.00
2024-12-08 16:59:52,53,11638,19,34,7888.14,13349.02,0.00
2024-12-08 16:59:52,53,11639,19,34,7875.97,13350.00,0.00
2024-12-08 16:59:52,54,11639,19,35,7730.12,13350.02,0.00
2024-12-08 16:59:52,53,11639,19,34,7825.59,13350.02,0.00
2024-12-08 16:59:52,52,11639,19,33,7964.90,13350.10,0.00
2024-12-08 16:59:52,52,11640,19,33,7998.85,13351.00,0.00
2024-12-08 16:59:52,53,11640,19,34,7847.92,13351.02,0.00
2024-12-08 16:59:52,53,11641,19,34,7835.70,13352.00,0.00
2024-12-08 16:59:52,54,11641,19,35,7690.59,13352.02,0.00
2024-12-08 16:59:52,53,11641,19,34,7785.32,13352.02,0.00
2024-12-08 16:59:52,52,11641,18,34,7750.88,13352.94,0.00
2024-12-08 16:59:52,52,11642,18,34,8000.00,13353.00,0.00
2024-12-08 16:59:52,53,11642,18,35,7849.05,13353.02,0.00
2024-12-08 16:59:52,53,11643,18,35,7834.88,13354.00,0.00
2024-12-08 16:59:52,54,11643,19,35,7689.79,13354.02,0.00
2024-12-08 16:59:52,53,11643,19,34,7787.01,13354.02,0.00
2024-12-08 16:59:52,52,11643,18,34,7741.96,13354.92,0.00
2024-12-08 16:59:52,52,11644,18,34,7988.57,13355.00,0.00
2024-12-08 16:59:52,53,11644,19,34,7837.85,13355.02,0.00
2024-12-08 16:59:52,53,11645,19,34,7824.88,13356.00,0.00
2024-12-08 16:59:52,54,11645,19,35,7679.98,13356.02,0.00
2024-12-08 16:59:52,53,11645,19,34,7774.49,13356.04,0.00
2024-12-08 16:59:52,52,11645,18,34,7776.43,13356.83,0.00
2024-12-08 16:59:52,52,11646,18,34,8010.32,13357.00,0.00
2024-12-08 16:59:52,53,11646,18,35,7859.18,13357.02,0.00
2024-12-08 16:59:52,52,11646,17,35,7874.09,13357.63,0.00
2024-12-08 16:59:52,52,11647,17,35,8082.44,13358.00,0.00
2024-12-08 16:59:52,53,11647,17,36,7929.94,13358.02,0.00
2024-12-08 16:59:52,52,11647,17,35,8031.07,13358.04,0.00
2024-12-08 16:59:52,51,11647,16,35,8185.77,13358.04,0.00
2024-12-08 16:59:52,50,11647,15,35,8271.79,13358.62,0.00
2024-12-08 16:59:52,50,11648,15,35,8405.54,13359.00,0.00
2024-12-08 16:59:52,51,11648,16,35,8240.72,13359.02,0.00
2024-12-08 16:59:52,50,11648,15,35,8275.01,13359.58,0.00
2024-12-08 16:59:52,49,11648,14,35,8266.58,13359.82,0.00
2024-12-08 16:59:52,49,11649,14,35,8514.85,13360.00,0.00
2024-12-08 16:59:52,50,11649,15,35,8344.56,13360.02,0.00
2024-12-08 16:59:52,49,11649,15,34,8460.33,13360.04,0.00
2024-12-08 16:59:52,49,11650,15,34,8496.40,13361.00,0.00
2024-12-08 16:59:52,50,11650,15,35,8326.47,13361.02,0.00
2024-12-08 16:59:52,50,11651,15,35,8309.18,13362.00,0.00
2024-12-08 16:59:52,51,11651,15,36,8146.25,13362.02,0.00
2024-12-08 16:59:52,50,11651,15,35,8258.41,13362.04,0.00
2024-12-08 16:59:52,50,11652,15,35,8291.09,13363.00,0.00
2024-12-08 16:59:52,51,11652,15,36,8128.52,13363.02,0.00
2024-12-08 16:59:52,51,11653,15,36,8110.90,13364.00,0.00
2024-12-08 16:59:52,52,11653,15,37,7954.92,13364.02,0.00
2024-12-08 16:59:52,51,11653,15,36,8061.12,13364.04,0.00
2024-12-08 16:59:52,50,11653,14,36,8147.48,13364.60,0.00
2024-12-08 16:59:52,50,11654,14,36,8254.70,13365.00,0.00
2024-12-08 16:59:52,51,11654,15,36,8092.84,13365.02,0.00
2024-12-08 16:59:52,50,11654,14,36,8094.50,13365.40,0.00
2024-12-08 16:59:52,50,11655,14,36,8282.05,13366.00,0.00
2024-12-08 16:59:52,51,11655,14,37,8119.66,13366.02,0.00
2024-12-08 16:59:52,50,11655,14,36,8223.25,13366.06,0.00
2024-12-08 16:59:52,50,11656,14,36,8258.61,13367.00,0.00
2024-12-08 16:59:52,51,11656,14,37,8096.67,13367.02,0.00
2024-12-08 16:59:52,51,11657,14,37,8082.74,13368.00,0.00
2024-12-08 16:59:52,52,11657,14,38,7927.30,13368.02,0.00
2024-12-08 16:59:52,51,11657,14,37,8022.47,13368.08,0.00
2024-12-08 16:59:53,51,11658,14,37,8057.13,13369.00,0.00
2024-12-08 16:59:53,52,11658,14,38,7902.19,13369.02,0.00
2024-12-08 16:59:53,52,11659,14,38,7889.75,13370.00,0.00
2024-12-08 16:59:53,53,11659,14,39,7740.89,13370.02,0.00
2024-12-08 16:59:53,52,11659,14,38,7833.21,13370.08,0.00
2024-12-08 16:59:53,51,11659,13,38,7914.08,13370.61,0.00
2024-12-08 16:59:53,51,11660,13,38,8019.23,13371.00,0.00
2024-12-08 16:59:53,52,11660,14,38,7865.01,13371.02,0.00
2024-12-08 16:59:53,51,11660,13,38,7824.46,13371.80,0.00
2024-12-08 16:59:53,51,11661,13,38,8060.60,13372.00,0.00
2024-12-08 16:59:53,52,11661,14,38,7905.58,13372.02,0.00
2024-12-08 16:59:53,51,11661,14,37,8002.93,13372.08,0.00
2024-12-08 16:59:53,51,11662,14,37,8037.60,13373.00,0.00
2024-12-08 16:59:53,52,11662,15,37,7883.03,13373.02,0.00
2024-12-08 16:59:53,51,11662,14,37,7885.75,13373.67,0.00
2024-12-08 16:59:53,51,11663,14,37,8103.65,13374.00,0.00
2024-12-08 16:59:53,52,11663,14,38,7947.81,13374.02,0.00
2024-12-08 16:59:53,51,11663,14,37,8048.59,13374.08,0.00
2024-12-08 16:59:53,51,11664,14,37,8083.27,13375.00,0.00
2024-12-08 16:59:53,52,11664,14,38,7927.83,13375.02,0.00
2024-12-08 16:59:53,52,11665,14,38,7909.52,13376.00,0.00
2024-12-08 16:59:53,53,11665,14,39,7760.28,13376.02,0.00
2024-12-08 16:59:53,52,11665,14,38,7858.08,13376.08,0.00
2024-12-08 16:59:53,52,11666,14,38,7888.28,13377.00,0.00
2024-12-08 16:59:53,53,11666,15,38,7739.44,13377.02,0.00
2024-12-08 16:59:53,52,11666,14,38,7663.78,13377.92,0.00
2024-12-08 16:59:53,52,11667,14,38,7910.81,13378.00,0.00
2024-12-08 16:59:53,53,11667,14,39,7761.55,13378.02,0.00
2024-12-08 16:59:53,52,11667,14,38,7873.04,13378.08,0.00
2024-12-08 16:59:53,52,11668,14,38,7904.49,13379.00,0.00
2024-12-08 16:59:53,53,11668,14,39,7755.35,13379.02,0.00
2024-12-08 16:59:53,53,11669,14,39,7731.75,13380.00,0.00
2024-12-08 16:59:53,54,11669,14,40,7588.57,13380.02,0.00
2024-12-08 16:59:53,53,11669,14,39,7686.32,13380.08,0.00
2024-12-08 16:59:53,52,11669,13,39,7661.51,13380.96,0.00
2024-12-08 16:59:53,52,11670,13,39,7910.32,13381.00,0.00
2024-12-08 16:59:53,53,11670,13,40,7761.07,13381.02,0.00
2024-12-08 16:59:53,52,11670,12,40,7782.09,13381.58,0.00
2024-12-08 16:59:53,52,11671,12,40,7883.19,13382.00,0.00
2024-12-08 16:59:53,53,11671,13,40,7734.45,13382.02,0.00
2024-12-08 16:59:53,52,11671,13,39,7839.45,13382.08,0.00
2024-12-08 16:59:53,51,11671,12,39,7919.22,13382.63,0.00
2024-12-08 16:59:53,50,11671,11,39,8016.12,13382.84,0.00
2024-12-08 16:59:53,50,11672,11,39,8255.53,13383.00,0.00
2024-12-08 16:59:53,51,11672,12,39,8093.65,13383.02,0.00
2024-12-08 16:59:53,51,11673,12,39,8060.12,13384.00,0.00
2024-12-08 16:59:53,52,11673,13,39,7905.12,13384.02,0.00
2024-12-08 16:59:53,51,11673,13,38,8015.51,13384.08,0.00
2024-12-08 16:59:53,51,11674,13,38,7854.94,13385.00,0.00
2024-12-08 16:59:53,52,11674,14,38,7703.88,13385.02,0.00
2024-12-08 16:59:53,51,11674,14,37,7545.51,13385.82,0.00
2024-12-08 16:59:53,51,11675,14,37,7604.80,13386.00,0.00
2024-12-08 16:59:53,52,11675,15,37,7458.55,13386.02,0.00
2024-12-08 16:59:53,51,11675,15,36,7562.81,13386.08,0.00
2024-12-08 16:59:53,50,11675,15,35,7473.13,13386.86,0.00
2024-12-08 16:59:53,50,11676,15,35,7722.23,13387.00,0.00
2024-12-08 16:59:53,51,11676,16,35,7570.82,13387.02,0.00
2024-12-08 16:59:53,51,11677,16,35,7554.08,13388.00,0.00
2024-12-08 16:59:53,52,11677,16,36,7408.81,13388.02,0.00
2024-12-08 16:59:53,51,11677,16,35,7514.71,13388.08,0.00
2024-12-08 16:59:53,50,11677,15,35,7640.95,13388.20,0.00
2024-12-08 16:59:53,50,11678,15,35,7802.14,13389.00,0.00
2024-12-08 16:59:53,51,11678,16,35,7649.15,13389.02,0.00
2024-12-08 16:59:53,51,11679,16,35,7628.28,13390.00,0.00
2024-12-08 16:59:53,52,11679,16,36,7481.58,13390.02,0.00
2024-12-08 16:59:53,51,11679,16,35,7591.53,13390.08,0.00
2024-12-08 16:59:53,50,11679,15,35,7732.68,13390.16,0.00
2024-12-08 16:59:53,50,11680,15,35,7781.43,13391.00,0.00
2024-12-08 16:59:53,51,11680,15,36,7628.85,13391.02,0.00
2024-12-08 16:59:53,50,11680,14,36,7576.12,13391.86,0.00
2024-12-08 16:59:53,50,11681,14,36,7825.31,13392.00,0.00
2024-12-08 16:59:53,51,11681,15,36,7671.87,13392.02,0.00
2024-12-08 16:59:53,51,11682,15,36,7654.10,13393.00,0.00
2024-12-08 16:59:53,52,11682,16,36,7506.91,13393.02,0.00
2024-12-08 16:59:53,51,11682,15,36,7651.47,13393.02,0.00
2024-12-08 16:59:53,50,11682,15,35,7764.33,13393.06,0.00
2024-12-08 16:59:54,50,11683,15,35,7799.73,13394.00,0.00
2024-12-08 16:59:54,51,11683,15,36,7646.80,13394.02,0.00
2024-12-08 16:59:54,51,11683,15,36,7621.10,13395.00,0.00
2024-12-08 16:59:54,52,11683,15,37,7474.54,13395.02,0.00
2024-12-08 16:59:54,51,11683,15,36,7594.84,13395.06,0.00
2024-12-08 16:59:54,50,11683,14,36,7738.60,13395.12,0.00
2024-12-08 16:59:54,50,11684,14,36,7782.02,13396.00,0.00
2024-12-08 16:59:54,51,11684,14,37,7629.43,13396.02,0.00
2024-12-08 16:59:54,50,11684,13,37,7671.75,13396.26,0.00
2024-12-08 16:59:54,50,11685,13,37,7841.05,13397.00,0.00
2024-12-08 16:59:54,51,11685,14,37,7687.30,13397.02,0.00
2024-12-08 16:59:54,50,11685,14,36,7814.26,13397.06,0.00
2024-12-08 16:59:54,50,11686,14,36,7849.67,13398.00,0.00
2024-12-08 16:59:54,51,11686,15,36,7695.76,13398.02,0.00
2024-12-08 16:59:54,51,11687,15,36,7670.06,13399.00,0.00
2024-12-08 16:59:54,52,11687,16,36,7522.56,13399.02,0.00
2024-12-08 16:59:54,51,11687,16,35,7638.54,13399.06,0.00
2024-12-08 16:59:54,51,11688,16,35,7670.63,13400.00,0.00
2024-12-08 16:59:54,52,11688,17,35,7523.12,13400.02,0.00
2024-12-08 16:59:54,52,11689,17,35,7499.06,13401.00,0.00
2024-12-08 16:59:54,53,11689,18,35,7357.57,13401.02,0.00
2024-12-08 16:59:54,52,11689,18,34,7465.56,13401.06,0.00
2024-12-08 16:59:54,52,11690,18,34,7494.46,13402.00,0.00
2024-12-08 16:59:54,53,11690,19,34,7353.06,13402.02,0.00
2024-12-08 16:59:54,53,11691,19,34,7332.36,13403.00,0.00
2024-12-08 16:59:54,54,11691,19,35,7196.58,13403.02,0.00
2024-12-08 16:59:54,53,11691,19,34,7296.96,13403.06,0.00
2024-12-08 16:59:54,53,11692,19,34,7322.80,13404.00,0.00
2024-12-08 16:59:54,54,11692,19,35,7187.19,13404.02,0.00
2024-12-08 16:59:54,53,11692,18,35,7320.27,13404.02,0.00
2024-12-08 16:59:54,52,11692,17,35,7314.12,13404.06,0.00
2024-12-08 16:59:54,52,11693,17,35,7446.13,13405.00,0.00
2024-12-08 16:59:54,53,11693,17,36,7305.64,13405.02,0.00
2024-12-08 16:59:54,52,11693,17,35,7410.04,13405.04,0.00
2024-12-08 16:59:54,51,11693,16,35,7407.44,13405.86,0.00
2024-12-08 16:59:54,51,11694,16,35,7651.99,13406.00,0.00
2024-12-08 16:59:54,52,11694,17,35,7504.84,13406.02,0.00
2024-12-08 16:59:54,51,11694,16,35,7649.36,13406.02,0.00
2024-12-08 16:59:54,51,11695,16,35,7631.70,13407.00,0.00
2024-12-08 16:59:54,52,11695,16,36,7484.93,13407.02,0.00
2024-12-08 16:59:54,51,11695,16,35,7597.52,13407.02,0.00
2024-12-08 16:59:54,51,11696,16,35,7624.38,13408.00,0.00
2024-12-08 16:59:54,52,11696,17,35,7477.76,13408.02,0.00
2024-12-08 16:59:54,51,11696,16,35,7401.19,13408.57,0.00
2024-12-08 16:59:54,51,11697,16,35,7606.54,13409.00,0.00
2024-12-08 16:59:54,52,11697,17,35,7460.26,13409.02,0.00
2024-12-08 16:59:54,51,11697,17,34,7572.36,13409.02,0.00
2024-12-08 16:59:54,50,11697,16,34,7651.64,13409.56,0.00
2024-12-08 16:59:54,50,11698,16,34,7753.85,13410.00,0.00
2024-12-08 16:59:54,51,11698,16,35,7601.82,13410.02,0.00
2024-12-08 16:59:54,51,11699,16,35,7577.30,13411.00,0.00
2024-12-08 16:59:54,52,11699,17,35,7431.58,13411.02,0.00
2024-12-08 16:59:54,51,11699,17,34,7545.75,13411.02,0.00
2024-12-08 16:59:54,50,11699,16,34,7521.62,13411.96,0.00
2024-12-08 16:59:54,50,11700,16,34,7784.52,13412.00,0.00
2024-12-08 16:59:54,51,11700,16,35,7631.88,13412.02,0.00
2024-12-08 16:59:54,50,11700,15,35,7642.67,13412.66,0.00
2024-12-08 16:59:54,50,11701,15,35,7759.04,13413.00,0.00
2024-12-08 16:59:54,51,11701,16,35,7606.91,13413.02,0.00
2024-12-08 16:59:54,50,11701,16,34,7729.54,13413.02,0.00
2024-12-08 16:59:54,50,11702,16,34,7759.62,13414.00,0.00
2024-12-08 16:59:54,51,11702,17,34,7607.47,13414.02,0.00
2024-12-08 16:59:54,51,11703,17,34,7582.02,13415.00,0.00
2024-12-08 16:59:54,52,11703,17,35,7436.21,13415.02,0.00
2024-12-08 16:59:54,51,11703,17,34,7553.09,13415.02,0.00
2024-12-08 16:59:54,50,11703,16,34,7548.47,13415.52,0.00
2024-12-08 16:59:54,50,11704,16,34,7751.97,13416.00,0.00
2024-12-08 16:59:54,51,11704,17,34,7599.97,13416.02,0.00
2024-12-08 16:59:54,51,11705,17,34,7581.09,13417.00,0.00
2024-12-08 16:59:54,52,11705,18,34,7435.30,13417.02,0.00
2024-12-08 16:59:54,51,11705,18,33,7544.26,13417.02,0.00
2024-12-08 16:59:54,51,11706,18,33,7569.13,13418.00,0.00
2024-12-08 16:59:54,52,11706,18,34,7423.57,13418.02,0.00
2024-12-08 16:59:54,52,11707,18,34,7403.67,13419.00,0.00
2024-12-08 16:59:54,53,11707,18,35,7263.98,13419.02,0.00
2024-12-08 16:59:54,52,11707,18,34,7370.12,13419.02,0.00
2024-12-08 16:59:54,52,11708,18,34,7391.72,13420.00,0.00
2024-12-08 16:59:54,53,11708,19,34,7252.25,13420.02,0.00
2024-12-08 16:59:54,52,11708,18,34,7155.56,13420.96,0.00
2024-12-08 16:59:55,52,11709,18,34,7408.51,13421.00,0.00
2024-12-08 16:59:55,53,11709,18,35,7268.73,13421.02,0.00
2024-12-08 16:59:55,52,11709,18,34,7377.54,13421.02,0.00
2024-12-08 16:59:55,52,11710,18,34,7399.36,13422.00,0.00
2024-12-08 16:59:55,53,11710,19,34,7259.75,13422.02,0.00
2024-12-08 16:59:55,53,11711,19,34,7237.45,13423.00,0.00
2024-12-08 16:59:55,54,11711,20,34,7103.43,13423.02,0.00
2024-12-08 16:59:55,53,11711,20,33,7209.59,13423.02,0.00
2024-12-08 16:59:55,53,11712,20,33,7229.01,13424.00,0.00
2024-12-08 16:59:55,54,11712,21,33,7095.14,13424.02,0.00
2024-12-08 16:59:55,54,11713,21,33,7076.91,13425.00,0.00
2024-12-08 16:59:55,55,11713,21,34,6948.23,13425.02,0.00
2024-12-08 16:59:55,54,11713,21,33,7047.07,13425.02,0.00
2024-12-08 16:59:55,54,11714,21,33,7065.00,13426.00,0.00
2024-12-08 16:59:55,55,11714,22,33,6936.55,13426.02,0.00
2024-12-08 16:59:55,54,11714,21,33,7000.39,13426.13,0.00
2024-12-08 16:59:55,53,11714,20,33,7033.27,13426.75,0.00
2024-12-08 16:59:55,53,11715,20,33,7253.84,13427.00,0.00
2024-12-08 16:59:55,54,11715,20,34,7119.51,13427.02,0.00
2024-12-08 16:59:55,53,11715,20,33,7225.98,13427.02,0.00
2024-12-08 16:59:55,53,11716,20,33,7246.78,13428.00,0.00
2024-12-08 16:59:55,54,11716,21,33,7112.58,13428.02,0.00
2024-12-08 16:59:55,54,11717,21,33,7090.83,13429.00,0.00
2024-12-08 16:59:55,55,11717,22,33,6961.91,13429.02,0.00
2024-12-08 16:59:55,54,11717,22,32,7065.96,13429.02,0.00
2024-12-08 16:59:55,54,11718,22,32,7083.90,13430.00,0.00
2024-12-08 16:59:55,55,11718,22,33,6955.10,13430.02,0.00
2024-12-08 16:59:55,54,11718,21,33,6957.00,13430.30,0.00
2024-12-08 16:59:55,53,11718,20,33,7044.91,13430.62,0.00
